"Ref_Date","GEO","Geographical_classification","VIOLATIONS","sum_Value_Actual_incidents","sum_Value_Cleared_by_charge","sum_Value_Cleared_otherwise","sum_Value_Percentage_change_in_rate","sum_Value_Rate_per_100_000_population","sum_Value_Rate_adult_charged_per_100_000_population_aged_18_years_and_over","sum_Value_Rate_total_persons_charged_per_100_000_population_aged_12_years_and_over","sum_Value_Rate_youth_charged_per_100_000_population_aged_12_to_17_years","sum_Value_Rate_youth_not_charged_per_100_000_population_aged_12_to_17_years","sum_Value_Total_cleared","sum_Value_Total_adult_charged","sum_Value_Total_persons_charged","sum_Value_Total_youth_charged","sum_Value_Total_youth_not_charged"
"1998","Alberta","48","Total, all violations","289665","92059","42137","0","9990.34","2926.1","3233.29","5754.83","3203.23","134196","62588","77584","14996","8347"
"1999","Alberta","48","Total, all violations","290612","89111","46014","-1.5","9840.4","2893.24","3165.19","5419.81","3375.17","135125","63385","77707","14322","8919"
"2000","Alberta","48","Total, all violations","286787","89370","41146","-3.01","9543.85","2949.81","3232.36","5602.42","4477.44","130516","66116","81086","14970","11964"
"2001","Alberta","48","Total, all violations","306773","91944","43254","5.11","10031.76","3133.47","3395.72","5619.17","5247.44","135198","71898","87105","15207","14201"
"2002","Alberta","48","Total, all violations","316476","92798","43761","0.84","10116.34","3103.76","3369.55","5635.2","5316.91","136559","73232","88830","15598","14717"
"2003","Alberta","48","Total, all violations","342201","93737","48595","6.26","10749.56","3135.71","3319.97","4910.39","5823.35","142332","75658","89384","13726","16278"
"2004","Alberta","48","Total, all violations","350224","94682","49102","0.57","10811.15","3149.83","3271.4","4338.53","5503.84","143784","77709","89902","12193","15468"
"2005","Alberta","48","Total, all violations","353060","92647","50632","-1.7","10627.3","2987.13","3092.97","4040.87","4898.04","143279","75907","87372","11465","13897"
"2006","Alberta","48","Total, all violations","348036","96532","59848","-4.28","10172.44","2890.17","2989.29","3896.22","5376.54","156380","75921","87107","11186","15436"
"2007","Alberta","48","Total, all violations","353358","95999","63579","-1.15","10055.63","2926.32","3066.03","4386.01","5308.52","159578","79332","91917","12585","15232"
"2008","Alberta","48","Total, all violations","361213","103180","68527","-0.1","10045.54","3095.97","3224.42","4478.5","5364.38","171707","86217","98992","12775","15302"
"2009","Alberta","48","Total, all violations","351582","102429","69733","-4.87","9556.22","3011.26","3116.13","4172.42","5127.43","172162","86066","97906","11840","14550"
"2010","Alberta","48","Total, all violations","338660","101518","69231","-5.06","9073.1","2934.65","3011.55","3804.16","4983.33","170749","85190","95904","10714","14035"
"2011","Alberta","48","Total, all violations","317298","99098","63251","-7.73","8371.56","2799.12","2862.4","3526.15","4191.48","162349","82568","92484","9916","11787"
"2012","Alberta","48","Total, all violations","318356","98781","60141","-2.01","8203.46","2730.42","2779.32","3307.61","3949.49","158922","82627","91892","9265","11063"
"2013","Alberta","48","Total, all violations","318310","97417","57253","-2.91","7964.48","2628.96","2655.81","2955.79","3347.49","154670","82121","90384","8263","9358"
"2014","Alberta","48","Total, all violations","328090","101772","55361","0.27","7986.06","2657.99","2665.84","2756.5","2969.23","157133","85503","93187","7684","8277"
"2015","Alberta","48","Total, all violations","369546","106799","54083","10.71","8841.53","2749.48","2736.44","2583.95","2815.34","160882","89924","97149","7225","7872"
"2016","Alberta","48","Total, all violations","374304","111845","49611","-0.46","8801.19","2878.89","2823.85","2177.45","2448.49","161456","95682","101844","6162","6929"
"1998","Alberta","48","Total, all Criminal Code violations (including traffic)","280518","86799","40523","0","9674.86","2743.35","3017.79","5270.53","3111.51","127322","58679","72413","13734","8108"
"1999","Alberta","48","Total, all Criminal Code violations (including traffic)","280872","83433","44575","-1.7","9510.59","2692.54","2933.02","4926.72","3276.78","128008","58988","72007","13019","8659"
"2000","Alberta","48","Total, all Criminal Code violations (including traffic)","276383","83380","39561","-3.29","9197.62","2723.43","2977","5103.93","4274.98","122941","61042","74680","13638","11423"
"2001","Alberta","48","Total, all Criminal Code violations (including traffic)","292888","85905","39665","4.13","9577.71","2917.69","3145.67","5078.58","4958.49","125570","66947","80691","13744","13419"
"2002","Alberta","48","Total, all Criminal Code violations (including traffic)","303896","86617","41173","1.43","9714.21","2893.58","3125.72","5104.48","5031.5","127790","68273","82402","14129","13927"
"2003","Alberta","48","Total, all Criminal Code violations (including traffic)","331951","88099","46580","7.34","10427.57","2941.29","3104.61","4514.36","5541.09","134679","70967","83586","12619","15489"
"2004","Alberta","48","Total, all Criminal Code violations (including traffic)","339371","89086","46930","0.47","10476.12","2951.5","3050.23","3916.88","5206.02","136016","72816","83824","11008","14631"
"2005","Alberta","48","Total, all Criminal Code violations (including traffic)","342068","86498","48766","-1.72","10296.43","2764.52","2853.03","3645.77","4654.84","135264","70250","80594","10344","13207"
"2006","Alberta","48","Total, all Criminal Code violations (including traffic)","337097","89658","57745","-4.31","9852.72","2644.7","2724.7","3456.65","5067.59","147403","69473","79397","9924","14549"
"2007","Alberta","48","Total, all Criminal Code violations (including traffic)","341455","88908","61238","-1.38","9716.9","2678.81","2793.34","3875.44","5019.6","150146","72622","83742","11120","14403"
"2008","Alberta","48","Total, all Criminal Code violations (including traffic)","348351","95833","65833","-0.3","9687.84","2850.67","2944.62","3861.85","5048.87","161666","79386","90402","11016","14402"
"2009","Alberta","48","Total, all Criminal Code violations (including traffic)","338278","95012","67063","-5.09","9194.61","2770.09","2849.13","3645.23","4808.51","162075","79173","89517","10344","13645"
"2010","Alberta","48","Total, all Criminal Code violations (including traffic)","323997","93409","66219","-5.59","8680.26","2672.12","2725.95","3280.8","4632.17","159628","77569","86809","9240","13046"
"2011","Alberta","48","Total, all Criminal Code violations (including traffic)","303008","91502","60161","-7.9","7994.53","2550.97","2591.9","3021.2","3840.15","151663","75248","83744","8496","10799"
"2012","Alberta","48","Total, all Criminal Code violations (including traffic)","303805","91247","56970","-2.08","7828.5","2495.14","2526.29","2862.78","3578.93","148217","75507","83526","8019","10025"
"2013","Alberta","48","Total, all Criminal Code violations (including traffic)","303872","90118","54084","-2.88","7603.22","2392.48","2405.9","2555.87","2977.97","144202","74734","81879","7145","8325"
"2014","Alberta","48","Total, all Criminal Code violations (including traffic)","312503","93861","52070","0.05","7606.66","2412.56","2409.58","2375.17","2651.39","145931","77608","84229","6621","7391"
"2015","Alberta","48","Total, all Criminal Code violations (including traffic)","354209","99258","50911","11.41","8474.59","2509.12","2491.44","2284.6","2509.2","150169","82063","88451","6388","7016"
"2016","Alberta","48","Total, all Criminal Code violations (including traffic)","360085","104751","46736","-0.09","8466.85","2652.57","2598.62","1965.08","2198.3","151487","88160","93721","5561","6221"
"1998","Alberta","48","Total, all Criminal Code violations (excluding traffic)","264804","72170","40068","0","9132.9","2170.78","2507.4","5270.53","3111.51","112238","46432","60166","13734","8108"
"1999","Alberta","48","Total, all Criminal Code violations (excluding traffic)","265726","70114","44089","-1.48","8997.73","2129.41","2430.5","4926.72","3276.78","114203","46651","59670","13019","8659"
"2000","Alberta","48","Total, all Criminal Code violations (excluding traffic)","261516","70952","38817","-3.28","8702.87","2183.4","2494.45","5103.55","4274.98","109769","48938","62575","13637","11423"
"2001","Alberta","48","Total, all Criminal Code violations (excluding traffic)","276051","71991","38508","3.73","9027.12","2323.54","2614.2","5078.58","4957.75","110499","53314","67058","13744","13417"
"2002","Alberta","48","Total, all Criminal Code violations (excluding traffic)","288160","73345","40102","2.04","9211.2","2331.89","2622.96","5104.12","5030.78","113447","55020","69148","14128","13925"
"2003","Alberta","48","Total, all Criminal Code violations (excluding traffic)","316218","75465","45464","7.84","9933.35","2414.84","2632.83","4514.36","5541.09","120929","58265","70884","12619","15489"
"2004","Alberta","48","Total, all Criminal Code violations (excluding traffic)","323309","76420","45926","0.47","9980.3","2438.99","2590.13","3916.88","5206.02","122346","60172","71180","11008","14631"
"2005","Alberta","48","Total, all Criminal Code violations (excluding traffic)","325471","74509","47690","-1.84","9796.85","2288.82","2425.11","3645.77","4654.84","122199","58162","68506","10344","13207"
"2006","Alberta","48","Total, all Criminal Code violations (excluding traffic)","320303","77012","56609","-4.44","9361.86","2165.08","2292.33","3456.65","5067.59","133621","56874","66798","9924","14549"
"2007","Alberta","48","Total, all Criminal Code violations (excluding traffic)","321596","75117","60058","-2.24","9151.77","2183.56","2332.02","3734.64","5000.78","135175","59196","69912","10716","14349"
"2008","Alberta","48","Total, all Criminal Code violations (excluding traffic)","324879","81027","64170","-1.28","9035.07","2331.36","2463.17","3750.02","5020.12","145197","64924","75621","10697","14320"
"2009","Alberta","48","Total, all Criminal Code violations (excluding traffic)","315803","80878","65118","-5","8583.72","2282.81","2397.36","3551.14","4775.38","145996","65246","75323","10077","13551"
"2010","Alberta","48","Total, all Criminal Code violations (excluding traffic)","302033","79273","63691","-5.73","8091.82","2191.26","2278.16","3173.92","4594.18","142964","63610","72549","8939","12939"
"2011","Alberta","48","Total, all Criminal Code violations (excluding traffic)","281104","77527","57721","-8.34","7416.62","2084.8","2157.57","2920.92","3806.37","135248","61497","69711","8214","10704"
"2012","Alberta","48","Total, all Criminal Code violations (excluding traffic)","282687","77777","55172","-1.78","7284.33","2055.24","2115.13","2762.11","3550.37","132949","62195","69932","7737","9945"
"2013","Alberta","48","Total, all Criminal Code violations (excluding traffic)","283839","77624","52685","-2.5","7101.98","1998.33","2037.23","2471.8","2955.43","130309","62422","69332","6910","8262"
"2014","Alberta","48","Total, all Criminal Code violations (excluding traffic)","293064","81160","50949","0.44","7133.49","2021.09","2042.63","2291.23","2639.56","132109","65015","71402","6387","7358"
"2015","Alberta","48","Total, all Criminal Code violations (excluding traffic)","335755","86978","49843","12.61","8033.07","2136.83","2142.39","2207.35","2499.19","136821","69887","76059","6172","6988"
"2016","Alberta","48","Total, all Criminal Code violations (excluding traffic)","342771","93676","45831","0.33","8059.74","2320.21","2288.27","1913.14","2185.94","139507","77114","82528","5414","6186"
"1998","Alberta","48","Total violent Criminal Code violations","40477","18225","10856","0","1396.02","629.09","669","996.62","466.65","29081","13456","16053","2597","1216"
"1999","Alberta","48","Total violent Criminal Code violations","45225","18735","13840","9.69","1531.36","627.81","678.56","1099.33","599.8","32575","13754","16659","2905","1585"
"2000","Alberta","48","Total violent Criminal Code violations","45910","19425","12568","-0.23","1527.82","650.23","705.46","1168.76","918.39","31993","14574","17697","3123","2454"
"2001","Alberta","48","Total violent Criminal Code violations","48088","19954","12190","2.93","1572.52","674.04","728.96","1194.63","1125.53","32144","15466","18699","3233","3046"
"2002","Alberta","48","Total violent Criminal Code violations","47564","19206","12313","-3.31","1520.41","634.59","689.99","1162.23","1066.49","31519","14973","18190","3217","2952"
"2003","Alberta","48","Total violent Criminal Code violations","48665","19048","12492","0.55","1528.71","628.48","668.53","1014.2","1186.99","31540","15164","17999","2835","3318"
"2004","Alberta","48","Total violent Criminal Code violations","48864","19051","11583","-1.33","1508.39","629.29","659.83","927.98","1003.77","30634","15525","18133","2608","2821"
"2005","Alberta","48","Total violent Criminal Code violations","49723","20541","12055","-0.78","1496.69","650.22","679.15","938.23","961.14","32596","16523","19185","2662","2727"
"2006","Alberta","48","Total violent Criminal Code violations","50973","22990","15004","-0.46","1489.85","699.35","723.03","939.75","1160.92","37994","18371","21069","2698","3333"
"2007","Alberta","48","Total violent Criminal Code violations","52615","22802","15772","0.5","1497.28","663.23","690.78","951.09","1150.78","38574","17980","20709","2729","3302"
"2008","Alberta","48","Total violent Criminal Code violations","55428","24331","16676","2.95","1541.48","693.51","718.91","966.86","1132.68","41007","19313","22071","2758","3231"
"2009","Alberta","48","Total violent Criminal Code violations","56226","24746","17834","-0.86","1528.26","695.1","714.5","909.9","1115","42580","19867","22449","2582","3164"
"2010","Alberta","48","Total violent Criminal Code violations","55027","24574","17352","-3.53","1474.24","678.74","693.66","847.54","1100.7","41926","19703","22090","2387","3100"
"2011","Alberta","48","Total violent Criminal Code violations","53194","23781","15562","-4.8","1403.46","642.69","658.19","820.73","922.43","39343","18958","21266","2308","2594"
"2012","Alberta","48","Total violent Criminal Code violations","53854","24228","15046","-1.12","1387.72","643.62","652.52","748.63","852.16","39274","19477","21574","2097","2387"
"2013","Alberta","48","Total violent Criminal Code violations","51361","23329","13906","-7.39","1285.11","604.89","611.83","689.31","747.98","37235","18895","20822","1927","2091"
"2014","Alberta","48","Total violent Criminal Code violations","51704","23788","13045","-2.07","1258.53","602.92","605.79","638.9","666.88","36833","19395","21176","1781","1859"
"2015","Alberta","48","Total violent Criminal Code violations","54555","25175","13122","3.71","1305.25","626","628.73","660.56","635.88","38297","20474","22321","1847","1778"
"2016","Alberta","48","Total violent Criminal Code violations","52886","25310","11814","-4.73","1243.53","631.97","628.74","590.83","558.32","37124","21004","22676","1672","1580"
"1998","Alberta","48","Homicide","64","56","4","0","2.21","2.57","2.75","4.22","0","60","55","66","11","0"
"1999","Alberta","48","Homicide","61","49","6","-6.42","2.07","2.42","2.53","3.41","0","55","53","62","9","0"
"2000","Alberta","48","Homicide","59","50","5","-4.94","1.96","2.28","2.27","2.25","0.37","55","51","57","6","1"
"2001","Alberta","48","Homicide","70","58","2","16.58","2.29","2.31","2.34","2.59","0","60","53","60","7","0"
"2002","Alberta","48","Homicide","70","48","7","-2.25","2.24","2.08","2.05","1.81","0","55","49","54","5","0"
"2003","Alberta","48","Homicide","64","41","7","-10.15","2.01","1.99","1.93","1.43","0","48","48","52","4","0"
"2004","Alberta","48","Homicide","86","52","10","32.05","2.65","2.39","2.37","2.13","0","62","59","65","6","0"
"2005","Alberta","48","Homicide","108","77","5","22.45","3.25","3.86","3.89","4.23","0","82","98","110","12","0"
"2006","Alberta","48","Homicide","95","65","4","-14.59","2.78","2.59","3.16","8.36","0","69","68","92","24","0"
"2007","Alberta","48","Homicide","88","45","2","-9.81","2.5","1.77","1.77","1.74","0","47","48","53","5","0"
"2008","Alberta","48","Homicide","110","53","12","22.16","3.06","2.33","2.35","2.45","0.35","65","65","72","7","1"
"2009","Alberta","48","Homicide","95","67","10","-15.59","2.58","2.27","2.32","2.82","0.35","77","65","73","8","1"
"2010","Alberta","48","Homicide","77","51","7","-20.11","2.06","1.89","2.01","3.2","0","58","55","64","9","0"
"2011","Alberta","48","Homicide","109","69","9","39.41","2.88","2.78","2.75","2.49","0","78","82","89","7","0"
"2012","Alberta","48","Homicide","85","58","6","-23.84","2.19","2.25","2.18","1.43","0","64","68","72","4","0"
"2013","Alberta","48","Homicide","82","67","1","-6.33","2.05","2.3","2.32","2.5","0","68","72","79","7","0"
"2014","Alberta","48","Homicide","106","77","15","25.75","2.58","2.27","2.29","2.51","0","92","73","80","7","0"
"2015","Alberta","48","Homicide","133","89","8","23.33","3.18","3.03","3.04","3.22","0","97","99","108","9","0"
"2016","Alberta","48","Homicide","116","78","4","-14.28","2.73","2.62","2.55","1.77","0","82","87","92","5","0"
"1998","Alberta","48","Murder, first degree","19","16","2","0","0.66","0.89","0.92","1.15","0","18","19","22","3","0"
"1999","Alberta","48","Murder, first degree","23","16","3","18.85","0.78","0.68","0.73","1.14","0","19","15","18","3","0"
"2000","Alberta","48","Murder, first degree","24","17","4","2.55","0.8","0.85","0.8","0.37","0","21","19","20","1","0"
"2001","Alberta","48","Murder, first degree","23","15","0","-5.83","0.75","0.57","0.51","0","0","15","13","13","0","0"
"2002","Alberta","48","Murder, first degree","30","14","6","27.5","0.96","0.68","0.64","0.36","0","20","16","17","1","0"
"2003","Alberta","48","Murder, first degree","28","10","7","-8.28","0.88","0.66","0.59","0","0","17","16","16","0","0"
"2004","Alberta","48","Murder, first degree","37","15","6","29.86","1.14","0.61","0.65","1.07","0","21","15","18","3","0"
"2005","Alberta","48","Murder, first degree","39","17","5","2.78","1.17","1.1","1.13","1.41","0","22","28","32","4","0"
"2006","Alberta","48","Murder, first degree","30","12","1","-25.31","0.88","0.57","0.79","2.79","0","13","15","23","8","0"
"2007","Alberta","48","Murder, first degree","33","7","0","7.1","0.94","0.52","0.57","1.05","0","7","14","17","3","0"
"2008","Alberta","48","Murder, first degree","57","19","9","68.8","1.59","1.15","1.07","0.35","0","28","32","33","1","0"
"2009","Alberta","48","Murder, first degree","37","15","8","-36.56","1.01","0.56","0.57","0.7","0","23","16","18","2","0"
"2010","Alberta","48","Murder, first degree","27","12","2","-28.07","0.72","0.34","0.31","0","0","14","10","10","0","0"
"2011","Alberta","48","Murder, first degree","42","15","5","53.19","1.11","0.61","0.56","0","0","20","18","18","0","0"
"2012","Alberta","48","Murder, first degree","28","10","3","-34.89","0.72","0.36","0.33","0","0","13","11","11","0","0"
"2013","Alberta","48","Murder, first degree","31","23","1","7.5","0.78","0.96","0.94","0.72","0","24","30","32","2","0"
"2014","Alberta","48","Murder, first degree","46","25","13","44.35","1.12","0.59","0.6","0.72","0","38","19","21","2","0"
"2015","Alberta","48","Murder, first degree","63","31","6","34.62","1.51","1.16","1.18","1.43","0","37","38","42","4","0"
"2016","Alberta","48","Murder, first degree","38","18","4","-40.72","0.89","0.72","0.67","0","0","22","24","24","0","0"
"1998","Alberta","48","Murder, second degree","34","31","2","0","1.17","1.26","1.46","3.07","0","33","27","35","8","0"
"1999","Alberta","48","Murder, second degree","32","27","3","-7.6","1.08","1.32","1.43","2.27","0","30","29","35","6","0"
"2000","Alberta","48","Murder, second degree","26","25","0","-20.15","0.87","1.07","1.16","1.87","0","25","24","29","5","0"
"2001","Alberta","48","Murder, second degree","37","34","2","39.84","1.21","1.39","1.48","2.22","0","36","32","38","6","0"
"2002","Alberta","48","Murder, second degree","27","23","1","-28.67","0.86","0.93","0.99","1.45","0","24","22","26","4","0"
"2003","Alberta","48","Murder, second degree","31","28","0","12.83","0.97","1.2","1.23","1.43","0","28","29","33","4","0"
"2004","Alberta","48","Murder, second degree","40","30","3","26.8","1.23","1.38","1.35","1.07","0","33","34","37","3","0"
"2005","Alberta","48","Murder, second degree","59","53","0","43.83","1.78","2.48","2.48","2.47","0","53","63","70","7","0"
"2006","Alberta","48","Murder, second degree","54","42","3","-11.13","1.58","1.56","1.72","3.13","0","45","41","50","9","0"
"2007","Alberta","48","Murder, second degree","46","31","2","-17.06","1.31","1.14","1.1","0.7","0","33","31","33","2","0"
"2008","Alberta","48","Murder, second degree","46","30","2","-2.27","1.28","1.11","1.14","1.4","0.35","32","31","35","4","1"
"2009","Alberta","48","Murder, second degree","45","40","1","-4.39","1.22","1.36","1.43","2.11","0","41","39","45","6","0"
"2010","Alberta","48","Murder, second degree","42","32","5","-8","1.13","1.38","1.48","2.49","0","37","40","47","7","0"
"2011","Alberta","48","Murder, second degree","56","45","1","31.31","1.48","1.86","1.83","1.42","0","46","55","59","4","0"
"2012","Alberta","48","Murder, second degree","44","37","3","-23.26","1.13","1.52","1.48","1.07","0","40","46","49","3","0"
"2013","Alberta","48","Murder, second degree","48","42","0","5.93","1.2","1.28","1.32","1.79","0","42","40","45","5","0"
"2014","Alberta","48","Murder, second degree","49","42","2","-0.69","1.19","1.37","1.4","1.79","0","44","44","49","5","0"
"2015","Alberta","48","Murder, second degree","55","45","1","10.33","1.32","1.44","1.46","1.79","0","46","47","52","5","0"
"2016","Alberta","48","Murder, second degree","55","41","0","-1.72","1.29","1.32","1.33","1.41","0","41","44","48","4","0"
"1998","Alberta","48","Manslaughter","10","9","0","0","0.34","0.42","0.38","0","0","9","9","9","0","0"
"1999","Alberta","48","Manslaughter","6","6","0","-41.09","0.2","0.41","0.37","0","0","6","9","9","0","0"
"2000","Alberta","48","Manslaughter","9","8","1","47.42","0.3","0.36","0.32","0","0.37","9","8","8","0","1"
"2001","Alberta","48","Manslaughter","8","7","0","-12.65","0.26","0.31","0.27","0","0","7","7","7","0","0"
"2002","Alberta","48","Manslaughter","13","11","0","58.85","0.42","0.47","0.42","0","0","11","11","11","0","0"
"2003","Alberta","48","Manslaughter","4","3","0","-69.76","0.13","0.12","0.11","0","0","3","3","3","0","0"
"2004","Alberta","48","Manslaughter","8","6","1","96.54","0.25","0.36","0.33","0","0","7","9","9","0","0"
"2005","Alberta","48","Manslaughter","10","7","0","21.89","0.3","0.28","0.28","0.35","0","7","7","8","1","0"
"2006","Alberta","48","Manslaughter","11","11","0","6.81","0.32","0.46","0.65","2.44","0","11","12","19","7","0"
"2007","Alberta","48","Manslaughter","9","7","0","-20.34","0.26","0.11","0.1","0","0","7","3","3","0","0"
"2008","Alberta","48","Manslaughter","7","4","1","-23.99","0.19","0.07","0.13","0.7","0","5","2","4","2","0"
"2009","Alberta","48","Manslaughter","13","12","1","81.51","0.35","0.35","0.32","0","0.35","13","10","10","0","1"
"2010","Alberta","48","Manslaughter","7","7","0","-46.93","0.19","0.17","0.22","0.71","0","7","5","7","2","0"
"2011","Alberta","48","Manslaughter","11","9","3","54.75","0.29","0.31","0.37","1.07","0","12","9","12","3","0"
"2012","Alberta","48","Manslaughter","13","11","0","15.42","0.33","0.36","0.36","0.36","0","11","11","12","1","0"
"2013","Alberta","48","Manslaughter","3","2","0","-77.59","0.08","0.06","0.06","0","0","2","2","2","0","0"
"2014","Alberta","48","Manslaughter","11","10","0","256.7","0.27","0.31","0.29","0","0","10","10","10","0","0"
"2015","Alberta","48","Manslaughter","15","13","1","34.03","0.36","0.43","0.39","0","0","14","14","14","0","0"
"2016","Alberta","48","Manslaughter","23","19","0","50.69","0.54","0.57","0.55","0.35","0","19","19","20","1","0"
"1998","Alberta","48","Infanticide","1","0","0","0","0.03","0","0","0","0","0","0","0","0","0"
"1999","Alberta","48","Infanticide","0","0","0","-100","0","0","0","0","0","0","0","0","0","0"
"2000","Alberta","48","Infanticide","0","0","0","0","0","0","0","0","0","0","0","0","0","0"
"2001","Alberta","48","Infanticide","2","2","0","0","0.07","0.04","0.08","0.37","0","2","1","2","1","0"
"2002","Alberta","48","Infanticide","0","0","0","-100","0","0","0","0","0","0","0","0","0","0"
"2003","Alberta","48","Infanticide","1","0","0","0","0.03","0","0","0","0","0","0","0","0","0"
"2004","Alberta","48","Infanticide","1","1","0","-1.73","0.03","0.04","0.04","0","0","1","1","1","0","0"
"2005","Alberta","48","Infanticide","0","0","0","-100","0","0","0","0","0","0","0","0","0","0"
"2006","Alberta","48","Infanticide","0","0","0","0","0","0","0","0","0","0","0","0","0","0"
"2007","Alberta","48","Infanticide","0","0","0","0","0","0","0","0","0","0","0","0","0","0"
"2008","Alberta","48","Infanticide","0","0","0","0","0","0","0","0","0","0","0","0","0","0"
"2009","Alberta","48","Infanticide","0","0","0","0","0","0","0","0","0","0","0","0","0","0"
"2010","Alberta","48","Infanticide","1","0","0","0","0.03","0","0","0","0","0","0","0","0","0"
"2011","Alberta","48","Infanticide","0","0","0","-100","0","0","0","0","0","0","0","0","0","0"
"2012","Alberta","48","Infanticide","0","0","0","0","0","0","0","0","0","0","0","0","0","0"
"2013","Alberta","48","Infanticide","0","0","0","0","0","0","0","0","0","0","0","0","0","0"
"2014","Alberta","48","Infanticide","0","0","0","0","0","0","0","0","0","0","0","0","0","0"
"2015","Alberta","48","Infanticide","0","0","0","0","0","0","0","0","0","0","0","0","0","0"
"2016","Alberta","48","Infanticide","0","0","0","0","0","0","0","0","0","0","0","0","0","0"
"1998","Alberta","48","Total other violations causing death","9","5","0","0","0.31","0.14","0.17","0.38","0","5","3","4","1","0"
"1999","Alberta","48","Total other violations causing death","16","10","0","74.54","0.54","0.18","0.2","0.38","0","10","4","5","1","0"
"2000","Alberta","48","Total other violations causing death","5","2","0","-69.29","0.17","0.09","0.08","0","0","2","2","2","0","0"
"2001","Alberta","48","Total other violations causing death","14","9","0","175.14","0.46","0.39","0.35","0","0","9","9","9","0","0"
"2002","Alberta","48","Total other violations causing death","13","4","0","-9.23","0.42","0.21","0.19","0","0","4","5","5","0","0"
"2003","Alberta","48","Total other violations causing death","10","5","2","-24.41","0.31","0.21","0.19","0","0","7","5","5","0","0"
"2004","Alberta","48","Total other violations causing death","9","2","0","-11.56","0.28","0.08","0.07","0","0","2","2","2","0","0"
"2005","Alberta","48","Total other violations causing death","5","5","0","-45.83","0.15","0.24","0.21","0","0","5","6","6","0","0"
"2006","Alberta","48","Total other violations causing death","14","12","0","171.88","0.41","0.34","0.31","0","0","12","9","9","0","0"
"2007","Alberta","48","Total other violations causing death","11","11","0","-23.5","0.31","0.44","0.4","0","0","11","12","12","0","0"
"2008","Alberta","48","Total other violations causing death","10","8","0","-11.16","0.28","0.22","0.26","0.7","0","8","6","8","2","0"
"2009","Alberta","48","Total other violations causing death","11","7","1","7.51","0.3","0.14","0.16","0.35","0.35","8","4","5","1","1"
"2010","Alberta","48","Total other violations causing death","7","7","0","-37.28","0.19","0.24","0.22","0","0","7","7","7","0","0"
"2011","Alberta","48","Total other violations causing death","9","9","0","26.62","0.24","0.31","0.28","0","0","9","9","9","0","0"
"2012","Alberta","48","Total other violations causing death","12","13","3","30.22","0.31","0.3","0.27","0","0","16","9","9","0","0"
"2013","Alberta","48","Total other violations causing death","17","12","0","37.56","0.43","0.35","0.32","0","0","12","11","11","0","0"
"2014","Alberta","48","Total other violations causing death","11","13","0","-37.05","0.27","0.34","0.31","0","0","13","11","11","0","0"
"2015","Alberta","48","Total other violations causing death","5","6","1","-55.32","0.12","0.18","0.17","0","0","7","6","6","0","0"
"2016","Alberta","48","Total other violations causing death","8","7","0","57.25","0.19","0.15","0.14","0","0","7","5","5","0","0"
"1998","Alberta","48","Criminal negligence causing death","9","5","0","0","0.31","0.14","0.17","0.38","0","5","3","4","1","0"
"1999","Alberta","48","Criminal negligence causing death","16","10","0","74.54","0.54","0.18","0.2","0.38","0","10","4","5","1","0"
"2000","Alberta","48","Criminal negligence causing death","5","2","0","-69.29","0.17","0.09","0.08","0","0","2","2","2","0","0"
"2001","Alberta","48","Criminal negligence causing death","14","9","0","175.14","0.46","0.39","0.35","0","0","9","9","9","0","0"
"2002","Alberta","48","Criminal negligence causing death","13","4","0","-9.23","0.42","0.21","0.19","0","0","4","5","5","0","0"
"2003","Alberta","48","Criminal negligence causing death","10","5","2","-24.41","0.31","0.21","0.19","0","0","7","5","5","0","0"
"2004","Alberta","48","Criminal negligence causing death","9","2","0","-11.56","0.28","0.08","0.07","0","0","2","2","2","0","0"
"2005","Alberta","48","Criminal negligence causing death","5","5","0","-45.83","0.15","0.24","0.21","0","0","5","6","6","0","0"
"2006","Alberta","48","Criminal negligence causing death","14","12","0","171.88","0.41","0.34","0.31","0","0","12","9","9","0","0"
"2007","Alberta","48","Criminal negligence causing death","11","11","0","-23.5","0.31","0.44","0.4","0","0","11","12","12","0","0"
"2008","Alberta","48","Criminal negligence causing death","8","6","0","-28.93","0.22","0.18","0.16","0","0","6","5","5","0","0"
"2009","Alberta","48","Criminal negligence causing death","10","7","1","22.17","0.27","0.14","0.16","0.35","0","8","4","5","1","0"
"2010","Alberta","48","Criminal negligence causing death","7","7","0","-31","0.19","0.24","0.22","0","0","7","7","7","0","0"
"2011","Alberta","48","Criminal negligence causing death","9","9","0","26.62","0.24","0.31","0.28","0","0","9","9","9","0","0"
"2012","Alberta","48","Criminal negligence causing death","11","12","3","19.37","0.28","0.26","0.24","0","0","15","8","8","0","0"
"2013","Alberta","48","Criminal negligence causing death","16","11","0","41.24","0.4","0.32","0.29","0","0","11","10","10","0","0"
"2014","Alberta","48","Criminal negligence causing death","11","13","0","-33.12","0.27","0.34","0.31","0","0","13","11","11","0","0"
"2015","Alberta","48","Criminal negligence causing death","5","6","1","-55.32","0.12","0.18","0.17","0","0","7","6","6","0","0"
"2016","Alberta","48","Criminal negligence causing death","8","7","0","57.25","0.19","0.15","0.14","0","0","7","5","5","0","0"
"1998","Alberta","48","Other related violations causing death","0","0","0","0","0","0","0","0","0","0","0","0","0","0"
"1999","Alberta","48","Other related violations causing death","0","0","0","0","0","0","0","0","0","0","0","0","0","0"
"2000","Alberta","48","Other related violations causing death","0","0","0","0","0","0","0","0","0","0","0","0","0","0"
"2001","Alberta","48","Other related violations causing death","0","0","0","0","0","0","0","0","0","0","0","0","0","0"
"2002","Alberta","48","Other related violations causing death","0","0","0","0","0","0","0","0","0","0","0","0","0","0"
"2003","Alberta","48","Other related violations causing death","0","0","0","0","0","0","0","0","0","0","0","0","0","0"
"2004","Alberta","48","Other related violations causing death","0","0","0","0","0","0","0","0","0","0","0","0","0","0"
"2005","Alberta","48","Other related violations causing death","0","0","0","0","0","0","0","0","0","0","0","0","0","0"
"2006","Alberta","48","Other related violations causing death","0","0","0","0","0","0","0","0","0","0","0","0","0","0"
"2007","Alberta","48","Other related violations causing death","0","0","0","0","0","0","0","0","0","0","0","0","0","0"
"2008","Alberta","48","Other related violations causing death","2","2","0","0","0.06","0.04","0.1","0.7","0","2","1","3","2","0"
"2009","Alberta","48","Other related violations causing death","1","0","0","-51.13","0.03","0","0","0","0.35","0","0","0","0","1"
"2010","Alberta","48","Other related violations causing death","0","0","0","-100","0","0","0","0","0","0","0","0","0","0"
"2011","Alberta","48","Other related violations causing death","0","0","0","0","0","0","0","0","0","0","0","0","0","0"
"2012","Alberta","48","Other related violations causing death","1","1","0","0","0.03","0.03","0.03","0","0","1","1","1","0","0"
"2013","Alberta","48","Other related violations causing death","1","1","0","-2.9","0.03","0.03","0.03","0","0","1","1","1","0","0"
"2014","Alberta","48","Other related violations causing death","0","0","0","-100","0","0","0","0","0","0","0","0","0","0"
"2015","Alberta","48","Other related violations causing death","0","0","0","0","0","0","0","0","0","0","0","0","0","0"
"2016","Alberta","48","Other related violations causing death","0","0","0","0","0","0","0","0","0","0","0","0","0","0"
"1998","Alberta","48","Attempted murder","35","21","3","0","1.21","0.79","1.04","3.07","0","24","17","25","8","0"
"1999","Alberta","48","Attempted murder","31","29","1","-13.04","1.05","1.6","1.71","2.65","0","30","35","42","7","0"
"2000","Alberta","48","Attempted murder","35","32","0","10.96","1.16","1.43","1.44","1.5","0","32","32","36","4","0"
"2001","Alberta","48","Attempted murder","32","23","2","-10.16","1.05","0.74","0.78","1.11","0","25","17","20","3","0"
"2002","Alberta","48","Attempted murder","42","37","2","28.3","1.34","1.61","1.59","1.45","0","39","38","42","4","0"
"2003","Alberta","48","Attempted murder","40","38","0","-6.41","1.26","1.37","1.41","1.79","0","38","33","38","5","0"
"2004","Alberta","48","Attempted murder","52","43","2","27.75","1.61","1.7","1.6","0.71","0","45","42","44","2","0"
"2005","Alberta","48","Attempted murder","60","41","1","12.51","1.81","1.3","1.2","0.35","0","42","33","34","1","0"
"2006","Alberta","48","Attempted murder","76","64","1","23","2.22","1.94","2.02","2.79","0.35","65","51","59","8","1"
"2007","Alberta","48","Attempted murder","64","36","4","-18.01","1.82","1.48","1.37","0.35","0","40","40","41","1","0"
"2008","Alberta","48","Attempted murder","76","46","1","16.05","2.11","1.33","1.43","2.45","0","47","37","44","7","0"
"2009","Alberta","48","Attempted murder","72","47","4","-7.41","1.96","1.47","1.43","1.06","0.35","51","42","45","3","1"
"2010","Alberta","48","Attempted murder","42","33","0","-42.5","1.13","1.17","1.22","1.78","0","33","34","39","5","0"
"2011","Alberta","48","Attempted murder","50","31","4","17.24","1.32","0.95","0.87","0","0","35","28","28","0","0"
"2012","Alberta","48","Attempted murder","43","32","4","-16.01","1.11","1.12","1.15","1.43","0","36","34","38","4","0"
"2013","Alberta","48","Attempted murder","49","40","2","10.65","1.23","1.22","1.15","0.36","0","42","38","39","1","0"
"2014","Alberta","48","Attempted murder","43","36","1","-14.63","1.05","0.9","0.86","0.36","0","37","29","30","1","0"
"2015","Alberta","48","Attempted murder","68","50","0","55.44","1.63","1.31","1.35","1.79","0.36","50","43","48","5","1"
"2016","Alberta","48","Attempted murder","53","48","2","-23.4","1.25","1.11","1.25","2.83","1.06","50","37","45","8","3"
"1998","Alberta","48","Sexual assault, level 3, aggravated","22","17","3","0","0.76","0.84","0.75","0","0","20","18","18","0","0"
"1999","Alberta","48","Sexual assault, level 3, aggravated","29","18","2","29.42","0.98","0.73","0.65","0","0","20","16","16","0","0"
"2000","Alberta","48","Sexual assault, level 3, aggravated","11","9","1","-62.72","0.37","0.36","0.32","0","0.37","10","8","8","0","1"
"2001","Alberta","48","Sexual assault, level 3, aggravated","23","19","1","105.46","0.75","0.74","0.74","0.74","0","20","17","19","2","0"
"2002","Alberta","48","Sexual assault, level 3, aggravated","19","13","0","-19.25","0.61","0.55","0.53","0.36","0","13","13","14","1","0"
"2003","Alberta","48","Sexual assault, level 3, aggravated","18","13","2","-6.9","0.57","0.54","0.56","0.72","0.36","15","13","15","2","1"
"2004","Alberta","48","Sexual assault, level 3, aggravated","13","12","2","-29.03","0.4","0.49","0.47","0.36","0","14","12","13","1","0"
"2005","Alberta","48","Sexual assault, level 3, aggravated","10","8","0","-24.99","0.3","0.35","0.32","0","0","8","9","9","0","0"
"2006","Alberta","48","Sexual assault, level 3, aggravated","13","10","1","26.23","0.38","0.34","0.34","0.35","0","11","9","10","1","0"
"2007","Alberta","48","Sexual assault, level 3, aggravated","11","5","0","-17.62","0.31","0.26","0.27","0.35","0","5","7","8","1","0"
"2008","Alberta","48","Sexual assault, level 3, aggravated","18","15","0","59.92","0.5","0.57","0.59","0.7","0","15","16","18","2","0"
"2009","Alberta","48","Sexual assault, level 3, aggravated","15","7","0","-18.55","0.41","0.17","0.22","0.7","0","7","5","7","2","0"
"2010","Alberta","48","Sexual assault, level 3, aggravated","21","16","0","37.99","0.56","0.48","0.44","0","0","16","14","14","0","0"
"2011","Alberta","48","Sexual assault, level 3, aggravated","29","25","3","36","0.77","0.71","0.68","0.36","0","28","21","22","1","0"
"2012","Alberta","48","Sexual assault, level 3, aggravated","15","12","1","-49.48","0.39","0.36","0.36","0.36","0","13","11","12","1","0"
"2013","Alberta","48","Sexual assault, level 3, aggravated","18","16","1","16.52","0.45","0.48","0.44","0","0","17","15","15","0","0"
"2014","Alberta","48","Sexual assault, level 3, aggravated","15","7","1","-18.93","0.37","0.22","0.23","0.36","0","8","7","8","1","0"
"2015","Alberta","48","Sexual assault, level 3, aggravated","7","6","0","-54.13","0.17","0.15","0.17","0.36","0","6","5","6","1","0"
"2016","Alberta","48","Sexual assault, level 3, aggravated","11","3","2","54.44","0.26","0.12","0.11","0","0","5","4","4","0","0"
"1998","Alberta","48","Sexual assault, level 2, weapon or bodily harm","59","40","4","0","2.03","1.36","1.54","3.07","0","44","29","37","8","0"
"1999","Alberta","48","Sexual assault, level 2, weapon or bodily harm","42","22","4","-30.11","1.42","0.78","0.81","1.14","0.38","26","17","20","3","1"
"2000","Alberta","48","Sexual assault, level 2, weapon or bodily harm","52","24","2","21.68","1.73","0.98","0.96","0.75","0","26","22","24","2","0"
"2001","Alberta","48","Sexual assault, level 2, weapon or bodily harm","29","27","2","-45.2","0.95","0.83","0.82","0.74","0.37","29","19","21","2","1"
"2002","Alberta","48","Sexual assault, level 2, weapon or bodily harm","41","21","2","38.2","1.31","0.76","0.8","1.08","0","23","18","21","3","0"
"2003","Alberta","48","Sexual assault, level 2, weapon or bodily harm","30","18","0","-28.09","0.94","0.41","0.59","2.15","0","18","10","16","6","0"
"2004","Alberta","48","Sexual assault, level 2, weapon or bodily harm","40","27","1","31.03","1.23","0.77","0.84","1.42","0.36","28","19","23","4","1"
"2005","Alberta","48","Sexual assault, level 2, weapon or bodily harm","36","19","2","-12.24","1.08","0.71","0.67","0.35","0.35","21","18","19","1","1"
"2006","Alberta","48","Sexual assault, level 2, weapon or bodily harm","35","18","3","-5.6","1.02","0.53","0.62","1.39","0","21","14","18","4","0"
"2007","Alberta","48","Sexual assault, level 2, weapon or bodily harm","44","17","3","22.4","1.25","0.52","0.57","1.05","0.35","20","14","17","3","1"
"2008","Alberta","48","Sexual assault, level 2, weapon or bodily harm","40","21","3","-11.16","1.11","0.68","0.62","0","0","24","19","19","0","0"
"2009","Alberta","48","Sexual assault, level 2, weapon or bodily harm","29","15","1","-29.14","0.79","0.38","0.38","0.35","0","16","11","12","1","0"
"2010","Alberta","48","Sexual assault, level 2, weapon or bodily harm","48","30","1","63.15","1.29","1","1","1.07","0","31","29","32","3","0"
"2011","Alberta","48","Sexual assault, level 2, weapon or bodily harm","53","32","3","8.74","1.4","0.75","0.84","1.78","0.36","35","22","27","5","1"
"2012","Alberta","48","Sexual assault, level 2, weapon or bodily harm","31","24","0","-42.87","0.8","0.73","0.7","0.36","0","24","22","23","1","0"
"2013","Alberta","48","Sexual assault, level 2, weapon or bodily harm","42","24","2","31.56","1.05","0.83","0.88","1.43","0","26","26","30","4","0"
"2014","Alberta","48","Sexual assault, level 2, weapon or bodily harm","33","23","2","-23.56","0.8","0.47","0.57","1.79","0.72","25","15","20","5","2"
"2015","Alberta","48","Sexual assault, level 2, weapon or bodily harm","45","29","2","34.03","1.08","0.76","0.82","1.43","0","31","25","29","4","0"
"2016","Alberta","48","Sexual assault, level 2, weapon or bodily harm","47","33","1","2.65","1.11","0.84","0.86","1.06","0","34","28","31","3","0"
"1998","Alberta","48","Sexual assault, level 1","2861","1168","564","0","98.67","35.48","38.51","63.32","34.15","1732","759","924","165","89"
"1999","Alberta","48","Sexual assault, level 1","2644","1070","517","-9.27","89.53","32.82","35.44","57.14","26.11","1587","719","870","151","69"
"2000","Alberta","48","Sexual assault, level 1","2436","1049","386","-9.45","81.07","30.92","34.76","66.99","42.29","1435","693","872","179","113"
"2001","Alberta","48","Sexual assault, level 1","2605","1148","447","5.08","85.19","35.04","38.32","66.14","51.73","1595","804","983","179","140"
"2002","Alberta","48","Sexual assault, level 1","2536","1035","392","-4.84","81.06","30.52","33.38","57.8","48.05","1427","720","880","160","133"
"2003","Alberta","48","Sexual assault, level 1","2371","900","311","-8.12","74.48","26.28","28.41","46.86","31.48","1211","634","765","131","88"
"2004","Alberta","48","Sexual assault, level 1","2404","970","283","-0.36","74.21","28.05","30.57","52.66","32.38","1253","692","840","148","91"
"2005","Alberta","48","Sexual assault, level 1","2271","923","286","-7.88","68.36","26.33","27.72","40.18","32.07","1209","669","783","114","91"
"2006","Alberta","48","Sexual assault, level 1","2129","923","346","-8.97","62.23","24.36","27.21","53.29","24.73","1269","640","793","153","71"
"2007","Alberta","48","Sexual assault, level 1","2234","852","436","2.16","63.57","23.64","25.05","38.34","28.58","1288","641","751","110","82"
"2008","Alberta","48","Sexual assault, level 1","2404","947","407","5.16","66.86","24.45","26.77","49.43","32.95","1354","681","822","141","94"
"2009","Alberta","48","Sexual assault, level 1","2204","945","486","-10.4","59.91","25.47","27.69","50.04","35.94","1431","728","870","142","102"
"2010","Alberta","48","Sexual assault, level 1","2638","1057","426","17.98","70.68","26.87","29.36","55.03","32.67","1483","780","935","155","92"
"2011","Alberta","48","Sexual assault, level 1","2709","1157","394","1.13","71.47","28.07","30.05","50.85","33.07","1551","828","971","143","93"
"2012","Alberta","48","Sexual assault, level 1","2809","1107","424","1.27","72.38","27.53","29.58","51.77","40.34","1531","833","978","145","113"
"2013","Alberta","48","Sexual assault, level 1","2727","1169","339","-5.73","68.23","29.29","30.82","47.93","31.48","1508","915","1049","134","88"
"2014","Alberta","48","Sexual assault, level 1","2766","1174","325","-1.33","67.33","28.41","29.95","47.71","32.29","1499","914","1047","133","90"
"2015","Alberta","48","Sexual assault, level 1","2799","1051","373","-0.54","66.97","25.07","26.7","45.78","35.41","1424","820","948","128","99"
"2016","Alberta","48","Sexual assault, level 1","2640","878","322","-7.3","62.08","21.15","22.15","33.92","25.8","1200","703","799","96","73"
"1998","Alberta","48","Total sexual violations against children","0","0","0","0","0","0","0","0","0","0","0","0","0","0"
"1999","Alberta","48","Total sexual violations against children","1","1","0","0","0.03","0.05","0.04","0","0","1","1","1","0","0"
"2000","Alberta","48","Total sexual violations against children","0","0","0","-100","0","0","0","0","0","0","0","0","0","0"
"2001","Alberta","48","Total sexual violations against children","0","0","0","0","0","0","0","0","0","0","0","0","0","0"
"2002","Alberta","48","Total sexual violations against children","0","0","0","0","0","0","0","0","0","0","0","0","0","0"
"2003","Alberta","48","Total sexual violations against children","6","2","0","0","0.19","0.08","0.07","0","0","2","2","2","0","0"
"2004","Alberta","48","Total sexual violations against children","4","1","1","-34.49","0.12","0.04","0.04","0","0","2","1","1","0","0"
"2005","Alberta","48","Total sexual violations against children","5","0","0","21.89","0.15","0","0","0","0","0","0","0","0","0"
"2006","Alberta","48","Total sexual violations against children","15","5","2","191.31","0.44","0.11","0.14","0.35","0","7","3","4","1","0"
"2007","Alberta","48","Total sexual violations against children","48","4","9","211.56","1.37","0.15","0.13","0","1.39","13","4","4","0","4"
"2008","Alberta","48","Total sexual violations against children","122","35","15","148.39","3.39","0.9","0.94","1.4","1.05","50","25","29","4","3"
"2009","Alberta","48","Total sexual violations against children","267","92","33","113.9","7.26","2.13","2.23","3.17","1.41","125","61","70","9","4"
"2010","Alberta","48","Total sexual violations against children","406","146","111","49.88","10.88","3.03","3.33","6.39","9.59","257","88","106","18","27"
"2011","Alberta","48","Total sexual violations against children","364","165","79","-11.71","9.6","3.7","3.93","6.4","9.96","244","109","127","18","28"
"2012","Alberta","48","Total sexual violations against children","372","144","84","-0.19","9.59","3.34","3.69","7.5","9.64","228","101","122","21","27"
"2013","Alberta","48","Total sexual violations against children","435","171","78","13.55","10.88","3.43","3.67","6.44","7.87","249","107","125","18","22"
"2014","Alberta","48","Total sexual violations against children","475","168","89","6.23","11.56","3.42","3.46","3.95","10.76","257","110","121","11","30"
"2015","Alberta","48","Total sexual violations against children","605","253","81","25.19","14.47","5.6","5.92","9.66","10.37","334","183","210","27","29"
"2016","Alberta","48","Total sexual violations against children","749","442","73","21.67","17.61","9.84","11.31","28.62","7.42","515","327","408","81","21"
"1999","Alberta","48","Sexual interference","1","1","0","0","0.03","0.05","0.04","0","0","1","1","1","0","0"
"2000","Alberta","48","Sexual interference","0","0","0","-100","0","0","0","0","0","0","0","0","0","0"
"2001","Alberta","48","Sexual interference","0","0","0","0","0","0","0","0","0","0","0","0","0","0"
"2002","Alberta","48","Sexual interference","0","0","0","0","0","0","0","0","0","0","0","0","0","0"
"2003","Alberta","48","Sexual interference","1","0","0","0","0.03","0","0","0","0","0","0","0","0","0"
"2004","Alberta","48","Sexual interference","0","0","0","-100","0","0","0","0","0","0","0","0","0","0"
"2005","Alberta","48","Sexual interference","1","0","0","0","0.03","0","0","0","0","0","0","0","0","0"
"2006","Alberta","48","Sexual interference","4","3","0","288.41","0.12","0.04","0.07","0.35","0","3","1","2","1","0"
"2007","Alberta","48","Sexual interference","17","2","2","313.79","0.48","0.07","0.07","0","0","4","2","2","0","0"
"2008","Alberta","48","Sexual interference","56","18","5","221.92","1.56","0.54","0.55","0.7","0.35","23","15","17","2","1"
"2009","Alberta","48","Sexual interference","169","67","21","194.95","4.59","1.64","1.72","2.47","1.41","88","47","54","7","4"
"2010","Alberta","48","Sexual interference","291","105","82","69.72","7.8","2.31","2.54","4.97","7.1","187","67","81","14","20"
"2011","Alberta","48","Sexual interference","260","126","59","-12.01","6.86","2.85","3","4.62","6.05","185","84","97","13","17"
"2012","Alberta","48","Sexual interference","238","103","58","-10.6","6.13","2.51","2.87","6.78","6.07","161","76","95","19","17"
"2013","Alberta","48","Sexual interference","262","112","47","6.89","6.56","2.37","2.47","3.58","5.01","159","74","84","10","14"
"2014","Alberta","48","Sexual interference","257","101","47","-4.57","6.26","2.24","2.23","2.15","7.17","148","72","78","6","20"
"2015","Alberta","48","Sexual interference","392","182","56","49.92","9.38","4.16","4.51","8.58","7.87","238","136","160","24","22"
"2016","Alberta","48","Sexual interference","510","373","46","27.86","11.99","8.3","9.62","25.09","4.95","419","276","347","71","14"
"2003","Alberta","48","Invitation to sexual touching","1","0","0","0","0.03","0","0","0","0","0","0","0","0","0"
"2004","Alberta","48","Invitation to sexual touching","1","1","0","-1.73","0.03","0.04","0.04","0","0","1","1","1","0","0"
"2005","Alberta","48","Invitation to sexual touching","1","0","0","-2.49","0.03","0","0","0","0","0","0","0","0","0"
"2006","Alberta","48","Invitation to sexual touching","1","1","0","-2.9","0.03","0.04","0.03","0","0","1","1","1","0","0"
"2007","Alberta","48","Invitation to sexual touching","3","0","1","192.09","0.09","0","0","0","0.35","1","0","0","0","1"
"2008","Alberta","48","Invitation to sexual touching","23","6","4","649.24","0.64","0.04","0.1","0.7","0.7","10","1","3","2","2"
"2009","Alberta","48","Invitation to sexual touching","42","19","4","78.47","1.14","0.28","0.32","0.7","0","23","8","10","2","0"
"2010","Alberta","48","Invitation to sexual touching","54","20","18","26.73","1.45","0.28","0.38","1.42","1.78","38","8","12","4","5"
"2011","Alberta","48","Invitation to sexual touching","46","19","10","-16.11","1.21","0.24","0.37","1.78","3.2","29","7","12","5","9"
"2012","Alberta","48","Invitation to sexual touching","50","21","15","6.16","1.29","0.33","0.36","0.71","2.86","36","10","12","2","8"
"2013","Alberta","48","Invitation to sexual touching","62","36","10","20.41","1.55","0.61","0.71","1.79","1.43","46","19","24","5","4"
"2014","Alberta","48","Invitation to sexual touching","61","27","16","-4.29","1.48","0.34","0.43","1.43","2.15","43","11","15","4","6"
"2015","Alberta","48","Invitation to sexual touching","63","28","8","1.51","1.51","0.43","0.48","1.07","1.07","36","14","17","3","3"
"2016","Alberta","48","Invitation to sexual touching","71","28","5","10.76","1.67","0.48","0.64","2.47","0.71","33","16","23","7","2"
"2003","Alberta","48","Sexual exploitation","1","1","0","0","0.03","0.04","0.04","0","0","1","1","1","0","0"
"2004","Alberta","48","Sexual exploitation","0","0","0","-100","0","0","0","0","0","0","0","0","0","0"
"2005","Alberta","48","Sexual exploitation","0","0","0","0","0","0","0","0","0","0","0","0","0","0"
"2006","Alberta","48","Sexual exploitation","0","0","0","0","0","0","0","0","0","0","0","0","0","0"
"2007","Alberta","48","Sexual exploitation","1","1","0","0","0.03","0.04","0.03","0","0","1","1","1","0","0"
"2008","Alberta","48","Sexual exploitation","9","5","0","779.54","0.25","0.18","0.16","0","0","5","5","5","0","0"
"2009","Alberta","48","Sexual exploitation","10","1","2","8.59","0.27","0.03","0.03","0","0","3","1","1","0","0"
"2010","Alberta","48","Sexual exploitation","17","13","2","67.56","0.46","0.31","0.28","0","0.36","15","9","9","0","1"
"2011","Alberta","48","Sexual exploitation","12","8","1","-30.48","0.32","0.2","0.19","0","0.36","9","6","6","0","1"
"2012","Alberta","48","Sexual exploitation","8","6","4","-34.89","0.21","0.17","0.15","0","0","10","5","5","0","0"
"2013","Alberta","48","Sexual exploitation","13","7","2","57.79","0.33","0.13","0.12","0","0","9","4","4","0","0"
"2014","Alberta","48","Sexual exploitation","15","10","2","12.25","0.37","0.16","0.14","0","0.36","12","5","5","0","1"
"2015","Alberta","48","Sexual exploitation","15","12","1","-1.71","0.36","0.34","0.31","0","0","13","11","11","0","0"
"2016","Alberta","48","Sexual exploitation","19","13","1","24.49","0.45","0.39","0.36","0","0","14","13","13","0","0"
"2005","Alberta","48","Making sexually explicit material available to children","0","0","0","0","0","0","0","0","0","0","0","0","0","0"
"2006","Alberta","48","Making sexually explicit material available to children","0","0","0","0","0","0","0","0","0","0","0","0","0","0"
"2007","Alberta","48","Making sexually explicit material available to children","0","0","0","0","0","0","0","0","0","0","0","0","0","0"
"2008","Alberta","48","Making sexually explicit material available to children","0","0","0","0","0","0","0","0","0","0","0","0","0","0"
"2009","Alberta","48","Making sexually explicit material available to children","0","0","0","0","0","0","0","0","0","0","0","0","0","0"
"2010","Alberta","48","Making sexually explicit material available to children","0","0","0","0","0","0","0","0","0","0","0","0","0","0"
"2011","Alberta","48","Making sexually explicit material available to children","0","0","0","0","0","0","0","0","0","0","0","0","0","0"
"2012","Alberta","48","Making sexually explicit material available to children","1","0","0","0","0.03","0","0","0","0","0","0","0","0","0"
"2013","Alberta","48","Making sexually explicit material available to children","4","0","1","288.4","0.1","0","0","0","0.36","1","0","0","0","1"
"2014","Alberta","48","Making sexually explicit material available to children","19","2","1","362.09","0.46","0.03","0.06","0.36","0","3","1","2","1","0"
"2015","Alberta","48","Making sexually explicit material available to children","28","8","5","44.85","0.67","0.21","0.2","0","1.07","13","7","7","0","3"
"2016","Alberta","48","Making sexually explicit material available to children","25","10","7","-12.25","0.59","0.24","0.25","0.35","0.71","17","8","9","1","2"
"2012","Alberta","48","Parent or guardian procuring sexual activity: person procured under the age of 16 years","0","0","0","0","0","0","0","0","0","0","0","0","0","0"
"2013","Alberta","48","Parent or guardian procuring sexual activity: person procured under the age of 16 years","0","0","0","0","0","0","0","0","0","0","0","0","0","0"
"2014","Alberta","48","Parent or guardian procuring sexual activity: person procured under the age of 16 years","0","0","0","0","0","0","0","0","0","0","0","0","0","0"
"2012","Alberta","48","Parent or guardian procuring sexual activity","0","0","0","0","0","0","0","0","0","0","0","0","0","0"
"2013","Alberta","48","Parent or guardian procuring sexual activity","0","0","0","0","0","0","0","0","0","0","0","0","0","0"
"2014","Alberta","48","Parent or guardian procuring sexual activity","0","0","0","0","0","0","0","0","0","0","0","0","0","0"
"2015","Alberta","48","Parent or guardian procuring sexual activity","0","0","0","0","0","0","0","0","0","0","0","0","0","0"
"2016","Alberta","48","Parent or guardian procuring sexual activity","0","0","0","0","0","0","0","0","0","0","0","0","0","0"
"2012","Alberta","48","Householder permitting illegal sexual activity: person under the age of 16 years","0","0","0","0","0","0","0","0","0","0","0","0","0","0"
"2013","Alberta","48","Householder permitting illegal sexual activity: person under the age of 16 years","0","0","0","0","0","0","0","0","0","0","0","0","0","0"
"2014","Alberta","48","Householder permitting illegal sexual activity: person under the age of 16 years","0","0","0","0","0","0","0","0","0","0","0","0","0","0"
"2012","Alberta","48","Householder permitting prohibited sexual activity","0","0","0","0","0","0","0","0","0","0","0","0","0","0"
"2013","Alberta","48","Householder permitting prohibited sexual activity","0","0","0","0","0","0","0","0","0","0","0","0","0","0"
"2014","Alberta","48","Householder permitting prohibited sexual activity","0","0","0","0","0","0","0","0","0","0","0","0","0","0"
"2015","Alberta","48","Householder permitting prohibited sexual activity","0","0","0","0","0","0","0","0","0","0","0","0","0","0"
"2016","Alberta","48","Householder permitting prohibited sexual activity","1","0","0","0","0.02","0","0","0","0","0","0","0","0","0"
"1998","Alberta","48","Luring a child via a computer","0","0","0","0","0","0","0","0","0","0","0","0","0","0"
"1999","Alberta","48","Luring a child via a computer","0","0","0","0","0","0","0","0","0","0","0","0","0","0"
"2000","Alberta","48","Luring a child via a computer","0","0","0","0","0","0","0","0","0","0","0","0","0","0"
"2001","Alberta","48","Luring a child via a computer","0","0","0","0","0","0","0","0","0","0","0","0","0","0"
"2002","Alberta","48","Luring a child via a computer","0","0","0","0","0","0","0","0","0","0","0","0","0","0"
"2003","Alberta","48","Luring a child via a computer","3","1","0","0","0.09","0.04","0.04","0","0","1","1","1","0","0"
"2004","Alberta","48","Luring a child via a computer","3","0","1","-1.73","0.09","0","0","0","0","1","0","0","0","0"
"2005","Alberta","48","Luring a child via a computer","3","0","0","-2.49","0.09","0","0","0","0","0","0","0","0","0"
"2006","Alberta","48","Luring a child via a computer","10","1","2","223.67","0.29","0.04","0.03","0","0","3","1","1","0","0"
"2007","Alberta","48","Luring a child via a computer","27","1","6","162.88","0.77","0.04","0.03","0","1.05","7","1","1","0","3"
"2008","Alberta","48","Luring a child via a computer","34","6","6","23.06","0.95","0.14","0.13","0","0","12","4","4","0","0"
"2009","Alberta","48","Luring a child via a computer","46","5","6","32.23","1.25","0.17","0.16","0","0","11","5","5","0","0"
"2010","Alberta","48","Luring a child via a computer","44","8","9","-5.72","1.18","0.14","0.13","0","0.36","17","4","4","0","1"
"2011","Alberta","48","Luring a child via a computer","46","12","9","2.96","1.21","0.41","0.37","0","0.36","21","12","12","0","1"
"2012","Alberta","48","Luring a child via a computer","75","14","7","59.24","1.93","0.33","0.3","0","0.71","21","10","10","0","2"
"2013","Alberta","48","Luring a child via a computer","94","16","18","21.7","2.35","0.32","0.38","1.07","1.07","34","10","13","3","3"
"2014","Alberta","48","Luring a child via a computer","123","28","23","27.29","2.99","0.65","0.6","0","1.08","51","21","21","0","3"
"2015","Alberta","48","Luring a child via a computer","107","23","11","-14.49","2.56","0.46","0.42","0","0.36","34","15","15","0","1"
"2016","Alberta","48","Luring a child via a computer","123","18","14","12.97","2.89","0.42","0.44","0.71","1.06","32","14","16","2","3"
"1998","Alberta","48","Assault, level 3, aggravated","365","282","20","0","12.59","11.73","11.75","11.9","0","302","251","282","31","0"
"1999","Alberta","48","Assault, level 3, aggravated","336","272","11","-9.62","11.38","11.78","12.5","18.54","0","283","258","307","49","0"
"2000","Alberta","48","Assault, level 3, aggravated","353","268","14","3.25","11.75","11.69","11.76","12.35","0.75","282","262","295","33","2"
"2001","Alberta","48","Assault, level 3, aggravated","421","319","8","17.19","13.77","13.51","13.72","15.52","0","327","310","352","42","0"
"2002","Alberta","48","Assault, level 3, aggravated","404","318","3","-6.2","12.91","13.99","14.79","21.68","1.08","321","330","390","60","3"
"2003","Alberta","48","Assault, level 3, aggravated","444","366","9","8","13.95","16.45","17.38","25.4","0.72","375","397","468","71","2"
"2004","Alberta","48","Assault, level 3, aggravated","481","337","11","6.46","14.85","13.94","14.92","23.48","1.78","348","344","410","66","5"
"2005","Alberta","48","Assault, level 3, aggravated","558","376","16","13.12","16.8","14.88","15.82","24.32","0.35","392","378","447","69","1"
"2006","Alberta","48","Assault, level 3, aggravated","551","397","24","-4.12","16.1","15.76","16.37","21.94","1.74","421","414","477","63","5"
"2007","Alberta","48","Assault, level 3, aggravated","648","431","25","14.5","18.44","15.2","16.54","29.27","1.39","456","412","496","84","4"
"2008","Alberta","48","Assault, level 3, aggravated","674","487","36","1.65","18.74","16.45","17.43","26.99","3.86","523","458","535","77","11"
"2009","Alberta","48","Assault, level 3, aggravated","681","467","37","-1.25","18.51","15.22","15.91","22.91","1.76","504","435","500","65","5"
"2010","Alberta","48","Assault, level 3, aggravated","642","487","18","-7.08","17.2","16.19","16.55","20.24","1.78","505","470","527","57","5"
"2011","Alberta","48","Assault, level 3, aggravated","670","500","23","2.77","17.68","17.02","17.3","20.27","1.42","523","502","559","57","4"
"2012","Alberta","48","Assault, level 3, aggravated","703","531","29","2.48","18.12","18.21","18.57","22.49","3.21","560","551","614","63","9"
"2013","Alberta","48","Assault, level 3, aggravated","672","526","21","-7.18","16.81","17.22","16.87","12.88","2.15","547","538","574","36","6"
"2014","Alberta","48","Assault, level 3, aggravated","681","510","25","-1.42","16.58","16.01","16.02","16.14","0.36","535","515","560","45","1"
"2015","Alberta","48","Assault, level 3, aggravated","692","515","26","-0.12","16.56","15.9","15.72","13.59","2.5","541","520","558","38","7"
"2016","Alberta","48","Assault, level 3, aggravated","625","485","16","-11.24","14.7","14.56","14.47","13.43","1.41","501","484","522","38","4"
"1998","Alberta","48","Assault, level 2, weapon or bodily harm","3897","2741","414","0","134.4","105.24","114.19","187.66","24.56","3155","2251","2740","489","64"
"1999","Alberta","48","Assault, level 2, weapon or bodily harm","3767","2598","466","-5.1","127.55","98.14","106.64","177.1","29.52","3064","2150","2618","468","78"
"2000","Alberta","48","Assault, level 2, weapon or bodily harm","4049","2668","468","5.64","134.74","96.73","108.51","207.33","59.5","3136","2168","2722","554","159"
"2001","Alberta","48","Assault, level 2, weapon or bodily harm","4446","2827","539","7.9","145.39","102.46","113.99","211.73","60.23","3366","2351","2924","573","163"
"2002","Alberta","48","Assault, level 2, weapon or bodily harm","4395","2727","498","-3.37","140.49","97.52","110.12","217.49","57.8","3225","2301","2903","602","160"
"2003","Alberta","48","Assault, level 2, weapon or bodily harm","4791","2885","614","7.13","150.5","99.72","110.31","201.77","84.79","3499","2406","2970","564","237"
"2004","Alberta","48","Assault, level 2, weapon or bodily harm","5279","3001","643","8.28","162.96","104.41","112.51","183.6","71.52","3644","2576","3092","516","201"
"2005","Alberta","48","Assault, level 2, weapon or bodily harm","5827","3251","701","7.63","175.4","106.33","115.97","202.31","71.9","3952","2702","3276","574","204"
"2006","Alberta","48","Assault, level 2, weapon or bodily harm","6590","3722","1009","9.82","192.61","120.03","126.8","188.79","121.21","4731","3153","3695","542","348"
"2007","Alberta","48","Assault, level 2, weapon or bodily harm","6877","3860","1045","1.6","195.7","115.68","125.65","219.91","103.16","4905","3136","3767","631","296"
"2008","Alberta","48","Assault, level 2, weapon or bodily harm","7040","3978","1037","0.04","195.79","116.7","123.87","193.86","110.08","5015","3250","3803","553","314"
"2009","Alberta","48","Assault, level 2, weapon or bodily harm","6728","3843","1078","-6.6","182.87","110.39","117.06","184.31","105.37","4921","3155","3678","523","299"
"2010","Alberta","48","Assault, level 2, weapon or bodily harm","6256","3802","981","-8.35","167.61","108.58","113.8","167.59","80.24","4783","3152","3624","472","226"
"2011","Alberta","48","Assault, level 2, weapon or bodily harm","6184","3719","848","-2.65","163.16","105.77","111.3","169.27","65.43","4567","3120","3596","476","184"
"2012","Alberta","48","Assault, level 2, weapon or bodily harm","6407","3884","839","1.19","165.1","108.78","111.27","138.16","65.69","4723","3292","3679","387","184"
"2013","Alberta","48","Assault, level 2, weapon or bodily harm","6456","3898","851","-2.16","161.54","104.81","107.54","138.08","64.75","4749","3274","3660","386","181"
"2014","Alberta","48","Assault, level 2, weapon or bodily harm","6654","3990","820","0.27","161.97","105.66","107.08","123.4","52.02","4810","3399","3743","344","145"
"2015","Alberta","48","Assault, level 2, weapon or bodily harm","7465","4426","928","10.27","178.6","113.83","115.32","132.68","60.08","5354","3723","4094","371","168"
"2016","Alberta","48","Assault, level 2, weapon or bodily harm","7474","4568","834","-1.6","175.74","117.16","117.7","124.03","54.42","5402","3894","4245","351","154"
"1998","Alberta","48","Assault, level 1","20212","9160","6847","0","697.1","346.81","357.28","443.24","294.34","16007","7418","8573","1155","767"
"1999","Alberta","48","Assault, level 1","20236","8415","7731","-1.71","685.21","308.38","323.62","449.95","333.39","16146","6756","7945","1189","881"
"2000","Alberta","48","Assault, level 1","20695","9013","6625","0.51","688.7","324.04","338.28","457.7","474.54","15638","7263","8486","1223","1268"
"2001","Alberta","48","Assault, level 1","21620","9192","6625","2.66","706.99","328.13","347.89","515.47","549.83","15817","7529","8924","1395","1488"
"2002","Alberta","48","Assault, level 1","21664","9010","6621","-2.05","692.5","309.05","329.33","502.17","531.8","15631","7292","8682","1390","1472"
"2003","Alberta","48","Assault, level 1","22046","8688","6950","0","692.53","299.99","308.36","380.64","645.73","15638","7238","8302","1064","1805"
"2004","Alberta","48","Assault, level 1","22384","8809","6563","-0.22","690.98","305.79","314.65","392.47","548.32","15372","7544","8647","1103","1541"
"2005","Alberta","48","Assault, level 1","22764","9964","6576","-0.83","685.21","330.17","335.17","379.94","510","16540","8390","9468","1078","1447"
"2006","Alberta","48","Assault, level 1","23113","11510","7393","-1.41","675.55","357.88","362.05","400.21","560.09","18903","9401","10550","1149","1608"
"2007","Alberta","48","Assault, level 1","23687","11219","7967","-0.22","674.07","340.95","343.07","363.15","590.38","19186","9243","10285","1042","1694"
"2008","Alberta","48","Assault, level 1","24810","11923","8185","2.36","689.98","347.17","351.13","389.83","560.56","20108","9668","10780","1112","1599"
"2009","Alberta","48","Assault, level 1","24917","12006","8540","-1.84","677.26","342.43","343.1","349.93","536","20546","9787","10780","993","1521"
"2010","Alberta","48","Assault, level 1","23393","11323","7961","-7.46","626.73","314.38","316.44","337.67","520.17","19284","9126","10077","951","1465"
"2011","Alberta","48","Assault, level 1","23506","11519","7418","-1.04","620.18","321.72","322.72","333.2","474.02","18937","9490","10427","937","1333"
"2012","Alberta","48","Assault, level 1","24010","11832","7219","-0.24","618.69","326.68","323.84","293.1","420.55","19051","9886","10707","821","1178"
"2013","Alberta","48","Assault, level 1","22533","11169","6781","-8.87","563.8","300.44","298.27","274.01","366.66","17950","9385","10151","766","1025"
"2014","Alberta","48","Assault, level 1","22739","11110","6708","-1.83","553.49","291.62","288.31","250.04","342.23","17818","9381","10078","697","954"
"2015","Alberta","48","Assault, level 1","23137","11445","6825","0.01","553.56","295.85","291.45","239.98","336.54","18270","9676","10347","671","941"
"2016","Alberta","48","Assault, level 1","22591","11324","6431","-4.04","531.19","294.05","287.14","206.01","298.24","17755","9773","10356","583","844"
"1998","Alberta","48","Total assaults against a peace officer","709","680","13","0","24.45","26.32","26.3","26.1","1.15","693","563","631","68","3"
"1999","Alberta","48","Total assaults against a peace officer","778","760","20","7.73","26.34","28.53","27.62","20.06","0.38","780","625","678","53","1"
"2000","Alberta","48","Total assaults against a peace officer","828","803","19","4.6","27.55","29.27","28.3","20.21","0.37","822","656","710","54","1"
"2001","Alberta","48","Total assaults against a peace officer","893","870","23","5.98","29.2","33.56","33.21","30.3","6.28","893","770","852","82","17"
"2002","Alberta","48","Total assaults against a peace officer","1028","963","45","12.53","32.86","35.35","34.37","26.01","4.34","1008","834","906","72","12"
"2003","Alberta","48","Total assaults against a peace officer","1030","976","49","-1.54","32.36","34.98","34.8","33.27","5.37","1025","844","937","93","15"
"2004","Alberta","48","Total assaults against a peace officer","1069","1003","65","1.99","33","35.63","35.99","39.14","5.34","1068","879","989","110","15"
"2005","Alberta","48","Total assaults against a peace officer","1071","1007","55","-2.31","32.24","32.7","33.13","37.01","4.58","1062","831","936","105","13"
"2006","Alberta","48","Total assaults against a peace officer","1166","1120","38","5.71","34.08","33.84","34.04","35.88","6.62","1158","889","992","103","19"
"2007","Alberta","48","Total assaults against a peace officer","1185","1123","61","-1.05","33.72","30.91","31.29","34.85","4.18","1184","838","938","100","12"
"2008","Alberta","48","Total assaults against a peace officer","1171","1097","61","-3.43","32.57","35.41","35.54","36.81","5.96","1158","986","1091","105","17"
"2009","Alberta","48","Total assaults against a peace officer","1840","1541","192","53.57","50.01","50","50.64","57.09","13.04","1733","1429","1591","162","37"
"2010","Alberta","48","Total assaults against a peace officer","2938","2159","583","57.39","78.71","66.31","64.94","50.77","31.25","2742","1925","2068","143","88"
"2011","Alberta","48","Total assaults against a peace officer","1521","1358","164","-49.02","40.13","34.71","34.54","32.72","6.4","1522","1024","1116","92","18"
"2012","Alberta","48","Total assaults against a peace officer","1242","1160","77","-20.25","32","27.49","28.37","37.84","3.93","1237","832","938","106","11"
"2013","Alberta","48","Total assaults against a peace officer","1215","1128","69","-5.01","30.4","25.74","25.68","25.04","5.37","1197","804","874","70","15"
"2014","Alberta","48","Total assaults against a peace officer","1241","1159","66","-0.64","30.21","25.83","25.89","26.55","2.87","1225","831","905","74","8"
"2015","Alberta","48","Total assaults against a peace officer","1347","1261","63","6.69","32.23","27.06","26.87","24.68","1.79","1324","885","954","69","5"
"2016","Alberta","48","Total assaults against a peace officer","1314","1240","58","-4.13","30.9","27.59","27.14","21.91","1.77","1298","917","979","62","5"
"1998","Alberta","48","Total other assaults","762","494","143","0","26.28","16.83","17.55","23.41","4.61","637","360","421","61","12"
"1999","Alberta","48","Total other assaults","699","463","127","-9.94","23.67","15.98","16.29","18.92","5.68","590","350","400","50","15"
"2000","Alberta","48","Total other assaults","525","359","78","-26.18","17.47","12.58","12.96","16.09","4.87","437","282","325","43","13"
"2001","Alberta","48","Total other assaults","546","399","50","2.19","17.85","16.52","16.33","14.78","3.33","449","379","419","40","9"
"2002","Alberta","48","Total other assaults","505","378","45","-9.59","16.14","13.73","13.92","15.53","4.7","423","324","367","43","13"
"2003","Alberta","48","Total other assaults","502","396","42","-2.31","15.77","14.75","15.08","17.89","3.58","438","356","406","50","10"
"2004","Alberta","48","Total other assaults","410","309","24","-19.74","12.66","12.24","12.19","11.74","2.85","333","302","335","33","8"
"2005","Alberta","48","Total other assaults","340","254","16","-19.14","10.23","7.2","7.58","10.93","2.82","270","183","214","31","8"
"2006","Alberta","48","Total other assaults","257","208","7","-26.6","7.51","5.41","5.49","6.27","1.04","215","142","160","18","3"
"2007","Alberta","48","Total other assaults","244","199","8","-7.56","6.94","4.32","4.57","6.97","1.74","207","117","137","20","5"
"2008","Alberta","48","Total other assaults","242","219","11","-3.07","6.73","5.82","5.9","6.66","0.35","230","162","181","19","1"
"2009","Alberta","48","Total other assaults","218","167","15","-11.96","5.93","4.55","4.52","4.23","3.17","182","130","142","12","9"
"2010","Alberta","48","Total other assaults","195","136","13","-11.83","5.22","3.51","3.52","3.55","1.78","149","102","112","10","5"
"2011","Alberta","48","Total other assaults","234","184","18","18.18","6.17","4.81","4.77","4.27","0.71","202","142","154","12","2"
"2012","Alberta","48","Total other assaults","193","144","10","-19.45","4.97","3.37","3.36","3.21","0.36","154","102","111","9","1"
"2013","Alberta","48","Total other assaults","215","173","9","8.17","5.38","4","4.23","6.8","0.36","182","125","144","19","1"
"2014","Alberta","48","Total other assaults","257","219","5","16.29","6.26","4.76","4.75","4.66","0.72","224","153","166","13","2"
"2015","Alberta","48","Total other assaults","237","207","8","-9.36","5.67","4.34","4.42","5.36","0","215","142","157","15","0"
"2016","Alberta","48","Total other assaults","187","164","5","-22.46","4.4","3.91","3.8","2.47","0.71","169","130","137","7","2"
"1998","Alberta","48","Unlawfully causing bodily harm","420","308","46","0","14.49","11.59","12.04","15.73","1.15","354","248","289","41","3"
"1999","Alberta","48","Unlawfully causing bodily harm","361","260","48","-15.61","12.22","9.49","9.86","12.87","0.76","308","208","242","34","2"
"2000","Alberta","48","Unlawfully causing bodily harm","264","181","35","-28.13","8.79","7.27","7.14","5.99","1.5","216","163","179","16","4"
"2001","Alberta","48","Unlawfully causing bodily harm","287","224","17","6.83","9.39","10.46","10.14","7.39","1.48","241","240","260","20","4"
"2002","Alberta","48","Unlawfully causing bodily harm","225","164","23","-23.37","7.19","7.04","6.9","5.78","1.45","187","166","182","16","4"
"2003","Alberta","48","Unlawfully causing bodily harm","240","183","23","4.82","7.54","7.71","7.95","10.02","1.07","206","186","214","28","3"
"2004","Alberta","48","Unlawfully causing bodily harm","200","141","18","-18.11","6.17","6.57","6.62","7.12","1.78","159","162","182","20","5"
"2005","Alberta","48","Unlawfully causing bodily harm","112","65","10","-45.39","3.37","2.64","2.55","1.76","0.7","75","67","72","5","2"
"2006","Alberta","48","Unlawfully causing bodily harm","35","27","1","-69.66","1.02","0.95","0.93","0.7","0.35","28","25","27","2","1"
"2007","Alberta","48","Unlawfully causing bodily harm","28","16","3","-22.11","0.8","0.33","0.33","0.35","0.35","19","9","10","1","1"
"2008","Alberta","48","Unlawfully causing bodily harm","14","14","3","-51.14","0.39","0.5","0.49","0.35","0","17","14","15","1","0"
"2009","Alberta","48","Unlawfully causing bodily harm","5","2","1","-65.09","0.14","0.07","0.06","0","0","3","2","2","0","0"
"2010","Alberta","48","Unlawfully causing bodily harm","10","5","3","97.13","0.27","0.1","0.16","0.71","1.07","8","3","5","2","3"
"2011","Alberta","48","Unlawfully causing bodily harm","10","9","0","-1.52","0.26","0.27","0.31","0.71","0","9","8","10","2","0"
"2012","Alberta","48","Unlawfully causing bodily harm","7","5","0","-31.63","0.18","0.07","0.09","0.36","0","5","2","3","1","0"
"2013","Alberta","48","Unlawfully causing bodily harm","6","8","0","-16.77","0.15","0.16","0.18","0.36","0","8","5","6","1","0"
"2014","Alberta","48","Unlawfully causing bodily harm","4","3","0","-35.15","0.1","0.09","0.09","0","0","3","3","3","0","0"
"2015","Alberta","48","Unlawfully causing bodily harm","1","1","0","-75.43","0.02","0.03","0.03","0","0","1","1","1","0","0"
"2016","Alberta","48","Unlawfully causing bodily harm","1","1","0","-1.72","0.02","0.06","0.06","0","0","1","2","2","0","0"
"1998","Alberta","48","Criminal negligence causing bodily harm","21","11","1","0","0.72","0.33","0.29","0","0","12","7","7","0","0"
"1999","Alberta","48","Criminal negligence causing bodily harm","30","15","0","40.25","1.02","0.23","0.24","0.38","0","15","5","6","1","0"
"2000","Alberta","48","Criminal negligence causing bodily harm","9","3","1","-70.52","0.3","0.04","0.08","0.37","0","4","1","2","1","0"
"2001","Alberta","48","Criminal negligence causing bodily harm","24","16","0","162.04","0.78","0.31","0.51","2.22","0","16","7","13","6","0"
"2002","Alberta","48","Criminal negligence causing bodily harm","16","6","0","-34.83","0.51","0.13","0.11","0","0","6","3","3","0","0"
"2003","Alberta","48","Criminal negligence causing bodily harm","21","9","1","28.98","0.66","0.21","0.22","0.36","0","10","5","6","1","0"
"2004","Alberta","48","Criminal negligence causing bodily harm","21","12","0","-1.73","0.65","0.32","0.29","0","0","12","8","8","0","0"
"2005","Alberta","48","Criminal negligence causing bodily harm","13","8","0","-39.64","0.39","0.24","0.21","0","0","8","6","6","0","0"
"2006","Alberta","48","Criminal negligence causing bodily harm","26","22","1","94.2","0.76","0.49","0.62","1.74","0.35","23","13","18","5","1"
"2007","Alberta","48","Criminal negligence causing bodily harm","28","20","3","4.85","0.8","0.37","0.43","1.05","1.05","23","10","13","3","3"
"2008","Alberta","48","Criminal negligence causing bodily harm","34","28","3","18.67","0.95","0.75","0.68","0","0.35","31","21","21","0","1"
"2009","Alberta","48","Criminal negligence causing bodily harm","14","11","2","-59.76","0.38","0.35","0.32","0","1.06","13","10","10","0","3"
"2010","Alberta","48","Criminal negligence causing bodily harm","21","16","2","47.85","0.56","0.48","0.44","0","0","18","14","14","0","0"
"2011","Alberta","48","Criminal negligence causing bodily harm","28","26","1","31.31","0.74","0.58","0.53","0","0","27","17","17","0","0"
"2012","Alberta","48","Criminal negligence causing bodily harm","29","28","4","1.15","0.75","0.43","0.42","0.36","0.36","32","13","14","1","1"
"2013","Alberta","48","Criminal negligence causing bodily harm","36","28","0","20.54","0.9","0.42","0.41","0.36","0","28","13","14","1","0"
"2014","Alberta","48","Criminal negligence causing bodily harm","25","15","2","-32.44","0.61","0.31","0.34","0.72","0.72","17","10","12","2","2"
"2015","Alberta","48","Criminal negligence causing bodily harm","12","14","2","-52.82","0.29","0.18","0.2","0.36","0","16","6","7","1","0"
"2016","Alberta","48","Criminal negligence causing bodily harm","23","22","2","88.37","0.54","0.39","0.42","0.71","0.35","24","13","15","2","1"
"1998","Alberta","48","Other assaults","321","175","96","0","11.07","4.91","5.21","7.68","3.45","271","105","125","20","9"
"1999","Alberta","48","Other assaults","308","188","79","-5.8","10.43","6.25","6.19","5.68","4.92","267","137","152","15","13"
"2000","Alberta","48","Other assaults","252","175","42","-19.59","8.39","5.26","5.74","9.73","3.37","217","118","144","26","9"
"2001","Alberta","48","Other assaults","235","159","33","-8.36","7.68","5.75","5.69","5.17","1.85","192","132","146","14","5"
"2002","Alberta","48","Other assaults","264","208","22","9.81","8.44","6.57","6.9","9.75","3.25","230","155","182","27","9"
"2003","Alberta","48","Other assaults","241","204","18","-10.29","7.57","6.84","6.91","7.51","2.5","222","165","186","21","7"
"2004","Alberta","48","Other assaults","189","156","6","-22.93","5.83","5.35","5.28","4.63","1.07","162","132","145","13","3"
"2005","Alberta","48","Other assaults","215","181","6","10.92","6.47","4.33","4.81","9.16","2.11","187","110","136","26","6"
"2006","Alberta","48","Other assaults","196","159","5","-11.48","5.73","3.96","3.95","3.83","0.35","164","104","115","11","1"
"2007","Alberta","48","Other assaults","188","163","2","-6.61","5.35","3.61","3.8","5.58","0.35","165","98","114","16","1"
"2008","Alberta","48","Other assaults","194","177","5","0.85","5.4","4.56","4.72","6.31","0","182","127","145","18","0"
"2009","Alberta","48","Other assaults","199","154","12","0.25","5.41","4.13","4.14","4.23","2.11","166","118","130","12","6"
"2010","Alberta","48","Other assaults","164","115","8","-18.77","4.39","2.93","2.92","2.84","0.71","123","85","93","8","2"
"2011","Alberta","48","Other assaults","196","149","17","17.7","5.17","3.97","3.93","3.56","0.71","166","117","127","10","2"
"2012","Alberta","48","Other assaults","157","111","6","-21.77","4.05","2.87","2.84","2.5","0","117","87","94","7","0"
"2013","Alberta","48","Other assaults","173","137","9","7","4.33","3.43","3.64","6.08","0.36","146","107","124","17","1"
"2014","Alberta","48","Other assaults","228","201","3","28.21","5.55","4.35","4.32","3.95","0","204","140","151","11","0"
"2015","Alberta","48","Other assaults","224","192","6","-3.43","5.36","4.13","4.2","5.01","0","198","135","149","14","0"
"2016","Alberta","48","Other assaults","163","141","3","-28.48","3.83","3.46","3.33","1.77","0.35","144","115","120","5","1"
"1998","Alberta","48","Total firearms, use of, discharge, pointing","84","28","16","0","2.9","0.56","0.75","2.3","3.07","44","12","18","6","8"
"1999","Alberta","48","Total firearms, use of, discharge, pointing","236","124","24","175.83","7.99","3.42","3.42","3.41","2.27","148","75","84","9","6"
"2000","Alberta","48","Total firearms, use of, discharge, pointing","203","94","23","-15.46","6.76","2.54","2.79","4.87","4.87","117","57","70","13","13"
"2001","Alberta","48","Total firearms, use of, discharge, pointing","221","90","47","6.98","7.23","3.01","3.51","7.76","11.45","137","69","90","21","31"
"2002","Alberta","48","Total firearms, use of, discharge, pointing","260","78","42","15","8.31","2.84","3.26","6.86","9.03","120","67","86","19","25"
"2003","Alberta","48","Total firearms, use of, discharge, pointing","311","81","53","17.55","9.77","2.78","3.94","13.95","15.38","134","67","106","39","43"
"2004","Alberta","48","Total firearms, use of, discharge, pointing","355","72","54","12.17","10.96","2.59","2.58","2.49","9.96","126","64","71","7","28"
"2005","Alberta","48","Total firearms, use of, discharge, pointing","341","86","53","-6.34","10.26","2.48","2.69","4.58","13.39","139","63","76","13","38"
"2006","Alberta","48","Total firearms, use of, discharge, pointing","152","45","23","-56.72","4.44","1.71","2.06","5.22","4.18","68","45","60","15","12"
"2007","Alberta","48","Total firearms, use of, discharge, pointing","177","45","36","13.38","5.04","1.33","1.47","2.79","14.64","81","36","44","8","42"
"2008","Alberta","48","Total firearms, use of, discharge, pointing","221","53","42","22.02","6.15","1.69","2.12","6.31","10.17","95","47","65","18","29"
"2009","Alberta","48","Total firearms, use of, discharge, pointing","238","87","35","5.25","6.47","2.52","2.74","4.93","7.05","122","72","86","14","20"
"2010","Alberta","48","Total firearms, use of, discharge, pointing","295","129","44","22.17","7.9","3.86","3.93","4.62","4.97","173","112","125","13","14"
"2011","Alberta","48","Total firearms, use of, discharge, pointing","309","122","39","3.15","8.15","3.12","3.5","7.47","5.33","161","92","113","21","15"
"2012","Alberta","48","Total firearms, use of, discharge, pointing","347","165","31","9.68","8.94","3.7","3.93","6.43","6.43","196","112","130","18","18"
"2013","Alberta","48","Total firearms, use of, discharge, pointing","307","141","32","-14.09","7.68","3.81","4.08","7.15","6.44","173","119","139","20","18"
"2014","Alberta","48","Total firearms, use of, discharge, pointing","354","151","47","12.18","8.62","3.92","4.15","6.82","7.53","198","126","145","19","21"
"2015","Alberta","48","Total firearms, use of, discharge, pointing","483","234","34","34.11","11.56","5.47","6.06","12.88","5.01","268","179","215","36","14"
"2016","Alberta","48","Total firearms, use of, discharge, pointing","458","216","30","-6.81","10.77","5.78","6.02","8.83","4.95","246","192","217","25","14"
"1998","Alberta","48","Discharge firearm with intent","17","14","0","0","0.59","0.23","0.25","0.38","0","14","5","6","1","0"
"1999","Alberta","48","Discharge firearm with intent","20","11","1","15.5","0.68","0.18","0.24","0.76","0","12","4","6","2","0"
"2000","Alberta","48","Discharge firearm with intent","16","13","1","-21.38","0.53","0.18","0.4","2.25","0","14","4","10","6","0"
"2001","Alberta","48","Discharge firearm with intent","14","6","2","-14.02","0.46","0.17","0.35","1.85","0.37","8","4","9","5","1"
"2002","Alberta","48","Discharge firearm with intent","13","10","0","-9.23","0.42","0.3","0.38","1.08","0","10","7","10","3","0"
"2003","Alberta","48","Discharge firearm with intent","20","21","2","51.19","0.63","0.37","0.45","1.07","0","23","9","12","3","0"
"2004","Alberta","48","Discharge firearm with intent","24","13","0","17.92","0.74","0.32","0.29","0","0","13","8","8","0","0"
"2005","Alberta","48","Discharge firearm with intent","59","26","3","139.71","1.78","0.39","0.42","0.7","0.35","29","10","12","2","1"
"2006","Alberta","48","Discharge firearm with intent","47","15","2","-22.65","1.37","0.61","0.82","2.79","0.35","17","16","24","8","1"
"2007","Alberta","48","Discharge firearm with intent","70","16","8","45.01","1.99","0.48","0.53","1.05","4.18","24","13","16","3","12"
"2008","Alberta","48","Discharge firearm with intent","99","18","18","38.21","2.75","0.65","1.01","4.56","5.96","36","18","31","13","17"
"2009","Alberta","48","Discharge firearm with intent","90","5","13","-11.15","2.45","0.28","0.25","0","2.82","18","8","8","0","8"
"2010","Alberta","48","Discharge firearm with intent","119","21","21","30.33","3.19","1","1.1","2.13","2.84","42","29","35","6","8"
"2011","Alberta","48","Discharge firearm with intent","136","20","17","12.55","3.59","0.78","0.87","1.78","1.78","37","23","28","5","5"
"2012","Alberta","48","Discharge firearm with intent","149","37","8","7","3.84","1.02","1.06","1.43","1.79","45","31","35","4","5"
"2013","Alberta","48","Discharge firearm with intent","122","28","9","-20.49","3.05","0.96","0.94","0.72","2.86","37","30","32","2","8"
"2014","Alberta","48","Discharge firearm with intent","148","27","23","18.01","3.6","0.99","1.14","2.87","2.87","50","32","40","8","8"
"2015","Alberta","48","Discharge firearm with intent","184","47","6","22.2","4.4","1.31","1.52","3.93","1.79","53","43","54","11","5"
"2016","Alberta","48","Discharge firearm with intent","194","49","9","3.62","4.56","1.87","2","3.53","2.83","58","62","72","10","8"
"1998","Alberta","48","Using firearm in commission of offence","7","0","2","0","0.24","0","0","0","0","2","0","0","0","0"
"1999","Alberta","48","Using firearm in commission of offence","14","7","0","96.36","0.47","0.18","0.16","0","0","7","4","4","0","0"
"2000","Alberta","48","Using firearm in commission of offence","16","6","1","12.32","0.53","0.09","0.16","0.75","0","7","2","4","2","0"
"2001","Alberta","48","Using firearm in commission of offence","12","3","4","-26.3","0.39","0.04","0.04","0","1.48","7","1","1","0","4"
"2002","Alberta","48","Using firearm in commission of offence","35","11","4","185.11","1.12","0.25","0.27","0.36","2.17","15","6","7","1","6"
"2003","Alberta","48","Using firearm in commission of offence","37","4","4","3.89","1.16","0.17","0.48","3.22","3.58","8","4","13","9","10"
"2004","Alberta","48","Using firearm in commission of offence","70","10","5","85.91","2.16","0.36","0.44","1.07","3.91","15","9","12","3","11"
"2005","Alberta","48","Using firearm in commission of offence","50","17","4","-30.35","1.51","0.59","0.57","0.35","1.41","21","15","16","1","4"
"2006","Alberta","48","Using firearm in commission of offence","23","7","1","-55.33","0.67","0.3","0.38","1.04","0","8","8","11","3","0"
"2007","Alberta","48","Using firearm in commission of offence","22","12","5","-6.87","0.63","0.3","0.37","1.05","2.79","17","8","11","3","8"
"2008","Alberta","48","Using firearm in commission of offence","21","13","3","-6.71","0.58","0.39","0.46","1.05","0","16","11","14","3","0"
"2009","Alberta","48","Using firearm in commission of offence","39","35","1","81.51","1.06","1.19","1.37","3.17","0","36","34","43","9","0"
"2010","Alberta","48","Using firearm in commission of offence","55","48","2","39","1.47","1.72","1.76","2.13","1.07","50","50","56","6","3"
"2011","Alberta","48","Using firearm in commission of offence","58","51","1","3.85","1.53","1.32","1.36","1.78","0","52","39","44","5","0"
"2012","Alberta","48","Using firearm in commission of offence","54","48","2","-9.07","1.39","1.39","1.51","2.86","0.71","50","42","50","8","2"
"2013","Alberta","48","Using firearm in commission of offence","56","51","4","0.7","1.4","1.6","1.65","2.15","0.72","55","50","56","6","2"
"2014","Alberta","48","Using firearm in commission of offence","65","58","2","12.92","1.58","1.71","1.83","3.23","1.08","60","55","64","9","3"
"2015","Alberta","48","Using firearm in commission of offence","81","71","2","22.49","1.94","1.96","2.28","6.08","0.72","73","64","81","17","2"
"2016","Alberta","48","Using firearm in commission of offence","84","76","1","1.92","1.98","2.17","2.25","3.18","0.35","77","72","81","9","1"
"1998","Alberta","48","Pointing a firearm","60","14","14","0","2.07","0.33","0.5","1.92","3.07","28","7","12","5","8"
"1999","Alberta","48","Pointing a firearm","202","106","23","230.53","6.84","3.06","3.01","2.65","2.27","129","67","74","7","6"
"2000","Alberta","48","Pointing a firearm","171","75","21","-16.8","5.69","2.28","2.23","1.87","4.87","96","51","56","5","13"
"2001","Alberta","48","Pointing a firearm","195","81","41","12.06","6.38","2.79","3.12","5.91","9.61","122","64","80","16","26"
"2002","Alberta","48","Pointing a firearm","212","57","38","6.27","6.78","2.29","2.62","5.42","6.86","95","54","69","15","19"
"2003","Alberta","48","Pointing a firearm","254","56","47","17.74","7.98","2.24","3.01","9.66","11.81","103","54","81","27","33"
"2004","Alberta","48","Pointing a firearm","261","49","49","0.98","8.06","1.91","1.86","1.42","6.05","98","47","51","4","17"
"2005","Alberta","48","Pointing a firearm","232","43","46","-13.32","6.98","1.5","1.7","3.52","11.63","89","38","48","10","33"
"2006","Alberta","48","Pointing a firearm","82","23","20","-65.68","2.4","0.8","0.86","1.39","3.83","43","21","25","4","11"
"2007","Alberta","48","Pointing a firearm","85","17","23","0.92","2.42","0.55","0.57","0.7","7.67","40","15","17","2","22"
"2008","Alberta","48","Pointing a firearm","101","22","21","16.12","2.81","0.65","0.65","0.7","4.21","43","18","20","2","12"
"2009","Alberta","48","Pointing a firearm","109","47","21","5.48","2.96","1.05","1.11","1.76","4.23","68","30","35","5","12"
"2010","Alberta","48","Pointing a firearm","121","60","21","9.42","3.24","1.14","1.07","0.36","1.07","81","33","34","1","3"
"2011","Alberta","48","Pointing a firearm","115","51","21","-6.4","3.03","1.02","1.27","3.91","3.56","72","30","41","11","10"
"2012","Alberta","48","Pointing a firearm","144","80","21","22.3","3.71","1.29","1.36","2.14","3.93","101","39","45","6","11"
"2013","Alberta","48","Pointing a firearm","129","62","19","-13.01","3.23","1.25","1.5","4.29","2.86","81","39","51","12","8"
"2014","Alberta","48","Pointing a firearm","141","66","22","6.33","3.43","1.21","1.17","0.72","3.59","88","39","41","2","10"
"2015","Alberta","48","Pointing a firearm","218","116","26","51.97","5.22","2.2","2.25","2.86","2.5","142","72","80","8","7"
"2016","Alberta","48","Pointing a firearm","180","91","20","-18.85","4.23","1.75","1.77","2.12","1.77","111","58","64","6","5"
"1998","Alberta","48","Total robbery","2902","1045","79","0","100.09","31.46","46.55","170.39","11.9","1124","673","1117","444","31"
"1999","Alberta","48","Total robbery","2877","1035","47","-2.67","97.42","31.72","44.93","154.4","7.95","1082","695","1103","408","21"
"2000","Alberta","48","Total robbery","2862","1092","66","-2.23","95.24","31.86","47","174.02","13.47","1158","714","1179","465","36"
"2001","Alberta","48","Total robbery","3074","1215","86","5.54","100.52","36.04","47.95","148.91","9.61","1301","827","1230","403","26"
"2002","Alberta","48","Total robbery","2953","1112","57","-6.1","94.39","32.76","45.44","153.54","11.2","1169","773","1198","425","31"
"2003","Alberta","48","Total robbery","3614","1262","87","20.27","113.53","37.26","47.8","138.8","21.46","1349","899","1287","388","60"
"2004","Alberta","48","Total robbery","3149","1120","57","-14.37","97.21","31.05","38.28","101.76","10.67","1177","766","1052","286","30"
"2005","Alberta","48","Total robbery","3370","1183","90","4.35","101.44","31.76","40.32","117.01","9.16","1273","807","1139","332","26"
"2006","Alberta","48","Total robbery","3546","1211","80","2.17","103.64","32.97","40.36","107.98","12.54","1291","866","1176","310","36"
"2007","Alberta","48","Total robbery","3870","1151","99","6.26","110.13","28.22","38.66","137.31","14.64","1250","765","1159","394","42"
"2008","Alberta","48","Total robbery","3820","1223","87","-3.54","106.24","30.74","40.46","135.32","12.62","1310","856","1242","386","36"
"2009","Alberta","48","Total robbery","3735","1227","113","-4.44","101.52","29.98","37.84","117","12.33","1340","857","1189","332","35"
"2010","Alberta","48","Total robbery","3220","1149","115","-15.02","86.27","30.31","36.68","102.26","9.59","1264","880","1168","288","27"
"2011","Alberta","48","Total robbery","2935","1080","68","-10.24","77.44","27.19","33.52","99.92","6.76","1148","802","1083","281","19"
"2012","Alberta","48","Total robbery","2719","1048","71","-9.52","70.06","26.73","32.21","91.39","8.21","1119","809","1065","256","23"
"2013","Alberta","48","Total robbery","2655","898","67","-5.18","66.43","23.59","28.18","79.41","6.08","965","737","959","222","17"
"2014","Alberta","48","Total robbery","2725","965","61","-0.15","66.33","25.86","29.49","71.39","5.02","1026","832","1031","199","14"
"2015","Alberta","48","Total robbery","3429","1262","57","23.69","82.04","30.42","34.87","86.91","3.93","1319","995","1238","243","11"
"2016","Alberta","48","Total robbery","3038","1134","37","-12.93","71.43","30.09","33.11","68.55","3.18","1171","1000","1194","194","9"
"1998","Alberta","48","Robbery","2902","1045","79","0","100.09","31.46","46.55","170.39","11.9","1124","673","1117","444","31"
"1999","Alberta","48","Robbery","2877","1035","47","-2.67","97.42","31.72","44.93","154.4","7.95","1082","695","1103","408","21"
"2000","Alberta","48","Robbery","2862","1092","66","-2.23","95.24","31.86","47","174.02","13.47","1158","714","1179","465","36"
"2001","Alberta","48","Robbery","3074","1215","86","5.54","100.52","36.04","47.95","148.91","9.61","1301","827","1230","403","26"
"2002","Alberta","48","Robbery","2953","1112","57","-6.1","94.39","32.76","45.44","153.54","11.2","1169","773","1198","425","31"
"2003","Alberta","48","Robbery","3614","1262","87","20.27","113.53","37.26","47.8","138.8","21.46","1349","899","1287","388","60"
"2004","Alberta","48","Robbery","3149","1120","57","-14.37","97.21","31.05","38.28","101.76","10.67","1177","766","1052","286","30"
"2005","Alberta","48","Robbery","3370","1183","90","4.35","101.44","31.76","40.32","117.01","9.16","1273","807","1139","332","26"
"2006","Alberta","48","Robbery","3546","1211","80","2.17","103.64","32.97","40.36","107.98","12.54","1291","866","1176","310","36"
"2007","Alberta","48","Robbery","3870","1151","99","6.26","110.13","28.22","38.66","137.31","14.64","1250","765","1159","394","42"
"2008","Alberta","48","Robbery","3820","1223","87","-3.54","106.24","30.74","40.46","135.32","12.62","1310","856","1242","386","36"
"2009","Alberta","48","Robbery","3735","1227","113","-4.44","101.52","29.98","37.84","117","12.33","1340","857","1189","332","35"
"2010","Alberta","48","Robbery","3220","1148","115","-15.02","86.27","30.31","36.68","102.26","9.59","1263","880","1168","288","27"
"2011","Alberta","48","Robbery","2935","1080","68","-10.24","77.44","27.19","33.52","99.92","6.76","1148","802","1083","281","19"
"2012","Alberta","48","Robbery","2719","1048","71","-9.52","70.06","26.73","32.21","91.39","8.21","1119","809","1065","256","23"
"2013","Alberta","48","Robbery","2655","898","67","-5.18","66.43","23.59","28.18","79.41","6.08","965","737","959","222","17"
"2014","Alberta","48","Robbery","2722","962","61","-0.26","66.26","25.74","29.38","71.39","5.02","1023","828","1027","199","14"
"2015","Alberta","48","Robbery","3428","1262","57","23.79","82.02","30.42","34.87","86.91","3.93","1319","995","1238","243","11"
"2016","Alberta","48","Robbery","3037","1132","37","-12.93","71.41","30","32.97","67.85","3.18","1169","997","1189","192","9"
"2005","Alberta","48","Robbery to steal a firearm","0","0","0","0","0","0","0","0","0","0","0","0","0","0"
"2006","Alberta","48","Robbery to steal a firearm","0","0","0","0","0","0","0","0","0","0","0","0","0","0"
"2007","Alberta","48","Robbery to steal a firearm","0","0","0","0","0","0","0","0","0","0","0","0","0","0"
"2008","Alberta","48","Robbery to steal a firearm","0","0","0","0","0","0","0","0","0","0","0","0","0","0"
"2009","Alberta","48","Robbery to steal a firearm","0","0","0","0","0","0","0","0","0","0","0","0","0","0"
"2010","Alberta","48","Robbery to steal a firearm","0","1","0","0","0","0","0","0","0","1","0","0","0","0"
"2011","Alberta","48","Robbery to steal a firearm","0","0","0","0","0","0","0","0","0","0","0","0","0","0"
"2012","Alberta","48","Robbery to steal a firearm","0","0","0","0","0","0","0","0","0","0","0","0","0","0"
"2013","Alberta","48","Robbery to steal a firearm","0","0","0","0","0","0","0","0","0","0","0","0","0","0"
"2014","Alberta","48","Robbery to steal a firearm","3","3","0","0","0.07","0.12","0.11","0","0","3","4","4","0","0"
"2015","Alberta","48","Robbery to steal a firearm","1","0","0","-67.24","0.02","0","0","0","0","0","0","0","0","0"
"2016","Alberta","48","Robbery to steal a firearm","1","2","0","-1.72","0.02","0.09","0.14","0.71","0","2","3","5","2","0"
"1998","Alberta","48","Total forcible confinement or kidnapping","174","135","8","0","6","4.77","4.88","5.76","0.38","143","102","117","15","1"
"1999","Alberta","48","Total forcible confinement or kidnapping","208","158","16","17.36","7.04","7.53","7.49","7.19","0.38","174","165","184","19","1"
"2000","Alberta","48","Total forcible confinement or kidnapping","261","232","9","23.32","8.69","9.59","9.65","10.1","1.5","241","215","242","27","4"
"2001","Alberta","48","Total forcible confinement or kidnapping","292","234","15","9.94","9.55","9.41","9.75","12.56","0","249","216","250","34","0"
"2002","Alberta","48","Total forcible confinement or kidnapping","320","258","7","7.12","10.23","10.6","10.13","6.14","0.36","265","250","267","17","1"
"2003","Alberta","48","Total forcible confinement or kidnapping","324","295","11","-0.5","10.18","12.68","12.93","15.03","1.07","306","306","348","42","3"
"2004","Alberta","48","Total forcible confinement or kidnapping","348","270","8","5.55","10.74","12.48","11.72","4.98","0","278","308","322","14","0"
"2005","Alberta","48","Total forcible confinement or kidnapping","433","332","11","21.33","13.03","13.62","13.1","8.46","1.06","343","346","370","24","3"
"2006","Alberta","48","Total forcible confinement or kidnapping","565","484","18","26.7","16.51","18.65","17.67","8.71","0.35","502","490","515","25","1"
"2007","Alberta","48","Total forcible confinement or kidnapping","547","478","23","-5.74","15.57","17.45","16.78","10.46","1.74","501","473","503","30","5"
"2008","Alberta","48","Total forcible confinement or kidnapping","610","530","24","8.98","16.96","19.79","18.5","5.96","2.8","554","551","568","17","8"
"2009","Alberta","48","Total forcible confinement or kidnapping","655","549","25","4.94","17.8","18.75","17.79","8.11","1.41","574","536","559","23","4"
"2010","Alberta","48","Total forcible confinement or kidnapping","623","546","21","-6.25","16.69","18.67","17.77","8.52","1.07","567","542","566","24","3"
"2011","Alberta","48","Total forcible confinement or kidnapping","434","369","21","-31.4","11.45","11.15","10.77","6.76","1.42","390","329","348","19","4"
"2012","Alberta","48","Total forcible confinement or kidnapping","460","378","16","3.52","11.85","11.2","10.74","5.71","0","394","339","355","16","0"
"2013","Alberta","48","Total forcible confinement or kidnapping","421","348","14","-11.13","10.53","10.56","9.99","3.58","0.72","362","330","340","10","2"
"2014","Alberta","48","Total forcible confinement or kidnapping","467","390","18","7.91","11.37","11.84","11.24","4.3","0","408","381","393","12","0"
"2015","Alberta","48","Total forcible confinement or kidnapping","501","414","12","5.45","11.99","12.11","11.72","7.15","0.36","426","396","416","20","1"
"2016","Alberta","48","Total forcible confinement or kidnapping","532","441","22","4.36","12.51","13.03","12.37","4.59","0","463","433","446","13","0"
"1998","Alberta","48","Forcible confinement or kidnapping","174","135","8","0","6","4.77","4.88","5.76","0.38","143","102","117","15","1"
"1999","Alberta","48","Forcible confinement or kidnapping","208","158","16","17.36","7.04","7.53","7.49","7.19","0.38","174","165","184","19","1"
"2000","Alberta","48","Forcible confinement or kidnapping","261","232","9","23.32","8.69","9.59","9.65","10.1","1.5","241","215","242","27","4"
"2001","Alberta","48","Forcible confinement or kidnapping","292","234","15","9.94","9.55","9.41","9.75","12.56","0","249","216","250","34","0"
"2002","Alberta","48","Forcible confinement or kidnapping","320","258","7","7.12","10.23","10.6","10.13","6.14","0.36","265","250","267","17","1"
"2003","Alberta","48","Forcible confinement or kidnapping","324","295","11","-0.5","10.18","12.68","12.93","15.03","1.07","306","306","348","42","3"
"2004","Alberta","48","Forcible confinement or kidnapping","348","270","8","5.55","10.74","12.48","11.72","4.98","0","278","308","322","14","0"
"2005","Alberta","48","Forcible confinement or kidnapping","433","332","11","21.33","13.03","13.62","13.1","8.46","1.06","343","346","370","24","3"
"2006","Alberta","48","Forcible confinement or kidnapping","565","484","18","26.7","16.51","18.65","17.67","8.71","0.35","502","490","515","25","1"
"2007","Alberta","48","Forcible confinement or kidnapping","547","478","23","-5.74","15.57","17.45","16.78","10.46","1.74","501","473","503","30","5"
"2008","Alberta","48","Forcible confinement or kidnapping","609","529","24","8.8","16.94","19.71","18.44","5.96","2.8","553","549","566","17","8"
"2009","Alberta","48","Forcible confinement or kidnapping","648","542","25","3.99","17.61","18.51","17.57","8.11","1.41","567","529","552","23","4"
"2010","Alberta","48","Forcible confinement or kidnapping","519","461","20","-21.05","13.9","15.74","15.1","8.52","1.07","481","457","481","24","3"
"2011","Alberta","48","Forcible confinement or kidnapping","188","152","12","-64.33","4.96","5.02","4.95","4.27","0.36","164","148","160","12","1"
"2012","Alberta","48","Forcible confinement or kidnapping","137","101","3","-28.83","3.53","3.17","2.96","0.71","0","104","96","98","2","0"
"2013","Alberta","48","Forcible confinement or kidnapping","124","97","2","-12.11","3.1","3.23","2.97","0","0","99","101","101","0","0"
"2014","Alberta","48","Forcible confinement or kidnapping","150","119","4","17.68","3.65","3.67","3.52","1.79","0","123","118","123","5","0"
"2015","Alberta","48","Forcible confinement or kidnapping","138","99","5","-9.57","3.3","3.24","3.04","0.72","0","104","106","108","2","0"
"2016","Alberta","48","Forcible confinement or kidnapping","115","91","5","-18.1","2.7","3.1","2.94","1.06","0","96","103","106","3","0"
"2005","Alberta","48","Kidnapping","0","0","0","0","0","0","0","0","0","0","0","0","0","0"
"2006","Alberta","48","Kidnapping","0","0","0","0","0","0","0","0","0","0","0","0","0","0"
"2007","Alberta","48","Kidnapping","0","0","0","0","0","0","0","0","0","0","0","0","0","0"
"2008","Alberta","48","Kidnapping","0","0","0","0","0","0","0","0","0","0","0","0","0","0"
"2009","Alberta","48","Kidnapping","0","0","0","0","0","0","0","0","0","0","0","0","0","0"
"2010","Alberta","48","Kidnapping","12","9","0","0","0.32","0.45","0.41","0","0","9","13","13","0","0"
"2011","Alberta","48","Kidnapping","37","24","0","203.65","0.98","0.78","0.74","0.36","0","24","23","24","1","0"
"2012","Alberta","48","Kidnapping","43","26","2","13.5","1.11","1.22","1.15","0.36","0","28","37","38","1","0"
"2013","Alberta","48","Kidnapping","43","21","0","-2.9","1.08","1.02","1.06","1.43","0","21","32","36","4","0"
"2014","Alberta","48","Kidnapping","64","43","2","44.79","1.56","1.83","1.75","0.72","0","45","59","61","2","0"
"2015","Alberta","48","Kidnapping","58","34","0","-10.92","1.39","1.56","1.52","1.07","0","34","51","54","3","0"
"2016","Alberta","48","Kidnapping","63","36","1","6.75","1.48","1.56","1.44","0","0","37","52","52","0","0"
"2005","Alberta","48","Forcible confinement","0","0","0","0","0","0","0","0","0","0","0","0","0","0"
"2006","Alberta","48","Forcible confinement","0","0","0","0","0","0","0","0","0","0","0","0","0","0"
"2007","Alberta","48","Forcible confinement","0","0","0","0","0","0","0","0","0","0","0","0","0","0"
"2008","Alberta","48","Forcible confinement","1","1","0","0","0.03","0.07","0.07","0","0","1","2","2","0","0"
"2009","Alberta","48","Forcible confinement","7","7","0","584.14","0.19","0.24","0.22","0","0","7","7","7","0","0"
"2010","Alberta","48","Forcible confinement","92","76","1","1195.45","2.46","2.48","2.26","0","0","77","72","72","0","0"
"2011","Alberta","48","Forcible confinement","209","193","9","123.72","5.51","5.36","5.08","2.13","1.07","202","158","164","6","3"
"2012","Alberta","48","Forcible confinement","280","251","11","30.84","7.22","6.81","6.62","4.64","0","262","206","219","13","0"
"2013","Alberta","48","Forcible confinement","254","230","12","-11.92","6.36","6.31","5.96","2.15","0.72","242","197","203","6","2"
"2014","Alberta","48","Forcible confinement","253","228","12","-3.1","6.16","6.34","5.98","1.79","0","240","204","209","5","0"
"2015","Alberta","48","Forcible confinement","305","281","7","18.49","7.3","7.31","7.15","5.36","0.36","288","239","254","15","1"
"2016","Alberta","48","Forcible confinement","354","314","16","14.07","8.32","8.36","7.99","3.53","0","330","278","288","10","0"
"1998","Alberta","48","Total abduction","100","37","30","0","3.45","1.78","1.58","0","0","67","38","38","0","0"
"1999","Alberta","48","Total abduction","86","26","23","-15.57","2.91","0.91","0.81","0","0","49","20","20","0","0"
"2000","Alberta","48","Total abduction","71","33","18","-18.86","2.36","1.16","1.04","0","0","51","26","26","0","0"
"2001","Alberta","48","Total abduction","80","19","24","10.72","2.62","0.78","0.7","0","0","43","18","18","0","0"
"2002","Alberta","48","Total abduction","62","22","19","-24.24","1.98","0.81","0.8","0.72","0","41","19","21","2","0"
"2003","Alberta","48","Total abduction","69","22","9","9.37","2.17","0.7","0.67","0.36","0.36","31","17","18","1","1"
"2004","Alberta","48","Total abduction","79","23","18","12.51","2.44","0.85","0.8","0.36","0","41","21","22","1","0"
"2005","Alberta","48","Total abduction","86","17","19","6.15","2.59","0.67","0.6","0","0","36","17","17","0","0"
"2006","Alberta","48","Total abduction","76","23","20","-14.19","2.22","0.65","0.65","0.7","0.35","43","17","19","2","1"
"2007","Alberta","48","Total abduction","97","30","21","24.27","2.76","0.81","0.77","0.35","0.35","51","22","23","1","1"
"2008","Alberta","48","Total abduction","59","15","17","-40.56","1.64","0.43","0.46","0.7","0","32","12","14","2","0"
"2009","Alberta","48","Total abduction","60","20","17","-0.61","1.63","0.63","0.57","0","0","37","18","18","0","0"
"2010","Alberta","48","Total abduction","67","19","19","10.07","1.8","0.55","0.5","0","0","38","16","16","0","0"
"2011","Alberta","48","Total abduction","61","18","11","-10.34","1.61","0.51","0.46","0","0","29","15","15","0","0"
"2012","Alberta","48","Total abduction","54","20","6","-13.54","1.39","0.5","0.45","0","0","26","15","15","0","0"
"2013","Alberta","48","Total abduction","45","15","14","-19.08","1.13","0.48","0.44","0","0.72","29","15","15","0","2"
"2014","Alberta","48","Total abduction","50","20","3","8.09","1.22","0.56","0.51","0","0","23","18","18","0","0"
"2015","Alberta","48","Total abduction","57","15","7","12.05","1.36","0.46","0.42","0","0","22","15","15","0","0"
"2016","Alberta","48","Total abduction","53","21","5","-8.62","1.25","0.33","0.3","0","0","26","11","11","0","0"
"1998","Alberta","48","Abduction under the age 14, not parent or guardian","28","7","8","0","0.97","0.23","0.21","0","0","15","5","5","0","0"
"1999","Alberta","48","Abduction under the age 14, not parent or guardian","26","3","8","-8.83","0.88","0.09","0.08","0","0","11","2","2","0","0"
"2000","Alberta","48","Abduction under the age 14, not parent or guardian","23","12","3","-13.06","0.77","0.45","0.4","0","0","15","10","10","0","0"
"2001","Alberta","48","Abduction under the age 14, not parent or guardian","18","3","3","-23.1","0.59","0.13","0.12","0","0","6","3","3","0","0"
"2002","Alberta","48","Abduction under the age 14, not parent or guardian","20","6","4","8.61","0.64","0.3","0.27","0","0","10","7","7","0","0"
"2003","Alberta","48","Abduction under the age 14, not parent or guardian","22","5","3","8.1","0.69","0.17","0.19","0.36","0","8","4","5","1","0"
"2004","Alberta","48","Abduction under the age 14, not parent or guardian","22","1","2","-1.73","0.68","0.08","0.11","0.36","0","3","2","3","1","0"
"2005","Alberta","48","Abduction under the age 14, not parent or guardian","36","2","4","59.56","1.08","0.08","0.07","0","0","6","2","2","0","0"
"2006","Alberta","48","Abduction under the age 14, not parent or guardian","35","4","3","-5.6","1.02","0.11","0.14","0.35","0","7","3","4","1","0"
"2007","Alberta","48","Abduction under the age 14, not parent or guardian","52","13","7","44.65","1.48","0.37","0.33","0","0.35","20","10","10","0","1"
"2008","Alberta","48","Abduction under the age 14, not parent or guardian","30","3","5","-43.62","0.83","0.11","0.1","0","0","8","3","3","0","0"
"2009","Alberta","48","Abduction under the age 14, not parent or guardian","30","6","9","-2.27","0.82","0.24","0.22","0","0","15","7","7","0","0"
"2010","Alberta","48","Abduction under the age 14, not parent or guardian","35","8","6","15","0.94","0.28","0.25","0","0","14","8","8","0","0"
"2011","Alberta","48","Abduction under the age 14, not parent or guardian","24","5","2","-32.47","0.63","0.2","0.19","0","0","7","6","6","0","0"
"2012","Alberta","48","Abduction under the age 14, not parent or guardian","27","6","2","9.87","0.7","0.17","0.15","0","0","8","5","5","0","0"
"2013","Alberta","48","Abduction under the age 14, not parent or guardian","17","2","5","-38.86","0.43","0.13","0.12","0","0.72","7","4","4","0","2"
"2014","Alberta","48","Abduction under the age 14, not parent or guardian","19","6","0","8.73","0.46","0.19","0.17","0","0","6","6","6","0","0"
"2015","Alberta","48","Abduction under the age 14, not parent or guardian","21","1","1","8.64","0.5","0.03","0.03","0","0","2","1","1","0","0"
"2016","Alberta","48","Abduction under the age 14, not parent or guardian","34","10","1","59.12","0.8","0.12","0.11","0","0","11","4","4","0","0"
"1998","Alberta","48","Abduction under the age 16","10","4","0","0","0.34","0.23","0.21","0","0","4","5","5","0","0"
"1999","Alberta","48","Abduction under the age 16","10","1","1","-1.82","0.34","0.05","0.04","0","0","2","1","1","0","0"
"2000","Alberta","48","Abduction under the age 16","2","2","2","-80.34","0.07","0","0","0","0","4","0","0","0","0"
"2001","Alberta","48","Abduction under the age 16","6","2","2","194.79","0.2","0.09","0.08","0","0","4","2","2","0","0"
"2002","Alberta","48","Abduction under the age 16","5","3","0","-18.54","0.16","0.08","0.15","0.72","0","3","2","4","2","0"
"2003","Alberta","48","Abduction under the age 16","5","2","0","-1.73","0.16","0.08","0.07","0","0.36","2","2","2","0","1"
"2004","Alberta","48","Abduction under the age 16","10","2","2","96.54","0.31","0.12","0.11","0","0","4","3","3","0","0"
"2005","Alberta","48","Abduction under the age 16","10","3","2","-2.49","0.3","0.12","0.11","0","0","5","3","3","0","0"
"2006","Alberta","48","Abduction under the age 16","7","3","0","-32.03","0.2","0.08","0.1","0.35","0","3","2","3","1","0"
"2007","Alberta","48","Abduction under the age 16","14","2","3","94.73","0.4","0.04","0.07","0.35","0","5","1","2","1","0"
"2008","Alberta","48","Abduction under the age 16","6","3","0","-58.12","0.17","0.07","0.13","0.7","0","3","2","4","2","0"
"2009","Alberta","48","Abduction under the age 16","8","3","0","30.31","0.22","0.07","0.06","0","0","3","2","2","0","0"
"2010","Alberta","48","Abduction under the age 16","6","0","1","-26.07","0.16","0","0","0","0","1","0","0","0","0"
"2011","Alberta","48","Abduction under the age 16","6","2","1","-1.52","0.16","0.07","0.06","0","0","3","2","2","0","0"
"2012","Alberta","48","Abduction under the age 16","6","2","1","-2.33","0.15","0.03","0.03","0","0","3","1","1","0","0"
"2013","Alberta","48","Abduction under the age 16","2","1","0","-67.63","0.05","0.03","0.03","0","0","1","1","1","0","0"
"2014","Alberta","48","Abduction under the age 16","9","3","0","337.77","0.22","0.12","0.11","0","0","3","4","4","0","0"
"2015","Alberta","48","Abduction under the age 16","9","2","1","-1.71","0.22","0","0","0","0","3","0","0","0","0"
"2016","Alberta","48","Abduction under the age 16","6","0","1","-34.48","0.14","0","0","0","0","1","0","0","0","0"
"1998","Alberta","48","Removal of children from Canada","0","0","0","0","0","0","0","0","0","0","0","0","0","0"
"1999","Alberta","48","Removal of children from Canada","0","0","0","0","0","0","0","0","0","0","0","0","0","0"
"2000","Alberta","48","Removal of children from Canada","0","0","0","0","0","0","0","0","0","0","0","0","0","0"
"2001","Alberta","48","Removal of children from Canada","0","0","0","0","0","0","0","0","0","0","0","0","0","0"
"2002","Alberta","48","Removal of children from Canada","0","0","0","0","0","0","0","0","0","0","0","0","0","0"
"2003","Alberta","48","Removal of children from Canada","0","0","0","0","0","0","0","0","0","0","0","0","0","0"
"2004","Alberta","48","Removal of children from Canada","2","1","0","0","0.06","0","0","0","0","1","0","0","0","0"
"2005","Alberta","48","Removal of children from Canada","0","0","0","-100","0","0","0","0","0","0","0","0","0","0"
"2006","Alberta","48","Removal of children from Canada","1","0","0","0","0.03","0","0","0","0","0","0","0","0","0"
"2007","Alberta","48","Removal of children from Canada","0","0","0","-100","0","0","0","0","0","0","0","0","0","0"
"2008","Alberta","48","Removal of children from Canada","1","0","0","0","0.03","0","0","0","0","0","0","0","0","0"
"2009","Alberta","48","Removal of children from Canada","0","0","0","-100","0","0","0","0","0","0","0","0","0","0"
"2010","Alberta","48","Removal of children from Canada","0","0","0","0","0","0","0","0","0","0","0","0","0","0"
"2011","Alberta","48","Removal of children from Canada","0","0","0","0","0","0","0","0","0","0","0","0","0","0"
"2012","Alberta","48","Removal of children from Canada","0","0","0","0","0","0","0","0","0","0","0","0","0","0"
"2013","Alberta","48","Removal of children from Canada","1","0","0","0","0.03","0","0","0","0","0","0","0","0","0"
"2014","Alberta","48","Removal of children from Canada","0","0","0","-100","0","0","0","0","0","0","0","0","0","0"
"2015","Alberta","48","Removal of children from Canada","0","0","0","0","0","0","0","0","0","0","0","0","0","0"
"2016","Alberta","48","Removal of children from Canada","1","0","1","0","0.02","0","0","0","0","1","0","0","0","0"
"1998","Alberta","48","Abduction under the age 14 contravening a custody order","32","15","13","0","1.1","0.75","0.67","0","0","28","16","16","0","0"
"1999","Alberta","48","Abduction under the age 14 contravening a custody order","28","14","9","-14.09","0.95","0.46","0.41","0","0","23","10","10","0","0"
"2000","Alberta","48","Abduction under the age 14 contravening a custody order","32","15","8","12.32","1.06","0.54","0.48","0","0","23","12","12","0","0"
"2001","Alberta","48","Abduction under the age 14 contravening a custody order","27","8","9","-17.09","0.88","0.35","0.31","0","0","17","8","8","0","0"
"2002","Alberta","48","Abduction under the age 14 contravening a custody order","25","5","12","-9.49","0.8","0.21","0.19","0","0","17","5","5","0","0"
"2003","Alberta","48","Abduction under the age 14 contravening a custody order","25","12","4","-1.73","0.79","0.25","0.22","0","0","16","6","6","0","0"
"2004","Alberta","48","Abduction under the age 14 contravening a custody order","26","11","9","2.2","0.8","0.36","0.33","0","0","20","9","9","0","0"
"2005","Alberta","48","Abduction under the age 14 contravening a custody order","18","4","6","-32.49","0.54","0.16","0.14","0","0","10","4","4","0","0"
"2006","Alberta","48","Abduction under the age 14 contravening a custody order","17","9","9","-8.29","0.5","0.3","0.27","0","0.35","18","8","8","0","1"
"2007","Alberta","48","Abduction under the age 14 contravening a custody order","16","10","4","-8.36","0.46","0.3","0.27","0","0","14","8","8","0","0"
"2008","Alberta","48","Abduction under the age 14 contravening a custody order","7","5","5","-57.24","0.19","0.14","0.13","0","0","10","4","4","0","0"
"2009","Alberta","48","Abduction under the age 14 contravening a custody order","14","8","2","95.47","0.38","0.21","0.19","0","0","10","6","6","0","0"
"2010","Alberta","48","Abduction under the age 14 contravening a custody order","9","3","6","-36.64","0.24","0.07","0.06","0","0","9","2","2","0","0"
"2011","Alberta","48","Abduction under the age 14 contravening a custody order","20","8","6","118.84","0.53","0.2","0.19","0","0","14","6","6","0","0"
"2012","Alberta","48","Abduction under the age 14 contravening a custody order","13","10","2","-36.52","0.33","0.23","0.21","0","0","12","7","7","0","0"
"2013","Alberta","48","Abduction under the age 14 contravening a custody order","10","5","4","-25.31","0.25","0.16","0.15","0","0","9","5","5","0","0"
"2014","Alberta","48","Abduction under the age 14 contravening a custody order","14","10","0","36.19","0.34","0.22","0.2","0","0","10","7","7","0","0"
"2015","Alberta","48","Abduction under the age 14 contravening a custody order","18","11","3","26.38","0.43","0.4","0.37","0","0","14","13","13","0","0"
"2016","Alberta","48","Abduction under the age 14 contravening a custody order","8","5","2","-56.32","0.19","0.09","0.08","0","0","7","3","3","0","0"
"1998","Alberta","48","Abduction under age 14, by parent or guardian","30","11","9","0","1.03","0.56","0.5","0","0","20","12","12","0","0"
"1999","Alberta","48","Abduction under age 14, by parent or guardian","22","8","5","-28","0.74","0.32","0.29","0","0","13","7","7","0","0"
"2000","Alberta","48","Abduction under age 14, by parent or guardian","14","4","5","-37.46","0.47","0.18","0.16","0","0","9","4","4","0","0"
"2001","Alberta","48","Abduction under age 14, by parent or guardian","29","6","10","103.55","0.95","0.22","0.19","0","0","16","5","5","0","0"
"2002","Alberta","48","Abduction under age 14, by parent or guardian","12","8","3","-59.55","0.38","0.21","0.19","0","0","11","5","5","0","0"
"2003","Alberta","48","Abduction under age 14, by parent or guardian","17","3","2","39.22","0.53","0.21","0.19","0","0","5","5","5","0","0"
"2004","Alberta","48","Abduction under age 14, by parent or guardian","19","8","5","9.83","0.59","0.28","0.25","0","0","13","7","7","0","0"
"2005","Alberta","48","Abduction under age 14, by parent or guardian","22","8","7","12.91","0.66","0.31","0.28","0","0","15","8","8","0","0"
"2006","Alberta","48","Abduction under age 14, by parent or guardian","16","7","8","-29.38","0.47","0.15","0.14","0","0","15","4","4","0","0"
"2007","Alberta","48","Abduction under age 14, by parent or guardian","15","5","7","-8.72","0.43","0.11","0.1","0","0","12","3","3","0","0"
"2008","Alberta","48","Abduction under age 14, by parent or guardian","15","4","7","-2.27","0.42","0.11","0.1","0","0","11","3","3","0","0"
"2009","Alberta","48","Abduction under age 14, by parent or guardian","8","3","6","-47.87","0.22","0.1","0.1","0","0","9","3","3","0","0"
"2010","Alberta","48","Abduction under age 14, by parent or guardian","17","8","6","109.46","0.46","0.21","0.19","0","0","14","6","6","0","0"
"2011","Alberta","48","Abduction under age 14, by parent or guardian","11","3","2","-36.28","0.29","0.03","0.03","0","0","5","1","1","0","0"
"2012","Alberta","48","Abduction under age 14, by parent or guardian","8","2","1","-28.97","0.21","0.07","0.06","0","0","3","2","2","0","0"
"2013","Alberta","48","Abduction under age 14, by parent or guardian","15","7","5","82.06","0.38","0.16","0.15","0","0","12","5","5","0","0"
"2014","Alberta","48","Abduction under age 14, by parent or guardian","8","1","3","-48.12","0.19","0.03","0.03","0","0","4","1","1","0","0"
"2015","Alberta","48","Abduction under age 14, by parent or guardian","9","1","2","10.58","0.22","0.03","0.03","0","0","3","1","1","0","0"
"2016","Alberta","48","Abduction under age 14, by parent or guardian","4","6","0","-56.32","0.09","0.12","0.11","0","0","6","4","4","0","0"
"1998","Alberta","48","Extortion","198","79","32","0","6.83","1.64","2.08","5.76","2.69","111","35","50","15","7"
"1999","Alberta","48","Extortion","196","53","44","-2.81","6.64","1.05","1.22","2.65","1.89","97","23","30","7","5"
"2010","Alberta","48","Extortion","116","53","22","-22.22","3.11","1.21","1.48","4.26","2.13","75","35","47","12","6"
"2000","Alberta","48","Extortion","158","47","22","-20.77","5.26","1.2","1.32","2.25","2.62","69","27","33","6","7"
"2011","Alberta","48","Extortion","114","49","24","-3.22","3.01","1.46","1.52","2.13","0.36","73","43","49","6","1"
"2001","Alberta","48","Extortion","150","39","13","-6.71","4.91","1.48","1.6","2.59","2.96","52","34","41","7","8"
"2012","Alberta","48","Extortion","135","61","31","15.66","3.48","1.95","2.06","3.21","0.71","92","59","68","9","2"
"2002","Alberta","48","Extortion","187","68","21","21.86","5.98","1.4","1.48","2.17","2.53","89","33","39","6","7"
"2013","Alberta","48","Extortion","166","73","22","19.4","4.15","2.02","2.17","3.93","0.36","95","63","74","11","1"
"2003","Alberta","48","Extortion","171","41","17","-10.14","5.37","1.28","1.26","1.07","1.07","58","31","34","3","3"
"2014","Alberta","48","Extortion","243","96","19","42.41","5.91","2.46","2.63","4.66","2.51","115","79","92","13","7"
"2004","Alberta","48","Extortion","146","36","12","-16.1","4.51","1.26","1.24","1.07","1.42","48","31","34","3","4"
"2015","Alberta","48","Extortion","304","54","40","22.97","7.27","1.74","1.69","1.07","1.43","94","57","60","3","4"
"2005","Alberta","48","Extortion","164","53","13","9.53","4.94","1.65","1.63","1.41","1.06","66","42","46","4","3"
"2016","Alberta","48","Extortion","275","73","18","-11.1","6.47","2.02","2.16","3.89","0.71","91","67","78","11","2"
"2006","Alberta","48","Extortion","109","62","14","-35.46","3.19","1.98","2.06","2.79","0","76","52","60","8","0"
"2007","Alberta","48","Extortion","88","48","11","-21.4","2.5","1.73","1.6","0.35","0.7","59","47","48","1","2"
"2008","Alberta","48","Extortion","114","53","24","26.6","3.17","1.69","1.79","2.8","2.45","77","47","55","8","7"
"2009","Alberta","48","Extortion","147","57","17","26.03","4","1.43","1.78","5.29","0.7","74","41","56","15","2"
"1998","Alberta","48","Criminal harassment","1359","454","539","0","46.87","10.29","9.29","1.15","8.44","993","220","223","3","22"
"1999","Alberta","48","Criminal harassment","1563","505","634","12.92","52.92","12.92","11.89","3.41","5.68","1139","283","292","9","15"
"2000","Alberta","48","Criminal harassment","1808","569","646","13.69","60.17","16.46","14.95","2.25","20.58","1215","369","375","6","55"
"2001","Alberta","48","Criminal harassment","1751","474","582","-4.83","57.26","14.69","13.25","1.11","36.21","1056","337","340","3","98"
"2002","Alberta","48","Criminal harassment","1884","487","651","5.18","60.22","15.05","13.62","1.45","36.85","1138","355","359","4","102"
"2003","Alberta","48","Criminal harassment","1995","509","724","4.06","62.67","14.8","13.63","3.58","48.65","1233","357","367","10","136"
"2004","Alberta","48","Criminal harassment","2098","547","682","3.34","64.76","15.85","14.63","3.91","37.72","1229","391","402","11","106"
"2005","Alberta","48","Criminal harassment","1782","493","661","-17.18","53.64","14.95","13.74","2.82","32.07","1154","380","388","8","91"
"2006","Alberta","48","Criminal harassment","1298","487","547","-29.27","37.94","15.46","14.31","3.83","39.36","1034","406","417","11","113"
"2007","Alberta","48","Criminal harassment","1317","498","595","-1.21","37.48","15.34","14.64","8.02","35.55","1093","416","439","23","102"
"2008","Alberta","48","Criminal harassment","1649","665","750","22.36","45.86","18.74","17.43","4.56","45.92","1415","522","535","13","131"
"2009","Alberta","48","Criminal harassment","1836","669","892","8.82","49.9","19.1","18.11","8.11","47.57","1561","546","569","23","135"
"2010","Alberta","48","Criminal harassment","2056","717","983","10.38","55.08","21.08","19.69","5.33","58.59","1700","612","627","15","165"
"2011","Alberta","48","Criminal harassment","2220","644","1021","6.34","58.57","18.71","17.49","4.62","55.12","1665","552","565","13","155"
"2012","Alberta","48","Criminal harassment","2242","739","970","-1.37","57.77","20.65","19.63","8.57","49.62","1709","625","649","24","139"
"2013","Alberta","48","Criminal harassment","2250","721","894","-2.55","56.3","19.02","18.36","11.09","48.65","1615","594","625","31","136"
"2014","Alberta","48","Criminal harassment","2032","652","771","-12.14","49.46","17.81","16.88","6.1","33.72","1423","573","590","17","94"
"2015","Alberta","48","Criminal harassment","2185","689","749","5.69","52.28","18.8","17.8","6.08","24.32","1438","615","632","17","68"
"2016","Alberta","48","Criminal harassment","1958","773","596","-11.93","46.04","19.53","18.66","8.48","17.67","1369","649","673","24","50"
"1998","Alberta","48","Uttering threats","3728","1392","1072","0","128.58","23.61","25.46","40.68","35.69","2464","505","611","106","93"
"1999","Alberta","48","Uttering threats","8313","2813","3125","118.93","281.49","62.9","74.58","171.43","147.59","5938","1378","1831","453","390"
"2000","Alberta","48","Uttering threats","8812","2771","3186","4.18","293.25","70.94","82.56","180.01","251.87","5957","1590","2071","481","673"
"2001","Alberta","48","Uttering threats","8935","2732","2799","-0.36","292.18","69.25","77.97","151.87","324.8","5531","1589","2000","411","879"
"2002","Alberta","48","Uttering threats","8472","2406","2879","-7.31","270.81","60.69","68.81","138.01","315.39","5285","1432","1814","382","873"
"2003","Alberta","48","Uttering threats","8301","2317","2787","-3.71","260.76","57.07","63.77","121.63","281.54","5104","1377","1717","340","787"
"2004","Alberta","48","Uttering threats","8157","2249","2563","-3.44","251.8","55.9","60.4","99.99","249.07","4812","1379","1660","281","700"
"2005","Alberta","48","Uttering threats","8062","2258","2771","-3.63","242.67","56.43","60.6","97.98","241.78","5029","1434","1712","278","686"
"2006","Alberta","48","Uttering threats","7947","2386","3728","-4.28","232.28","58.59","60.95","82.55","286.66","6114","1539","1776","237","823"
"2007","Alberta","48","Uttering threats","8159","2519","3761","-0.04","232.18","56.66","59.34","84.69","266.96","6280","1536","1779","243","766"
"2008","Alberta","48","Uttering threats","9017","2692","4156","8","250.77","62.19","64.53","87.29","285.36","6848","1732","1981","249","814"
"2009","Alberta","48","Uttering threats","9256","2666","4476","0.33","251.58","60.91","62.57","79.29","274.52","7142","1741","1966","225","779"
"2010","Alberta","48","Uttering threats","8804","2469","4243","-6.25","235.87","53.12","54.36","67.11","286.89","6712","1542","1731","189","808"
"2011","Alberta","48","Uttering threats","8105","2484","3463","-9.34","213.84","52.61","54.16","70.41","196.65","5947","1552","1750","198","553"
"2012","Alberta","48","Uttering threats","8197","2507","3364","-1.23","211.22","50.66","51.99","66.4","184.21","5871","1533","1719","186","516"
"2013","Alberta","48","Uttering threats","7654","2436","3021","-9.33","191.51","48.34","49.36","60.81","157.39","5457","1510","1680","170","440"
"2014","Alberta","48","Uttering threats","7936","2726","2827","0.87","193.17","53.22","53.84","60.98","148.16","5553","1712","1882","170","413"
"2015","Alberta","48","Uttering threats","8046","2732","2750","-0.35","192.5","52.25","52.76","58.65","127.32","5482","1709","1873","164","356"
"2016","Alberta","48","Uttering threats","7629","2863","2278","-6.82","179.38","55.03","54.87","53.01","103.54","5141","1829","1979","150","293"
"1998","Alberta","48","Indecent/Harassing communications","2572","177","986","0","88.71","2.76","2.58","1.15","41.06","1163","59","62","3","107"
"1999","Alberta","48","Indecent/Harassing communications","2790","165","983","6.5","94.47","2.6","2.44","1.14","35.19","1148","57","60","3","93"
"2000","Alberta","48","Indecent/Harassing communications","2424","151","958","-14.61","80.67","2.1","2.15","2.62","37.42","1109","47","54","7","100"
"2001","Alberta","48","Indecent/Harassing communications","2586","106","882","4.83","84.56","1.83","1.75","1.11","64.66","988","42","45","3","175"
"2002","Alberta","48","Indecent/Harassing communications","2371","80","967","-10.38","75.79","1.57","1.59","1.81","38.66","1047","37","42","5","107"
"2003","Alberta","48","Indecent/Harassing communications","2221","48","779","-7.95","69.77","1.2","1.08","0","41.14","827","29","29","0","115"
"2004","Alberta","48","Indecent/Harassing communications","1997","43","561","-11.64","61.65","0.93","0.87","0.36","28.11","604","23","24","1","79"
"2005","Alberta","48","Indecent/Harassing communications","2085","64","732","1.81","62.76","1.53","1.45","0.7","35.6","796","39","41","2","101"
"2006","Alberta","48","Indecent/Harassing communications","2829","66","1664","31.75","82.69","1.94","1.96","2.09","94.74","1730","51","57","6","272"
"2007","Alberta","48","Indecent/Harassing communications","2840","67","1600","-2.26","80.82","2.29","2.2","1.39","78.76","1667","62","66","4","226"
"2008","Alberta","48","Indecent/Harassing communications","2790","62","1718","-3.99","77.59","1.54","1.76","3.86","50.13","1780","43","54","11","143"
"2009","Alberta","48","Indecent/Harassing communications","2848","80","1781","-0.23","77.41","2.2","2.04","0.35","66.25","1861","63","64","1","188"
"2010","Alberta","48","Indecent/Harassing communications","2844","99","1725","-1.57","76.19","2.79","2.64","1.07","55.39","1824","81","84","3","156"
"2011","Alberta","48","Indecent/Harassing communications","3206","81","1870","11.01","84.59","2","1.92","1.07","62.23","1951","59","62","3","175"
"2012","Alberta","48","Indecent/Harassing communications","3327","91","1790","1.35","85.73","2.41","2.24","0.36","57.83","1881","73","74","1","162"
"2013","Alberta","48","Indecent/Harassing communications","2898","60","1592","-15.42","72.51","1.63","1.53","0.36","46.5","1652","51","52","1","130"
"2014","Alberta","48","Indecent/Harassing communications","2428","64","1170","-18.5","59.1","1.49","1.37","0","24.04","1234","48","48","0","67"
"2015","Alberta","48","Indecent/Harassing communications","2396","71","1071","-3","57.33","1.8","1.66","0","23.25","1142","59","59","0","65"
"2016","Alberta","48","Indecent/Harassing communications","2479","143","1002","1.68","58.29","3.46","3.19","0","30.74","1145","115","115","0","87"
"2012","Alberta","48","Total commodification of sexual activity violations","0","0","0","0","0","0","0","0","0","0","0","0","0","0"
"2013","Alberta","48","Total commodification of sexual activity violations","0","0","0","0","0","0","0","0","0","0","0","0","0","0"
"2014","Alberta","48","Total commodification of sexual activity violations","2","1","0","0","0.05","0.06","0.06","0","0","1","2","2","0","0"
"2015","Alberta","48","Total commodification of sexual activity violations","144","112","7","6977.04","3.45","3.58","3.35","0.72","0","119","117","119","2","0"
"2016","Alberta","48","Total commodification of sexual activity violations","144","111","6","-1.72","3.39","3.43","3.19","0.35","0","117","114","115","1","0"
"2012","Alberta","48","Obtaining sexual services for consideration","0","0","0","0","0","0","0","0","0","0","0","0","0","0"
"2013","Alberta","48","Obtaining sexual services for consideration","0","0","0","0","0","0","0","0","0","0","0","0","0","0"
"2014","Alberta","48","Obtaining sexual services for consideration","0","0","0","0","0","0","0","0","0","0","0","0","0","0"
"2015","Alberta","48","Obtaining sexual services for consideration","94","91","0","0","2.25","2.84","2.65","0.36","0","91","93","94","1","0"
"2016","Alberta","48","Obtaining sexual services for consideration","92","84","3","-3.81","2.16","2.53","2.33","0","0","87","84","84","0","0"
"2012","Alberta","48","Obtaining sexual services for consideration from person under 18 years","0","0","0","0","0","0","0","0","0","0","0","0","0","0"
"2013","Alberta","48","Obtaining sexual services for consideration from person under 18 years","0","0","0","0","0","0","0","0","0","0","0","0","0","0"
"2014","Alberta","48","Obtaining sexual services for consideration from person under 18 years","0","0","0","0","0","0","0","0","0","0","0","0","0","0"
"2015","Alberta","48","Obtaining sexual services for consideration from person under 18 years","9","6","0","0","0.22","0.18","0.17","0","0","6","6","6","0","0"
"2016","Alberta","48","Obtaining sexual services for consideration from person under 18 years","3","0","0","-67.24","0.07","0","0","0","0","0","0","0","0","0"
"2012","Alberta","48","Receive material benefit from sexual services","0","0","0","0","0","0","0","0","0","0","0","0","0","0"
"2013","Alberta","48","Receive material benefit from sexual services","0","0","0","0","0","0","0","0","0","0","0","0","0","0"
"2014","Alberta","48","Receive material benefit from sexual services","0","0","0","0","0","0","0","0","0","0","0","0","0","0"
"2015","Alberta","48","Receive material benefit from sexual services","8","7","0","0","0.19","0.24","0.23","0","0","7","8","8","0","0"
"2016","Alberta","48","Receive material benefit from sexual services","1","1","0","-87.72","0.02","0.09","0.08","0","0","1","3","3","0","0"
"2012","Alberta","48","Receive material benefit from sexual services provided by a person under 18 years","0","0","0","0","0","0","0","0","0","0","0","0","0","0"
"2013","Alberta","48","Receive material benefit from sexual services provided by a person under 18 years","0","0","0","0","0","0","0","0","0","0","0","0","0","0"
"2014","Alberta","48","Receive material benefit from sexual services provided by a person under 18 years","0","0","0","0","0","0","0","0","0","0","0","0","0","0"
"2015","Alberta","48","Receive material benefit from sexual services provided by a person under 18 years","1","1","0","0","0.02","0","0.03","0.36","0","1","0","1","1","0"
"2016","Alberta","48","Receive material benefit from sexual services provided by a person under 18 years","1","0","0","-1.72","0.02","0","0","0","0","0","0","0","0","0"
"2012","Alberta","48","Procuring","30","11","7","-5.48","0.77","0.59","0.54","0","1.07","18","18","18","0","3"
"2013","Alberta","48","Procuring","88","48","14","184.83","2.2","1.63","1.56","0.72","0","62","51","53","2","0"
"2014","Alberta","48","Procuring","45","14","10","-52.46","1.1","0.46","0.43","0","0","24","15","15","0","0"
"2015","Alberta","48","Procuring","28","9","5","1035.51","0.6699999999999999","0.37","0.33","0","0","14","12","12","0","0"
"2016","Alberta","48","Procuring","34","26","1","48.97","0.7999999999999999","0.81","0.75","0","0","27","27","27","0","0"
"2012","Alberta","48","Procuring - person under 18 years","0","0","0","0","0","0","0","0","0","0","0","0","0","0"
"2013","Alberta","48","Procuring - person under 18 years","0","0","0","0","0","0","0","0","0","0","0","0","0","0"
"2014","Alberta","48","Procuring - person under 18 years","0","0","0","0","0","0","0","0","0","0","0","0","0","0"
"2015","Alberta","48","Procuring - person under 18 years","5","1","2","0","0.12","0.03","0.03","0","0","3","1","1","0","0"
"2016","Alberta","48","Procuring - person under 18 years","11","5","0","116.21","0.26","0.15","0.17","0.35","0","5","5","6","1","0"
"2012","Alberta","48","Advertising sexual services","0","0","0","0","0","0","0","0","0","0","0","0","0","0"
"2013","Alberta","48","Advertising sexual services","0","0","0","0","0","0","0","0","0","0","0","0","0","0"
"2014","Alberta","48","Advertising sexual services","0","0","0","0","0","0","0","0","0","0","0","0","0","0"
"2015","Alberta","48","Advertising sexual services","2","0","0","0","0.05","0","0","0","0","0","0","0","0","0"
"2016","Alberta","48","Advertising sexual services","6","1","2","194.84","0.14","0.03","0.03","0","0","3","1","1","0","0"
"1998","Alberta","48","Total other violent violations","365","214","79","0","12.59","4.11","4","3.07","4.61","293","88","96","8","12"
"1999","Alberta","48","Total other violent violations","316","149","59","-15","10.7","3.38","3.71","6.43","3.41","208","74","91","17","9"
"2000","Alberta","48","Total other violent violations","263","159","42","-18.2","8.75","4.02","4.38","7.48","2.99","201","90","110","20","8"
"2001","Alberta","48","Total other violent violations","300","154","43","12.09","9.81","3.31","3.98","9.61","4.06","197","76","102","26","11"
"2002","Alberta","48","Total other violent violations","338","141","55","10.13","10.8","3.52","3.79","6.14","4.7","196","83","100","17","13"
"2003","Alberta","48","Total other violent violations","307","145","39","-10.74","9.64","3.94","4.35","7.87","4.29","184","95","117","22","12"
"2004","Alberta","48","Total other violent violations","304","125","23","-2.69","9.38","2.84","3.09","5.34","4.27","148","70","85","15","12"
"2005","Alberta","48","Total other violent violations","345","130","47","10.66","10.38","3.07","3.33","5.64","4.93","177","78","94","16","14"
"2006","Alberta","48","Total other violent violations","397","172","82","11.74","11.6","4.26","4.46","6.27","6.97","254","112","130","18","20"
"2007","Alberta","48","Total other violent violations","379","164","66","-7.05","10.79","4.09","4.64","9.76","6.27","230","111","139","28","18"
"2008","Alberta","48","Total other violent violations","431","209","90","11.14","11.99","4.67","5.05","8.76","8.06","299","130","155","25","23"
"2009","Alberta","48","Total other violent violations","374","187","81","-15.19","10.17","4.93","5.38","9.87","7.4","268","141","169","28","21"
"2010","Alberta","48","Total other violent violations","339","146","79","-10.66","9.08","3.48","3.8","7.1","4.62","225","101","121","20","13"
"2011","Alberta","48","Total other violent violations","372","166","82","8.07","9.81","4.64","4.83","6.76","3.2","248","137","156","19","9"
"2012","Alberta","48","Total other violent violations","451","278","71","18.41","11.62","5.65","5.93","8.93","1.43","349","171","196","25","4"
"2013","Alberta","48","Total other violent violations","504","244","96","8.51","12.61","5.31","5.49","7.51","2.5","340","166","187","21","7"
"2014","Alberta","48","Total other violent violations","446","237","72","-13.91","10.86","5.78","5.89","7.17","3.95","309","186","206","20","11"
"2015","Alberta","48","Total other violent violations","470","254","80","3.58","11.24","6.27","6.45","8.58","3.22","334","205","229","24","9"
"2016","Alberta","48","Total other violent violations","505","265","72","5.6","11.87","6.17","6.24","7.07","6.71","337","205","225","20","19"
"1998","Alberta","48","Conspire to commit murder","1","1","0","0","0.03","0.05","0.04","0","0","1","1","1","0","0"
"1999","Alberta","48","Conspire to commit murder","0","0","0","-100","0","0","0","0","0","0","0","0","0","0"
"2000","Alberta","48","Conspire to commit murder","0","0","0","0","0","0","0","0","0","0","0","0","0","0"
"2001","Alberta","48","Conspire to commit murder","0","0","0","0","0","0","0","0","0","0","0","0","0","0"
"2002","Alberta","48","Conspire to commit murder","0","0","0","0","0","0","0","0","0","0","0","0","0","0"
"2003","Alberta","48","Conspire to commit murder","1","1","0","0","0.03","0.04","0.04","0","0","1","1","1","0","0"
"2004","Alberta","48","Conspire to commit murder","0","0","0","-100","0","0","0","0","0","0","0","0","0","0"
"2005","Alberta","48","Conspire to commit murder","1","1","0","0","0.03","0","0","0","0","1","0","0","0","0"
"2006","Alberta","48","Conspire to commit murder","2","0","0","94.2","0.06","0","0","0","0","0","0","0","0","0"
"2007","Alberta","48","Conspire to commit murder","8","1","2","289.45","0.23","0.04","0.03","0","1.39","3","1","1","0","4"
"2008","Alberta","48","Conspire to commit murder","4","0","0","-51.14","0.11","0","0","0","0","0","0","0","0","0"
"2009","Alberta","48","Conspire to commit murder","2","1","0","-51.13","0.05","0.1","0.13","0.35","0","1","3","4","1","0"
"2010","Alberta","48","Conspire to commit murder","2","0","0","-1.43","0.05","0","0","0","0","0","0","0","0","0"
"2011","Alberta","48","Conspire to commit murder","4","0","0","96.96","0.11","0","0","0","0","0","0","0","0","0"
"2012","Alberta","48","Conspire to commit murder","3","1","1","-26.75","0.08","0","0.03","0.36","0","2","0","1","1","0"
"2013","Alberta","48","Conspire to commit murder","7","4","0","126.57","0.18","0.22","0.21","0","0","4","7","7","0","0"
"2014","Alberta","48","Conspire to commit murder","5","0","0","-30.51","0.12","0","0","0","0","0","0","0","0","0"
"2015","Alberta","48","Conspire to commit murder","6","1","2","17.95","0.14","0.09","0.08","0","0","3","3","3","0","0"
"2016","Alberta","48","Conspire to commit murder","3","2","0","-50.86","0.07","0.21","0.19","0","0","2","7","7","0","0"
"1998","Alberta","48","Other sexual violations","270","187","40","0","9.31","2.99","2.96","2.69","4.61","227","64","71","7","12"
"1999","Alberta","48","Other sexual violations","220","114","29","-20","7.45","2.33","2.69","5.68","3.03","143","51","66","15","8"
"2000","Alberta","48","Other sexual violations","212","135","32","-5.29","7.06","3.21","3.31","4.12","2.99","167","72","83","11","8"
"2001","Alberta","48","Other sexual violations","197","113","34","-8.69","6.44","2","2.46","6.28","4.06","147","46","63","17","11"
"2002","Alberta","48","Other sexual violations","217","95","43","7.68","6.94","2.29","2.58","5.06","3.97","138","54","68","14","11"
"2003","Alberta","48","Other sexual violations","160","86","26","-27.54","5.03","1.99","2.08","2.86","3.94","112","48","56","8","11"
"2004","Alberta","48","Other sexual violations","170","77","19","4.41","5.25","1.62","1.75","2.85","3.56","96","40","48","8","10"
"2005","Alberta","48","Other sexual violations","226","86","36","29.63","6.8","1.93","2.12","3.88","4.23","122","49","60","11","12"
"2006","Alberta","48","Other sexual violations","216","91","50","-7.19","6.31","1.87","1.96","2.79","4.53","141","49","57","8","13"
"2007","Alberta","48","Other sexual violations","194","83","46","-12.55","5.52","1.25","1.77","6.62","4.18","129","34","53","19","12"
"2008","Alberta","48","Other sexual violations","207","96","54","4.28","5.76","1.87","2.12","4.56","5.26","150","52","65","13","15"
"2009","Alberta","48","Other sexual violations","100","54","39","-52.79","2.72","1.22","1.43","3.52","5.64","93","35","45","10","16"
"2010","Alberta","48","Other sexual violations","5","3","2","-95.07","0.13","0.03","0.03","0","0","5","1","1","0","0"
"2011","Alberta","48","Other sexual violations","9","1","2","77.26","0.24","0","0","0","0","3","0","0","0","0"
"2012","Alberta","48","Other sexual violations","10","2","1","8.52","0.26","0","0","0","0","3","0","0","0","0"
"2013","Alberta","48","Other sexual violations","0","0","0","-100","0","0","0","0","0","0","0","0","0","0"
"2014","Alberta","48","Other sexual violations","5","0","0","0","0.12","0","0","0","0","0","0","0","0","0"
"2015","Alberta","48","Other sexual violations","10","3","1","96.58","0.24","0.03","0.03","0","0.36","4","1","1","0","1"
"2016","Alberta","48","Other sexual violations","2","1","0","-80.34","0.05","0.06","0.06","0","0","1","2","2","0","0"
"2005","Alberta","48","Sexual Exploitation of a person with a disability","0","0","0","0","0","0","0","0","0","0","0","0","0","0"
"2006","Alberta","48","Sexual Exploitation of a person with a disability","0","0","0","0","0","0","0","0","0","0","0","0","0","0"
"2007","Alberta","48","Sexual Exploitation of a person with a disability","0","0","0","0","0","0","0","0","0","0","0","0","0","0"
"2008","Alberta","48","Sexual Exploitation of a person with a disability","0","0","0","0","0","0","0","0","0","0","0","0","0","0"
"2009","Alberta","48","Sexual Exploitation of a person with a disability","0","0","1","0","0","0","0","0","0","1","0","0","0","0"
"2010","Alberta","48","Sexual Exploitation of a person with a disability","1","0","0","0","0.03","0","0","0","0","0","0","0","0","0"
"2011","Alberta","48","Sexual Exploitation of a person with a disability","0","0","0","-100","0","0","0","0","0","0","0","0","0","0"
"2012","Alberta","48","Sexual Exploitation of a person with a disability","2","0","0","0","0.05","0","0","0","0","0","0","0","0","0"
"2013","Alberta","48","Sexual Exploitation of a person with a disability","2","0","0","-2.9","0.05","0","0","0","0","0","0","0","0","0"
"2014","Alberta","48","Sexual Exploitation of a person with a disability","0","0","0","-100","0","0","0","0","0","0","0","0","0","0"
"2015","Alberta","48","Sexual Exploitation of a person with a disability","3","1","0","0","0.07","0.03","0.03","0","0","1","1","1","0","0"
"2016","Alberta","48","Sexual Exploitation of a person with a disability","2","0","0","-34.48","0.05","0","0","0","0","0","0","0","0","0"
"2005","Alberta","48","Incest","1","1","0","0","0.03","0","0","0","0","1","0","0","0","0"
"2006","Alberta","48","Incest","1","1","0","-2.9","0.03","0","0","0","0","1","0","0","0","0"
"2007","Alberta","48","Incest","3","2","0","192.09","0.09","0.04","0.03","0","0","2","1","1","0","0"
"2008","Alberta","48","Incest","15","8","2","388.64","0.42","0.07","0.13","0.7","0","10","2","4","2","0"
"2009","Alberta","48","Incest","22","18","2","43.34","0.6","0.31","0.38","1.06","0.35","20","9","12","3","1"
"2010","Alberta","48","Incest","28","19","6","25.45","0.75","0.38","0.47","1.42","1.42","25","11","15","4","4"
"2011","Alberta","48","Incest","31","23","4","9.03","0.82","0.68","0.71","1.07","0.71","27","20","23","3","2"
"2012","Alberta","48","Incest","24","21","2","-24.39","0.62","0.53","0.57","1.07","0","23","16","19","3","0"
"2013","Alberta","48","Incest","30","21","3","21.38","0.75","0.35","0.44","1.43","0.72","24","11","15","4","2"
"2014","Alberta","48","Incest","28","22","4","-9.2","0.68","0.47","0.57","1.79","0","26","15","20","5","0"
"2015","Alberta","48","Incest","31","22","7","8.82","0.74","0.46","0.59","2.15","0.36","29","15","21","6","1"
"2016","Alberta","48","Incest","23","15","2","-27.08","0.54","0.15","0.36","2.83","0","17","5","13","8","0"
"2005","Alberta","48","Corrupting morals of a child","0","0","0","0","0","0","0","0","0","0","0","0","0","0"
"2006","Alberta","48","Corrupting morals of a child","0","0","0","0","0","0","0","0","0","0","0","0","0","0"
"2007","Alberta","48","Corrupting morals of a child","0","0","0","0","0","0","0","0","0","0","0","0","0","0"
"2008","Alberta","48","Corrupting morals of a child","1","0","0","0","0.03","0","0","0","0","0","0","0","0","0"
"2009","Alberta","48","Corrupting morals of a child","5","0","0","388.67","0.14","0","0","0","0","0","0","0","0","0"
"2010","Alberta","48","Corrupting morals of a child","8","0","3","57.71","0.21","0","0","0","0","3","0","0","0","0"
"2011","Alberta","48","Corrupting morals of a child","11","2","3","35.41","0.29","0.1","0.15","0.71","0","5","3","5","2","0"
"2012","Alberta","48","Corrupting morals of a child","4","0","1","-64.48","0.1","0","0","0","0","1","0","0","0","0"
"2013","Alberta","48","Corrupting morals of a child","10","0","7","142.75","0.25","0","0","0","0","7","0","0","0","0"
"2014","Alberta","48","Corrupting morals of a child","3","0","1","-70.82","0.07","0","0","0","0","1","0","0","0","0"
"2015","Alberta","48","Corrupting morals of a child","2","1","0","-34.47","0.05","0.03","0.03","0","0","1","1","1","0","0"
"2016","Alberta","48","Corrupting morals of a child","6","4","0","194.84","0.14","0","0","0","0","4","0","0","0","0"
"2005","Alberta","48","Anal intercourse","0","0","0","0","0","0","0","0","0","0","0","0","0","0"
"2006","Alberta","48","Anal intercourse","0","0","0","0","0","0","0","0","0","0","0","0","0","0"
"2007","Alberta","48","Anal intercourse","0","0","0","0","0","0","0","0","0","0","0","0","0","0"
"2008","Alberta","48","Anal intercourse","0","0","0","0","0","0","0","0","0","0","0","0","0","0"
"2009","Alberta","48","Anal intercourse","3","0","0","0","0.08","0","0","0","0","0","0","0","0","0"
"2010","Alberta","48","Anal intercourse","1","0","2","-67.14","0.03","0","0","0","0.36","2","0","0","0","1"
"2011","Alberta","48","Anal intercourse","0","0","0","-100","0","0","0","0","0","0","0","0","0","0"
"2012","Alberta","48","Anal intercourse","0","0","1","0","0","0","0","0","0.36","1","0","0","0","1"
"2013","Alberta","48","Anal intercourse","2","0","1","0","0.05","0","0","0","0","1","0","0","0","0"
"2014","Alberta","48","Anal intercourse","2","0","1","-2.72","0.05","0","0","0","0","1","0","0","0","0"
"2015","Alberta","48","Anal intercourse","2","2","0","-1.71","0.05","0.03","0.03","0","0","2","1","1","0","0"
"2016","Alberta","48","Anal intercourse","1","1","0","-50.86","0.02","0.03","0.03","0","0","1","1","1","0","0"
"2005","Alberta","48","Bestiality, commit or compel person","0","0","0","0","0","0","0","0","0","0","0","0","0","0"
"2006","Alberta","48","Bestiality, commit or compel person","0","0","0","0","0","0","0","0","0","0","0","0","0","0"
"2007","Alberta","48","Bestiality, commit or compel person","0","0","0","0","0","0","0","0","0","0","0","0","0","0"
"2008","Alberta","48","Bestiality, commit or compel person","2","0","0","0","0.06","0","0","0","0","0","0","0","0","0"
"2009","Alberta","48","Bestiality, commit or compel person","2","1","0","-2.27","0.05","0.03","0.03","0","0","1","1","1","0","0"
"2010","Alberta","48","Bestiality, commit or compel person","2","1","2","-1.43","0.05","0","0","0","0.36","3","0","0","0","1"
"2011","Alberta","48","Bestiality, commit or compel person","4","2","1","96.96","0.11","0.03","0.03","0","0","3","1","1","0","0"
"2012","Alberta","48","Bestiality, commit or compel person","5","3","0","22.08","0.13","0.03","0.06","0.36","0","3","1","2","1","0"
"2013","Alberta","48","Bestiality, commit or compel person","4","1","2","-22.32","0.1","0","0.03","0.36","0.36","3","0","1","1","1"
"2014","Alberta","48","Bestiality, commit or compel person","2","2","0","-51.36","0.05","0.06","0.06","0","0","2","2","2","0","0"
"2015","Alberta","48","Bestiality, commit or compel person","3","2","0","47.44","0.07","0.09","0.08","0","0","2","3","3","0","0"
"2016","Alberta","48","Bestiality, commit or compel person","1","1","0","-67.24","0.02","0.03","0.03","0","0","1","1","1","0","0"
"2001","Alberta","48","Intimidation of a justice system participant or a journalist","0","0","0","0","0","0","0","0","0","0","0","0","0","0"
"2002","Alberta","48","Intimidation of a justice system participant or a journalist","0","0","0","0","0","0","0","0","0","0","0","0","0","0"
"2003","Alberta","48","Intimidation of a justice system participant or a journalist","0","0","0","0","0","0","0","0","0","0","0","0","0","0"
"2004","Alberta","48","Intimidation of a justice system participant or a journalist","1","1","0","0","0.03","0.04","0.04","0","0","1","1","1","0","0"
"2005","Alberta","48","Intimidation of a justice system participant or a journalist","4","0","2","290.04","0.12","0","0","0","0","2","0","0","0","0"
"2006","Alberta","48","Intimidation of a justice system participant or a journalist","8","7","0","94.2","0.23","0.23","0.21","0","0","7","6","6","0","0"
"2007","Alberta","48","Intimidation of a justice system participant or a journalist","4","4","0","-51.32","0.11","0.11","0.1","0","0","4","3","3","0","0"
"2008","Alberta","48","Intimidation of a justice system participant or a journalist","11","5","5","168.75","0.31","0.07","0.1","0.35","0","10","2","3","1","0"
"2009","Alberta","48","Intimidation of a justice system participant or a journalist","11","9","1","-2.27","0.3","0.21","0.22","0.35","0","10","6","7","1","0"
"2010","Alberta","48","Intimidation of a justice system participant or a journalist","22","13","6","97.13","0.59","0.41","0.44","0.71","0.36","19","12","14","2","1"
"2011","Alberta","48","Intimidation of a justice system participant or a journalist","31","15","7","38.77","0.82","0.44","0.43","0.36","0","22","13","14","1","0"
"2012","Alberta","48","Intimidation of a justice system participant or a journalist","46","34","8","44.92","1.19","1.02","1.06","1.43","0","42","31","35","4","0"
"2013","Alberta","48","Intimidation of a justice system participant or a journalist","30","22","3","-36.67","0.75","0.96","0.91","0.36","0","25","30","31","1","0"
"2014","Alberta","48","Intimidation of a justice system participant or a journalist","44","37","3","42.68","1.07","0.96","0.89","0","0.36","40","31","31","0","1"
"2015","Alberta","48","Intimidation of a justice system participant or a journalist","43","28","9","-3.94","1.03","0.98","0.9","0","0","37","32","32","0","0"
"2016","Alberta","48","Intimidation of a justice system participant or a journalist","40","33","2","-8.58","0.94","0.72","0.72","0.71","0","35","24","26","2","0"
"1998","Alberta","48","Intimidation of a justice system participant or a journalist","0","0","0","0","0","0","0","0","0","0","0","0","0","0"
"1999","Alberta","48","Intimidation of a justice system participant or a journalist","0","0","0","0","0","0","0","0","0","0","0","0","0","0"
"2000","Alberta","48","Intimidation of a justice system participant or a journalist","0","0","0","0","0","0","0","0","0","0","0","0","0","0"
"2005","Alberta","48","Intimidation of a non-justice participant","0","0","0","0","0","0","0","0","0","0","0","0","0","0"
"2006","Alberta","48","Intimidation of a non-justice participant","0","0","0","0","0","0","0","0","0","0","0","0","0","0"
"2007","Alberta","48","Intimidation of a non-justice participant","0","0","0","0","0","0","0","0","0","0","0","0","0","0"
"2008","Alberta","48","Intimidation of a non-justice participant","5","5","0","0","0.14","0.04","0.03","0","0","5","1","1","0","0"
"2009","Alberta","48","Intimidation of a non-justice participant","13","7","4","154.11","0.35","0.21","0.19","0","0.35","11","6","6","0","1"
"2010","Alberta","48","Intimidation of a non-justice participant","18","8","6","36.48","0.48","0.31","0.31","0.36","1.42","14","9","10","1","4"
"2011","Alberta","48","Intimidation of a non-justice participant","41","19","13","124.32","1.08","0.58","0.56","0.36","0.36","32","17","18","1","1"
"2012","Alberta","48","Intimidation of a non-justice participant","44","30","10","4.81","1.13","0.69","0.64","0","0.36","40","21","21","0","1"
"2013","Alberta","48","Intimidation of a non-justice participant","44","29","9","-2.9","1.1","0.48","0.47","0.36","0","38","15","16","1","0"
"2014","Alberta","48","Intimidation of a non-justice participant","33","24","6","-27.04","0.8","0.53","0.49","0","0","30","17","17","0","0"
"2015","Alberta","48","Intimidation of a non-justice participant","46","38","5","37.01","1.1","0.7","0.65","0","0","43","23","23","0","0"
"2016","Alberta","48","Intimidation of a non-justice participant","49","38","5","4.69","1.15","0.87","0.8","0","0","43","29","29","0","0"
"1998","Alberta","48","Explosives causing death or bodily harm","1","1","0","0","0.03","0","0","0","0","1","0","0","0","0"
"1999","Alberta","48","Explosives causing death or bodily harm","6","1","0","489.07","0.2","0","0","0","0","1","0","0","0","0"
"2000","Alberta","48","Explosives causing death or bodily harm","1","1","0","-83.62","0.03","0.04","0.04","0","0","1","1","1","0","0"
"2001","Alberta","48","Explosives causing death or bodily harm","8","3","0","686.11","0.26","0.09","0.12","0.37","0","3","2","3","1","0"
"2002","Alberta","48","Explosives causing death or bodily harm","15","3","2","83.28","0.48","0.04","0.04","0","0.36","5","1","1","0","1"
"2003","Alberta","48","Explosives causing death or bodily harm","5","0","0","-67.24","0.16","0","0","0","0","0","0","0","0","0"
"2004","Alberta","48","Explosives causing death or bodily harm","13","3","0","155.5","0.4","0.12","0.11","0","0.36","3","3","3","0","1"
"2005","Alberta","48","Explosives causing death or bodily harm","3","1","0","-77.5","0.09","0.04","0.07","0.35","0","1","1","2","1","0"
"2006","Alberta","48","Explosives causing death or bodily harm","1","1","0","-67.63","0.03","0.04","0.03","0","0","1","1","1","0","0"
"2007","Alberta","48","Explosives causing death or bodily harm","5","2","2","386.81","0.14","0","0","0","0","4","0","0","0","0"
"2008","Alberta","48","Explosives causing death or bodily harm","9","1","0","75.91","0.25","0.04","0.03","0","0","1","1","1","0","0"
"2009","Alberta","48","Explosives causing death or bodily harm","3","9","0","-67.42","0.08","0.31","0.54","2.82","0","9","9","17","8","0"
"2010","Alberta","48","Explosives causing death or bodily harm","2","1","0","-34.29","0.05","0.03","0.09","0.71","0","1","1","3","2","0"
"2011","Alberta","48","Explosives causing death or bodily harm","3","2","0","47.72","0.08","0.07","0.12","0.71","0.71","2","2","4","2","2"
"2012","Alberta","48","Explosives causing death or bodily harm","1","1","0","-67.44","0.03","0.07","0.06","0","0","1","2","2","0","0"
"2013","Alberta","48","Explosives causing death or bodily harm","4","2","1","288.4","0.1","0.06","0.06","0","0","3","2","2","0","0"
"2014","Alberta","48","Explosives causing death or bodily harm","3","3","0","-27.04","0.07","0.03","0.09","0.72","0","3","1","3","2","0"
"2015","Alberta","48","Explosives causing death or bodily harm","1","0","1","-67.24","0.02","0.03","0.03","0","0","1","1","1","0","0"
"2016","Alberta","48","Explosives causing death or bodily harm","1","0","1","-1.72","0.02","0","0","0","0","1","0","0","0","0"
"1998","Alberta","48","Arson, disregard for human life","10","2","0","0","0.34","0.09","0.08","0","0","2","2","2","0","0"
"1999","Alberta","48","Arson, disregard for human life","12","4","0","17.81","0.41","0.09","0.12","0.38","0","4","2","3","1","0"
"2000","Alberta","48","Arson, disregard for human life","10","10","0","-18.1","0.33","0.31","0.64","3.37","0","10","7","16","9","0"
"2001","Alberta","48","Arson, disregard for human life","9","6","1","-11.56","0.29","0.09","0.27","1.85","0","7","2","7","5","0"
"2002","Alberta","48","Arson, disregard for human life","17","13","0","84.64","0.54","0.3","0.27","0","0","13","7","7","0","0"
"2003","Alberta","48","Arson, disregard for human life","38","22","6","119.67","1.19","0.66","0.85","2.5","0","28","16","23","7","0"
"2004","Alberta","48","Arson, disregard for human life","27","19","0","-30.18","0.83","0.49","0.51","0.71","0","19","12","14","2","0"
"2005","Alberta","48","Arson, disregard for human life","31","16","1","11.96","0.93","0.31","0.32","0.35","0","17","8","9","1","0"
"2006","Alberta","48","Arson, disregard for human life","44","21","6","37.82","1.29","0.57","0.69","1.74","0.35","27","15","20","5","1"
"2007","Alberta","48","Arson, disregard for human life","55","33","1","21.7","1.57","1.11","1.23","2.44","0.35","34","30","37","7","1"
"2008","Alberta","48","Arson, disregard for human life","50","33","5","-11.16","1.39","0.75","0.85","1.75","0.7","38","21","26","5","2"
"2009","Alberta","48","Arson, disregard for human life","50","30","3","-2.27","1.36","0.59","0.6","0.7","0.35","33","17","19","2","1"
"2010","Alberta","48","Arson, disregard for human life","44","36","4","-13.26","1.18","0.72","0.85","2.13","0.36","40","21","27","6","1"
"2011","Alberta","48","Arson, disregard for human life","60","48","3","34.29","1.58","0.98","1.18","3.2","1.07","51","29","38","9","3"
"2012","Alberta","48","Arson, disregard for human life","113","100","3","83.94","2.91","0.93","1.18","3.93","0","103","28","39","11","0"
"2013","Alberta","48","Arson, disregard for human life","97","70","1","-16.65","2.43","0.8","0.88","1.79","0","71","25","30","5","0"
"2014","Alberta","48","Arson, disregard for human life","42","19","2","-57.88","1.02","0.5","0.51","0.72","0","21","16","18","2","0"
"2015","Alberta","48","Arson, disregard for human life","52","43","1","21.7","1.24","0.79","0.93","2.5","0","44","26","33","7","0"
"2016","Alberta","48","Arson, disregard for human life","51","38","1","-3.61","1.2","0.81","0.89","1.77","0","39","27","32","5","0"
"1998","Alberta","48","Voyeurism","0","0","0","0","0","0","0","0","0","0","0","0","0","0"
"1999","Alberta","48","Voyeurism","0","0","0","0","0","0","0","0","0","0","0","0","0","0"
"2000","Alberta","48","Voyeurism","0","0","0","0","0","0","0","0","0","0","0","0","0","0"
"2001","Alberta","48","Voyeurism","0","0","0","0","0","0","0","0","0","0","0","0","0","0"
"2002","Alberta","48","Voyeurism","0","0","0","0","0","0","0","0","0","0","0","0","0","0"
"2003","Alberta","48","Voyeurism","0","0","0","0","0","0","0","0","0","0","0","0","0","0"
"2004","Alberta","48","Voyeurism","0","0","0","0","0","0","0","0","0","0","0","0","0","0"
"2005","Alberta","48","Voyeurism","1","0","0","0","0.03","0","0","0","0","0","0","0","0","0"
"2006","Alberta","48","Voyeurism","11","9","0","968.12","0.32","0.3","0.27","0","0","9","8","8","0","0"
"2007","Alberta","48","Voyeurism","26","12","1","130.13","0.74","0.41","0.4","0.35","0","13","11","12","1","0"
"2008","Alberta","48","Voyeurism","35","16","5","31.56","0.97","0.5","0.49","0.35","0.7","21","14","15","1","2"
"2009","Alberta","48","Voyeurism","42","16","7","17.28","1.14","0.56","0.51","0","0.35","23","16","16","0","1"
"2010","Alberta","48","Voyeurism","61","28","7","43.16","1.63","0.65","0.66","0.71","0.36","35","19","21","2","1"
"2011","Alberta","48","Voyeurism","49","23","3","-20.89","1.29","0.64","0.62","0.36","0","26","19","20","1","0"
"2012","Alberta","48","Voyeurism","77","48","12","53.48","1.98","1.16","1.15","1.07","0.36","60","35","38","3","1"
"2013","Alberta","48","Voyeurism","98","45","12","23.58","2.45","1.06","1.03","0.72","0.72","57","33","35","2","2"
"2014","Alberta","48","Voyeurism","102","58","11","1.25","2.48","1.34","1.4","2.15","3.23","69","43","49","6","9"
"2015","Alberta","48","Voyeurism","83","34","12","-20.02","1.99","0.67","0.82","2.5","2.15","46","22","29","7","6"
"2016","Alberta","48","Voyeurism","84","39","7","-0.54","1.98","0.84","0.86","1.06","0.71","46","28","31","3","2"
"2012","Alberta","48","Failure to comply with mandatory safeguards in relation to medical assistance in dying","0","0","0","0","0","0","0","0","0","0","0","0","0","0"
"2013","Alberta","48","Failure to comply with mandatory safeguards in relation to medical assistance in dying","0","0","0","0","0","0","0","0","0","0","0","0","0","0"
"2014","Alberta","48","Failure to comply with mandatory safeguards in relation to medical assistance in dying","0","0","0","0","0","0","0","0","0","0","0","0","0","0"
"2015","Alberta","48","Failure to comply with mandatory safeguards in relation to medical assistance in dying","0","0","0","0","0","0","0","0","0","0","0","0","0","0"
"2016","Alberta","48","Failure to comply with mandatory safeguards in relation to medical assistance in dying","0","0","0","0","0","0","0","0","0","0","0","0","0","0"
"2012","Alberta","48","Nonconsensual distribution of intimate images","0","0","0","0","0","0","0","0","0","0","0","0","0","0"
"2013","Alberta","48","Nonconsensual distribution of intimate images","0","0","0","0","0","0","0","0","0","0","0","0","0","0"
"2014","Alberta","48","Nonconsensual distribution of intimate images","0","0","0","0","0","0","0","0","0","0","0","0","0","0"
"2015","Alberta","48","Nonconsensual distribution of intimate images","37","10","7","0","0.89","0.18","0.2","0.36","0","17","6","7","1","0"
"2016","Alberta","48","Nonconsensual distribution of intimate images","96","14","31","154.99","2.26","0.3","0.3","0.35","6.01","45","10","11","1","17"
"2005","Alberta","48","Trap likely to or causing bodily harm","0","0","0","0","0","0","0","0","0","0","0","0","0","0"
"2006","Alberta","48","Trap likely to or causing bodily harm","0","0","0","0","0","0","0","0","0","0","0","0","0","0"
"2007","Alberta","48","Trap likely to or causing bodily harm","0","0","0","0","0","0","0","0","0","0","0","0","0","0"
"2008","Alberta","48","Trap likely to or causing bodily harm","0","0","0","0","0","0","0","0","0","0","0","0","0","0"
"2009","Alberta","48","Trap likely to or causing bodily harm","0","0","0","0","0","0","0","0","0","0","0","0","0","0"
"2010","Alberta","48","Trap likely to or causing bodily harm","0","0","0","0","0","0.07","0.06","0","0","0","2","2","0","0"
"2011","Alberta","48","Trap likely to or causing bodily harm","0","0","0","0","0","0","0","0","0","0","0","0","0","0"
"2012","Alberta","48","Trap likely to or causing bodily harm","1","0","1","0","0.03","0","0","0","0","1","0","0","0","0"
"2013","Alberta","48","Trap likely to or causing bodily harm","0","0","0","-100","0","0","0","0","0","0","0","0","0","0"
"2014","Alberta","48","Trap likely to or causing bodily harm","1","1","0","0","0.02","0.06","0.06","0","0","1","2","2","0","0"
"2015","Alberta","48","Trap likely to or causing bodily harm","0","0","0","-100","0","0","0","0","0","0","0","0","0","0"
"2016","Alberta","48","Trap likely to or causing bodily harm","0","0","0","0","0","0","0","0","0","0","0","0","0","0"
"1998","Alberta","48","Hostage-taking","17","17","0","0","0.59","0.84","0.79","0.38","0","17","18","19","1","0"
"1999","Alberta","48","Hostage-taking","24","23","0","38.6","0.81","0.82","0.77","0.38","0","23","18","19","1","0"
"2000","Alberta","48","Hostage-taking","3","3","0","-87.72","0.1","0.13","0.12","0","0","3","3","3","0","0"
"2001","Alberta","48","Hostage-taking","16","16","0","424.08","0.52","0.74","0.78","1.11","0","16","17","20","3","0"
"2002","Alberta","48","Hostage-taking","24","17","0","46.63","0.77","0.59","0.64","1.08","0","17","14","17","3","0"
"2003","Alberta","48","Hostage-taking","21","20","0","-14.01","0.66","0.87","0.93","1.43","0","20","21","25","4","0"
"2004","Alberta","48","Hostage-taking","17","14","0","-20.45","0.52","0.32","0.4","1.07","0","14","8","11","3","0"
"2005","Alberta","48","Hostage-taking","17","13","0","-2.49","0.51","0.47","0.53","1.06","0","13","12","15","3","0"
"2006","Alberta","48","Hostage-taking","7","6","0","-60.02","0.2","0.19","0.17","0","0","6","5","5","0","0"
"2007","Alberta","48","Hostage-taking","2","1","0","-72.18","0.06","0.07","0.07","0","0","1","2","2","0","0"
"2008","Alberta","48","Hostage-taking","3","3","0","46.59","0.08","0.18","0.16","0","0","3","5","5","0","0"
"2009","Alberta","48","Hostage-taking","1","0","0","-67.42","0.03","0","0","0","0","0","0","0","0","0"
"2010","Alberta","48","Hostage-taking","1","0","0","-1.43","0.03","0","0","0","0","0","0","0","0","0"
"2011","Alberta","48","Hostage-taking","4","2","0","293.92","0.11","0.07","0.06","0","0","2","2","2","0","0"
"2012","Alberta","48","Hostage-taking","5","3","0","22.08","0.13","0.1","0.09","0","0","3","3","3","0","0"
"2013","Alberta","48","Hostage-taking","4","4","0","-22.32","0.1","0.1","0.09","0","0","4","3","3","0","0"
"2014","Alberta","48","Hostage-taking","2","1","1","-51.36","0.05","0","0","0","0","2","0","0","0","0"
"2015","Alberta","48","Hostage-taking","2","1","1","-1.71","0.05","0.03","0.03","0","0","2","1","1","0","0"
"2016","Alberta","48","Hostage-taking","0","0","0","-100","0","0","0","0","0","0","0","0","0","0"
"2005","Alberta","48","Trafficking in persons","0","0","0","0","0","0","0","0","0","0","0","0","0","0"
"2006","Alberta","48","Trafficking in persons","0","0","0","0","0","0","0","0","0","0","0","0","0","0"
"2007","Alberta","48","Trafficking in persons","0","0","0","0","0","0","0","0","0","0","0","0","0","0"
"2008","Alberta","48","Trafficking in persons","2","0","0","0","0.06","0","0","0","0","0","0","0","0","0"
"2009","Alberta","48","Trafficking in persons","10","7","2","388.67","0.27","0.17","0.16","0","0","9","5","5","0","0"
"2010","Alberta","48","Trafficking in persons","4","0","1","-60.57","0.11","0","0","0","0","1","0","0","0","0"
"2011","Alberta","48","Trafficking in persons","2","1","1","-50.76","0.05","0.03","0.03","0","0","2","1","1","0","0"
"2012","Alberta","48","Trafficking in persons","2","1","0","-2.33","0.05","0","0","0","0","1","0","0","0","0"
"2013","Alberta","48","Trafficking in persons","11","8","2","434.06","0.28","0.35","0.35","0.36","0","10","11","12","1","0"
"2014","Alberta","48","Trafficking in persons","7","5","1","-38.09","0.17","0.19","0.17","0","0","6","6","6","0","0"
"2015","Alberta","48","Trafficking in persons","12","10","1","68.5","0.29","0.43","0.42","0.36","0","11","14","15","1","0"
"2016","Alberta","48","Trafficking in persons","27","8","5","121.13","0.63","0.27","0.25","0","0","13","9","9","0","0"
"2012","Alberta","48","Forging or destroying documents related to assistance requests with criminal intent","0","0","0","0","0","0","0","0","0","0","0","0","0","0"
"2013","Alberta","48","Forging or destroying documents related to assistance requests with criminal intent","0","0","0","0","0","0","0","0","0","0","0","0","0","0"
"2014","Alberta","48","Forging or destroying documents related to assistance requests with criminal intent","0","0","0","0","0","0","0","0","0","0","0","0","0","0"
"2015","Alberta","48","Forging or destroying documents related to assistance requests with criminal intent","0","0","0","0","0","0","0","0","0","0","0","0","0","0"
"2016","Alberta","48","Forging or destroying documents related to assistance requests with criminal intent","0","0","0","0","0","0","0","0","0","0","0","0","0","0"
"1998","Alberta","48","Other violent violations","66","6","39","0","2.28","0.14","0.13","0","0","45","3","3","0","0"
"1999","Alberta","48","Other violent violations","54","7","30","-19.67","1.83","0.14","0.12","0","0.38","37","3","3","0","1"
"2000","Alberta","48","Other violent violations","37","10","10","-32.66","1.23","0.31","0.28","0","0","20","7","7","0","0"
"2001","Alberta","48","Other violent violations","70","16","8","85.91","2.29","0.39","0.35","0","0","24","9","9","0","0"
"2002","Alberta","48","Other violent violations","65","13","10","-9.23","2.08","0.3","0.27","0","0.36","23","7","7","0","1"
"2003","Alberta","48","Other violent violations","82","16","7","23.97","2.58","0.37","0.45","1.07","0.36","23","9","12","3","1"
"2004","Alberta","48","Other violent violations","76","11","4","-8.92","2.35","0.24","0.29","0.71","0.36","15","6","8","2","1"
"2005","Alberta","48","Other violent violations","61","12","8","-21.74","1.84","0.31","0.28","0","0.7","20","8","8","0","2"
"2006","Alberta","48","Other violent violations","107","36","26","70.33","3.13","1.07","1.13","1.74","2.09","62","28","33","5","6"
"2007","Alberta","48","Other violent violations","82","26","14","-25.39","2.33","1.07","1","0.35","0.35","40","29","30","1","1"
"2008","Alberta","48","Other violent violations","87","42","19","3.69","2.42","1.15","1.14","1.05","1.4","61","32","35","3","4"
"2009","Alberta","48","Other violent violations","110","35","22","23.57","2.99","1.19","1.18","1.06","0.35","57","34","37","3","1"
"2010","Alberta","48","Other violent violations","140","37","40","25.45","3.75","0.86","0.88","1.07","0","77","25","28","3","0"
"2011","Alberta","48","Other violent violations","123","28","45","-13.48","3.25","1.02","0.93","0","0.36","73","30","30","0","1"
"2012","Alberta","48","Other violent violations","114","34","31","-9.48","2.94","1.12","1.09","0.71","0.36","65","34","36","2","1"
"2013","Alberta","48","Other violent violations","161","38","55","37.13","4.03","0.93","1.03","2.15","0.72","93","29","35","6","2"
"2014","Alberta","48","Other violent violations","167","65","42","0.91","4.06","1.65","1.66","1.79","0.36","107","53","58","5","1"
"2015","Alberta","48","Other violent violations","137","58","33","-19.37","3.28","1.68","1.61","0.72","0.36","91","55","57","2","1"
"2016","Alberta","48","Other violent violations","119","71","18","-14.63","2.8","1.87","1.75","0.35","0","89","62","63","1","0"
"1998","Alberta","48","Total property crime violations","183876","30370","17873","0","6341.75","904.04","1140.22","3078.89","2407.7","48243","19337","27360","8023","6274"
"1999","Alberta","48","Total property crime violations","180669","29196","18954","-3.53","6117.62","893.51","1100.79","2819.27","2481.33","48150","19575","27025","7450","6557"
"2000","Alberta","48","Total property crime violations","175103","28006","16951","-4.75","5827.17","857.07","1072.44","2879.05","2934.44","44957","19210","26903","7693","7841"
"2001","Alberta","48","Total property crime violations","179943","27070","16508","0.98","5884.3","851.16","1046.22","2700.03","3151.94","43578","19530","26837","7307","8530"
"2002","Alberta","48","Total property crime violations","190955","28318","17328","3.73","6103.99","876.51","1083.85","2851.2","3304.6","45646","20681","28573","7892","9147"
"2003","Alberta","48","Total property crime violations","211870","29185","19650","9.03","6655.47","921.76","1075.8","2405.47","3604.62","48835","22240","28964","6724","10076"
"2004","Alberta","48","Total property crime violations","215063","28936","19949","-0.25","6638.83","927.86","1031.8","1944.21","3438.3","48885","22891","28355","5464","9663"
"2005","Alberta","48","Total property crime violations","216057","27034","20039","-2.04","6503.43","838.52","937.14","1820.42","2935.23","47073","21308","26473","5165","8328"
"2006","Alberta","48","Total property crime violations","213115","26846","24009","-4.22","6228.95","769.05","862.09","1713.35","3005.24","50855","20202","25121","4919","8628"
"2007","Alberta","48","Total property crime violations","212706","25412","26179","-2.82","6053.05","723.17","832.44","1864.88","2991.62","51591","19605","24956","5351","8584"
"2008","Alberta","48","Total property crime violations","205373","24779","28165","-5.64","5711.54","709.78","805.98","1745.12","3002.96","52944","19766","24744","4978","8566"
"2009","Alberta","48","Total property crime violations","196531","24318","27870","-6.47","5341.83","690.73","778.19","1659.1","2788.9","52188","19742","24450","4708","7914"
"2010","Alberta","48","Total property crime violations","183234","22859","26327","-8.1","4909.05","634.92","708.36","1465.35","2624.64","49186","18431","22558","4127","7392"
"2011","Alberta","48","Total property crime violations","165634","21132","23882","-10.98","4370.07","574.59","636.18","1282.3","2154.59","45014","16949","20555","3606","6059"
"2012","Alberta","48","Total property crime violations","166922","20920","22491","-1.57","4301.28","555.98","609.63","1189.17","2041.68","43411","16825","20156","3331","5719"
"2013","Alberta","48","Total property crime violations","171763","21153","22139","-0.08","4297.71","559.27","601.07","1068.13","1681.61","43292","17470","20456","2986","4701"
"2014","Alberta","48","Total property crime violations","178692","22879","21415","1.21","4349.55","566.71","592.92","895.4","1479.06","44294","18230","20726","2496","4123"
"2015","Alberta","48","Total property crime violations","217481","25366","21400","19.63","5203.32","638.23","654.1","839.74","1473.83","46766","20874","23222","2348","4121"
"2016","Alberta","48","Total property crime violations","221390","25939","19700","0.04","5205.65","657.33","659.19","680.94","1299.69","45639","21847","23774","1927","3678"
"1998","Alberta","48","Total breaking and entering","29960","3876","1829","0","1033.3","125.39","192.62","744.49","150.43","5705","2682","4622","1940","392"
"1999","Alberta","48","Total breaking and entering","29287","3627","2361","-4.03","991.69","106.95","161.5","613.81","150.23","5988","2343","3965","1622","397"
"2000","Alberta","48","Total breaking and entering","26802","3557","1784","-10.06","891.93","115.51","171.37","639.96","227.54","5341","2589","4299","1710","608"
"2001","Alberta","48","Total breaking and entering","25551","3301","1472","-6.32","835.54","113.49","161.94","572.74","232.79","4773","2604","4154","1550","630"
"2002","Alberta","48","Total breaking and entering","27291","3381","1862","4.41","872.37","107.4","161.14","619.23","233.38","5243","2534","4248","1714","646"
"2003","Alberta","48","Total breaking and entering","30596","3618","1843","10.17","961.11","115.84","168.37","621.76","307.66","5461","2795","4533","1738","860"
"2004","Alberta","48","Total breaking and entering","31254","3458","2007","0.38","964.79","117.83","150.72","439.44","369.7","5465","2907","4142","1235","1039"
"2005","Alberta","48","Total breaking and entering","29192","2845","1474","-8.92","878.69","91.77","118.7","359.85","193.85","4319","2332","3353","1021","550"
"2006","Alberta","48","Total breaking and entering","26046","2786","1809","-13.36","761.28","79.37","100.58","294.67","192.96","4595","2085","2931","846","554"
"2007","Alberta","48","Total breaking and entering","25336","2500","1617","-5.29","721","69.61","92.46","308.43","188.2","4117","1887","2772","885","540"
"2008","Alberta","48","Total breaking and entering","23400","2341","1601","-9.74","650.77","65.68","84.1","263.98","184.75","3942","1829","2582","753","527"
"2009","Alberta","48","Total breaking and entering","23300","2161","1596","-2.68","633.31","63.12","76","205.8","181.49","3757","1804","2388","584","515"
"2010","Alberta","48","Total breaking and entering","22611","2308","1709","-4.35","605.78","63.73","81.3","262.39","158","4017","1850","2589","739","445"
"2011","Alberta","48","Total breaking and entering","18581","2010","1200","-19.07","490.24","56.51","67.78","185.98","104.9","3210","1667","2190","523","295"
"2012","Alberta","48","Total breaking and entering","19414","2086","1206","2.04","500.26","55.12","66.81","193.14","155.65","3292","1668","2209","541","436"
"2013","Alberta","48","Total breaking and entering","19316","2185","1147","-3.39","483.31","55.96","63.91","152.74","103.02","3332","1748","2175","427","288"
"2014","Alberta","48","Total breaking and entering","20159","2167","972","1.53","490.69","55.33","63.34","155.69","94.71","3139","1780","2214","434","264"
"2015","Alberta","48","Total breaking and entering","27656","2598","969","34.85","661.68","70.2","75.01","131.25","91.56","3567","2296","2663","367","256"
"2016","Alberta","48","Total breaking and entering","27989","2715","835","-0.54","658.12","74.5","78.25","122.27","77.74","3550","2476","2822","346","220"
"1998","Alberta","48","Breaking and entering","29960","3876","1829","0","1033.3","125.39","192.62","744.49","150.43","5705","2682","4622","1940","392"
"1999","Alberta","48","Breaking and entering","29287","3627","2361","-4.03","991.69","106.95","161.5","613.81","150.23","5988","2343","3965","1622","397"
"2000","Alberta","48","Breaking and entering","26802","3557","1784","-10.06","891.93","115.51","171.37","639.96","227.54","5341","2589","4299","1710","608"
"2001","Alberta","48","Breaking and entering","25551","3301","1472","-6.32","835.54","113.49","161.94","572.74","232.79","4773","2604","4154","1550","630"
"2002","Alberta","48","Breaking and entering","27291","3381","1862","4.41","872.37","107.4","161.14","619.23","233.38","5243","2534","4248","1714","646"
"2003","Alberta","48","Breaking and entering","30596","3618","1843","10.17","961.11","115.84","168.37","621.76","307.66","5461","2795","4533","1738","860"
"2004","Alberta","48","Breaking and entering","31254","3458","2007","0.38","964.79","117.83","150.72","439.44","369.7","5465","2907","4142","1235","1039"
"2005","Alberta","48","Breaking and entering","29192","2845","1474","-8.92","878.69","91.77","118.7","359.85","193.85","4319","2332","3353","1021","550"
"2006","Alberta","48","Breaking and entering","26046","2786","1809","-13.36","761.28","79.37","100.58","294.67","192.96","4595","2085","2931","846","554"
"2007","Alberta","48","Breaking and entering","25336","2500","1617","-5.29","721","69.61","92.46","308.43","188.2","4117","1887","2772","885","540"
"2008","Alberta","48","Breaking and entering","23390","2339","1599","-9.78","650.49","65.64","84.07","263.98","184.75","3938","1828","2581","753","527"
"2009","Alberta","48","Breaking and entering","23249","2154","1595","-2.85","631.92","62.94","75.72","204.39","181.13","3749","1799","2379","580","514"
"2010","Alberta","48","Breaking and entering","22506","2300","1704","-4.58","602.96","63.42","80.99","262.04","157.65","4004","1841","2579","738","444"
"2011","Alberta","48","Breaking and entering","18474","1995","1195","-19.16","487.42","56.24","67.29","183.14","104.55","3190","1659","2174","515","294"
"2012","Alberta","48","Breaking and entering","19282","2071","1199","1.94","496.86","54.66","66.24","191.35","155.65","3270","1654","2190","536","436"
"2013","Alberta","48","Breaking and entering","19162","2170","1143","-3.5","479.46","55.67","63.53","151.31","103.02","3313","1739","2162","423","288"
"2014","Alberta","48","Breaking and entering","19925","2150","965","1.16","485","54.96","62.79","153.18","94.35","3115","1768","2195","427","263"
"2015","Alberta","48","Breaking and entering","27346","2558","962","34.9","654.26","69.1","73.83","129.11","90.48","3520","2260","2621","361","253"
"2016","Alberta","48","Breaking and entering","27655","2681","826","-0.61","650.27","73.87","77.58","121.21","77.74","3507","2455","2798","343","220"
"2005","Alberta","48","Breaking and entering to steal a firearm","0","0","0","0","0","0","0","0","0","0","0","0","0","0"
"2006","Alberta","48","Breaking and entering to steal a firearm","0","0","0","0","0","0","0","0","0","0","0","0","0","0"
"2007","Alberta","48","Breaking and entering to steal a firearm","0","0","0","0","0","0","0","0","0","0","0","0","0","0"
"2008","Alberta","48","Breaking and entering to steal a firearm","8","1","1","0","0.22","0.04","0.03","0","0","2","1","1","0","0"
"2009","Alberta","48","Breaking and entering to steal a firearm","36","7","1","339.81","0.98","0.17","0.29","1.41","0.35","8","5","9","4","1"
"2010","Alberta","48","Breaking and entering to steal a firearm","32","8","0","-12.38","0.86","0.31","0.31","0.36","0","8","9","10","1","0"
"2011","Alberta","48","Breaking and entering to steal a firearm","32","10","0","-1.52","0.84","0.24","0.31","1.07","0","10","7","10","3","0"
"2012","Alberta","48","Breaking and entering to steal a firearm","49","7","5","49.55","1.26","0.23","0.24","0.36","0","12","7","8","1","0"
"2013","Alberta","48","Breaking and entering to steal a firearm","65","12","1","28.81","1.63","0.19","0.26","1.07","0","13","6","9","3","0"
"2014","Alberta","48","Breaking and entering to steal a firearm","119","12","2","78.1","2.9","0.25","0.37","1.79","0","14","8","13","5","0"
"2015","Alberta","48","Breaking and entering to steal a firearm","190","28","4","56.94","4.55","0.79","0.85","1.43","1.07","32","26","30","4","3"
"2016","Alberta","48","Breaking and entering to steal a firearm","210","27","3","8.62","4.94","0.48","0.53","1.06","0","30","16","19","3","0"
"2005","Alberta","48","Break and enter to steal a firearm from a motor vehicle","0","0","0","0","0","0","0","0","0","0","0","0","0","0"
"2006","Alberta","48","Break and enter to steal a firearm from a motor vehicle","0","0","0","0","0","0","0","0","0","0","0","0","0","0"
"2007","Alberta","48","Break and enter to steal a firearm from a motor vehicle","0","0","0","0","0","0","0","0","0","0","0","0","0","0"
"2008","Alberta","48","Break and enter to steal a firearm from a motor vehicle","2","1","1","0","0.06","0","0","0","0","2","0","0","0","0"
"2009","Alberta","48","Break and enter to steal a firearm from a motor vehicle","15","0","0","633.01","0.41","0","0","0","0","0","0","0","0","0"
"2010","Alberta","48","Break and enter to steal a firearm from a motor vehicle","73","0","5","379.69","1.96","0","0","0","0.36","5","0","0","0","1"
"2011","Alberta","48","Break and enter to steal a firearm from a motor vehicle","75","5","5","1.18","1.98","0.03","0.19","1.78","0.36","10","1","6","5","1"
"2012","Alberta","48","Break and enter to steal a firearm from a motor vehicle","83","8","2","8.08","2.14","0.23","0.33","1.43","0","10","7","11","4","0"
"2013","Alberta","48","Break and enter to steal a firearm from a motor vehicle","89","3","3","4.12","2.23","0.1","0.12","0.36","0","6","3","4","1","0"
"2014","Alberta","48","Break and enter to steal a firearm from a motor vehicle","115","5","5","25.7","2.8","0.12","0.17","0.72","0.36","10","4","6","2","1"
"2015","Alberta","48","Break and enter to steal a firearm from a motor vehicle","120","12","3","2.57","2.87","0.31","0.34","0.72","0","15","10","12","2","0"
"2016","Alberta","48","Break and enter to steal a firearm from a motor vehicle","124","7","6","1.55","2.92","0.15","0.14","0","0","13","5","5","0","0"
"1998","Alberta","48","Total possession of stolen property","3878","3324","323","0","133.75","97.38","119.9","304.7","81.36","3647","2083","2877","794","212"
"1999","Alberta","48","Total possession of stolen property","4436","3781","432","12.3","150.21","120.87","140.36","301.98","87.04","4213","2648","3446","798","230"
"2000","Alberta","48","Total possession of stolen property","4334","3640","390","-3.98","144.23","117.16","140.48","336.07","94.31","4030","2626","3524","898","252"
"2001","Alberta","48","Total possession of stolen property","4131","3489","376","-6.34","135.09","110.31","128.88","286.37","86.1","3865","2531","3306","775","233"
"2002","Alberta","48","Total possession of stolen property","4500","3777","362","6.48","143.85","118.33","137.58","301.67","72.26","4139","2792","3627","835","200"
"2003","Alberta","48","Total possession of stolen property","5472","4533","466","19.5","171.89","146.88","163.91","310.88","93.01","4999","3544","4413","869","260"
"2004","Alberta","48","Total possession of stolen property","5914","4701","473","6.21","182.56","151.39","161.67","251.92","74.37","5174","3735","4443","708","209"
"2005","Alberta","48","Total possession of stolen property","5949","4423","426","-1.91","179.07","145.96","154.31","229.09","69.08","4849","3709","4359","650","196"
"2006","Alberta","48","Total possession of stolen property","6480","4988","448","5.77","189.4","140.09","152.95","270.64","61.65","5436","3680","4457","777","177"
"2007","Alberta","48","Total possession of stolen property","6212","4547","481","-6.66","176.78","139.14","154.21","296.58","75.63","5028","3772","4623","851","217"
"2008","Alberta","48","Total possession of stolen property","5820","4099","493","-8.44","161.86","128.09","140.16","258.02","69.41","4592","3567","4303","736","198"
"2009","Alberta","48","Total possession of stolen property","5043","3274","413","-15.31","137.07","99.23","111.4","233.99","65.9","3687","2836","3500","664","187"
"2010","Alberta","48","Total possession of stolen property","4665","2898","391","-8.82","124.98","87.22","96.84","196","55.39","3289","2532","3084","552","156"
"2011","Alberta","48","Total possession of stolen property","3519","2386","319","-25.71","92.84","68.07","75.89","157.89","40.89","2705","2008","2452","444","115"
"2012","Alberta","48","Total possession of stolen property","3790","2413","330","5.19","97.66","66.72","74.37","157.08","44.98","2743","2019","2459","440","126"
"2013","Alberta","48","Total possession of stolen property","4515","2839","350","15.68","112.97","74.21","82.01","169.2","44.71","3189","2318","2791","473","125"
"2014","Alberta","48","Total possession of stolen property","5294","3039","333","14.07","128.86","74.92","78.44","119.1","33.36","3372","2410","2742","332","93"
"2015","Alberta","48","Total possession of stolen property","7477","4072","404","38.82","178.89","101.05","102.7","121.96","30.4","4476","3305","3646","341","85"
"2016","Alberta","48","Total possession of stolen property","7828","4090","382","2.89","184.06","100.86","99.12","78.8","26.5","4472","3352","3575","223","75"
"2005","Alberta","48","Total trafficking in stolen property","0","0","0","0","0","0","0","0","0","0","0","0","0","0"
"2006","Alberta","48","Total trafficking in stolen property","0","0","0","0","0","0","0","0","0","0","0","0","0","0"
"2007","Alberta","48","Total trafficking in stolen property","0","0","0","0","0","0","0","0","0","0","0","0","0","0"
"2008","Alberta","48","Total trafficking in stolen property","0","0","0","0","0","0","0","0","0","0","0","0","0","0"
"2009","Alberta","48","Total trafficking in stolen property","0","0","0","0","0","0","0","0","0","0","0","0","0","0"
"2010","Alberta","48","Total trafficking in stolen property","0","0","0","0","0","0","0","0","0","0","0","0","0","0"
"2011","Alberta","48","Total trafficking in stolen property","27","20","0","0","0.71","0.85","0.84","0.71","0","20","25","27","2","0"
"2012","Alberta","48","Total trafficking in stolen property","66","58","2","138.74","1.7","1.12","1.42","4.64","0.36","60","34","47","13","1"
"2013","Alberta","48","Total trafficking in stolen property","130","87","5","91.26","3.25","1.89","2.15","5.01","0.36","92","59","73","14","1"
"2014","Alberta","48","Total trafficking in stolen property","179","143","7","33.95","4.36","3.57","3.78","6.1","0.72","150","115","132","17","2"
"2015","Alberta","48","Total trafficking in stolen property","239","165","4","31.24","5.72","4.49","4.51","4.65","0","169","147","160","13","0"
"2016","Alberta","48","Total trafficking in stolen property","294","213","14","20.89","6.91","6.14","5.85","2.47","0.35","227","204","211","7","1"
"1998","Alberta","48","Total theft of motor vehicle","15526","1777","1129","0","535.48","52.46","81.43","319.29","82.12","2906","1122","1954","832","214"
"1999","Alberta","48","Total theft of motor vehicle","14847","1613","1108","-6.12","502.73","49.71","77.55","308.42","66.6","2721","1089","1904","815","176"
"2000","Alberta","48","Total theft of motor vehicle","14916","1701","979","-1.26","496.38","51.44","78.25","303.14","116.02","2680","1153","1963","810","310"
"2001","Alberta","48","Total theft of motor vehicle","17467","1921","1070","15.07","571.19","59.27","90.79","358.06","158.15","2991","1360","2329","969","428"
"2002","Alberta","48","Total theft of motor vehicle","17975","1868","1053","0.59","574.58","59.34","85.69","310.34","135.48","2921","1400","2259","859","375"
"2003","Alberta","48","Total theft of motor vehicle","20930","1893","1164","14.43","657.47","62.91","84.17","267.59","121.27","3057","1518","2266","748","339"
"2004","Alberta","48","Total theft of motor vehicle","20739","1573","1002","-2.63","640.2","54.6","68.92","194.63","108.88","2575","1347","1894","547","306"
"2005","Alberta","48","Total theft of motor vehicle","21025","1326","1093","-1.15","632.86","38.92","50.83","157.55","112.08","2419","989","1436","447","318"
"2006","Alberta","48","Total theft of motor vehicle","24478","1519","1616","13.05","715.45","38.94","51.41","165.45","134.45","3135","1023","1498","475","386"
"2007","Alberta","48","Total theft of motor vehicle","23322","1307","1732","-7.24","663.68","27.67","35.72","111.87","126.16","3039","750","1071","321","362"
"2008","Alberta","48","Total theft of motor vehicle","22186","1150","1785","-7.03","617.01","25.28","31.47","91.85","123.4","2935","704","966","262","352"
"2009","Alberta","48","Total theft of motor vehicle","18309","1138","1396","-19.34","497.65","24.21","29.89","87.04","107.13","2534","692","939","247","304"
"2010","Alberta","48","Total theft of motor vehicle","15303","995","1230","-17.62","409.99","22.08","27.66","85.22","96.58","2225","641","881","240","272"
"2011","Alberta","48","Total theft of motor vehicle","13558","1035","1180","-12.75","357.71","24.41","30.11","89.97","92.81","2215","720","973","253","261"
"2012","Alberta","48","Total theft of motor vehicle","13850","1144","1248","-0.23","356.89","24.52","30.06","89.96","92.82","2392","742","994","252","260"
"2013","Alberta","48","Total theft of motor vehicle","15841","1105","1187","11.06","396.36","24.68","30.97","101.23","71.9","2292","771","1054","283","201"
"2014","Alberta","48","Total theft of motor vehicle","16648","1151","1157","2.24","405.23","25.83","30.58","85.38","89.32","2308","831","1069","238","249"
"2015","Alberta","48","Total theft of motor vehicle","22457","1209","1119","32.59","537.29","25.68","29.41","72.96","74.39","2328","840","1044","204","208"
"2016","Alberta","48","Total theft of motor vehicle","22801","1147","1119","-0.22","536.13","26.33","27.89","46.29","59.37","2266","875","1006","131","168"
"1998","Alberta","48","Total theft over $5,000 (non-motor vehicle)","2372","349","193","0","81.81","13.6","14.96","26.1","14.2","542","291","359","68","37"
"1999","Alberta","48","Total theft over $5,000 (non-motor vehicle)","2533","343","207","4.84","85.77","12.69","14.13","26.11","9.08","550","278","347","69","24"
"2000","Alberta","48","Total theft over $5,000 (non-motor vehicle)","1847","342","142","-28.34","61.47","12.49","12.96","16.84","6.74","484","280","325","45","18"
"2001","Alberta","48","Total theft over $5,000 (non-motor vehicle)","1781","286","90","-5.25","58.24","12.38","12.36","12.19","7.02","376","284","317","33","19"
"2002","Alberta","48","Total theft over $5,000 (non-motor vehicle)","1881","274","111","3.24","60.13","11.15","10.7","6.86","4.34","385","263","282","19","12"
"2003","Alberta","48","Total theft over $5,000 (non-motor vehicle)","1990","308","86","3.97","62.51","12.89","12.52","9.3","3.94","394","311","337","26","11"
"2004","Alberta","48","Total theft over $5,000 (non-motor vehicle)","1886","248","90","-6.87","58.22","10.38","10.01","6.76","4.63","338","256","275","19","13"
"2005","Alberta","48","Total theft over $5,000 (non-motor vehicle)","2291","267","115","18.45","68.96","10.47","10.83","14.1","10.93","382","266","306","40","31"
"2006","Alberta","48","Total theft over $5,000 (non-motor vehicle)","2214","235","116","-6.16","64.71","9.06","8.65","4.88","6.97","351","238","252","14","20"
"2007","Alberta","48","Total theft over $5,000 (non-motor vehicle)","2455","230","97","7.96","69.86","7.75","7.74","7.67","4.18","327","210","232","22","12"
"2008","Alberta","48","Total theft over $5,000 (non-motor vehicle)","2555","213","122","1.71","71.06","6.89","7.07","8.76","8.06","335","192","217","25","23"
"2009","Alberta","48","Total theft over $5,000 (non-motor vehicle)","2300","219","110","-12.02","62.52","6.33","6.46","7.75","6.34","329","181","203","22","18"
"2010","Alberta","48","Total theft over $5,000 (non-motor vehicle)","2117","228","130","-9.28","56.72","6.72","6.59","5.33","6.04","358","195","210","15","17"
"2011","Alberta","48","Total theft over $5,000 (non-motor vehicle)","1981","173","92","-7.85","52.27","5.25","5.51","8.18","3.91","265","155","178","23","11"
"2012","Alberta","48","Total theft over $5,000 (non-motor vehicle)","2299","219","152","13.34","59.24","6.58","6.81","9.28","8.93","371","199","225","26","25"
"2013","Alberta","48","Total theft over $5,000 (non-motor vehicle)","2295","220","94","-3.07","57.42","6.37","6.55","8.59","2.86","314","199","223","24","8"
"2014","Alberta","48","Total theft over $5,000 (non-motor vehicle)","2463","203","113","4.4","59.95","5.69","5.72","6.1","8.61","316","183","200","17","24"
"2015","Alberta","48","Total theft over $5,000 (non-motor vehicle)","3149","228","96","25.67","75.34","6.54","6.62","7.51","2.15","324","214","235","21","6"
"2016","Alberta","48","Total theft over $5,000 (non-motor vehicle)","3245","239","72","1.27","76.3","6.74","6.57","4.59","0.71","311","224","237","13","2"
"1998","Alberta","48","Theft over $5,000","1516","265","126","0","52.29","10.99","11.25","13.43","6.52","391","235","270","35","17"
"1999","Alberta","48","Theft over $5,000","1671","267","143","8.22","56.58","10.59","11.32","17.41","2.27","410","232","278","46","6"
"2000","Alberta","48","Theft over $5,000","1309","272","118","-23.01","43.56","10.17","10.21","10.48","4.49","390","228","256","28","12"
"2001","Alberta","48","Theft over $5,000","1280","243","78","-3.91","41.86","10.68","10.53","9.24","4.06","321","245","270","25","11"
"2002","Alberta","48","Theft over $5,000","1324","220","94","1.11","42.32","9.54","8.91","3.61","3.25","314","225","235","10","9"
"2003","Alberta","48","Theft over $5,000","1476","250","71","9.55","46.37","10.9","10.36","5.72","2.5","321","263","279","16","7"
"2004","Alberta","48","Theft over $5,000","1356","218","83","-9.72","41.86","9.12","8.59","3.91","4.27","301","225","236","11","12"
"2005","Alberta","48","Theft over $5,000","1840","243","108","32.31","55.38","9.6","9.7","10.57","10.93","351","244","274","30","31"
"2006","Alberta","48","Theft over $5,000","1528","214","107","-19.36","44.66","8.11","7.79","4.88","5.57","321","213","227","14","16"
"2007","Alberta","48","Theft over $5,000","1701","214","91","8.39","48.41","7.38","7.34","6.97","3.83","305","200","220","20","11"
"2008","Alberta","48","Theft over $5,000","1811","199","110","4.05","50.36","6.57","6.51","5.96","6.66","309","183","200","17","19"
"2009","Alberta","48","Theft over $5,000","1650","203","101","-10.95","44.85","5.84","5.79","5.29","4.23","304","167","182","15","12"
"2010","Alberta","48","Theft over $5,000","1552","208","115","-7.29","41.58","6.17","6","4.26","3.91","323","179","191","12","11"
"2011","Alberta","48","Theft over $5,000","1498","156","84","-4.95","39.52","4.64","4.86","7.11","2.49","240","137","157","20","7"
"2012","Alberta","48","Theft over $5,000","1752","194","134","14.23","45.15","5.75","6.02","8.93","6.07","328","174","199","25","17"
"2013","Alberta","48","Theft over $5,000","1704","202","80","-5.56","42.64","5.95","6.14","8.23","1.79","282","186","209","23","5"
"2014","Alberta","48","Theft over $5,000","1808","177","103","3.22","44.01","5.04","4.95","3.95","7.53","280","162","173","11","21"
"2015","Alberta","48","Theft over $5,000","2404","189","86","30.69","57.52","5.2","5.18","5.01","1.79","275","170","184","14","5"
"2016","Alberta","48","Theft over $5,000","2297","195","64","-6.1","54.01","5.48","5.27","2.83","0.71","259","182","190","8","2"
"1998","Alberta","48","Theft over $5,000 from a motor vehicle","742","43","26","0","25.59","1.26","2.04","8.44","3.45","69","27","49","22","9"
"1999","Alberta","48","Theft over $5,000 from a motor vehicle","761","39","37","0.69","25.77","0.64","1.14","5.3","2.27","76","14","28","14","6"
"2000","Alberta","48","Theft over $5,000 from a motor vehicle","493","53","11","-36.33","16.41","1.78","1.99","3.74","0.75","64","40","50","10","2"
"2001","Alberta","48","Theft over $5,000 from a motor vehicle","466","28","10","-7.12","15.24","1.05","1.13","1.85","1.85","38","24","29","5","5"
"2002","Alberta","48","Theft over $5,000 from a motor vehicle","531","45","13","11.39","16.97","1.31","1.44","2.53","0","58","31","38","7","0"
"2003","Alberta","48","Theft over $5,000 from a motor vehicle","486","47","13","-10.06","15.27","1.41","1.6","3.22","0.72","60","34","43","9","2"
"2004","Alberta","48","Theft over $5,000 from a motor vehicle","498","18","4","0.7","15.37","0.65","0.84","2.49","0","22","16","23","7","0"
"2005","Alberta","48","Theft over $5,000 from a motor vehicle","421","16","4","-17.57","12.67","0.43","0.64","2.47","0","20","11","18","7","0"
"2006","Alberta","48","Theft over $5,000 from a motor vehicle","644","13","4","48.54","18.82","0.49","0.45","0","0","17","13","13","0","0"
"2007","Alberta","48","Theft over $5,000 from a motor vehicle","712","7","0","7.64","20.26","0.11","0.17","0.7","0","7","3","5","2","0"
"2008","Alberta","48","Theft over $5,000 from a motor vehicle","704","9","5","-3.37","19.58","0.14","0.29","1.75","0","14","4","9","5","0"
"2009","Alberta","48","Theft over $5,000 from a motor vehicle","599","5","5","-16.84","16.28","0.07","0.13","0.7","2.11","10","2","4","2","6"
"2010","Alberta","48","Theft over $5,000 from a motor vehicle","520","12","4","-14.43","13.93","0.28","0.31","0.71","0","16","8","10","2","0"
"2011","Alberta","48","Theft over $5,000 from a motor vehicle","434","3","2","-17.81","11.45","0.07","0.06","0","0","5","2","2","0","0"
"2012","Alberta","48","Theft over $5,000 from a motor vehicle","482","10","7","8.47","12.42","0.36","0.36","0.36","0.36","17","11","12","1","1"
"2013","Alberta","48","Theft over $5,000 from a motor vehicle","534","5","3","7.58","13.36","0.1","0.12","0.36","0","8","3","4","1","0"
"2014","Alberta","48","Theft over $5,000 from a motor vehicle","590","9","6","7.48","14.36","0.25","0.29","0.72","0","15","8","10","2","0"
"2015","Alberta","48","Theft over $5,000 from a motor vehicle","666","12","7","10.95","15.93","0.34","0.39","1.07","0.36","19","11","14","3","1"
"2016","Alberta","48","Theft over $5,000 from a motor vehicle","856","10","2","26.32","20.13","0.27","0.3","0.71","0","12","9","11","2","0"
"1998","Alberta","48","Shoplifting over $5,000","114","41","41","0","3.93","1.36","1.67","4.22","4.22","82","29","40","11","11"
"1999","Alberta","48","Shoplifting over $5,000","101","37","27","-13.02","3.42","1.46","1.67","3.41","4.54","64","32","41","9","12"
"2000","Alberta","48","Shoplifting over $5,000","45","17","13","-56.21","1.5","0.54","0.76","2.62","1.5","30","12","19","7","4"
"2001","Alberta","48","Shoplifting over $5,000","35","15","2","-23.57","1.14","0.65","0.7","1.11","1.11","17","15","18","3","3"
"2002","Alberta","48","Shoplifting over $5,000","26","9","4","-27.38","0.83","0.3","0.34","0.72","1.08","13","7","9","2","3"
"2003","Alberta","48","Shoplifting over $5,000","28","11","2","5.83","0.88","0.58","0.56","0.36","0.72","13","14","15","1","2"
"2004","Alberta","48","Shoplifting over $5,000","32","12","3","12.31","0.99","0.61","0.58","0.36","0.36","15","15","16","1","1"
"2005","Alberta","48","Shoplifting over $5,000","30","8","3","-8.58","0.9","0.43","0.5","1.06","0","11","11","14","3","0"
"2006","Alberta","48","Shoplifting over $5,000","42","8","5","35.94","1.23","0.46","0.41","0","1.39","13","12","12","0","4"
"2007","Alberta","48","Shoplifting over $5,000","42","9","6","-2.64","1.2","0.26","0.23","0","0.35","15","7","7","0","1"
"2008","Alberta","48","Shoplifting over $5,000","40","5","7","-6.93","1.11","0.18","0.26","1.05","1.4","12","5","8","3","4"
"2009","Alberta","48","Shoplifting over $5,000","51","11","4","24.61","1.39","0.42","0.54","1.76","0","15","12","17","5","0"
"2010","Alberta","48","Shoplifting over $5,000","45","8","11","-13.03","1.21","0.28","0.28","0.36","2.13","19","8","9","1","6"
"2011","Alberta","48","Shoplifting over $5,000","49","14","6","7.23","1.29","0.54","0.59","1.07","1.42","20","16","19","3","4"
"2012","Alberta","48","Shoplifting over $5,000","65","15","11","29.56","1.67","0.46","0.42","0","2.5","26","14","14","0","7"
"2013","Alberta","48","Shoplifting over $5,000","57","13","11","-14.85","1.43","0.32","0.29","0","1.07","24","10","10","0","3"
"2014","Alberta","48","Shoplifting over $5,000","65","17","4","10.94","1.58","0.4","0.49","1.43","1.08","21","13","17","4","3"
"2015","Alberta","48","Shoplifting over $5,000","79","27","3","19.46","1.89","1.01","1.04","1.43","0","30","33","37","4","0"
"2016","Alberta","48","Shoplifting over $5,000","92","34","6","14.45","2.16","0.99","1","1.06","0","40","33","36","3","0"
"2015","Alberta","48","Shoplifting $5,000 or under","14215","6478","2327","17.08","340.1","174.68","177.74","213.51","443.47","8805","5713","6310","597","1240"
"2016","Alberta","48","Shoplifting $5,000 or under","16580","6939","2637","14.63","389.85","182.27","184.55","211.31","426.16","9576","6058","6656","598","1206"
"1998","Alberta","48","Shoplifting $5,000 or under","11657","6218","3859","0","402.04","234.79","277.93","632.05","1102.15","10077","5022","6669","1647","2872"
"1999","Alberta","48","Shoplifting $5,000 or under","12287","6449","4060","3.48","416.05","239.91","283.38","643.7","1198.47","10509","5256","6957","1701","3167"
"2000","Alberta","48","Shoplifting $5,000 or under","11694","6051","3996","-6.46","389.16","213.53","254.85","601.41","1168.01","10047","4786","6393","1607","3121"
"2001","Alberta","48","Shoplifting $5,000 or under","10996","5838","3443","-7.6","359.58","209.85","243.42","528.03","1019.48","9281","4815","6244","1429","2759"
"2002","Alberta","48","Shoplifting $5,000 or under","12291","6573","3540","9.26","392.89","231.11","268.9","591.05","1087.44","10113","5453","7089","1636","3010"
"2003","Alberta","48","Shoplifting $5,000 or under","12968","6583","3943","3.68","407.36","237.19","257.92","436.8","1177.33","10526","5723","6944","1221","3291"
"2004","Alberta","48","Shoplifting $5,000 or under","13208","6950","3613","0.09","407.72","253.62","265.67","371.48","1050.03","10563","6257","7301","1044","2951"
"2005","Alberta","48","Shoplifting $5,000 or under","11207","6213","2633","-17.26","337.34","217.97","233.39","371.49","785.26","8846","5539","6593","1054","2228"
"2006","Alberta","48","Shoplifting $5,000 or under","9766","5668","1870","-15.38","285.44","189.16","204.94","349.36","582.73","7538","4969","5972","1003","1673"
"2007","Alberta","48","Shoplifting $5,000 or under","9081","4995","2160","-9.47","258.42","155","180.23","418.56","641.26","7155","4202","5403","1201","1840"
"2008","Alberta","48","Shoplifting $5,000 or under","11125","6092","2683","19.72","309.39","192.47","216.12","446.97","659.42","8775","5360","6635","1275","1881"
"2009","Alberta","48","Shoplifting $5,000 or under","13650","7392","3208","19.92","371.02","232.46","258.19","517.32","734.05","10600","6644","8112","1468","2083"
"2010","Alberta","48","Shoplifting $5,000 or under","12584","6718","3194","-9.13","337.14","209.38","227.63","415.78","709.42","9912","6078","7249","1171","1998"
"2011","Alberta","48","Shoplifting $5,000 or under","11369","5917","2747","-11.03","299.96","183.1","198.82","363.78","577.85","8664","5401","6424","1023","1625"
"2012","Alberta","48","Shoplifting $5,000 or under","10740","5501","2314","-7.74","276.75","168.33","178.24","285.24","463.74","7815","5094","5893","799","1299"
"2013","Alberta","48","Shoplifting $5,000 or under","10649","5407","2069","-3.72","266.45","161.96","170.22","262.56","389.19","7476","5059","5793","734","1088"
"2014","Alberta","48","Shoplifting $5,000 or under","11934","5829","2191","9.02","290.49","163.02","165.29","191.56","368.78","8020","5244","5778","534","1028"
"1998","Alberta","48","Fraud","14270","6608","2203","0","492.16","163.3","161.07","142.76","83.66","8811","3493","3865","372","218"
"1999","Alberta","48","Fraud","13223","6246","2203","-9.03","447.74","169.34","167.94","156.29","88.93","8449","3710","4123","413","235"
"2000","Alberta","48","Fraud","11800","5509","1637","-12.3","392.69","154.5","154.19","151.57","71.85","7146","3463","3868","405","192"
"2001","Alberta","48","Fraud","11782","5235","1478","-1.89","385.28","142.3","139.64","117.14","78.34","6713","3265","3582","317","212"
"2002","Alberta","48","Fraud","13202","5108","1416","9.53","422.01","142.83","139.97","115.61","63.95","6524","3370","3690","320","177"
"2003","Alberta","48","Fraud","13905","5597","1684","3.5","436.8","146.39","140.1","85.86","84.07","7281","3532","3772","240","235"
"2004","Alberta","48","Fraud","14266","5002","1464","0.82","440.38","145.15","138.79","82.91","80.42","6466","3581","3814","233","226"
"2005","Alberta","48","Fraud","13869","4956","1355","-5.2","417.46","140.69","132.96","63.79","58.15","6311","3575","3756","181","165"
"2006","Alberta","48","Fraud","11950","4288","1383","-16.33","349.28","118.58","111.98","51.55","63.74","5671","3115","3263","148","183"
"2007","Alberta","48","Fraud","12729","3968","1420","3.71","362.23","111.66","107.61","69.35","65.17","5388","3027","3226","199","187"
"2008","Alberta","48","Fraud","12607","3858","1319","-3.21","350.61","108.19","104.95","73.27","61.7","5177","3013","3222","209","176"
"2009","Alberta","48","Fraud","12676","3845","1437","-1.73","344.54","103.74","99.59","57.79","62.73","5282","2965","3129","164","178"
"2010","Alberta","48","Fraud","11943","3591","1219","-7.13","319.97","93.56","88.62","37.64","45.8","4810","2716","2822","106","129"
"2011","Alberta","48","Fraud","10513","3128","1198","-13.31","277.37","82.89","78.86","36.63","39.12","4326","2445","2548","103","110"
"2012","Alberta","48","Fraud","10693","2987","1045","-0.66","275.54","73.89","70.29","31.42","37.84","4032","2236","2324","88","106"
"2013","Alberta","48","Fraud","12153","3084","1070","10.36","304.08","78.46","74.16","26.11","27.19","4154","2451","2524","73","76"
"2014","Alberta","48","Fraud","13354","3413","928","6.9","325.05","84.71","79.99","25.47","29.77","4341","2725","2796","71","83"
"2015","Alberta","48","Fraud","16186","3850","1101","19.14","387.26","96.53","90.87","24.68","31.11","4951","3157","3226","69","87"
"2016","Alberta","48","Fraud","18211","4320","926","10.57","428.2","113.64","107.03","29.33","22.26","5246","3777","3860","83","63"
"2005","Alberta","48","Identity theft","0","0","0","0","0","0","0","0","0","0","0","0","0","0"
"2006","Alberta","48","Identity theft","0","0","0","0","0","0","0","0","0","0","0","0","0","0"
"2007","Alberta","48","Identity theft","0","0","0","0","0","0","0","0","0","0","0","0","0","0"
"2008","Alberta","48","Identity theft","0","0","0","0","0","0","0","0","0","0","0","0","0","0"
"2009","Alberta","48","Identity theft","0","0","0","0","0","0","0","0","0","0","0","0","0","0"
"2010","Alberta","48","Identity theft","120","14","8","0","3.21","0.24","0.25","0.36","0.36","22","7","8","1","1"
"2011","Alberta","48","Identity theft","193","33","11","58.39","5.09","0.14","0.15","0.36","1.07","44","4","5","1","3"
"2012","Alberta","48","Identity theft","335","78","11","69.52","8.63","1.09","1.03","0.36","1.07","89","33","34","1","3"
"2013","Alberta","48","Identity theft","361","53","14","4.64","9.03","0.99","1.03","1.43","1.79","67","31","35","4","5"
"2014","Alberta","48","Identity theft","432","108","13","16.42","10.52","2.14","2.09","1.43","1.43","121","69","73","4","4"
"2015","Alberta","48","Identity theft","448","127","11","1.93","10.72","2.75","2.76","2.86","0","138","90","98","8","0"
"2016","Alberta","48","Identity theft","555","199","5","21.75","13.05","4.39","4.21","2.12","0","204","146","152","6","0"
"2005","Alberta","48","Identity fraud","0","0","0","0","0","0","0","0","0","0","0","0","0","0"
"2006","Alberta","48","Identity fraud","0","0","0","0","0","0","0","0","0","0","0","0","0","0"
"2007","Alberta","48","Identity fraud","0","0","0","0","0","0","0","0","0","0","0","0","0","0"
"2008","Alberta","48","Identity fraud","21","13","1","0","0.58","0","0","0","0","14","0","0","0","0"
"2009","Alberta","48","Identity fraud","54","21","7","151.32","1.47","0","0","0","0","28","0","0","0","0"
"2010","Alberta","48","Identity fraud","601","262","28","997.02","16.1","6.51","6.47","6.04","2.13","290","189","206","17","6"
"2011","Alberta","48","Identity fraud","799","390","43","30.92","21.08","10.24","9.9","6.4","4.27","433","302","320","18","12"
"2012","Alberta","48","Identity fraud","1014","504","39","23.95","26.13","13.75","13.43","10","1.43","543","416","444","28","4"
"2013","Alberta","48","Identity fraud","1167","509","61","11.75","29.2","14.89","14.28","7.51","1.79","570","465","486","21","5"
"2014","Alberta","48","Identity fraud","1358","646","39","13.2","33.06","18","17.28","8.97","0.72","685","579","604","25","2"
"2015","Alberta","48","Identity fraud","1644","735","50","18.99","39.33","21.01","19.97","7.87","3.22","785","687","709","22","9"
"2016","Alberta","48","Identity fraud","2136","748","50","27.69","50.22","20.49","19.71","10.6","1.41","798","681","711","30","4"
"1998","Alberta","48","Total mischief","38905","3721","4099","0","1341.81","91.31","122.48","378.39","487.76","7820","1953","2939","986","1271"
"1999","Alberta","48","Total mischief","37999","3381","4152","-4.11","1286.68","90.33","118.21","349.29","486.65","7533","1979","2902","923","1286"
"2000","Alberta","48","Total mischief","40524","3461","4550","4.81","1348.58","91.64","123.22","388.09","742.5","8011","2054","3091","1037","1984"
"2001","Alberta","48","Total mischief","43735","3288","5222","6.05","1430.18","92.39","122.68","379.49","933.02","8510","2120","3147","1027","2525"
"2002","Alberta","48","Total mischief","44176","3389","5414","-1.26","1412.11","91.59","124.8","407.88","1059.99","8803","2161","3290","1129","2934"
"2003","Alberta","48","Total mischief","48670","2947","6545","8.27","1528.87","85.5","108.53","307.3","1095.77","9492","2063","2922","859","3063"
"2004","Alberta","48","Total mischief","51478","3288","7643","3.94","1589.09","84.55","107.71","310.99","1083.83","10931","2086","2960","874","3046"
"2005","Alberta","48","Total mischief","55250","3332","9229","4.65","1663.05","86.18","110.52","328.49","1088.37","12561","2190","3122","932","3088"
"2006","Alberta","48","Total mischief","59834","3694","12359","5.16","1748.84","92.35","115.41","326.37","1338.56","16053","2426","3363","937","3843"
"2007","Alberta","48","Total mischief","62095","3767","14062","1.04","1767.06","98.6","123.22","355.83","1249.41","17829","2673","3694","1021","3585"
"2008","Alberta","48","Total mischief","61814","3642","15916","-2.72","1719.08","95.73","120.16","358.63","1308.67","19558","2666","3689","1023","3733"
"2009","Alberta","48","Total mischief","59152","3588","15706","-6.47","1607.79","95.83","115.28","311.17","1167.86","19294","2739","3622","883","3314"
"2010","Alberta","48","Total mischief","55810","3530","14891","-7","1495.22","89.15","105.6","275.17","1139.05","18421","2588","3363","775","3208"
"2011","Alberta","48","Total mischief","52397","3878","14004","-7.54","1382.44","88.89","104.77","271.32","964.04","17882","2622","3385","763","2711"
"2012","Alberta","48","Total mischief","50930","3777","13113","-5.07","1312.37","89.88","102.35","237.05","928.2","16890","2720","3384","664","2600"
"2013","Alberta","48","Total mischief","49392","3497","13200","-5.83","1235.84","86.34","94.56","186.37","746.19","16697","2697","3218","521","2086"
"2014","Alberta","48","Total mischief","49174","3893","12836","-3.15","1196.95","80.08","86.57","161.43","618.46","16729","2576","3026","450","1724"
"2015","Alberta","48","Total mischief","52457","3481","12697","4.85","1255.05","79.68","84.87","145.56","602.98","16178","2606","3013","407","1686"
"2016","Alberta","48","Total mischief","47330","2963","11168","-11.33","1112.89","67.31","69.98","101.42","494.01","14131","2237","2524","287","1398"
"1998","Alberta","48","Total theft under $5,000 (non-motor vehicle)","77946","10556","7967","0","2688.3","356.11","441.13","1138.99","1476.32","18523","7617","10585","2968","3847"
"1999","Alberta","48","Total theft under $5,000 (non-motor vehicle)","77410","10094","8381","-2.5","2621.18","341.02","416.45","1041.8","1568.95","18475","7471","10224","2753","4146"
"2000","Alberta","48","Total theft under $5,000 (non-motor vehicle)","73879","9687","7361","-6.2","2458.58","311.55","386.79","1017.94","1637.69","17048","6983","9703","2720","4376"
"2001","Alberta","48","Total theft under $5,000 (non-motor vehicle)","74196","9421","6654","-1.31","2426.28","316.97","383.06","943.36","1599.62","16075","7273","9826","2553","4329"
"2002","Alberta","48","Total theft under $5,000 (non-motor vehicle)","80795","10351","7011","6.45","2582.66","342.07","416.31","1049.15","1694.03","17362","8071","10975","2904","4689"
"2003","Alberta","48","Total theft under $5,000 (non-motor vehicle)","89138","10182","7774","8.42","2800.09","348.44","393.19","779.52","1862.05","17956","8407","10586","2179","5205"
"2004","Alberta","48","Total theft under $5,000 (non-motor vehicle)","88215","10581","7153","-2.75","2723.13","361.64","389.54","634.43","1667.02","17734","8922","10705","1783","4685"
"2005","Alberta","48","Total theft under $5,000 (non-motor vehicle)","87115","9798","6249","-3.71","2622.21","322.34","354.71","644.64","1361.88","16047","8191","10020","1829","3864"
"2006","Alberta","48","Total theft under $5,000 (non-motor vehicle)","80648","9225","6155","-10.11","2357.19","287.98","316.24","574.71","1164.06","15380","7565","9215","1650","3342"
"2007","Alberta","48","Total theft under $5,000 (non-motor vehicle)","78873","9001","6660","-4.78","2244.52","266.77","307.35","690.75","1243.84","15661","7232","9214","1982","3569"
"2008","Alberta","48","Total theft under $5,000 (non-motor vehicle)","75088","9342","6790","-6.96","2088.24","277.25","313.64","668.88","1204.55","16132","7721","9629","1908","3436"
"2009","Alberta","48","Total theft under $5,000 (non-motor vehicle)","74064","9981","7109","-3.6","2013.11","296.21","336.04","737.22","1169.62","17090","8466","10558","2092","3319"
"2010","Alberta","48","Total theft under $5,000 (non-motor vehicle)","68514","8875","6617","-8.82","1835.57","263.15","289.84","564.91","1083.3","15492","7639","9230","1591","3051"
"2011","Alberta","48","Total theft under $5,000 (non-motor vehicle)","62818","7996","5763","-9.71","1657.38","235.41","259.7","514.56","877.98","13759","6944","8391","1447","2469"
"2012","Alberta","48","Total theft under $5,000 (non-motor vehicle)","63185","7559","5265","-1.76","1628.16","221.5","239.67","435.9","750.06","12824","6703","7924","1221","2101"
"2013","Alberta","48","Total theft under $5,000 (non-motor vehicle)","65376","7459","4942","0.47","1635.78","213.56","228.31","393.13","668.93","12401","6671","7770","1099","1870"
"2014","Alberta","48","Total theft under $5,000 (non-motor vehicle)","68430","8005","4960","1.83","1665.66","213.75","221.25","307.79","591.91","12965","6876","7734","858","1650"
"2015","Alberta","48","Total theft under $5,000 (non-motor vehicle)","84348","8779","4901","21.16","2018.06","227.85","234.32","310.07","629.45","13680","7452","8319","867","1760"
"2016","Alberta","48","Total theft under $5,000 (non-motor vehicle)","89856","9207","5077","4.7","2112.83","234.84","238.12","276.69","608.15","14284","7805","8588","783","1721"
"1998","Alberta","48","Theft $5,000 or under","35158","3114","3431","0","1212.57","87.38","114.69","338.86","299.33","6545","1869","2752","883","780"
"1999","Alberta","48","Theft $5,000 or under","33308","2807","3751","-6.99","1127.84","80.84","101.38","271.71","308.42","6558","1771","2489","718","815"
"2000","Alberta","48","Theft $5,000 or under","32606","2831","2888","-3.79","1085.08","79.37","100.97","282.18","382.1","5719","1779","2533","754","1021"
"2001","Alberta","48","Theft $5,000 or under","32616","2771","2757","-1.71","1066.57","86.47","107.99","290.44","460.41","5528","1984","2770","786","1246"
"2002","Alberta","48","Theft $5,000 or under","35021","2888","2940","4.96","1119.47","87.35","110.65","309.25","491.7","5828","2061","2917","856","1361"
"2003","Alberta","48","Theft $5,000 or under","38661","2626","3192","8.49","1214.46","87.24","101.51","224.66","538.05","5818","2105","2733","628","1504"
"2004","Alberta","48","Theft $5,000 or under","38143","2833","3015","-3.05","1177.45","89.21","98.9","183.96","473.95","5848","2201","2718","517","1332"
"2005","Alberta","48","Theft $5,000 or under","44601","3052","3386","14.02","1342.51","93.97","106.73","220.99","531.15","6438","2388","3015","627","1507"
"2006","Alberta","48","Theft $5,000 or under","35688","3089","4015","-22.3","1043.09","92.85","103.26","198.54","546.85","7104","2439","3009","570","1570"
"2007","Alberta","48","Theft $5,000 or under","35880","3661","4066","-2.11","1021.05","108.52","122.35","253.02","559.36","7727","2942","3668","726","1605"
"2008","Alberta","48","Theft $5,000 or under","32010","2947","3850","-12.81","890.22","81.05","92.38","202.98","493.95","6797","2257","2836","579","1409"
"2009","Alberta","48","Theft $5,000 or under","29403","2278","3584","-10.22","799.19","60.18","71.55","186.07","393.98","5862","1720","2248","528","1118"
"2010","Alberta","48","Theft $5,000 or under","27094","1855","3156","-9.17","725.88","49.85","55.9","118.24","324.17","5011","1447","1780","333","913"
"2011","Alberta","48","Theft $5,000 or under","25676","1784","2784","-6.67","677.43","47.94","53.7","114.15","243.59","4568","1414","1735","321","685"
"2012","Alberta","48","Theft $5,000 or under","26352","1827","2748","0.24","679.04","48.25","54.29","119.6","256.68","4575","1460","1795","335","719"
"2013","Alberta","48","Theft $5,000 or under","28147","1835","2658","3.72","704.27","47.44","51.92","101.95","237.88","4493","1482","1767","285","665"
"2014","Alberta","48","Theft $5,000 or under","29505","1904","2525","1.98","718.18","46.13","49.61","89.68","194.07","4429","1484","1734","250","541"
"2015","Alberta","48","Theft $5,000 or under","34364","2032","2350","14.48","822.17","49.07","51.15","75.46","163.08","4382","1605","1816","211","456"
"2016","Alberta","48","Theft $5,000 or under","33970","1995","2227","-2.85","798.75","48.2","48.25","48.76","159.72","4222","1602","1740","138","452"
"1998","Alberta","48","Theft $5,000 or under from a motor vehicle","31131","1224","677","0","1073.69","33.94","48.51","168.09","74.83","1901","726","1164","438","195"
"1999","Alberta","48","Theft $5,000 or under from a motor vehicle","31815","838","570","0.34","1077.29","20.27","31.69","126.39","62.06","1408","444","778","334","164"
"2000","Alberta","48","Theft $5,000 or under from a motor vehicle","29579","805","477","-8.63","984.35","18.65","30.97","134.35","87.57","1282","418","777","359","234"
"2001","Alberta","48","Theft $5,000 or under from a motor vehicle","30584","812","454","1.6","1000.13","20.66","31.66","124.9","119.72","1266","474","812","338","324"
"2002","Alberta","48","Theft $5,000 or under from a motor vehicle","33483","890","531","7.02","1070.3","23.61","36.76","148.85","114.89","1421","557","969","412","318"
"2003","Alberta","48","Theft $5,000 or under from a motor vehicle","37509","973","639","10.09","1178.27","24","33.76","118.06","146.67","1612","579","909","330","410"
"2004","Alberta","48","Theft $5,000 or under from a motor vehicle","36864","798","525","-3.42","1137.96","18.81","24.96","78.99","143.04","1323","464","686","222","402"
"2005","Alberta","48","Theft $5,000 or under from a motor vehicle","31307","533","230","-17.19","942.36","10.39","14.58","52.16","45.47","763","264","412","148","129"
"2006","Alberta","48","Theft $5,000 or under from a motor vehicle","35194","468","270","9.16","1028.65","5.98","8.03","26.82","34.48","738","157","234","77","99"
"2007","Alberta","48","Theft $5,000 or under from a motor vehicle","33912","345","434","-6.18","965.05","3.25","4.77","19.17","43.22","779","88","143","55","124"
"2008","Alberta","48","Theft $5,000 or under from a motor vehicle","31953","303","257","-7.92","888.63","3.73","5.15","18.93","51.18","560","104","158","54","146"
"2009","Alberta","48","Theft $5,000 or under from a motor vehicle","31011","311","317","-5.15","842.9","3.57","6.3","33.83","41.58","628","102","198","96","118"
"2010","Alberta","48","Theft $5,000 or under from a motor vehicle","28836","302","267","-8.35","772.55","3.93","6.31","30.89","49.71","569","114","201","87","140"
"2011","Alberta","48","Theft $5,000 or under from a motor vehicle","25773","295","232","-11.98","679.99","4.37","7.18","36.63","56.54","527","129","232","103","159"
"2012","Alberta","48","Theft $5,000 or under from a motor vehicle","26093","231","203","-1.12","672.37","4.92","7.14","31.06","29.63","434","149","236","87","83"
"2013","Alberta","48","Theft $5,000 or under from a motor vehicle","26580","217","215","-1.09","665.06","4.16","6.17","28.62","41.85","432","130","210","80","117"
"2014","Alberta","48","Theft $5,000 or under from a motor vehicle","26991","272","244","-1.21","656.99","4.6","6.35","26.55","29.06","516","148","222","74","81"
"2015","Alberta","48","Theft $5,000 or under from a motor vehicle","35769","269","224","30.26","855.79","4.1","5.44","21.1","22.89","493","134","193","59","64"
"2016","Alberta","48","Theft $5,000 or under from a motor vehicle","39306","273","213","8","924.22","4.36","5.32","16.61","22.26","486","145","192","47","63"
"1998","Alberta","48","Mischief","38905","3721","4099","0","1341.81","91.31","122.48","378.39","487.76","7820","1953","2939","986","1271"
"1999","Alberta","48","Mischief","37999","3381","4152","-4.11","1286.68","90.33","118.21","349.29","486.65","7533","1979","2902","923","1286"
"2000","Alberta","48","Mischief","40524","3461","4550","4.81","1348.58","91.64","123.22","388.09","742.5","8011","2054","3091","1037","1984"
"2001","Alberta","48","Mischief","43735","3288","5222","6.05","1430.18","92.39","122.68","379.49","933.02","8510","2120","3147","1027","2525"
"2002","Alberta","48","Mischief","44176","3389","5414","-1.26","1412.11","91.59","124.8","407.88","1059.99","8803","2161","3290","1129","2934"
"2003","Alberta","48","Mischief","48670","2947","6545","8.27","1528.87","85.5","108.53","307.3","1095.77","9492","2063","2922","859","3063"
"2004","Alberta","48","Mischief","51478","3288","7643","3.94","1589.09","84.55","107.71","310.99","1083.83","10931","2086","2960","874","3046"
"2005","Alberta","48","Mischief","55250","3332","9229","4.65","1663.05","86.18","110.52","328.49","1088.37","12561","2190","3122","932","3088"
"2006","Alberta","48","Mischief","59834","3694","12359","5.16","1748.84","92.35","115.41","326.37","1338.56","16053","2426","3363","937","3843"
"2007","Alberta","48","Mischief","62095","3767","14062","1.04","1767.06","98.6","123.22","355.83","1249.41","17829","2673","3694","1021","3585"
"2008","Alberta","48","Mischief","61813","3642","15916","-2.72","1719.05","95.73","120.16","358.63","1308.67","19558","2666","3689","1023","3733"
"2009","Alberta","48","Mischief","59144","3587","15706","-6.49","1607.57","95.8","115.25","311.17","1167.86","19293","2738","3621","883","3314"
"2010","Alberta","48","Mischief","55804","3528","14891","-7","1495.05","89.15","105.57","274.82","1139.05","18419","2588","3362","774","3208"
"2011","Alberta","48","Mischief","52396","3877","14004","-7.53","1382.41","88.82","104.7","271.32","964.04","17881","2620","3383","763","2711"
"2012","Alberta","48","Mischief","50926","3777","13113","-5.07","1312.27","89.88","102.35","237.05","928.2","16890","2720","3384","664","2600"
"2013","Alberta","48","Mischief","49388","3497","13199","-5.83","1235.74","86.34","94.56","186.37","745.12","16696","2697","3218","521","2083"
"2014","Alberta","48","Mischief","49164","3893","12836","-3.16","1196.7","80.08","86.57","161.43","618.46","16729","2576","3026","450","1724"
"2015","Alberta","48","Mischief","52440","3480","12695","4.84","1254.65","79.65","84.84","145.56","602.98","16175","2605","3012","407","1686"
"2016","Alberta","48","Mischief","47322","2962","11168","-11.31","1112.71","67.28","69.96","101.42","494.01","14130","2236","2523","287","1398"
"2012","Alberta","48","Mischief in relation to cultural property","0","0","0","0","0","0","0","0","0","0","0","0","0","0"
"2013","Alberta","48","Mischief in relation to cultural property","0","0","0","0","0","0","0","0","0","0","0","0","0","0"
"2014","Alberta","48","Mischief in relation to cultural property","0","0","0","0","0","0","0","0","0","0","0","0","0","0"
"2015","Alberta","48","Mischief in relation to cultural property","7","1","2","0","0.17","0.03","0.03","0","0","3","1","1","0","0"
"2016","Alberta","48","Mischief in relation to cultural property","2","0","0","-71.92","0.05","0","0","0","0","0","0","0","0","0"
"2005","Alberta","48","Mischief to religious property motivated by hate","0","0","0","0","0","0","0","0","0","0","0","0","0","0"
"2006","Alberta","48","Mischief to religious property motivated by hate","0","0","0","0","0","0","0","0","0","0","0","0","0","0"
"2007","Alberta","48","Mischief to religious property motivated by hate","0","0","0","0","0","0","0","0","0","0","0","0","0","0"
"2008","Alberta","48","Mischief to religious property motivated by hate","1","0","0","0","0.03","0","0","0","0","0","0","0","0","0"
"2009","Alberta","48","Mischief to religious property motivated by hate","8","1","0","681.88","0.22","0.03","0.03","0","0","1","1","1","0","0"
"2010","Alberta","48","Mischief to religious property motivated by hate","6","2","0","-26.07","0.16","0","0.03","0.36","0","2","0","1","1","0"
"2011","Alberta","48","Mischief to religious property motivated by hate","1","1","0","-83.59","0.03","0.07","0.06","0","0","1","2","2","0","0"
"2012","Alberta","48","Mischief to religious property motivated by hate","4","0","0","290.67","0.1","0","0","0","0","0","0","0","0","0"
"2013","Alberta","48","Mischief to religious property motivated by hate","4","0","1","-2.9","0.1","0","0","0","1.07","1","0","0","0","3"
"2014","Alberta","48","Mischief to religious property motivated by hate","10","0","0","143.21","0.24","0","0","0","0","0","0","0","0","0"
"2015","Alberta","48","Mischief to religious property motivated by hate","10","0","0","-1.71","0.24","0","0","0","0","0","0","0","0","0"
"2016","Alberta","48","Mischief to religious property motivated by hate","4","1","0","-60.69","0.09","0.03","0.03","0","0","1","1","1","0","0"
"2012","Alberta","48","Mischief relating to war memorials","0","0","0","0","0","0","0","0","0","0","0","0","0","0"
"2013","Alberta","48","Mischief relating to war memorials","0","0","0","0","0","0","0","0","0","0","0","0","0","0"
"2014","Alberta","48","Mischief relating to war memorials","0","0","0","0","0","0","0","0","0","0","0","0","0","0"
"2015","Alberta","48","Mischief relating to war memorials","0","0","0","0","0","0","0","0","0","0","0","0","0","0"
"2016","Alberta","48","Mischief relating to war memorials","2","0","0","0","0.05","0","0","0","0","0","0","0","0","0"
"1998","Alberta","48","Arson","1019","159","130","0","35.14","4.49","6.63","24.18","31.85","289","96","159","63","83"
"1999","Alberta","48","Arson","934","111","110","-10.01","31.63","2.6","4.64","21.57","23.84","221","57","114","57","63"
"2000","Alberta","48","Arson","1001","109","108","5.33","33.31","2.77","5.18","25.45","37.8","217","62","130","68","101"
"2001","Alberta","48","Arson","1300","129","146","27.62","42.51","4.05","6.86","30.67","56.9","275","93","176","83","154"
"2002","Alberta","48","Arson","1135","170","99","-14.66","36.28","3.81","7.66","40.46","41.19","269","90","202","112","114"
"2003","Alberta","48","Arson","1169","107","88","1.22","36.72","2.9","5.01","23.25","36.85","195","70","135","65","103"
"2004","Alberta","48","Arson","1311","85","117","10.21","40.47","2.31","4.44","23.13","49.46","202","57","122","65","139"
"2005","Alberta","48","Arson","1366","87","98","1.6","41.12","2.2","4.28","22.91","40.88","185","56","121","65","116"
"2006","Alberta","48","Arson","1465","111","123","4.14","42.82","2.66","4.87","25.08","42.84","234","70","142","72","123"
"2007","Alberta","48","Arson","1684","92","110","11.92","47.92","1.99","4.14","24.4","39.03","202","54","124","70","112"
"2008","Alberta","48","Arson","1882","121","138","9.22","52.34","2.66","4.43","21.74","42.42","259","74","136","62","121"
"2009","Alberta","48","Arson","1633","91","96","-15.2","44.39","2.06","3.53","18.32","27.84","187","59","111","52","79"
"2010","Alberta","48","Arson","1550","158","104","-6.44","41.53","2.55","5.18","32.31","37.99","262","74","165","91","107"
"2011","Alberta","48","Arson","1244","83","70","-20.96","32.82","1.93","2.66","10.31","25.25","153","57","86","29","71"
"2012","Alberta","48","Arson","1341","94","80","5.28","34.56","1.78","3.36","20.35","20.35","174","54","111","57","57"
"2013","Alberta","48","Arson","1197","104","67","-13.33","29.95","1.92","3.14","16.81","12.88","171","60","107","47","36"
"2014","Alberta","48","Arson","1186","105","56","-3.61","28.87","2.55","3.75","17.58","10.04","161","82","131","49","28"
"2015","Alberta","48","Arson","1398","109","48","15.86","33.45","2.35","2.99","10.37","8.58","157","77","106","29","24"
"2016","Alberta","48","Arson","1128","87","52","-20.7","26.52","1.96","2.3","6.36","9.19","139","65","83","18","26"
"2005","Alberta","48","Altering, removing or destroying Vehicle Identification Number (VIN)","0","0","0","0","0","0","0","0","0","0","0","0","0","0"
"2006","Alberta","48","Altering, removing or destroying Vehicle Identification Number (VIN)","0","0","0","0","0","0","0","0","0","0","0","0","0","0"
"2007","Alberta","48","Altering, removing or destroying Vehicle Identification Number (VIN)","0","0","0","0","0","0","0","0","0","0","0","0","0","0"
"2008","Alberta","48","Altering, removing or destroying Vehicle Identification Number (VIN)","0","0","0","0","0","0","0","0","0","0","0","0","0","0"
"2009","Alberta","48","Altering, removing or destroying Vehicle Identification Number (VIN)","0","0","0","0","0","0","0","0","0","0","0","0","0","0"
"2010","Alberta","48","Altering, removing or destroying Vehicle Identification Number (VIN)","0","0","0","0","0","0","0","0","0","0","0","0","0","0"
"2011","Alberta","48","Altering, removing or destroying Vehicle Identification Number (VIN)","4","0","2","0","0.11","0","0","0","0.36","2","0","0","0","1"
"2012","Alberta","48","Altering, removing or destroying Vehicle Identification Number (VIN)","5","1","0","22.08","0.13","0.03","0.03","0","0","1","1","1","0","0"
"2013","Alberta","48","Altering, removing or destroying Vehicle Identification Number (VIN)","20","11","2","288.4","0.5","0","0","0","0","13","0","0","0","0"
"2014","Alberta","48","Altering, removing or destroying Vehicle Identification Number (VIN)","15","6","1","-27.04","0.37","0.12","0.14","0.36","0","7","4","5","1","0"
"2015","Alberta","48","Altering, removing or destroying Vehicle Identification Number (VIN)","22","13","0","44.16","0.53","0.09","0.08","0","0","13","3","3","0","0"
"2016","Alberta","48","Altering, removing or destroying Vehicle Identification Number (VIN)","17","11","0","-24.06","0.4","0.15","0.14","0","0","11","5","5","0","0"
"2014","Alberta","48","Offensive weapons, explosives","21","7","1","-27.04","0.51","0.19","0.2","0.36","0","8","6","7","1","0"
"2015","Alberta","48","Offensive weapons, explosives","38","7","0","77.86","0.91","0.31","0.28","0","0","7","10","10","0","0"
"2016","Alberta","48","Offensive weapons, explosives","25","13","2","-35.34","0.59","0.81","0.75","0","0","15","27","27","0","0"
"1998","Alberta","48","Offensive weapons, explosives","65","22","8","0","2.24","0.19","0.21","0.38","1.92","30","4","5","1","5"
"1999","Alberta","48","Offensive weapons, explosives","77","28","24","16.3","2.61","0.73","0.98","3.03","4.92","52","16","24","8","13"
"2000","Alberta","48","Offensive weapons, explosives","77","19","15","-1.72","2.56","0.54","0.92","4.12","1.12","34","12","23","11","3"
"2001","Alberta","48","Offensive weapons, explosives","52","16","4","-33.64","1.7","0.39","0.78","4.06","3.7","20","9","20","11","10"
"2002","Alberta","48","Offensive weapons, explosives","55","11","12","3.39","1.76","0.25","0.34","1.08","6.14","23","6","9","3","17"
"2003","Alberta","48","Offensive weapons, explosives","49","23","12","-12.45","1.54","0.91","0.97","1.43","5.37","35","22","26","4","15"
"2004","Alberta","48","Offensive weapons, explosives","33","7","9","-33.82","1.02","0.32","0.33","0.36","2.13","16","8","9","1","6"
"2005","Alberta","48","Offensive weapons, explosives","36","7","0","6.37","1.08","0.35","0.35","0.35","0.7","7","9","10","1","2"
"2006","Alberta","48","Offensive weapons, explosives","13","1","3","-64.94","0.38","0.04","0.07","0.35","0.7","4","1","2","1","2"
"2007","Alberta","48","Offensive weapons, explosives","25","6","3","87.24","0.71","0.15","0.2","0.7","2.09","9","4","6","2","6"
"2008","Alberta","48","Offensive weapons, explosives","30","12","3","17.27","0.83","0.54","0.68","2.1","1.05","15","15","21","6","3"
"2009","Alberta","48","Offensive weapons, explosives","30","3","6","-2.27","0.82","0.14","0.13","0","2.47","9","4","4","0","7"
"2010","Alberta","48","Offensive weapons, explosives","25","9","3","-17.86","0.67","0.41","0.38","0","0.36","12","12","12","0","1"
"2011","Alberta","48","Offensive weapons, explosives","27","5","3","6.36","0.71","0.1","0.12","0.36","0.36","8","3","4","1","1"
"2012","Alberta","48","Offensive weapons, explosives","24","7","1","-13.19","0.62","0.23","0.21","0","0.36","8","7","7","0","1"
"2013","Alberta","48","Offensive weapons, explosives","28","11","2","13.28","0.7","0.42","0.38","0","0","13","13","13","0","0"
"1998","Alberta","48","Offensive weapons, prohibited","196","146","45","0","6.76","3.79","4.21","7.68","2.69","191","81","101","20","7"
"1999","Alberta","48","Offensive weapons, prohibited","59","39","6","-70.45","2","1.32","1.26","0.76","0.38","45","29","31","2","1"
"2000","Alberta","48","Offensive weapons, prohibited","6","2","0","-90.01","0.2","0.04","0.08","0.37","0","2","1","2","1","0"
"2001","Alberta","48","Offensive weapons, prohibited","0","0","0","-100","0","0","0","0","0","0","0","0","0","0"
"2002","Alberta","48","Offensive weapons, prohibited","2","1","0","0","0.06","0","0","0","0","1","0","0","0","0"
"2003","Alberta","48","Offensive weapons, prohibited","8","0","0","293.09","0.25","0","0","0","0","0","0","0","0","0"
"2004","Alberta","48","Offensive weapons, prohibited","75","20","9","821.27","2.32","0.45","0.47","0.71","0.71","29","11","13","2","2"
"2005","Alberta","48","Offensive weapons, prohibited","0","0","0","-100","0","0","0","0","0","0","0","0","0","0"
"2006","Alberta","48","Offensive weapons, prohibited","0","0","0","0","0","0","0","0","0","0","0","0","0","0"
"2007","Alberta","48","Offensive weapons, prohibited","0","0","0","0","0","0","0","0","0","0","0","0","0","0"
"2008","Alberta","48","Offensive weapons, prohibited","0","0","0","0","0","0","0","0","0","0","0","0","0","0"
"2009","Alberta","48","Offensive weapons, prohibited","0","0","0","0","0","0","0","0","0","0","0","0","0","0"
"2010","Alberta","48","Offensive weapons, prohibited","0","0","0","0","0","0","0","0","0","0","0","0","0","0"
"2011","Alberta","48","Offensive weapons, prohibited","0","0","0","0","0","0","0","0","0","0","0","0","0","0"
"2012","Alberta","48","Offensive weapons, prohibited","0","0","0","0","0","0","0","0","0","0","0","0","0","0"
"2013","Alberta","48","Offensive weapons, prohibited","0","0","0","0","0","0","0","0","0","0","0","0","0","0"
"2014","Alberta","48","Offensive weapons, prohibited","0","0","0","0","0","0","0","0","0","0","0","0","0","0"
"2015","Alberta","48","Offensive weapons, prohibited","0","0","0","0","0","0","0","0","0","0","0","0","0","0"
"2016","Alberta","48","Offensive weapons, prohibited","0","0","0","0","0","0","0","0","0","0","0","0","0","0"
"1998","Alberta","48","Offensive weapons, restricted","108","70","16","0","3.72","1.5","1.33","0","0","86","32","32","0","0"
"1999","Alberta","48","Offensive weapons, restricted","13","8","1","-88.18","0.44","0.14","0.16","0.38","0","9","3","4","1","0"
"2000","Alberta","48","Offensive weapons, restricted","1","0","0","-92.44","0.03","0","0","0","0","0","0","0","0","0"
"2001","Alberta","48","Offensive weapons, restricted","0","0","0","-100","0","0","0","0","0","0","0","0","0","0"
"2002","Alberta","48","Offensive weapons, restricted","0","0","0","0","0","0","0","0","0","0","0","0","0","0"
"2003","Alberta","48","Offensive weapons, restricted","0","0","0","0","0","0","0","0","0","0","0","0","0","0"
"2004","Alberta","48","Offensive weapons, restricted","4","0","1","0","0.12","0","0","0","0","1","0","0","0","0"
"2005","Alberta","48","Offensive weapons, restricted","0","0","0","-100","0","0","0","0","0","0","0","0","0","0"
"2006","Alberta","48","Offensive weapons, restricted","0","0","0","0","0","0","0","0","0","0","0","0","0","0"
"2007","Alberta","48","Offensive weapons, restricted","0","0","0","0","0","0","0","0","0","0","0","0","0","0"
"2008","Alberta","48","Offensive weapons, restricted","0","0","0","0","0","0","0","0","0","0","0","0","0","0"
"2009","Alberta","48","Offensive weapons, restricted","0","0","0","0","0","0","0","0","0","0","0","0","0","0"
"2010","Alberta","48","Offensive weapons, restricted","0","0","0","0","0","0","0","0","0","0","0","0","0","0"
"2011","Alberta","48","Offensive weapons, restricted","0","0","0","0","0","0","0","0","0","0","0","0","0","0"
"2012","Alberta","48","Offensive weapons, restricted","0","0","0","0","0","0","0","0","0","0","0","0","0","0"
"2013","Alberta","48","Offensive weapons, restricted","0","0","0","0","0","0","0","0","0","0","0","0","0","0"
"2014","Alberta","48","Offensive weapons, restricted","0","0","0","0","0","0","0","0","0","0","0","0","0","0"
"2015","Alberta","48","Offensive weapons, restricted","0","0","0","0","0","0","0","0","0","0","0","0","0","0"
"2016","Alberta","48","Offensive weapons, restricted","0","0","0","0","0","0","0","0","0","0","0","0","0","0"
"1998","Alberta","48","Firearm transfers or serial numbers","66","52","7","0","2.28","0.7","0.67","0.38","0","59","15","16","1","0"
"1999","Alberta","48","Firearm transfers or serial numbers","41","14","23","-39.01","1.39","0.27","0.24","0","0","37","6","6","0","0"
"2000","Alberta","48","Firearm transfers or serial numbers","6","1","4","-85.62","0.2","0.04","0.04","0","0.37","5","1","1","0","1"
"2001","Alberta","48","Firearm transfers or serial numbers","0","0","0","-100","0","0","0","0","0","0","0","0","0","0"
"2002","Alberta","48","Firearm transfers or serial numbers","0","0","0","0","0","0","0","0","0","0","0","0","0","0"
"2003","Alberta","48","Firearm transfers or serial numbers","0","0","0","0","0","0","0","0","0","0","0","0","0","0"
"2004","Alberta","48","Firearm transfers or serial numbers","0","0","0","0","0","0","0","0","0","0","0","0","0","0"
"2005","Alberta","48","Firearm transfers or serial numbers","0","0","0","0","0","0","0","0","0","0","0","0","0","0"
"2006","Alberta","48","Firearm transfers or serial numbers","0","0","0","0","0","0","0","0","0","0","0","0","0","0"
"2007","Alberta","48","Firearm transfers or serial numbers","0","0","0","0","0","0","0","0","0","0","0","0","0","0"
"2008","Alberta","48","Firearm transfers or serial numbers","0","0","0","0","0","0","0","0","0","0","0","0","0","0"
"2009","Alberta","48","Firearm transfers or serial numbers","0","0","0","0","0","0","0","0","0","0","0","0","0","0"
"2010","Alberta","48","Firearm transfers or serial numbers","0","0","0","0","0","0","0","0","0","0","0","0","0","0"
"2011","Alberta","48","Firearm transfers or serial numbers","0","0","0","0","0","0","0","0","0","0","0","0","0","0"
"2012","Alberta","48","Firearm transfers or serial numbers","0","0","0","0","0","0","0","0","0","0","0","0","0","0"
"2013","Alberta","48","Firearm transfers or serial numbers","0","0","0","0","0","0","0","0","0","0","0","0","0","0"
"2014","Alberta","48","Firearm transfers or serial numbers","0","0","0","0","0","0","0","0","0","0","0","0","0","0"
"2015","Alberta","48","Firearm transfers or serial numbers","0","0","0","0","0","0","0","0","0","0","0","0","0","0"
"2016","Alberta","48","Firearm transfers or serial numbers","0","0","0","0","0","0","0","0","0","0","0","0","0","0"
"1998","Alberta","48","Other offensive weapons","829","555","200","0","28.59","14.63","19.8","62.17","26.86","755","313","475","162","70"
"1999","Alberta","48","Other offensive weapons","246","126","48","-70.87","8.33","4.43","5.46","14","6.43","174","97","134","37","17"
"2000","Alberta","48","Other offensive weapons","86","13","20","-65.64","2.86","0.31","0.44","1.5","4.49","33","7","11","4","12"
"2001","Alberta","48","Other offensive weapons","57","9","11","-34.87","1.86","0.17","0.31","1.48","4.8","20","4","8","4","13"
"2002","Alberta","48","Other offensive weapons","27","6","1","-53.7","0.86","0","0.15","1.45","0.72","7","0","4","4","2"
"2003","Alberta","48","Other offensive weapons","97","13","19","253.05","3.05","0.12","0.19","0.72","7.87","32","3","5","2","22"
"2004","Alberta","48","Other offensive weapons","188","43","33","90.46","5.8","1.38","1.49","2.49","3.2","76","34","41","7","9"
"2005","Alberta","48","Other offensive weapons","12","1","0","-93.78","0.36","0","0.04","0.35","0","1","0","1","1","0"
"2006","Alberta","48","Other offensive weapons","0","0","0","-100","0","0","0","0","0","0","0","0","0","0"
"2007","Alberta","48","Other offensive weapons","0","0","0","0","0","0","0","0","0","0","0","0","0","0"
"2008","Alberta","48","Other offensive weapons","0","0","0","0","0","0","0","0","0","0","0","0","0","0"
"2009","Alberta","48","Other offensive weapons","0","0","0","0","0","0","0","0","0","0","0","0","0","0"
"2010","Alberta","48","Other offensive weapons","0","0","0","0","0","0","0","0","0","0","0","0","0","0"
"2011","Alberta","48","Other offensive weapons","0","0","0","0","0","0","0","0","0","0","0","0","0","0"
"2012","Alberta","48","Other offensive weapons","0","0","0","0","0","0","0","0","0","0","0","0","0","0"
"2013","Alberta","48","Other offensive weapons","0","0","0","0","0","0","0","0","0","0","0","0","0","0"
"2014","Alberta","48","Other offensive weapons","0","0","0","0","0","0","0","0","0","0","0","0","0","0"
"2015","Alberta","48","Other offensive weapons","0","0","0","0","0","0","0","0","0","0","0","0","0","0"
"2016","Alberta","48","Other offensive weapons","0","0","0","0","0","0","0","0","0","0","0","0","0","0"
"1998","Alberta","48","Total other Criminal Code violations","40451","23575","11339","0","1395.13","637.65","698.18","1195.02","237.16","34914","13639","16753","3114","618"
"1999","Alberta","48","Total other Criminal Code violations","39832","22183","11295","-3.32","1348.75","608.09","651.15","1008.12","195.65","33478","13322","15986","2664","517"
"2000","Alberta","48","Total other Criminal Code violations","40503","23521","9298","-0.06","1347.88","676.11","716.54","1055.74","422.15","32819","15154","17975","2821","1128"
"2001","Alberta","48","Total other Criminal Code violations","48020","24967","9810","16.5","1570.3","798.34","839.02","1183.92","680.27","34777","18318","21522","3204","1841"
"2002","Alberta","48","Total other Criminal Code violations","49641","25821","10461","1.05","1586.8","820.78","849.12","1090.69","659.69","36282","19366","22385","3019","1826"
"2003","Alberta","48","Total other Criminal Code violations","55683","27232","13322","10.23","1749.17","864.6","888.49","1094.69","749.47","40554","20861","23921","3060","2095"
"2004","Alberta","48","Total other Criminal Code violations","59382","28433","14394","4.8","1833.08","881.85","898.5","1044.69","763.95","42827","21756","24692","2936","2147"
"2005","Alberta","48","Total other Criminal Code violations","59691","26934","15596","-1.98","1796.73","800.08","808.82","887.12","758.48","42530","20331","22848","2517","2152"
"2006","Alberta","48","Total other Criminal Code violations","56215","27176","17596","-8.55","1643.06","696.68","707.21","803.56","901.43","44772","18301","20608","2307","2588"
"2007","Alberta","48","Total other Criminal Code violations","56275","26903","18107","-2.53","1601.44","797.17","808.8","918.67","858.38","45010","21611","24247","2636","2463"
"2008","Alberta","48","Total other Criminal Code violations","64078","31917","19329","11.28","1782.05","928.07","938.29","1038.03","884.48","51246","25845","28806","2961","2523"
"2009","Alberta","48","Total other Criminal Code violations","63046","31814","19414","-3.84","1713.63","896.98","904.67","982.14","871.49","51228","25637","28424","2787","2473"
"2010","Alberta","48","Total other Criminal Code violations","63772","31840","20012","-0.3","1708.53","877.61","876.14","861.03","868.84","51852","25476","27901","2425","2447"
"2011","Alberta","48","Total other Criminal Code violations","62276","32614","18277","-3.83","1643.08","867.52","863.2","817.89","729.34","50891","25590","27890","2300","2051"
"2012","Alberta","48","Total other Criminal Code violations","61911","32629","17635","-2.91","1595.33","855.64","852.98","824.31","656.52","50264","25893","28202","2309","1839"
"2013","Alberta","48","Total other Criminal Code violations","60715","33142","16640","-4.77","1519.16","834.17","824.33","714.35","525.84","49782","26057","28054","1997","1470"
"2014","Alberta","48","Total other Criminal Code violations","62668","34493","16489","0.41","1525.41","851.46","843.92","756.93","493.62","50982","27390","29500","2110","1376"
"2015","Alberta","48","Total other Criminal Code violations","63719","36437","15321","-0.06","1524.5","872.6","859.56","707.05","389.47","51758","28539","30516","1977","1089"
"2016","Alberta","48","Total other Criminal Code violations","68495","42427","14317","5.64","1610.56","1030.91","1000.34","641.36","327.93","56744","34263","36078","1815","928"
"1998","Alberta","48","Counterfeiting","63","33","30","0","2.17","1.26","1.33","1.92","2.69","63","27","32","5","7"
"1999","Alberta","48","Counterfeiting","195","127","68","203.88","6.6","4.61","5.01","8.33","7.57","195","101","123","22","20"
"2000","Alberta","48","Counterfeiting","137","101","36","-30.95","4.56","3.39","3.79","7.11","7.86","137","76","95","19","21"
"2001","Alberta","48","Counterfeiting","152","123","29","9.02","4.97","3.53","3.74","5.54","5.54","152","81","96","15","15"
"2002","Alberta","48","Counterfeiting","201","151","50","29.26","6.43","6.44","6.3","5.06","3.25","201","152","166","14","9"
"2003","Alberta","48","Counterfeiting","195","153","42","-4.66","6.13","5.06","5.31","7.51","5.37","195","122","143","21","15"
"2004","Alberta","48","Counterfeiting","295","251","44","48.66","9.11","8.84","8.44","4.98","7.83","295","218","232","14","22"
"2005","Alberta","48","Counterfeiting","176","136","40","-41.82","5.3","4.64","4.5","3.17","5.64","176","118","127","9","16"
"2006","Alberta","48","Counterfeiting","68","44","24","-62.48","1.99","1.6","1.51","0.7","4.18","68","42","44","2","12"
"2007","Alberta","48","Counterfeiting","94","74","20","34.59","2.67","2.25","2.1","0.7","4.18","94","61","63","2","12"
"2008","Alberta","48","Counterfeiting","188","144","44","95.45","5.23","4.06","3.84","1.75","3.51","188","113","118","5","10"
"2009","Alberta","48","Counterfeiting","135","105","30","-29.82","3.67","3.29","3.25","2.82","1.41","135","94","102","8","4"
"2010","Alberta","48","Counterfeiting","103","78","25","-24.8","2.76","2.17","2.1","1.42","0","103","63","67","4","0"
"2011","Alberta","48","Counterfeiting","78","58","20","-25.42","2.06","2.14","1.98","0.36","0.71","78","63","64","1","2"
"2012","Alberta","48","Counterfeiting","49","36","13","-38.65","1.26","1.16","1.06","0","1.43","49","35","35","0","4"
"2013","Alberta","48","Counterfeiting","34","24","10","-32.62","0.85","0.7","0.65","0","0.72","34","22","22","0","2"
"2014","Alberta","48","Counterfeiting","34","23","11","-2.72","0.83","0.62","0.6","0.36","0","34","20","21","1","0"
"2015","Alberta","48","Counterfeiting","164","136","28","374.12","3.92","3.21","3.01","0.72","1.07","164","105","107","2","3"
"2016","Alberta","48","Counterfeiting","259","219","40","55.21","6.09","5.96","5.66","2.12","0.35","259","198","204","6","1"
"1998","Alberta","48","Total weapons violations","1895","1213","439","0","65.36","31.56","37.51","86.35","37.61","1652","675","900","225","98"
"1999","Alberta","48","Total weapons violations","1438","849","348","-25.5","48.69","25.06","30.18","72.66","30.65","1197","549","741","192","81"
"2000","Alberta","48","Total weapons violations","1415","885","266","-3.29","47.09","27.48","33.53","84.2","42.29","1151","616","841","225","113"
"2001","Alberta","48","Total weapons violations","1576","1045","307","9.44","51.54","36.87","43.43","99.03","58.75","1352","846","1114","268","159"
"2002","Alberta","48","Total weapons violations","1774","1067","334","10.03","56.71","37.72","42.83","86.35","57.8","1401","890","1129","239","160"
"2003","Alberta","48","Total weapons violations","1995","1167","431","10.51","62.67","40.45","45.95","93.37","77.63","1598","976","1237","261","217"
"2004","Alberta","48","Total weapons violations","2251","1266","418","10.88","69.49","45.07","49.34","86.82","71.16","1684","1112","1356","244","200"
"2005","Alberta","48","Total weapons violations","2262","1292","385","-2.01","68.09","42.19","46.48","84.94","51.81","1677","1072","1313","241","147"
"2006","Alberta","48","Total weapons violations","2075","1365","370","-10.93","60.65","43.74","47.26","79.42","53.29","1735","1149","1377","228","153"
"2007","Alberta","48","Total weapons violations","2176","1379","447","2.1","61.92","40.98","45.36","86.78","63.43","1826","1111","1360","249","182"
"2008","Alberta","48","Total weapons violations","2136","1306","476","-4.07","59.4","39.82","44.82","93.6","63.45","1782","1109","1376","267","181"
"2009","Alberta","48","Total weapons violations","2105","1230","536","-3.68","57.22","36.04","39.88","78.59","39.47","1766","1030","1253","223","112"
"2010","Alberta","48","Total weapons violations","2056","1123","575","-3.73","55.08","33.24","37.31","79.18","57.17","1698","965","1188","223","161"
"2011","Alberta","48","Total weapons violations","1914","1131","444","-8.32","50.5","33.73","37.2","73.61","47.65","1575","995","1202","207","134"
"2012","Alberta","48","Total weapons violations","1851","1135","417","-5.55","47.7","32.65","36.45","77.47","41.41","1552","988","1205","217","116"
"2013","Alberta","48","Total weapons violations","2020","1266","395","5.97","50.54","36.18","39.49","76.55","42.93","1661","1130","1344","214","120"
"2014","Alberta","48","Total weapons violations","2463","1605","462","18.62","59.95","47.06","49.35","75.69","39.1","2067","1514","1725","211","109"
"2015","Alberta","48","Total weapons violations","3139","2008","566","25.27","75.1","57.08","58.45","74.39","40.41","2574","1867","2075","208","113"
"2016","Alberta","48","Total weapons violations","3014","1997","513","-5.64","70.87","60.24","60.06","57.95","39.22","2510","2002","2166","164","111"
"1998","Alberta","48","Weapons trafficking","79","62","17","0","2.72","1.87","2","3.07","0.38","79","40","48","8","1"
"1999","Alberta","48","Weapons trafficking","8","10","6","-90.06","0.27","0.27","0.24","0","0.38","16","6","6","0","1"
"2000","Alberta","48","Weapons trafficking","4","3","1","-50.86","0.13","0.09","0.12","0.37","0.37","4","2","3","1","1"
"2001","Alberta","48","Weapons trafficking","9","5","1","121.09","0.29","0.09","0.12","0.37","0.74","6","2","3","1","2"
"2002","Alberta","48","Weapons trafficking","10","5","2","8.61","0.32","0.21","0.23","0.36","0","7","5","6","1","0"
"2003","Alberta","48","Weapons trafficking","24","9","1","135.85","0.75","0.21","0.19","0","0","10","5","5","0","0"
"2004","Alberta","48","Weapons trafficking","3","16","0","-87.72","0.09","0.24","0.25","0.36","0","16","6","7","1","0"
"2005","Alberta","48","Weapons trafficking","7","5","2","127.52","0.21","0.24","0.21","0","0","7","6","6","0","0"
"2006","Alberta","48","Weapons trafficking","7","3","2","-2.9","0.2","0.19","0.17","0","0","5","5","5","0","0"
"2007","Alberta","48","Weapons trafficking","10","4","1","39.09","0.28","0.22","0.2","0","0","5","6","6","0","0"
"2008","Alberta","48","Weapons trafficking","14","15","1","36.82","0.39","0.54","0.55","0.7","0.7","16","15","17","2","2"
"2009","Alberta","48","Weapons trafficking","20","11","3","39.62","0.54","0.42","0.41","0.35","0","14","12","13","1","0"
"2010","Alberta","48","Weapons trafficking","11","6","1","-45.79","0.29","0.31","0.28","0","0","7","9","9","0","0"
"2011","Alberta","48","Weapons trafficking","15","8","1","34.29","0.4","0.31","0.31","0.36","0.71","9","9","10","1","2"
"2012","Alberta","48","Weapons trafficking","16","7","0","4.18","0.41","0.26","0.27","0.36","0","7","8","9","1","0"
"2013","Alberta","48","Weapons trafficking","10","8","1","-39.31","0.25","0.22","0.26","0.72","0","9","7","9","2","0"
"2014","Alberta","48","Weapons trafficking","13","7","0","26.47","0.32","0.19","0.17","0","0","7","6","6","0","0"
"2015","Alberta","48","Weapons trafficking","22","15","2","66.34","0.53","0.49","0.45","0","0","17","16","16","0","0"
"2016","Alberta","48","Weapons trafficking","19","13","0","-15.12","0.45","0.51","0.47","0","0","13","17","17","0","0"
"1998","Alberta","48","Weapons possession contrary to order","12","3","0","0","0.41","0.09","0.08","0","0","3","2","2","0","0"
"1999","Alberta","48","Weapons possession contrary to order","13","8","2","6.36","0.44","0.27","0.24","0","0","10","6","6","0","0"
"2000","Alberta","48","Weapons possession contrary to order","22","19","0","66.32","0.73","0.54","0.64","1.5","0","19","12","16","4","0"
"2001","Alberta","48","Weapons possession contrary to order","32","30","3","42.93","1.05","1.22","1.13","0.37","0","33","28","29","1","0"
"2002","Alberta","48","Weapons possession contrary to order","36","23","0","9.97","1.15","0.93","0.87","0.36","0","23","22","23","1","0"
"2003","Alberta","48","Weapons possession contrary to order","57","41","2","55.6","1.79","1.78","1.63","0.36","0","43","43","44","1","0"
"2004","Alberta","48","Weapons possession contrary to order","77","61","1","32.75","2.38","2.63","2.37","0","0","62","65","65","0","0"
"2005","Alberta","48","Weapons possession contrary to order","109","96","0","38.03","3.28","3.5","3.47","3.17","0","96","89","98","9","0"
"2006","Alberta","48","Weapons possession contrary to order","63","61","1","-43.88","1.84","2.32","2.13","0.35","0","62","61","62","1","0"
"2007","Alberta","48","Weapons possession contrary to order","81","87","2","25.18","2.31","3.14","3","1.74","1.39","89","85","90","5","4"
"2008","Alberta","48","Weapons possession contrary to order","92","86","0","11","2.56","3.2","3.22","3.51","0.35","86","89","99","10","1"
"2009","Alberta","48","Weapons possession contrary to order","96","105","4","1.98","2.61","3.57","3.56","3.52","0.35","109","102","112","10","1"
"2010","Alberta","48","Weapons possession contrary to order","97","94","2","-0.41","2.6","3.58","3.45","2.13","0","96","104","110","6","0"
"2011","Alberta","48","Weapons possession contrary to order","104","100","2","5.59","2.74","3.76","3.53","1.07","0.36","102","111","114","3","1"
"2012","Alberta","48","Weapons possession contrary to order","111","110","1","4.24","2.86","3.6","3.48","2.14","0.36","111","109","115","6","1"
"2013","Alberta","48","Weapons possession contrary to order","124","119","1","8.47","3.1","4.23","4.14","3.22","0","120","132","141","9","0"
"2014","Alberta","48","Weapons possession contrary to order","157","152","2","23.17","3.82","5.35","4.92","0","0.72","154","172","172","0","2"
"2015","Alberta","48","Weapons possession contrary to order","233","228","3","45.87","5.57","8.16","7.77","3.22","0.72","231","267","276","9","2"
"2016","Alberta","48","Weapons possession contrary to order","248","239","2","4.61","5.83","8.42","7.9","1.77","0.35","241","280","285","5","1"
"1998","Alberta","48","Possession of weapons","290","173","101","0","10","6.08","6.63","11.13","3.45","274","130","159","29","9"
"1999","Alberta","48","Possession of weapons","588","417","82","99.06","19.91","11.69","15.72","49.2","13.24","499","256","386","130","35"
"2000","Alberta","48","Possession of weapons","791","615","108","32.21","26.32","18.56","23.76","67.36","22.08","723","416","596","180","59"
"2001","Alberta","48","Possession of weapons","1003","816","162","24.6","32.8","28.98","35.16","87.57","32.15","978","665","902","237","87"
"2002","Alberta","48","Possession of weapons","1182","855","179","15.2","37.78","29.84","34.59","75.15","31.79","1034","704","912","208","88"
"2003","Alberta","48","Possession of weapons","1382","952","260","14.9","43.41","32.2","37.92","87.29","52.23","1212","777","1021","244","146"
"2004","Alberta","48","Possession of weapons","1594","1060","267","13.34","49.21","37.45","41.88","80.77","53.73","1327","924","1151","227","151"
"2005","Alberta","48","Possession of weapons","1778","1102","309","8.77","53.52","34.95","39.47","80.01","47.93","1411","888","1115","227","136"
"2006","Alberta","48","Possession of weapons","1784","1233","289","-2.57","52.14","38.68","42.59","78.37","49.81","1522","1016","1241","225","143"
"2007","Alberta","48","Possession of weapons","1864","1198","372","1.73","53.04","34.56","39.33","84.34","59.6","1570","937","1179","242","171"
"2008","Alberta","48","Possession of weapons","1798","1099","389","-5.73","50","32.35","37.36","86.24","59.25","1488","901","1147","246","169"
"2009","Alberta","48","Possession of weapons","1761","1047","432","-4.28","47.87","29.74","33.77","74.36","35.24","1479","850","1061","211","100"
"2010","Alberta","48","Possession of weapons","1737","947","494","-2.78","46.54","26.77","31.18","76.69","56.1","1441","777","993","216","158"
"2011","Alberta","48","Possession of weapons","1596","954","372","-9.51","42.11","27.56","31.38","71.48","45.87","1326","813","1014","201","129"
"2012","Alberta","48","Possession of weapons","1542","952","342","-5.64","39.73","26.73","30.82","74.97","38.56","1294","809","1019","210","108"
"2013","Alberta","48","Possession of weapons","1699","1084","325","6.99","42.51","29.84","33.35","72.62","42.21","1409","932","1135","203","118"
"2014","Alberta","48","Possession of weapons","2108","1384","393","20.7","51.31","39.82","42.63","74.98","38.03","1777","1281","1490","209","106"
"2015","Alberta","48","Possession of weapons","2627","1710","461","22.49","62.85","46.6","48.5","70.81","37.91","2171","1524","1722","198","106"
"2016","Alberta","48","Possession of weapons","2562","1675","443","-4.15","60.24","48.89","49.47","56.19","38.87","2118","1625","1784","159","110"
"1998","Alberta","48","Unauthorized importing or exporting of weapons","12","13","1","0","0.41","0.05","0.04","0","0","14","1","1","0","0"
"1999","Alberta","48","Unauthorized importing or exporting of weapons","0","0","0","-100","0","0","0","0","0","0","0","0","0","0"
"2000","Alberta","48","Unauthorized importing or exporting of weapons","1","1","0","0","0.03","0.04","0.04","0","0","1","1","1","0","0"
"2001","Alberta","48","Unauthorized importing or exporting of weapons","0","0","0","-100","0","0","0","0","0","0","0","0","0","0"
"2002","Alberta","48","Unauthorized importing or exporting of weapons","3","2","0","0","0.1","0.08","0.08","0","0","2","2","2","0","0"
"2003","Alberta","48","Unauthorized importing or exporting of weapons","0","0","0","-100","0","0","0","0","0","0","0","0","0","0"
"2004","Alberta","48","Unauthorized importing or exporting of weapons","0","0","0","0","0","0","0","0","0","0","0","0","0","0"
"2005","Alberta","48","Unauthorized importing or exporting of weapons","4","2","2","0","0.12","0.08","0.07","0","0","4","2","2","0","0"
"2006","Alberta","48","Unauthorized importing or exporting of weapons","11","9","1","167.03","0.32","0.34","0.31","0","0","10","9","9","0","0"
"2007","Alberta","48","Unauthorized importing or exporting of weapons","14","11","2","23.92","0.4","0.37","0.33","0","0","13","10","10","0","0"
"2008","Alberta","48","Unauthorized importing or exporting of weapons","23","18","1","60.55","0.64","0.61","0.59","0.35","0","19","17","18","1","0"
"2009","Alberta","48","Unauthorized importing or exporting of weapons","8","5","3","-66.01","0.22","0.17","0.16","0","0","8","5","5","0","0"
"2010","Alberta","48","Unauthorized importing or exporting of weapons","17","6","6","109.46","0.46","0.21","0.19","0","0.36","12","6","6","0","1"
"2011","Alberta","48","Unauthorized importing or exporting of weapons","6","2","1","-65.24","0.16","0.07","0.06","0","0","3","2","2","0","0"
"2012","Alberta","48","Unauthorized importing or exporting of weapons","9","3","2","46.5","0.23","0.1","0.09","0","0","5","3","3","0","0"
"2013","Alberta","48","Unauthorized importing or exporting of weapons","23","2","6","148.15","0.58","0.06","0.06","0","0.36","8","2","2","0","1"
"2014","Alberta","48","Unauthorized importing or exporting of weapons","24","2","7","1.51","0.58","0.06","0.06","0","0","9","2","2","0","0"
"2015","Alberta","48","Unauthorized importing or exporting of weapons","44","0","26","80.2","1.05","0","0","0","1.43","26","0","0","0","4"
"2016","Alberta","48","Unauthorized importing or exporting of weapons","9","1","8","-79.9","0.21","0","0","0","0","9","0","0","0","0"
"1998","Alberta","48","Firearms documentation or administration","0","0","0","0","0","0","0","0","0","0","0","0","0","0"
"1999","Alberta","48","Firearms documentation or administration","1","0","1","0","0.03","0","0","0","0","1","0","0","0","0"
"2000","Alberta","48","Firearms documentation or administration","25","0","14","2357","0.83","0","0","0","0","14","0","0","0","0"
"2001","Alberta","48","Firearms documentation or administration","100","4","39","293.06","3.27","0.13","0.16","0.37","1.11","43","3","4","1","3"
"2002","Alberta","48","Firearms documentation or administration","153","12","67","49.56","4.89","0.59","0.61","0.72","1.45","79","14","16","2","4"
"2003","Alberta","48","Firearms documentation or administration","140","20","58","-10.08","4.4","0.66","0.67","0.72","8.23","78","16","18","2","23"
"2004","Alberta","48","Firearms documentation or administration","149","17","55","4.59","4.6","0.61","0.73","1.78","10.67","72","15","20","5","30"
"2005","Alberta","48","Firearms documentation or administration","91","3","21","-40.45","2.74","0.12","0.11","0","1.06","24","3","3","0","3"
"2006","Alberta","48","Firearms documentation or administration","21","2","3","-77.59","0.61","0","0","0","0.7","5","0","0","0","2"
"2007","Alberta","48","Firearms documentation or administration","12","1","4","-44.36","0.34","0.04","0.03","0","0","5","1","1","0","0"
"2008","Alberta","48","Firearms documentation or administration","10","3","2","-18.56","0.28","0.11","0.1","0","0.35","5","3","3","0","1"
"2009","Alberta","48","Firearms documentation or administration","5","1","5","-51.13","0.14","0.03","0.03","0","0","6","1","1","0","0"
"2010","Alberta","48","Firearms documentation or administration","9","2","2","77.42","0.24","0.07","0.06","0","0","4","2","2","0","0"
"2011","Alberta","48","Firearms documentation or administration","9","2","1","-1.52","0.24","0.03","0.03","0","0","3","1","1","0","0"
"2012","Alberta","48","Firearms documentation or administration","2","0","2","-78.3","0.05","0","0","0","0","2","0","0","0","0"
"2013","Alberta","48","Firearms documentation or administration","11","1","1","434.06","0.28","0.03","0.03","0","0","2","1","1","0","0"
"2014","Alberta","48","Firearms documentation or administration","4","2","0","-64.62","0.1","0.03","0.03","0","0","2","1","1","0","0"
"2015","Alberta","48","Firearms documentation or administration","7","2","2","72.01","0.17","0.03","0.06","0.36","0","4","1","2","1","0"
"2016","Alberta","48","Firearms documentation or administration","10","7","1","40.4","0.24","0.12","0.11","0","0","8","4","4","0","0"
"1998","Alberta","48","Unsafe storage of firearms","238","117","44","0","8.21","2.66","2.54","1.54","2.3","161","57","61","4","6"
"1999","Alberta","48","Unsafe storage of firearms","392","199","155","61.71","13.27","5.93","5.87","5.3","5.3","354","130","144","14","14"
"2000","Alberta","48","Unsafe storage of firearms","396","212","104","-0.72","13.18","7.32","7.49","8.98","13.85","316","164","188","24","37"
"2001","Alberta","48","Unsafe storage of firearms","323","165","87","-19.85","10.56","5.88","5.77","4.8","16.26","252","135","148","13","44"
"2002","Alberta","48","Unsafe storage of firearms","306","152","73","-7.39","9.78","5.81","5.96","7.23","17.7","225","137","157","20","49"
"2003","Alberta","48","Unsafe storage of firearms","238","109","79","-23.57","7.48","4.56","4.38","2.86","3.94","188","110","118","8","11"
"2004","Alberta","48","Unsafe storage of firearms","128","42","43","-47.15","3.95","1.99","1.82","0.36","0.71","85","49","50","1","2"
"2005","Alberta","48","Unsafe storage of firearms","225","76","51","71.4","6.77","2.95","2.76","1.06","2.11","127","75","78","3","6"
"2006","Alberta","48","Unsafe storage of firearms","176","56","71","-24.04","5.14","2.17","1.99","0.35","2.09","127","57","58","1","6"
"2007","Alberta","48","Unsafe storage of firearms","170","72","63","-5.96","4.84","2.51","2.27","0","0.35","135","68","68","0","1"
"2008","Alberta","48","Unsafe storage of firearms","169","73","80","-2.85","4.7","2.48","2.31","0.7","1.75","153","69","71","2","5"
"2009","Alberta","48","Unsafe storage of firearms","185","58","83","6.99","5.03","1.96","1.81","0.35","1.41","141","56","57","1","4"
"2010","Alberta","48","Unsafe storage of firearms","160","59","67","-14.75","4.29","1.89","1.76","0.36","0.36","126","55","56","1","1"
"2011","Alberta","48","Unsafe storage of firearms","157","60","64","-3.37","4.14","1.9","1.76","0.36","0.36","124","56","57","1","1"
"2012","Alberta","48","Unsafe storage of firearms","147","56","69","-8.55","3.79","1.72","1.57","0","2.14","125","52","52","0","6"
"2013","Alberta","48","Unsafe storage of firearms","125","41","59","-17.43","3.13","1.38","1.26","0","0.36","100","43","43","0","1"
"2014","Alberta","48","Unsafe storage of firearms","136","51","59","5.84","3.31","1.43","1.34","0.36","0.36","110","46","47","1","1"
"2015","Alberta","48","Unsafe storage of firearms","168","46","72","21.42","4.02","1.5","1.38","0","0.36","118","49","49","0","1"
"2016","Alberta","48","Unsafe storage of firearms","141","49","57","-17.52","3.32","1.47","1.36","0","0","106","49","49","0","0"
"1998","Alberta","48","Child pornography","2","1","0","0","0.07","0","0","0","0","1","0","0","0","0"
"1999","Alberta","48","Child pornography","13","5","0","538.16","0.44","0.18","0.2","0.38","0","5","4","5","1","0"
"2000","Alberta","48","Child pornography","13","4","0","-1.72","0.43","0.13","0.12","0","0","4","3","3","0","0"
"2001","Alberta","48","Child pornography","20","11","1","51.18","0.65","0.22","0.23","0.37","0","12","5","6","1","0"
"2002","Alberta","48","Child pornography","26","8","3","27.08","0.83","0.3","0.27","0","0","11","7","7","0","0"
"2003","Alberta","48","Child pornography","61","12","1","130.56","1.92","0.41","0.37","0","0.36","13","10","10","0","1"
"2004","Alberta","48","Child pornography","82","29","12","32.1","2.53","1.05","0.95","0","1.07","41","26","26","0","3"
"2005","Alberta","48","Child pornography","115","35","8","36.75","3.46","1.22","1.1","0","0.35","43","31","31","0","1"
"2006","Alberta","48","Child pornography","131","39","20","10.61","3.83","1.37","1.24","0","1.74","59","36","36","0","5"
"2007","Alberta","48","Child pornography","140","29","14","4.05","3.98","1.07","0.97","0","2.79","43","29","29","0","8"
"2008","Alberta","48","Child pornography","127","35","13","-11.35","3.53","1.18","1.07","0","1.05","48","33","33","0","3"
"2009","Alberta","48","Child pornography","141","39","32","8.51","3.83","1.19","1.18","1.06","7.05","71","34","37","3","20"
"2010","Alberta","48","Child pornography","145","36","41","1.36","3.88","1.24","1.13","0","12.78","77","36","36","0","36"
"2011","Alberta","48","Child pornography","171","48","43","16.14","4.51","1.25","1.27","1.42","17.42","91","37","41","4","49"
"2012","Alberta","48","Child pornography","169","57","36","-3.48","4.35","1.45","1.36","0.36","14.28","93","44","45","1","40"
"2013","Alberta","48","Child pornography","162","49","43","-6.92","4.05","1.44","1.38","0.72","15.38","92","45","47","2","43"
"2014","Alberta","48","Child pornography","270","74","66","62.14","6.57","1.77","1.72","1.08","20.09","140","57","60","3","56"
"2015","Alberta","48","Child pornography","278","61","54","1.2","6.65","1.5","1.46","1.07","14.31","115","49","52","3","40"
"2016","Alberta","48","Child pornography","195","43","74","-31.06","4.59","1.2","1.11","0","18.38","117","40","40","0","52"
"2012","Alberta","48","Making, or distribution of child pornography","0","0","0","0","0","0","0","0","0","0","0","0","0","0"
"2013","Alberta","48","Making, or distribution of child pornography","0","0","0","0","0","0","0","0","0","0","0","0","0","0"
"2014","Alberta","48","Making, or distribution of child pornography","0","0","0","0","0","0","0","0","0","0","0","0","0","0"
"2015","Alberta","48","Making, or distribution of child pornography","1","0","0","0","0.02","0","0","0","0","0","0","0","0","0"
"2016","Alberta","48","Making, or distribution of child pornography","172","14","14","16803.88","4.04","0.42","0.42","0.35","3.53","28","14","15","1","10"
"1998","Alberta","48","Total prostitution","709","500","224","0","24.45","21.27","20.55","14.58","1.54","724","455","493","38","4"
"1999","Alberta","48","Total prostitution","622","396","226","-13.87","21.06","17.12","15.48","1.89","1.14","622","375","380","5","3"
"2000","Alberta","48","Total prostitution","778","524","251","22.93","25.89","21.86","19.77","2.25","0.37","775","490","496","6","1"
"2001","Alberta","48","Total prostitution","1175","831","326","48.41","38.42","35.17","31.54","0.74","0.74","1157","807","809","2","2"
"2002","Alberta","48","Total prostitution","854","655","197","-28.95","27.3","28.99","26.06","1.08","0.36","852","684","687","3","1"
"2003","Alberta","48","Total prostitution","711","570","107","-18.18","22.33","25.2","22.73","1.43","0","677","608","612","4","0"
"2004","Alberta","48","Total prostitution","575","473","91","-20.53","17.75","19.29","17.39","0.71","0.36","564","476","478","2","1"
"2005","Alberta","48","Total prostitution","756","585","135","28.2","22.76","22.39","20.21","0.7","1.06","720","569","571","2","3"
"2006","Alberta","48","Total prostitution","855","610","173","9.82","24.99","19.53","17.71","1.04","1.04","783","513","516","3","3"
"2007","Alberta","48","Total prostitution","521","475","43","-40.67","14.83","17.48","15.91","1.05","0.35","518","474","477","3","1"
"2008","Alberta","48","Total prostitution","684","617","27","28.3","19.02","22.16","20.13","0.35","1.4","644","617","618","1","4"
"2009","Alberta","48","Total prostitution","508","455","22","-27.41","13.81","16.02","14.67","1.06","0.35","477","458","461","3","1"
"2010","Alberta","48","Total prostitution","560","479","19","8.66","15","16.74","15.26","0","0.36","498","486","486","0","1"
"2011","Alberta","48","Total prostitution","403","349","17","-29.13","10.63","10.78","9.87","0.36","0.36","366","318","319","1","1"
"2012","Alberta","48","Total prostitution","284","193","22","-31.17","7.32","6.61","6.05","0","1.43","215","200","200","0","4"
"2013","Alberta","48","Total prostitution","446","341","31","52.49","11.16","11.11","10.28","1.07","0","372","347","350","3","0"
"2014","Alberta","48","Total prostitution","208","115","18","-54.63","5.06","3.54","3.26","0","0","133","114","114","0","0"
"2015","Alberta","48","Total prostitution","11","5","1","-94.8","0.26","0.12","0.11","0","0","6","4","4","0","0"
"2016","Alberta","48","Total prostitution","40","34","0","257.38","0.94","1.05","0.97","0","0","34","35","35","0","0"
"1998","Alberta","48","Bawdy house","17","15","0","0","0.59","2.01","1.79","0","0","15","43","43","0","0"
"1999","Alberta","48","Bawdy house","2","1","0","-88.45","0.07","0.05","0.04","0","0","1","1","1","0","0"
"2000","Alberta","48","Bawdy house","1","2","0","-50.86","0.03","0.13","0.12","0","0","2","3","3","0","0"
"2001","Alberta","48","Bawdy house","4","5","0","293.06","0.13","0.52","0.47","0","0","5","12","12","0","0"
"2002","Alberta","48","Bawdy house","7","7","0","71.06","0.22","1.48","1.33","0","0","7","35","35","0","0"
"2003","Alberta","48","Bawdy house","18","17","0","152.7","0.57","1.7","1.52","0","0","17","41","41","0","0"
"2004","Alberta","48","Bawdy house","4","2","0","-78.16","0.12","0.2","0.18","0","0","2","5","5","0","0"
"2005","Alberta","48","Bawdy house","0","0","0","-100","0","0","0","0","0","0","0","0","0","0"
"2006","Alberta","48","Bawdy house","2","0","0","0","0.06","0","0","0","0","0","0","0","0","0"
"2007","Alberta","48","Bawdy house","3","2","0","46.04","0.09","0.3","0.27","0","0","2","8","8","0","0"
"2008","Alberta","48","Bawdy house","5","4","1","62.88","0.14","0.22","0.2","0","0","5","6","6","0","0"
"2009","Alberta","48","Bawdy house","5","5","0","-2.27","0.14","0.35","0.32","0","0","5","10","10","0","0"
"2010","Alberta","48","Bawdy house","10","5","5","97.13","0.27","0.31","0.28","0","0","10","9","9","0","0"
"2011","Alberta","48","Bawdy house","7","4","0","-31.06","0.18","0.34","0.31","0","0","4","10","10","0","0"
"2012","Alberta","48","Bawdy house","12","2","1","67.43","0.31","0.23","0.21","0","0","3","7","7","0","0"
"2013","Alberta","48","Bawdy house","13","7","1","5.19","0.33","0.38","0.35","0","0","8","12","12","0","0"
"2014","Alberta","48","Bawdy house","10","0","3","-25.17","0.24","0","0","0","0","3","0","0","0","0"
"2015","Alberta","48","Bawdy house","1","0","0","-90.17","0.02","0","0","0","0","0","0","0","0","0"
"2016","Alberta","48","Bawdy house","0","0","0","-100","0","0","0","0","0","0","0","0","0","0"
"1998","Alberta","48","Procuring","88","99","25","0","3.04","1.78","1.67","0.77","0","124","38","40","2","0"
"1999","Alberta","48","Procuring","21","18","2","-76.57","0.71","0.64","0.61","0.38","0","20","14","15","1","0"
"2000","Alberta","48","Procuring","20","14","3","-6.4","0.67","0.54","0.52","0.37","0","17","12","13","1","0"
"2001","Alberta","48","Procuring","22","10","5","8.09","0.72","0.48","0.43","0","0.37","15","11","11","0","1"
"2002","Alberta","48","Procuring","11","6","4","-51.12","0.35","0.38","0.34","0","0","10","9","9","0","0"
"2003","Alberta","48","Procuring","19","13","0","69.74","0.6","0.87","0.85","0.72","0","13","21","23","2","0"
"2004","Alberta","48","Procuring","4","2","0","-79.31","0.12","0.16","0.15","0","0","2","4","4","0","0"
"2005","Alberta","48","Procuring","17","2","8","314.42","0.51","0.08","0.07","0","0.35","10","2","2","0","1"
"2006","Alberta","48","Procuring","29","8","10","65.64","0.85","0.3","0.27","0","0","18","8","8","0","0"
"2007","Alberta","48","Procuring","17","3","3","-42.93","0.48","0.15","0.13","0","0","6","4","4","0","0"
"2008","Alberta","48","Procuring","27","9","6","55.21","0.75","0.25","0.23","0","1.05","15","7","7","0","3"
"2009","Alberta","48","Procuring","20","5","4","-27.6","0.54","0.17","0.16","0","0","9","5","5","0","0"
"2010","Alberta","48","Procuring","35","8","4","72.49","0.94","0.28","0.25","0","0","12","8","8","0","0"
"2011","Alberta","48","Procuring","31","50","5","-12.78","0.82","0.41","0.37","0","0","55","12","12","0","0"
"1998","Alberta","48","Obtains or communicates with a person under age 18 for purpose of sex","5","4","1","0","0.17","0.09","0.08","0","0","5","2","2","0","0"
"1999","Alberta","48","Obtains or communicates with a person under age 18 for purpose of sex","19","18","1","273.08","0.64","0.55","0.49","0","0","19","12","12","0","0"
"2000","Alberta","48","Obtains or communicates with a person under age 18 for purpose of sex","4","4","0","-79.31","0.13","0.18","0.16","0","0","4","4","4","0","0"
"2001","Alberta","48","Obtains or communicates with a person under age 18 for purpose of sex","4","1","1","-1.74","0.13","0","0","0","0","2","0","0","0","0"
"2002","Alberta","48","Obtains or communicates with a person under age 18 for purpose of sex","7","5","0","71.06","0.22","0.21","0.19","0","0","5","5","5","0","0"
"2003","Alberta","48","Obtains or communicates with a person under age 18 for purpose of sex","13","4","1","82.5","0.41","0.25","0.22","0","0","5","6","6","0","0"
"2004","Alberta","48","Obtains or communicates with a person under age 18 for purpose of sex","1","1","0","-92.44","0.03","0.04","0.04","0","0","1","1","1","0","0"
"2005","Alberta","48","Obtains or communicates with a person under age 18 for purpose of sex","5","1","0","387.55","0.15","0.04","0.04","0","0","1","1","1","0","0"
"2006","Alberta","48","Obtains or communicates with a person under age 18 for purpose of sex","3","1","0","-41.74","0.09","0.04","0.03","0","0","1","1","1","0","0"
"2007","Alberta","48","Obtains or communicates with a person under age 18 for purpose of sex","3","2","2","-2.64","0.09","0.07","0.07","0","0","4","2","2","0","0"
"2008","Alberta","48","Obtains or communicates with a person under age 18 for purpose of sex","1","0","0","-67.42","0.03","0","0","0","0","0","0","0","0","0"
"2009","Alberta","48","Obtains or communicates with a person under age 18 for purpose of sex","0","0","0","-100","0","0","0","0","0","0","0","0","0","0"
"2010","Alberta","48","Obtains or communicates with a person under age 18 for purpose of sex","4","2","0","0","0.11","0.07","0.06","0","0.36","2","2","2","0","1"
"2011","Alberta","48","Obtains or communicates with a person under age 18 for purpose of sex","9","6","1","121.58","0.24","0.2","0.19","0","0","7","6","6","0","0"
"1998","Alberta","48","Living off the avails of prostitution of a person under age 18","5","3","0","0","0.17","0.09","0.08","0","0","3","2","2","0","0"
"2012","Alberta","48","Obtains or communicates with a person under age 18 for purpose of sex","7","0","0","-24.04","0.18","0","0","0","0","0","0","0","0","0"
"1999","Alberta","48","Living off the avails of prostitution of a person under age 18","16","9","2","214.17","0.54","0.32","0.29","0","0.76","11","7","7","0","2"
"2013","Alberta","48","Obtains or communicates with a person under age 18 for purpose of sex","6","2","0","-16.77","0.15","0.06","0.06","0","0","2","2","2","0","0"
"2000","Alberta","48","Living off the avails of prostitution of a person under age 18","3","5","0","-81.57","0.1","0.13","0.24","1.12","0","5","3","6","3","0"
"2014","Alberta","48","Obtains or communicates with a person under age 18 for purpose of sex","4","0","0","-35.15","0.1","0","0","0","0","0","0","0","0","0"
"2001","Alberta","48","Living off the avails of prostitution of a person under age 18","0","0","0","-100","0","0","0","0","0","0","0","0","0","0"
"2015","Alberta","48","Obtains or communicates with a person under age 18 for purpose of sex","0","1","0","-100","0","0.03","0.03","0","0","1","1","1","0","0"
"2002","Alberta","48","Living off the avails of prostitution of a person under age 18","1","1","0","0","0.03","0.04","0.04","0","0","1","1","1","0","0"
"2016","Alberta","48","Obtains or communicates with a person under age 18 for purpose of sex","0","0","0","0","0","0","0","0","0","0","0","0","0","0"
"2003","Alberta","48","Living off the avails of prostitution of a person under age 18","3","2","0","194.81","0.09","0.12","0.15","0.36","0","2","3","4","1","0"
"2004","Alberta","48","Living off the avails of prostitution of a person under age 18","0","0","0","-100","0","0","0","0","0","0","0","0","0","0"
"2005","Alberta","48","Living off the avails of prostitution of a person under age 18","1","1","0","0","0.03","0.04","0.04","0","0","1","1","1","0","0"
"2006","Alberta","48","Living off the avails of prostitution of a person under age 18","0","0","0","-100","0","0","0","0","0","0","0","0","0","0"
"2007","Alberta","48","Living off the avails of prostitution of a person under age 18","0","0","0","0","0","0","0","0","0","0","0","0","0","0"
"2008","Alberta","48","Living off the avails of prostitution of a person under age 18","0","0","0","0","0","0","0","0","0","0","0","0","0","0"
"2009","Alberta","48","Living off the avails of prostitution of a person under age 18","1","0","0","0","0.03","0","0","0","0","0","0","0","0","0"
"2010","Alberta","48","Living off the avails of prostitution of a person under age 18","2","0","0","97.13","0.05","0","0","0","0","0","0","0","0","0"
"2011","Alberta","48","Living off the avails of prostitution of a person under age 18","4","4","0","96.96","0.11","0.2","0.19","0","0","4","6","6","0","0"
"2012","Alberta","48","Living off the avails of prostitution of a person under age 18","4","3","0","-2.33","0.1","0.1","0.09","0","0","3","3","3","0","0"
"2013","Alberta","48","Living off the avails of prostitution of a person under age 18","4","2","0","-2.9","0.1","0.03","0.03","0","0","2","1","1","0","0"
"2014","Alberta","48","Living off the avails of prostitution of a person under age 18","2","1","0","-51.36","0.05","0","0","0","0","1","0","0","0","0"
"2015","Alberta","48","Living off the avails of prostitution of a person under age 18","0","0","0","-100","0","0","0","0","0","0","0","0","0","0"
"2016","Alberta","48","Living off the avails of prostitution of a person under age 18","0","0","0","0","0","0","0","0","0","0","0","0","0","0"
"1998","Alberta","48","Other prostitution","594","379","198","0","20.49","17.3","16.92","13.82","1.54","577","370","406","36","4"
"1999","Alberta","48","Other prostitution","564","350","221","-6.78","19.1","15.57","14.05","1.51","0.38","571","341","345","4","1"
"2000","Alberta","48","Other prostitution","750","499","248","30.69","24.96","20.88","18.74","0.75","0.37","747","468","470","2","1"
"2001","Alberta","48","Other prostitution","1145","815","320","50.02","37.44","34.17","30.64","0.74","0.37","1135","784","786","2","1"
"2002","Alberta","48","Other prostitution","828","636","193","-29.31","26.47","26.87","24.16","1.08","0.36","829","634","637","3","1"
"2003","Alberta","48","Other prostitution","658","534","106","-21.91","20.67","22.26","19.98","0.36","0","640","537","538","1","0"
"2004","Alberta","48","Other prostitution","566","468","91","-15.47","17.47","18.89","17.03","0.71","0.36","559","466","468","2","1"
"2005","Alberta","48","Other prostitution","733","581","127","26.28","22.06","22.23","20.07","0.7","0.7","708","565","567","2","2"
"2006","Alberta","48","Other prostitution","821","601","163","8.76","24","19.19","17.4","1.04","1.04","764","504","507","3","3"
"2007","Alberta","48","Other prostitution","498","468","38","-40.94","14.17","16.97","15.44","1.05","0.35","506","460","463","3","1"
"2008","Alberta","48","Other prostitution","651","604","20","27.75","18.1","21.69","19.71","0.35","0.35","624","604","605","1","1"
"2009","Alberta","48","Other prostitution","482","445","18","-27.64","13.1","15.5","14.2","1.06","0.35","463","443","446","3","1"
"2010","Alberta","48","Other prostitution","509","464","10","4.09","13.64","16.09","14.66","0","0","474","467","467","0","0"
"2011","Alberta","48","Other prostitution","352","285","11","-31.9","9.29","9.63","8.82","0.36","0.36","296","284","285","1","1"
"2012","Alberta","48","Other prostitution","231","177","14","-35.91","5.95","5.68","5.2","0","0.36","191","172","172","0","1"
"2013","Alberta","48","Other prostitution","335","282","16","40.82","8.38","9","8.29","0.36","0","298","281","282","1","0"
"2014","Alberta","48","Other prostitution","149","101","5","-56.73","3.63","3.14","2.89","0","0","106","101","101","0","0"
"2015","Alberta","48","Other prostitution","0","0","0","-100","0","0","0","0","0","0","0","0","0","0"
"2016","Alberta","48","Other prostitution","0","0","0","0","0","0","0","0","0","0","0","0","0","0"
"2012","Alberta","48","Communicating to provide sexual services for consideration","0","0","0","0","0","0","0","0","0","0","0","0","0","0"
"2013","Alberta","48","Communicating to provide sexual services for consideration","0","0","0","0","0","0","0","0","0","0","0","0","0","0"
"2014","Alberta","48","Communicating to provide sexual services for consideration","0","0","0","0","0","0","0","0","0","0","0","0","0","0"
"2015","Alberta","48","Communicating to provide sexual services for consideration","0","0","0","0","0","0","0","0","0","0","0","0","0","0"
"2016","Alberta","48","Communicating to provide sexual services for consideration","29","27","0","0","0.68","0.84","0.78","0","0","27","28","28","0","0"
"2012","Alberta","48","Stopping or impeding traffic for the purpose of offering, providing or obtaining sexual services for consideration","0","0","0","0","0","0","0","0","0","0","0","0","0","0"
"2013","Alberta","48","Stopping or impeding traffic for the purpose of offering, providing or obtaining sexual services for consideration","0","0","0","0","0","0","0","0","0","0","0","0","0","0"
"2014","Alberta","48","Stopping or impeding traffic for the purpose of offering, providing or obtaining sexual services for consideration","0","0","0","0","0","0","0","0","0","0","0","0","0","0"
"2015","Alberta","48","Stopping or impeding traffic for the purpose of offering, providing or obtaining sexual services for consideration","7","1","1","0","0.17","0","0","0","0","2","0","0","0","0"
"2016","Alberta","48","Stopping or impeding traffic for the purpose of offering, providing or obtaining sexual services for consideration","7","1","0","-1.72","0.16","0.03","0.03","0","0","1","1","1","0","0"
"1998","Alberta","48","Disturb the peace","11392","732","6509","0","392.9","30.11","30.67","35.31","63.32","7241","644","736","92","165"
"1999","Alberta","48","Disturb the peace","13719","714","8104","18.23","464.54","29.76","30.88","40.11","83.63","8818","652","758","106","221"
"2000","Alberta","48","Disturb the peace","15622","733","6874","11.91","519.88","38.28","39.66","51.27","264.22","7607","858","995","137","706"
"2001","Alberta","48","Disturb the peace","17321","673","7448","8.95","566.41","40.18","41.36","51.36","458.93","8121","922","1061","139","1242"
"2002","Alberta","48","Disturb the peace","17607","649","8012","-0.63","562.82","38.36","39.87","52.75","437.15","8661","905","1051","146","1210"
"2003","Alberta","48","Disturb the peace","22331","702","10884","24.64","701.48","44.68","44.87","46.51","515.51","11586","1078","1208","130","1441"
"2004","Alberta","48","Disturb the peace","25493","708","12020","12.18","786.95","45.11","47.05","64.05","539.42","12728","1113","1293","180","1516"
"2005","Alberta","48","Disturb the peace","27194","689","13148","4.02","818.55","31.68","31.93","34.19","574.5","13837","805","902","97","1630"
"2006","Alberta","48","Disturb the peace","24766","503","14932","-11.57","723.86","19.64","19.53","18.46","685.13","15435","516","569","53","1967"
"2007","Alberta","48","Disturb the peace","25282","690","15309","-0.61","719.46","25.78","26.82","36.59","622.79","15999","699","804","105","1787"
"2008","Alberta","48","Disturb the peace","27386","819","16366","5.86","761.62","28.37","28.79","32.95","639.79","17185","790","884","94","1825"
"2009","Alberta","48","Disturb the peace","25607","841","16102","-8.61","696.01","30.23","30.4","32.07","635.73","16943","864","955","91","1804"
"2010","Alberta","48","Disturb the peace","26309","931","16386","1.27","704.85","32.86","32.19","25.21","602.9","17317","954","1025","71","1698"
"2011","Alberta","48","Disturb the peace","24301","1060","14819","-9.04","641.16","36.31","36","32.72","504.96","15879","1071","1163","92","1420"
"2012","Alberta","48","Disturb the peace","23723","1038","14204","-4.66","611.3","35.69","34.09","16.78","419.48","15242","1080","1127","47","1175"
"2013","Alberta","48","Disturb the peace","22076","939","13196","-9.64","552.37","30.8","29.3","12.52","328.38","14135","962","997","35","918"
"2014","Alberta","48","Disturb the peace","21632","629","12607","-4.67","526.55","20.67","20.14","13.99","313.89","13236","665","704","39","875"
"2015","Alberta","48","Disturb the peace","20176","594","11254","-8.32","482.72","18.5","17.41","4.65","230.68","11848","605","618","13","645"
"2016","Alberta","48","Disturb the peace","18592","407","10049","-9.44","437.16","11.64","11.31","7.42","172.8","10456","387","408","21","489"
"1998","Alberta","48","Total administration of justice violations","18862","17712","2039","0","650.54","457.51","507.35","916.41","54.88","19751","9786","12174","2388","143"
"1999","Alberta","48","Total administration of justice violations","18885","17788","1624","-1.7","639.46","462.57","499.09","801.88","26.11","19412","10134","12253","2119","69"
"2000","Alberta","48","Total administration of justice violations","18442","19251","1230","-4.03","613.72","519.15","550.03","809.11","52.02","20481","11636","13798","2162","139"
"2001","Alberta","48","Total administration of justice violations","23400","20237","1054","24.68","765.2","618.87","650.96","923.04","80.18","21291","14200","16698","2498","217"
"2002","Alberta","48","Total administration of justice violations","24834","21153","1144","3.74","793.83","643.16","664.24","843.94","71.17","22297","15175","17511","2336","197"
"2003","Alberta","48","Total administration of justice violations","26104","22531","1205","3.3","820","685.89","702.93","850","84.43","23736","16549","18925","2376","236"
"2004","Alberta","48","Total administration of justice violations","26508","23665","1181","-0.21","818.28","699.77","711.03","809.85","69.39","24846","17264","19540","2276","195"
"2005","Alberta","48","Total administration of justice violations","24859","22159","1259","-8.56","748.27","632.12","638.26","693.27","71.2","23418","16063","18030","1967","202"
"2006","Alberta","48","Total administration of justice violations","24010","22433","1285","-6.21","701.77","542.81","552.24","638.46","101.71","23718","14259","16092","1833","292"
"2007","Alberta","48","Total administration of justice violations","23500","22205","1402","-4.71","668.75","645.08","653.15","729.43","89.92","23607","17488","19581","2093","258"
"2008","Alberta","48","Total administration of justice violations","28998","27032","1493","20.59","806.45","770.5","776.82","838.56","107.27","28525","21457","23849","2392","306"
"2009","Alberta","48","Total administration of justice violations","29682","27143","1737","0.04","806.78","750","755.43","810.17","124.4","28880","21436","23735","2299","353"
"2010","Alberta","48","Total administration of justice violations","30130","27409","1971","0.05","807.22","738.16","734.96","701.96","120.72","29380","21428","23405","1977","340"
"2011","Alberta","48","Total administration of justice violations","30947","28111","2010","1.15","816.5","730.05","723.59","655.73","106.68","30121","21535","23379","1844","300"
"2012","Alberta","48","Total administration of justice violations","31276","28315","2034","-1.3","805.93","724.88","720.27","670.45","126.38","30349","21936","23814","1878","354"
"2013","Alberta","48","Total administration of justice violations","31693","28684","2156","-1.6","793","703.72","694.13","587.01","99.8","30840","21982","23623","1641","279"
"2014","Alberta","48","Total administration of justice violations","33777","30207","2543","3.68","822.17","730.72","722.28","624.91","91.12","32750","23506","25248","1742","254"
"2015","Alberta","48","Total administration of justice violations","35362","31583","2673","2.9","846.05","739.44","727.82","591.89","75.82","34256","24184","25839","1655","212"
"2016","Alberta","48","Total administration of justice violations","41702","37693","2882","15.9","980.56","899.96","872.08","544.54","67.14","40575","29911","31452","1541","190"
"1998","Alberta","48","Fail to comply with order","9808","11115","170","0","338.27","290.19","320.9","572.95","4.99","11285","6207","7700","1493","13"
"1999","Alberta","48","Fail to comply with order","10033","11520","207","0.43","339.73","302.4","329.53","554.39","4.54","11727","6625","8090","1465","12"
"2000","Alberta","48","Fail to comply with order","10139","12844","187","-0.68","337.41","342.47","368.38","585.69","8.98","13031","7676","9241","1565","24"
"2001","Alberta","48","Fail to comply with order","13885","13750","241","34.57","454.05","419.65","446.76","676.58","21.8","13991","9629","11460","1831","59"
"2002","Alberta","48","Fail to comply with order","14610","14123","292","2.86","467.02","423.06","446.39","645.24","15.9","14415","9982","11768","1786","44"
"2003","Alberta","48","Fail to comply with order","15785","15355","351","6.17","495.85","464.77","483.67","646.8","27.19","15706","11214","13022","1808","76"
"2004","Alberta","48","Fail to comply with order","16345","16327","424","1.76","504.56","479.07","497.29","657.2","27.4","16751","11819","13666","1847","77"
"2005","Alberta","48","Fail to comply with order","14977","14841","470","-10.65","450.82","427.64","441.44","564.98","29.96","15311","10867","12470","1603","85"
"2006","Alberta","48","Fail to comply with order","13958","13574","560","-9.5","407.97","357","369.94","488.33","44.58","14134","9378","10780","1402","128"
"2007","Alberta","48","Fail to comply with order","15677","15286","648","9.35","446.13","442.5","458.25","607.11","39.73","15934","11996","13738","1742","114"
"2008","Alberta","48","Fail to comply with order","19892","19107","673","24","553.21","535.22","546.99","661.87","49.43","19780","14905","16793","1888","141"
"2009","Alberta","48","Fail to comply with order","20485","19364","862","0.65","556.79","519.6","531.49","651.24","57.09","20226","14851","16699","1848","162"
"2010","Alberta","48","Fail to comply with order","20997","19768","971","1.03","562.53","512.07","516.81","565.62","57.52","20739","14865","16458","1593","162"
"2011","Alberta","48","Fail to comply with order","21859","20472","1009","2.52","576.73","509.05","510.86","529.85","53.7","21481","15016","16506","1490","151"
"2012","Alberta","48","Fail to comply with order","21878","20351","1037","-2.25","563.76","497.4","501.89","550.49","61.4","21388","15052","16594","1542","172"
"2013","Alberta","48","Fail to comply with order","22356","20795","1208","-0.78","559.37","485.77","484.15","466.1","50.8","22003","15174","16477","1303","142"
"2014","Alberta","48","Fail to comply with order","23754","21556","1682","3.37","578.2","501.15","501.69","507.97","49.86","23238","16121","17537","1416","139"
"2015","Alberta","48","Fail to comply with order","24506","22109","1844","1.4","586.32","489.88","487.86","464.22","38.27","23953","16022","17320","1298","107"
"2016","Alberta","48","Fail to comply with order","29421","26760","2094","17.99","691.79","607.69","594.28","436.76","38.52","28854","20197","21433","1236","109"
"1998","Alberta","48","Escape or helps to escape from lawful custody","171","170","9","0","5.9","5.52","5.71","7.29","0.38","179","118","137","19","1"
"1999","Alberta","48","Escape or helps to escape from lawful custody","139","123","7","-20.19","4.71","4.06","4.32","6.43","0.38","130","89","106","17","1"
"2000","Alberta","48","Escape or helps to escape from lawful custody","113","103","3","-20.1","3.76","3.39","3.71","6.36","0.37","106","76","93","17","1"
"2001","Alberta","48","Escape or helps to escape from lawful custody","159","159","2","38.27","5.2","4.79","5.81","14.41","0.37","161","110","149","39","1"
"2002","Alberta","48","Escape or helps to escape from lawful custody","151","143","1","-7.17","4.83","5.13","5.92","12.64","0.36","144","121","156","35","1"
"2003","Alberta","48","Escape or helps to escape from lawful custody","142","138","4","-7.59","4.46","5.39","5.57","7.15","0","142","130","150","20","0"
"2004","Alberta","48","Escape or helps to escape from lawful custody","121","116","2","-16.26","3.74","4.09","4.4","7.12","0","118","101","121","20","0"
"2005","Alberta","48","Escape or helps to escape from lawful custody","156","145","6","25.72","4.7","4.88","4.99","5.99","0.35","151","124","141","17","1"
"2006","Alberta","48","Escape or helps to escape from lawful custody","175","160","10","8.93","5.11","4.83","5.11","7.66","0","170","127","149","22","0"
"2007","Alberta","48","Escape or helps to escape from lawful custody","139","126","12","-22.67","3.96","3.32","3.9","9.41","0","138","90","117","27","0"
"2008","Alberta","48","Escape or helps to escape from lawful custody","102","95","0","-28.29","2.84","2.55","2.87","5.96","0.7","95","71","88","17","2"
"2009","Alberta","48","Escape or helps to escape from lawful custody","106","102","2","1.57","2.88","2.8","2.9","3.88","0","104","80","91","11","0"
"2010","Alberta","48","Escape or helps to escape from lawful custody","72","68","2","-33.05","1.93","1.83","1.95","3.2","0.36","70","53","62","9","1"
"2011","Alberta","48","Escape or helps to escape from lawful custody","69","66","3","-5.62","1.82","1.73","1.83","2.84","0","69","51","59","8","0"
"2012","Alberta","48","Escape or helps to escape from lawful custody","58","56","2","-17.9","1.49","1.19","1.27","2.14","0","58","36","42","6","0"
"2013","Alberta","48","Escape or helps to escape from lawful custody","56","53","0","-6.25","1.4","1.15","1.41","4.29","0.72","53","36","48","12","2"
"2014","Alberta","48","Escape or helps to escape from lawful custody","51","49","2","-11.4","1.24","0.96","1","1.43","0","51","31","35","4","0"
"2015","Alberta","48","Escape or helps to escape from lawful custody","50","50","0","-3.64","1.2","1.01","1.04","1.43","0","50","33","37","4","0"
"2016","Alberta","48","Escape or helps to escape from lawful custody","65","61","2","27.76","1.53","1.5","1.44","0.71","0","63","50","52","2","0"
"1998","Alberta","48","Prisoner unlawfully at large","695","696","16","0","23.97","24.59","27.3","49.5","1.15","712","526","655","129","3"
"1999","Alberta","48","Prisoner unlawfully at large","749","753","13","5.81","25.36","27.84","29.25","40.87","0.38","766","610","718","108","1"
"2000","Alberta","48","Prisoner unlawfully at large","818","806","9","7.33","27.22","31.23","31.29","31.81","0","815","700","785","85","0"
"2001","Alberta","48","Prisoner unlawfully at large","829","820","10","-0.41","27.11","30.59","31.3","37.32","2.96","830","702","803","101","8"
"2002","Alberta","48","Prisoner unlawfully at large","813","790","15","-4.14","25.99","30.01","29.4","24.21","1.08","805","708","775","67","3"
"2003","Alberta","48","Prisoner unlawfully at large","862","846","5","4.19","27.08","32","30.42","16.81","0.36","851","772","819","47","1"
"2004","Alberta","48","Prisoner unlawfully at large","848","839","4","-3.33","26.18","31.05","29.62","17.08","0.36","843","766","814","48","1"
"2005","Alberta","48","Prisoner unlawfully at large","796","777","3","-8.47","23.96","28.92","26.97","9.52","0","780","735","762","27","0"
"2006","Alberta","48","Prisoner unlawfully at large","778","739","7","-5.09","22.74","25.32","23.95","11.49","0","746","665","698","33","0"
"2007","Alberta","48","Prisoner unlawfully at large","694","693","9","-13.15","19.75","24.35","22.75","7.67","0","702","660","682","22","0"
"2008","Alberta","48","Prisoner unlawfully at large","644","608","15","-9.31","17.91","20.72","19.61","8.76","0.35","623","577","602","25","1"
"2009","Alberta","48","Prisoner unlawfully at large","564","532","17","-14.41","15.33","17.32","16.71","10.57","0.7","549","495","525","30","2"
"2010","Alberta","48","Prisoner unlawfully at large","592","550","9","3.46","15.86","17.36","17.02","13.49","0","559","504","542","38","0"
"2011","Alberta","48","Prisoner unlawfully at large","583","534","18","-3.02","15.38","16.88","16.28","9.96","0","552","498","526","28","0"
"2012","Alberta","48","Prisoner unlawfully at large","685","627","12","14.75","17.65","19.63","18.66","8.21","0.71","639","594","617","23","2"
"2013","Alberta","48","Prisoner unlawfully at large","682","622","22","-3.32","17.06","18.98","17.89","5.72","0.72","644","593","609","16","2"
"2014","Alberta","48","Prisoner unlawfully at large","682","591","19","-2.72","16.6","17.72","16.45","1.79","0.72","610","570","575","5","2"
"2015","Alberta","48","Prisoner unlawfully at large","706","599","33","1.75","16.89","17.43","16.22","2.15","1.07","632","570","576","6","3"
"2016","Alberta","48","Prisoner unlawfully at large","753","650","23","4.82","17.71","18.84","17.44","1.06","0.35","673","626","629","3","1"
"1998","Alberta","48","Fail to appear","2086","2628","8","0","71.94","67","70.89","102.85","0","2636","1433","1701","268","0"
"1999","Alberta","48","Fail to appear","1822","2670","6","-14.25","61.69","67.87","71.32","99.9","0","2676","1487","1751","264","0"
"2000","Alberta","48","Fail to appear","1867","2862","5","0.71","62.13","73.97","76.7","99.55","0","2867","1658","1924","266","0"
"2001","Alberta","48","Fail to appear","2968","2989","4","56.21","97.06","95.27","96.1","103.09","0","2993","2186","2465","279","0"
"2002","Alberta","48","Fail to appear","3641","3611","4","19.92","116.39","116.09","114.44","100.43","0.72","3615","2739","3017","278","2"
"2003","Alberta","48","Fail to appear","4103","4045","14","10.74","128.89","123.01","123.83","130.93","0","4059","2968","3334","366","0"
"2004","Alberta","48","Fail to appear","4252","4205","37","1.84","131.26","120.18","117.83","97.14","0.36","4242","2965","3238","273","1"
"2005","Alberta","48","Fail to appear","4306","4245","57","-1.25","129.61","104.4","101.31","73.66","0","4302","2653","2862","209","0"
"2006","Alberta","48","Fail to appear","5610","5658","42","26.51","163.97","83.33","82.16","71.4","1.04","5700","2189","2394","205","3"
"2007","Alberta","48","Fail to appear","3514","3701","42","-39.01","100","99.71","96.03","61.34","0.7","3743","2703","2879","176","2"
"2008","Alberta","48","Fail to appear","4606","4647","20","28.1","128.1","132.72","131.23","116.74","0.35","4667","3696","4029","333","1"
"2009","Alberta","48","Fail to appear","4389","4394","35","-6.87","119.3","124.28","122.47","104.31","2.47","4429","3552","3848","296","7"
"2010","Alberta","48","Fail to appear","4211","4182","33","-5.43","112.82","117.81","114.55","80.95","0.71","4215","3420","3648","228","2"
"2011","Alberta","48","Fail to appear","4290","4266","30","0.33","113.19","116.72","113.19","76.1","0.71","4296","3443","3657","214","2"
"2012","Alberta","48","Fail to appear","4408","4380","25","0.35","113.59","118.17","114.12","70.33","0.71","4405","3576","3773","197","2"
"2013","Alberta","48","Fail to appear","4636","4551","22","2.12","116","119.99","117.01","83.71","0.72","4573","3748","3982","234","2"
"2014","Alberta","48","Fail to appear","5498","5444","20","15.37","133.83","139.95","134.97","77.49","0","5464","4502","4718","216","0"
"2015","Alberta","48","Fail to appear","6207","6201","19","10.97","148.5","159.02","153.74","91.91","1.43","6220","5201","5458","257","4"
"2016","Alberta","48","Fail to appear","7424","7364","32","17.55","174.56","193.05","184","77.74","1.06","7396","6416","6636","220","3"
"1998","Alberta","48","Breach of probation","5225","2725","1599","0","180.21","61.39","73.22","170.39","31.47","4324","1313","1757","444","82"
"1999","Alberta","48","Breach of probation","5233","2406","1125","-1.67","177.19","51.72","55.4","85.9","7.57","3531","1133","1360","227","20"
"2000","Alberta","48","Breach of probation","4631","2307","800","-13.03","154.11","57.78","59.36","72.6","9.36","3107","1295","1489","194","25"
"2001","Alberta","48","Breach of probation","4636","2184","614","-1.63","151.6","58.05","60.15","77.97","18.48","2798","1332","1543","211","50"
"2002","Alberta","48","Breach of probation","4696","2150","605","-0.98","150.11","58.62","57.81","50.94","21.68","2755","1383","1524","141","60"
"2003","Alberta","48","Breach of probation","4398","1842","632","-7.96","138.15","51.56","50.48","41.14","32.2","2474","1244","1359","115","90"
"2004","Alberta","48","Breach of probation","4224","1927","543","-5.62","130.39","57.4","54.47","28.82","21.71","2470","1416","1497","81","61"
"2005","Alberta","48","Breach of probation","3741","1846","511","-13.64","112.61","56.55","54.2","33.13","23.61","2357","1437","1531","94","67"
"2006","Alberta","48","Breach of probation","2392","1948","229","-37.91","69.91","61.44","60.06","47.37","21.6","2177","1614","1750","136","62"
"2007","Alberta","48","Breach of probation","2263","1933","234","-7.89","64.4","59.76","57.24","33.46","20.21","2167","1620","1716","96","58"
"2008","Alberta","48","Breach of probation","2351","1990","239","1.53","65.38","62.63","59.71","31.2","24.19","2229","1744","1833","89","69"
"2009","Alberta","48","Breach of probation","2725","2248","264","13.28","74.07","69.03","65.6","31.01","25.02","2512","1973","2061","88","71"
"2010","Alberta","48","Breach of probation","2705","2312","280","-2.16","72.47","72.27","68.08","24.85","26.98","2592","2098","2168","70","76"
"2011","Alberta","48","Breach of probation","2537","2161","255","-7.64","66.94","66.78","63.29","26.67","25.96","2416","1970","2045","75","73"
"2012","Alberta","48","Breach of probation","2719","2331","264","4.67","70.06","71.67","67.45","21.78","24.28","2595","2169","2230","61","68"
"2013","Alberta","48","Breach of probation","2502","2119","276","-10.65","62.6","61.34","57.65","16.45","26.83","2395","1916","1962","46","75"
"2014","Alberta","48","Breach of probation","2350","1972","251","-8.63","57.2","53.78","51.78","28.7","19.73","2223","1730","1810","80","55"
"2015","Alberta","48","Breach of probation","2327","1972","231","-2.67","55.67","53.17","50.67","21.46","18.24","2203","1739","1799","60","51"
"2016","Alberta","48","Breach of probation","2510","2120","248","6.01","59.02","57.74","54.84","20.85","16.61","2368","1919","1978","59","47"
"1998","Alberta","48","Other violations against the administration of law and justice (Part IV Criminal Code)","877","378","237","0","30.25","8.84","9.34","13.43","16.89","615","189","224","35","44"
"1999","Alberta","48","Other violations against the administration of law and justice (Part IV Criminal Code)","909","316","266","1.76","30.78","8.67","9.29","14.38","13.24","582","190","228","38","35"
"2000","Alberta","48","Other violations against the administration of law and justice (Part IV Criminal Code)","874","329","226","-5.5","29.09","10.31","10.6","13.1","33.31","555","231","266","35","89"
"2001","Alberta","48","Other violations against the administration of law and justice (Part IV Criminal Code)","923","335","183","3.77","30.18","10.5","10.84","13.67","36.58","518","241","278","37","99"
"2002","Alberta","48","Other violations against the administration of law and justice (Part IV Criminal Code)","923","336","227","-2.25","29.5","10.26","10.28","10.48","31.43","563","242","271","29","87"
"2003","Alberta","48","Other violations against the administration of law and justice (Part IV Criminal Code)","814","305","199","-13.33","25.57","9.16","8.95","7.15","24.68","504","221","241","20","69"
"2004","Alberta","48","Other violations against the administration of law and justice (Part IV Criminal Code)","718","251","171","-13.32","22.16","7.99","7.42","2.49","19.57","422","197","204","7","55"
"2005","Alberta","48","Other violations against the administration of law and justice (Part IV Criminal Code)","883","305","212","19.92","26.58","9.72","9.35","5.99","17.27","517","247","264","17","49"
"2006","Alberta","48","Other violations against the administration of law and justice (Part IV Criminal Code)","1097","354","437","20.63","32.06","10.89","11.02","12.19","34.48","791","286","321","35","99"
"2007","Alberta","48","Other violations against the administration of law and justice (Part IV Criminal Code)","1213","466","457","7.66","34.52","15.46","14.98","10.46","29.27","923","419","449","30","84"
"2008","Alberta","48","Other violations against the administration of law and justice (Part IV Criminal Code)","1403","585","546","13.03","39.02","16.66","16.42","14.02","32.25","1131","464","504","40","92"
"2009","Alberta","48","Other violations against the administration of law and justice (Part IV Criminal Code)","1413","503","557","-1.57","38.41","16.97","16.26","9.16","39.12","1060","485","511","26","111"
"2010","Alberta","48","Other violations against the administration of law and justice (Part IV Criminal Code)","1553","529","676","8.33","41.61","16.81","16.55","13.85","35.15","1205","488","527","39","99"
"2011","Alberta","48","Other violations against the administration of law and justice (Part IV Criminal Code)","1609","612","695","2.03","42.45","18.88","18.14","10.31","26.31","1307","557","586","29","74"
"2012","Alberta","48","Other violations against the administration of law and justice (Part IV Criminal Code)","1528","570","694","-7.25","39.37","16.82","16.88","17.49","39.27","1264","509","558","49","110"
"2013","Alberta","48","Other violations against the administration of law and justice (Part IV Criminal Code)","1461","544","628","-7.16","36.56","16.49","16.01","10.73","20.03","1172","515","545","30","56"
"2014","Alberta","48","Other violations against the administration of law and justice (Part IV Criminal Code)","1442","595","569","-3.98","35.1","17.16","16.39","7.53","20.81","1164","552","573","21","58"
"2015","Alberta","48","Other violations against the administration of law and justice (Part IV Criminal Code)","1566","652","546","6.74","37.47","18.93","18.28","10.73","16.81","1198","619","649","30","47"
"2016","Alberta","48","Other violations against the administration of law and justice (Part IV Criminal Code)","1529","738","483","-4.04","35.95","21.15","20.07","7.42","10.6","1221","703","724","21","30"
"1998","Alberta","48","Total other violations","7528","3384","2098","0","259.64","95.93","100.77","140.46","77.14","5482","2052","2418","366","201"
"1999","Alberta","48","Total other violations","4960","2304","925","-35.31","167.95","68.79","70.3","82.88","46.55","3229","1507","1726","219","123"
"2000","Alberta","48","Total other violations","4096","2023","641","-18.84","136.31","65.81","69.64","101.79","55.39","2664","1475","1747","272","148"
"2001","Alberta","48","Total other violations","4376","2047","645","4.98","143.1","63.5","67.75","103.83","76.12","2692","1457","1738","281","206"
"2002","Alberta","48","Total other violations","4345","2138","721","-2.94","138.89","65.82","69.57","101.52","89.96","2859","1553","1834","281","249"
"2003","Alberta","48","Total other violations","4286","2097","652","-3.06","134.64","62.91","66.34","95.88","66.18","2749","1518","1786","268","185"
"2004","Alberta","48","Total other violations","4178","2041","628","-4.21","128.97","62.71","64.3","78.28","74.72","2669","1547","1767","220","210"
"2005","Alberta","48","Total other violations","4329","2038","621","1.03","130.31","65.84","66.34","70.84","53.93","2659","1673","1874","201","153"
"2006","Alberta","48","Total other violations","4310","2182","792","-3.32","125.97","67.99","67.74","65.48","54.34","2974","1786","1974","188","156"
"2007","Alberta","48","Total other violations","4562","2051","872","3.06","129.82","64.52","64.48","64.13","74.93","2923","1749","1933","184","215"
"2008","Alberta","48","Total other violations","4559","1964","910","-2.34","126.79","61.98","62.8","70.81","68.01","2874","1726","1928","202","194"
"2009","Alberta","48","Total other violations","4868","2001","955","4.36","132.32","60.21","59.87","56.38","63.08","2956","1721","1881","160","179"
"2010","Alberta","48","Total other violations","4469","1784","995","-9.51","119.73","53.19","53.19","53.26","74.92","2779","1544","1694","150","211"
"2011","Alberta","48","Total other violations","4462","1857","924","-1.67","117.72","53.26","53.3","53.7","51.56","2781","1571","1722","151","145"
"2012","Alberta","48","Total other violations","4559","1855","909","-0.21","117.48","53.2","53.72","59.26","52.12","2764","1610","1776","166","146"
"2013","Alberta","48","Total other violations","4284","1839","809","-8.76","107.19","50.23","49.1","36.49","38.63","2648","1569","1671","102","108"
"2014","Alberta","48","Total other violations","4284","1840","782","-2.72","104.28","47.06","46.57","40.9","29.42","2622","1514","1628","114","82"
"2015","Alberta","48","Total other violations","4588","2050","745","5.27","109.77","52.74","51.29","34.33","27.18","2795","1725","1821","96","76"
"2016","Alberta","48","Total other violations","4521","2020","745","-3.16","106.3","50.43","48.74","28.98","26.5","2765","1676","1758","82","75"
"1998","Alberta","48","Betting house","0","0","0","0","0","0","0","0","0","0","0","0","0","0"
"1999","Alberta","48","Betting house","0","0","0","0","0","0","0","0","0","0","0","0","0","0"
"2000","Alberta","48","Betting house","1","1","0","0","0.03","0.94","0.84","0","0","1","21","21","0","0"
"2001","Alberta","48","Betting house","0","0","0","-100","0","0","0","0","0","0","0","0","0","0"
"2002","Alberta","48","Betting house","0","0","0","0","0","0","0","0","0","0","0","0","0","0"
"2003","Alberta","48","Betting house","0","0","0","0","0","0","0","0","0","0","0","0","0","0"
"2004","Alberta","48","Betting house","1","0","0","0","0.03","0","0","0","0","0","0","0","0","0"
"2005","Alberta","48","Betting house","1","0","1","-2.49","0.03","0","0","0","0","1","0","0","0","0"
"2006","Alberta","48","Betting house","0","0","0","-100","0","0","0","0","0","0","0","0","0","0"
"2007","Alberta","48","Betting house","0","0","0","0","0","0","0","0","0","0","0","0","0","0"
"2008","Alberta","48","Betting house","0","0","0","0","0","0","0","0","0","0","0","0","0","0"
"2009","Alberta","48","Betting house","0","0","0","0","0","0","0","0","0","0","0","0","0","0"
"2010","Alberta","48","Betting house","0","0","0","0","0","0","0","0","0","0","0","0","0","0"
"2011","Alberta","48","Betting house","0","0","0","0","0","0","0","0","0","0","0","0","0","0"
"2012","Alberta","48","Betting house","1","0","0","0","0.03","0","0","0","0","0","0","0","0","0"
"2013","Alberta","48","Betting house","0","0","0","-100","0","0","0","0","0","0","0","0","0","0"
"2014","Alberta","48","Betting house","0","0","0","0","0","0","0","0","0","0","0","0","0","0"
"2015","Alberta","48","Betting house","1","1","0","0","0.02","0.06","0.06","0","0","1","2","2","0","0"
"2016","Alberta","48","Betting house","0","0","0","-100","0","0","0","0","0","0","0","0","0","0"
"1998","Alberta","48","Gaming house","2","0","1","0","0.07","0","0","0","0","1","0","0","0","0"
"1999","Alberta","48","Gaming house","2","0","1","-1.82","0.07","0","0","0","0","1","0","0","0","0"
"2000","Alberta","48","Gaming house","6","19","23","194.84","0.2","1.65","1.47","0","0","42","37","37","0","0"
"2001","Alberta","48","Gaming house","4","4","0","-34.49","0.13","0.31","0.27","0","0","4","7","7","0","0"
"2002","Alberta","48","Gaming house","0","0","0","-100","0","0","0","0","0","0","0","0","0","0"
"2003","Alberta","48","Gaming house","0","0","0","0","0","0","0","0","0","0","0","0","0","0"
"2004","Alberta","48","Gaming house","0","0","0","0","0","0","0","0","0","0","0","0","0","0"
"2005","Alberta","48","Gaming house","0","0","0","0","0","0","0","0","0","0","0","0","0","0"
"2006","Alberta","48","Gaming house","2","1","1","0","0.06","0.46","0.41","0","0","2","12","12","0","0"
"2007","Alberta","48","Gaming house","1","1","0","-51.32","0.03","0.07","0.07","0","0","1","2","2","0","0"
"2008","Alberta","48","Gaming house","0","0","0","-100","0","0","0","0","0","0","0","0","0","0"
"2009","Alberta","48","Gaming house","0","0","0","0","0","0","0","0","0","0","0","0","0","0"
"2010","Alberta","48","Gaming house","3","1","0","0","0.08","0.03","0.03","0","0","1","1","1","0","0"
"2011","Alberta","48","Gaming house","1","0","1","-67.17","0.03","0","0","0","0","1","0","0","0","0"
"2012","Alberta","48","Gaming house","0","0","0","-100","0","0","0","0","0","0","0","0","0","0"
"2013","Alberta","48","Gaming house","1","1","0","0","0.03","0.03","0.03","0","0","1","1","1","0","0"
"2014","Alberta","48","Gaming house","0","0","0","-100","0","0","0","0","0","0","0","0","0","0"
"2015","Alberta","48","Gaming house","1","0","0","0","0.02","0","0","0","0","0","0","0","0","0"
"2016","Alberta","48","Gaming house","1","0","0","-1.72","0.02","0","0","0","0","0","0","0","0","0"
"2003","Alberta","48","Indecent acts","598","123","85","8.42","18.78","4.64","4.42","2.5","10.37","208","112","119","7","29"
"2004","Alberta","48","Indecent acts","677","128","119","11.25","20.9","4.74","4.48","2.13","12.1","247","117","123","6","34"
"2005","Alberta","48","Indecent acts","684","133","114","-1.48","20.59","4.8","4.67","3.52","6.7","247","122","132","10","19"
"2006","Alberta","48","Indecent acts","597","119","121","-15.25","17.45","3.84","3.77","3.13","7.31","240","101","110","9","21"
"1998","Alberta","48","Other violations related to gaming and betting","40","10","2","0","1.38","0.47","0.42","0","0","12","10","10","0","0"
"2007","Alberta","48","Indecent acts","552","108","120","-9.98","15.71","3.32","3.24","2.44","10.11","228","90","97","7","29"
"1999","Alberta","48","Other violations related to gaming and betting","36","11","6","-11.64","1.22","1.1","0.98","0","0","17","24","24","0","0"
"2008","Alberta","48","Indecent acts","530","94","106","-6.17","14.74","3.12","3","1.75","11.57","200","87","92","5","33"
"2000","Alberta","48","Other violations related to gaming and betting","12","5","3","-67.24","0.4","0.27","0.24","0","0","8","6","6","0","0"
"2009","Alberta","48","Indecent acts","670","128","127","23.55","18.21","3.95","3.72","1.41","9.51","255","113","117","4","27"
"2001","Alberta","48","Other violations related to gaming and betting","20","8","1","63.77","0.65","0.44","0.39","0","0","9","10","10","0","0"
"2010","Alberta","48","Indecent acts","599","129","111","-11.88","16.05","3.65","3.45","1.42","6.39","240","106","110","4","18"
"2002","Alberta","48","Other violations related to gaming and betting","12","7","0","-41.35","0.38","0.34","0.3","0","0","7","8","8","0","0"
"2011","Alberta","48","Indecent acts","563","120","98","-7.44","14.85","3.22","3.31","4.27","8.89","218","95","107","12","25"
"2003","Alberta","48","Other violations related to gaming and betting","18","5","4","47.41","0.57","0.5","0.45","0","0.36","9","12","12","0","1"
"2012","Alberta","48","Indecent acts","584","104","93","1.31","15.05","2.94","2.87","2.14","5.36","197","89","95","6","15"
"2004","Alberta","48","Other violations related to gaming and betting","14","6","3","-23.57","0.43","0.24","0.22","0","0.71","9","6","6","0","2"
"2013","Alberta","48","Indecent acts","500","101","95","-16.87","12.51","2.91","2.76","1.07","9.3","196","91","94","3","26"
"2005","Alberta","48","Other violations related to gaming and betting","8","6","3","-44.28","0.24","0.47","0.42","0","0","9","12","12","0","0"
"2014","Alberta","48","Indecent acts","535","103","80","4.09","13.02","2.7","2.66","2.15","2.87","183","87","93","6","8"
"2006","Alberta","48","Other violations related to gaming and betting","10","7","2","21.38","0.29","0.27","0.24","0","0","9","7","7","0","0"
"2015","Alberta","48","Indecent acts","548","122","84","0.68","13.11","3.3","3.1","0.72","2.5","206","108","110","2","7"
"2007","Alberta","48","Other violations related to gaming and betting","11","6","3","7.1","0.31","0.15","0.13","0","0","9","4","4","0","0"
"2016","Alberta","48","Indecent acts","527","131","76","-5.49","12.39","2.98","2.88","1.77","4.24","207","99","104","5","12"
"2008","Alberta","48","Other violations related to gaming and betting","21","9","7","86.57","0.58","0.36","0.33","0","0","16","10","10","0","0"
"1998","Alberta","48","Indecent acts","602","152","85","0","20.76","11.17","10.42","4.22","6.14","237","239","250","11","16"
"2009","Alberta","48","Other violations related to gaming and betting","18","9","4","-16.23","0.49","0.31","0.29","0","0","13","9","9","0","0"
"1999","Alberta","48","Indecent acts","711","160","109","15.95","24.08","6.07","5.74","3.03","9.08","269","133","141","8","24"
"2010","Alberta","48","Other violations related to gaming and betting","8","7","1","-56.19","0.21","0.24","0.22","0","0","8","7","7","0","0"
"2000","Alberta","48","Indecent acts","671","155","69","-7.25","22.33","5.58","5.7","6.74","7.86","224","125","143","18","21"
"2011","Alberta","48","Other violations related to gaming and betting","3","2","0","-63.07","0.08","0.07","0.06","0","0","2","2","2","0","0"
"2001","Alberta","48","Indecent acts","588","114","102","-13.89","19.23","4.53","4.21","1.48","14.04","216","104","108","4","38"
"2012","Alberta","48","Other violations related to gaming and betting","7","2","2","127.89","0.18","0.07","0.06","0","0","4","2","2","0","0"
"2002","Alberta","48","Indecent acts","542","144","91","-9.9","17.33","4.66","4.82","6.14","10.12","235","110","127","17","28"
"2013","Alberta","48","Other violations related to gaming and betting","3","1","2","-58.39","0.08","0.03","0.03","0","0","3","1","1","0","0"
"2014","Alberta","48","Other violations related to gaming and betting","5","3","0","62.14","0.12","0.09","0.09","0","0","3","3","3","0","0"
"2015","Alberta","48","Other violations related to gaming and betting","5","1","2","-1.71","0.12","0.06","0.06","0","0","3","2","2","0","0"
"2016","Alberta","48","Other violations related to gaming and betting","1","1","0","-80.34","0.02","0.03","0.03","0","0","1","1","1","0","0"
"1998","Alberta","48","Corrupting morals","44","17","5","0","1.52","0.51","0.5","0.38","0","22","11","12","1","0"
"1999","Alberta","48","Corrupting morals","36","5","3","-19.67","1.22","0.27","0.24","0","0","8","6","6","0","0"
"2000","Alberta","48","Corrupting morals","21","16","2","-42.67","0.7","0.31","0.28","0","0","18","7","7","0","0"
"2001","Alberta","48","Corrupting morals","38","15","7","77.81","1.24","0.52","0.47","0","0","22","12","12","0","0"
"2002","Alberta","48","Corrupting morals","47","8","7","20.9","1.5","0.3","0.3","0.36","0.36","15","7","8","1","1"
"2003","Alberta","48","Corrupting morals","23","5","5","-51.91","0.72","0.17","0.15","0","0.72","10","4","4","0","2"
"2004","Alberta","48","Corrupting morals","17","3","3","-27.37","0.52","0.12","0.11","0","1.07","6","3","3","0","3"
"2005","Alberta","48","Corrupting morals","11","2","2","-36.91","0.33","0.2","0.18","0","0","4","5","5","0","0"
"2006","Alberta","48","Corrupting morals","5","1","1","-55.86","0.15","0.04","0.03","0","0","2","1","1","0","0"
"2007","Alberta","48","Corrupting morals","8","0","6","55.78","0.23","0","0","0","0.35","6","0","0","0","1"
"2008","Alberta","48","Corrupting morals","6","2","3","-26.7","0.17","0.07","0.07","0","0","5","2","2","0","0"
"2009","Alberta","48","Corrupting morals","11","0","4","79.18","0.3","0","0","0","0.7","4","0","0","0","2"
"2012","Alberta","48","Common Bawdy House","0","0","0","0","0","0","0","0","0","0","0","0","0","0"
"2010","Alberta","48","Corrupting morals","11","0","1","-1.43","0.29","0","0","0","0","1","0","0","0","0"
"2013","Alberta","48","Common Bawdy House","0","0","0","0","0","0","0","0","0","0","0","0","0","0"
"2011","Alberta","48","Corrupting morals","5","2","3","-55.24","0.13","0.07","0.06","0","0.71","5","2","2","0","2"
"2014","Alberta","48","Common Bawdy House","0","0","0","0","0","0","0","0","0","0","0","0","0","0"
"2012","Alberta","48","Corrupting morals","10","0","4","95.33","0.26","0","0","0","0","4","0","0","0","0"
"2015","Alberta","48","Common Bawdy House","1","0","0","0","0.02","0","0","0","0","0","0","0","0","0"
"2013","Alberta","48","Corrupting morals","16","2","4","55.36","0.4","0.03","0.03","0","0.36","6","1","1","0","1"
"2016","Alberta","48","Common Bawdy House","2","0","0","96.56","0.05","0","0","0","0","0","0","0","0","0"
"2014","Alberta","48","Corrupting morals","11","0","3","-33.12","0.27","0","0","0","0.72","3","0","0","0","2"
"2015","Alberta","48","Corrupting morals","11","1","2","-1.71","0.26","0","0","0","0","3","0","0","0","0"
"2016","Alberta","48","Corrupting morals","7","0","3","-37.46","0.16","0","0","0","0.71","3","0","0","0","2"
"1998","Alberta","48","Obstruct public or peace officer","1717","1656","56","0","59.22","49.28","50.09","56.8","1.15","1712","1054","1202","148","3"
"1999","Alberta","48","Obstruct public or peace officer","1599","1470","76","-8.57","54.14","45.19","45.21","45.41","4.92","1546","990","1110","120","13"
"2000","Alberta","48","Obstruct public or peace officer","1501","1407","68","-7.74","49.95","45.69","47.16","59.5","5.61","1475","1024","1183","159","15"
"2001","Alberta","48","Obstruct public or peace officer","1530","1478","75","0.16","50.03","44.19","45.65","58.01","8.87","1553","1014","1171","157","24"
"2002","Alberta","48","Obstruct public or peace officer","1651","1508","126","5.48","52.78","46.45","46.88","50.58","6.14","1634","1096","1236","140","17"
"2003","Alberta","48","Obstruct public or peace officer","1682","1487","170","0.12","52.84","43.48","44.13","49.73","9.66","1657","1049","1188","139","27"
"2004","Alberta","48","Obstruct public or peace officer","1628","1453","169","-4.89","50.26","43.09","43.01","42.34","12.45","1622","1063","1182","119","35"
"2005","Alberta","48","Obstruct public or peace officer","1555","1398","141","-6.86","46.81","44.27","43.51","36.66","10.93","1539","1125","1229","104","31"
"2006","Alberta","48","Obstruct public or peace officer","1675","1552","128","4.6","48.96","49.34","48.25","38.31","12.54","1680","1296","1406","110","36"
"2007","Alberta","48","Obstruct public or peace officer","1620","1425","171","-5.83","46.1","46.26","45.46","37.99","10.46","1596","1254","1363","109","30"
"2008","Alberta","48","Obstruct public or peace officer","1556","1369","175","-6.13","43.27","42.62","42.41","40.32","10.52","1544","1187","1302","115","30"
"2009","Alberta","48","Obstruct public or peace officer","1577","1378","170","-0.95","42.86","41.99","41.47","36.3","11.98","1548","1200","1303","103","34"
"2010","Alberta","48","Obstruct public or peace officer","1381","1195","178","-13.68","37","35.59","35.33","32.67","14.2","1373","1033","1125","92","40"
"2011","Alberta","48","Obstruct public or peace officer","1419","1196","194","1.19","37.44","34.61","34.48","33.07","10.31","1390","1021","1114","93","29"
"2012","Alberta","48","Obstruct public or peace officer","1453","1247","188","0.01","37.44","36.35","36.02","32.49","11.78","1435","1100","1191","91","33"
"2013","Alberta","48","Obstruct public or peace officer","1330","1152","155","-11.12","33.28","31.08","30.32","21.82","8.94","1307","971","1032","61","25"
"2014","Alberta","48","Obstruct public or peace officer","1364","1171","162","-0.23","33.2","29.35","28.66","20.81","6.82","1333","944","1002","58","19"
"2015","Alberta","48","Obstruct public or peace officer","1453","1254","175","4.71","34.76","30.61","29.86","21.1","5.36","1429","1001","1060","59","15"
"2016","Alberta","48","Obstruct public or peace officer","1383","1157","167","-6.46","32.52","27.02","26.2","16.61","5.65","1324","898","945","47","16"
"1998","Alberta","48","Trespass at night","436","95","114","0","15.04","2.52","3.17","8.44","6.91","209","54","76","22","18"
"1999","Alberta","48","Trespass at night","432","73","131","-2.72","14.63","2.05","2.12","2.65","18.16","204","45","52","7","48"
"2000","Alberta","48","Trespass at night","415","78","99","-5.59","13.81","2.63","2.99","5.99","21.71","177","59","75","16","58"
"2001","Alberta","48","Trespass at night","387","66","75","-8.37","12.66","2.44","3.2","9.61","15.89","141","56","82","26","43"
"2002","Alberta","48","Trespass at night","442","88","97","11.64","14.13","3.05","3.6","8.31","27.46","185","72","95","23","76"
"2003","Alberta","48","Trespass at night","411","76","98","-8.62","12.91","2.82","3.49","9.3","22.9","174","68","94","26","64"
"2004","Alberta","48","Trespass at night","418","54","82","-0.06","12.9","2.07","2.47","6.05","24.91","136","51","68","17","70"
"2005","Alberta","48","Trespass at night","413","44","53","-3.66","12.43","1.38","1.52","2.82","14.1","97","35","43","8","40"
"2006","Alberta","48","Trespass at night","356","36","75","-16.3","10.41","1.14","1.13","1.04","4.88","111","30","33","3","14"
"2007","Alberta","48","Trespass at night","355","30","85","-2.91","10.1","0.7","0.87","2.44","19.87","115","19","26","7","57"
"2008","Alberta","48","Trespass at night","366","28","71","0.76","10.18","0.72","1.01","3.86","7.01","99","20","31","11","20"
"2009","Alberta","48","Trespass at night","420","32","89","12.15","11.42","0.66","0.99","4.23","13.39","121","19","31","12","38"
"2010","Alberta","48","Trespass at night","430","26","76","0.91","11.52","0.55","0.85","3.91","17.4","102","16","27","11","49"
"2011","Alberta","48","Trespass at night","370","27","69","-15.26","9.76","0.71","0.71","0.71","13.16","96","21","23","2","37"
"2012","Alberta","48","Trespass at night","352","27","62","-7.09","9.07","0.56","0.7","2.14","6.78","89","17","23","6","19"
"2013","Alberta","48","Trespass at night","317","29","48","-12.55","7.93","0.61","0.59","0.36","4.29","77","19","20","1","12"
"2014","Alberta","48","Trespass at night","325","38","44","-0.26","7.91","0.75","0.8","1.43","3.95","82","24","28","4","11"
"2015","Alberta","48","Trespass at night","363","25","35","9.78","8.68","0.58","0.62","1.07","2.86","60","19","22","3","8"
"2016","Alberta","48","Trespass at night","383","28","45","3.69","9.01","0.6","0.55","0","2.12","73","20","20","0","6"
"2005","Alberta","48","Utter threats to property or animal","2","0","1","0","0.06","0","0","0","0","1","0","0","0","0"
"2006","Alberta","48","Utter threats to property or animal","1","1","0","-51.45","0.03","0.04","0.07","0.35","0","1","1","2","1","0"
"2007","Alberta","48","Utter threats to property or animal","6","2","1","484.18","0.17","0.07","0.07","0","0","3","2","2","0","0"
"2008","Alberta","48","Utter threats to property or animal","27","7","6","339.77","0.75","0.18","0.2","0.35","0.7","13","5","6","1","2"
"2009","Alberta","48","Utter threats to property or animal","151","18","73","446.59","4.1","0.56","0.51","0","3.17","91","16","16","0","9"
"2010","Alberta","48","Utter threats to property or animal","536","37","360","249.88","14.36","0.9","1","2.13","18.11","397","26","32","6","51"
"2011","Alberta","48","Utter threats to property or animal","546","52","317","0.32","14.41","1.59","1.55","1.07","11.02","369","47","50","3","31"
"2012","Alberta","48","Utter threats to property or animal","570","48","335","1.96","14.69","1.26","1.3","1.79","12.14","383","38","43","5","34"
"2013","Alberta","48","Utter threats to property or animal","528","53","306","-10.05","13.21","1.41","1.35","0.72","10.37","359","44","46","2","29"
"2014","Alberta","48","Utter threats to property or animal","509","49","287","-6.22","12.39","1.31","1.23","0.36","6.46","336","42","43","1","18"
"2015","Alberta","48","Utter threats to property or animal","540","54","275","4.28","12.92","1.41","1.41","1.43","8.23","329","46","50","4","23"
"2016","Alberta","48","Utter threats to property or animal","573","59","274","4.28","13.47","1.44","1.39","0.71","8.13","333","48","50","2","23"
"2005","Alberta","48","Advocating genocide","0","0","0","0","0","0","0","0","0","0","0","0","0","0"
"2006","Alberta","48","Advocating genocide","0","0","0","0","0","0","0","0","0","0","0","0","0","0"
"2007","Alberta","48","Advocating genocide","0","0","0","0","0","0","0","0","0","0","0","0","0","0"
"2008","Alberta","48","Advocating genocide","0","0","0","0","0","0","0","0","0","0","0","0","0","0"
"2009","Alberta","48","Advocating genocide","0","0","0","0","0","0","0","0","0","0","0","0","0","0"
"2010","Alberta","48","Advocating genocide","0","0","0","0","0","0","0","0","0","0","0","0","0","0"
"2011","Alberta","48","Advocating genocide","0","0","0","0","0","0","0","0","0","0","0","0","0","0"
"2012","Alberta","48","Advocating genocide","1","0","0","0","0.03","0","0","0","0","0","0","0","0","0"
"2013","Alberta","48","Advocating genocide","0","0","0","-100","0","0","0","0","0","0","0","0","0","0"
"2014","Alberta","48","Advocating genocide","0","0","0","0","0","0","0","0","0","0","0","0","0","0"
"2015","Alberta","48","Advocating genocide","1","0","0","0","0.02","0","0","0","0","0","0","0","0","0"
"2016","Alberta","48","Advocating genocide","0","0","0","-100","0","0","0","0","0","0","0","0","0","0"
"2005","Alberta","48","Public incitement of hatred","0","0","0","0","0","0","0","0","0","0","0","0","0","0"
"2006","Alberta","48","Public incitement of hatred","1","1","0","0","0.03","0.04","0.03","0","0","1","1","1","0","0"
"2007","Alberta","48","Public incitement of hatred","0","0","0","-100","0","0","0","0","0","0","0","0","0","0"
"2008","Alberta","48","Public incitement of hatred","1","1","0","0","0.03","0.04","0.03","0","0","1","1","1","0","0"
"2009","Alberta","48","Public incitement of hatred","3","0","0","193.2","0.08","0","0","0","0","0","0","0","0","0"
"2010","Alberta","48","Public incitement of hatred","5","0","0","64.28","0.13","0","0","0","0","0","0","0","0","0"
"2011","Alberta","48","Public incitement of hatred","1","0","1","-80.3","0.03","0","0","0","0","1","0","0","0","0"
"2012","Alberta","48","Public incitement of hatred","4","0","0","290.67","0.1","0","0","0","0","0","0","0","0","0"
"2013","Alberta","48","Public incitement of hatred","2","0","1","-51.45","0.05","0","0","0","0","1","0","0","0","0"
"2014","Alberta","48","Public incitement of hatred","7","6","0","240.49","0.17","0.12","0.11","0","0","6","4","4","0","0"
"2015","Alberta","48","Public incitement of hatred","7","0","1","-1.71","0.17","0","0","0","0","1","0","0","0","0"
"2016","Alberta","48","Public incitement of hatred","6","0","1","-15.76","0.14","0","0","0","0","1","0","0","0","0"
"2005","Alberta","48","Unauthorized recording of a movie","0","0","0","0","0","0","0","0","0","0","0","0","0","0"
"2006","Alberta","48","Unauthorized recording of a movie","0","0","0","0","0","0","0","0","0","0","0","0","0","0"
"2007","Alberta","48","Unauthorized recording of a movie","1","1","0","0","0.03","0.04","0.03","0","0","1","1","1","0","0"
"2008","Alberta","48","Unauthorized recording of a movie","2","0","0","95.45","0.06","0","0","0","0","0","0","0","0","0"
"2009","Alberta","48","Unauthorized recording of a movie","2","0","1","-2.27","0.05","0","0","0","0","1","0","0","0","0"
"2010","Alberta","48","Unauthorized recording of a movie","1","0","0","-50.72","0.03","0","0","0","0","0","0","0","0","0"
"2011","Alberta","48","Unauthorized recording of a movie","0","0","0","-100","0","0","0","0","0","0","0","0","0","0"
"2012","Alberta","48","Unauthorized recording of a movie","0","0","0","0","0","0","0","0","0","0","0","0","0","0"
"2013","Alberta","48","Unauthorized recording of a movie","2","0","2","0","0.05","0","0","0","0","2","0","0","0","0"
"2014","Alberta","48","Unauthorized recording of a movie","2","1","1","-2.72","0.05","0.03","0.03","0","0.36","2","1","1","0","1"
"2015","Alberta","48","Unauthorized recording of a movie","0","0","0","-100","0","0","0","0","0","0","0","0","0","0"
"2016","Alberta","48","Unauthorized recording of a movie","0","0","0","0","0","0","0","0","0","0","0","0","0","0"
"1998","Alberta","48","Offences against public order (Part II Criminal Code)","179","50","52","0","6.17","1.31","1.33","1.54","1.54","102","28","32","4","4"
"1999","Alberta","48","Offences against public order (Part II Criminal Code)","138","41","63","-24.31","4.67","1.14","1.18","1.51","1.51","104","25","29","4","4"
"2000","Alberta","48","Offences against public order (Part II Criminal Code)","151","19","53","7.54","5.03","0.71","0.84","1.87","2.99","72","16","21","5","8"
"2001","Alberta","48","Offences against public order (Part II Criminal Code)","115","23","24","-25.16","3.76","0.96","1.05","1.85","4.43","47","22","27","5","12"
"2002","Alberta","48","Offences against public order (Part II Criminal Code)","121","21","21","2.85","3.87","0.76","0.87","1.81","2.89","42","18","23","5","8"
"2003","Alberta","48","Offences against public order (Part II Criminal Code)","122","22","28","-0.92","3.83","0.66","0.74","1.43","3.94","50","16","20","4","11"
"2004","Alberta","48","Offences against public order (Part II Criminal Code)","125","20","35","0.69","3.86","0.57","0.55","0.36","2.49","55","14","15","1","7"
"2005","Alberta","48","Offences against public order (Part II Criminal Code)","114","24","35","-11.07","3.43","0.87","0.81","0.35","0.7","59","22","23","1","2"
"2006","Alberta","48","Offences against public order (Part II Criminal Code)","79","47","14","-32.71","2.31","1.41","1.34","0.7","1.04","61","37","39","2","3"
"2007","Alberta","48","Offences against public order (Part II Criminal Code)","48","31","10","-40.84","1.37","1.03","0.97","0.35","0.35","41","28","29","1","1"
"2008","Alberta","48","Offences against public order (Part II Criminal Code)","46","21","10","-6.34","1.28","0.75","0.68","0","0.35","31","21","21","0","1"
"2009","Alberta","48","Offences against public order (Part II Criminal Code)","54","42","6","14.73","1.47","1.43","1.37","0.7","0","48","41","43","2","0"
"2010","Alberta","48","Offences against public order (Part II Criminal Code)","63","42","12","15","1.69","1.45","1.38","0.71","0","54","42","44","2","0"
"2011","Alberta","48","Offences against public order (Part II Criminal Code)","77","52","12","20.36","2.03","1.56","1.67","2.84","0","64","46","54","8","0"
"2012","Alberta","48","Offences against public order (Part II Criminal Code)","54","42","8","-31.51","1.39","1.39","1.33","0.71","0.36","50","42","44","2","1"
"2013","Alberta","48","Offences against public order (Part II Criminal Code)","42","28","9","-24.48","1.05","0.86","0.82","0.36","0","37","27","28","1","0"
"2014","Alberta","48","Offences against public order (Part II Criminal Code)","44","26","4","1.91","1.07","0.71","0.69","0.36","0.72","30","23","24","1","2"
"2015","Alberta","48","Offences against public order (Part II Criminal Code)","48","32","1","7.23","1.15","0.89","0.82","0","0","33","29","29","0","0"
"2016","Alberta","48","Offences against public order (Part II Criminal Code)","51","29","9","4.42","1.2","0.78","0.83","1.41","0.71","38","26","30","4","2"
"2002","Alberta","48","Property or service for terrorist activity","0","0","0","0","0","0","0","0","0","0","0","0","0","0"
"2003","Alberta","48","Property or service for terrorist activity","0","0","0","0","0","0","0","0","0","0","0","0","0","0"
"2004","Alberta","48","Property or service for terrorist activity","0","0","0","0","0","0","0","0","0","0","0","0","0","0"
"2005","Alberta","48","Property or service for terrorist activity","0","0","0","0","0","0","0","0","0","0","0","0","0","0"
"2006","Alberta","48","Property or service for terrorist activity","0","0","0","0","0","0","0","0","0","0","0","0","0","0"
"2007","Alberta","48","Property or service for terrorist activity","0","0","0","0","0","0","0","0","0","0","0","0","0","0"
"2008","Alberta","48","Property or service for terrorist activity","2","0","0","0","0.06","0","0","0","0","0","0","0","0","0"
"2009","Alberta","48","Property or service for terrorist activity","1","0","0","-51.13","0.03","0","0","0","0","0","0","0","0","0"
"2010","Alberta","48","Property or service for terrorist activity","1","0","0","-1.43","0.03","0","0","0","0","0","0","0","0","0"
"2011","Alberta","48","Property or service for terrorist activity","4","0","0","293.92","0.11","0","0","0","0","0","0","0","0","0"
"2012","Alberta","48","Property or service for terrorist activity","2","1","0","-51.17","0.05","0.03","0.03","0","0","1","1","1","0","0"
"2013","Alberta","48","Property or service for terrorist activity","3","0","0","45.65","0.08","0","0","0","0","0","0","0","0","0"
"2014","Alberta","48","Property or service for terrorist activity","0","0","0","-100","0","0","0","0","0","0","0","0","0","0"
"2015","Alberta","48","Property or service for terrorist activity","3","0","0","0","0.07","0","0","0","0","0","0","0","0","0"
"2016","Alberta","48","Property or service for terrorist activity","3","0","0","-1.72","0.07","0","0","0","0","0","0","0","0","0"
"2002","Alberta","48","Freezing of property, disclosure or audit","0","0","0","0","0","0","0","0","0","0","0","0","0","0"
"2003","Alberta","48","Freezing of property, disclosure or audit","0","0","0","0","0","0","0","0","0","0","0","0","0","0"
"2004","Alberta","48","Freezing of property, disclosure or audit","0","0","0","0","0","0","0","0","0","0","0","0","0","0"
"2005","Alberta","48","Freezing of property, disclosure or audit","0","0","0","0","0","0","0","0","0","0","0","0","0","0"
"2006","Alberta","48","Freezing of property, disclosure or audit","0","0","0","0","0","0","0","0","0","0","0","0","0","0"
"2007","Alberta","48","Freezing of property, disclosure or audit","0","0","0","0","0","0","0","0","0","0","0","0","0","0"
"2008","Alberta","48","Freezing of property, disclosure or audit","0","0","0","0","0","0","0","0","0","0","0","0","0","0"
"2009","Alberta","48","Freezing of property, disclosure or audit","0","0","0","0","0","0","0","0","0","0","0","0","0","0"
"2010","Alberta","48","Freezing of property, disclosure or audit","0","0","0","0","0","0","0","0","0","0","0","0","0","0"
"2011","Alberta","48","Freezing of property, disclosure or audit","0","0","0","0","0","0","0","0","0","0","0","0","0","0"
"2012","Alberta","48","Freezing of property, disclosure or audit","0","0","0","0","0","0","0","0","0","0","0","0","0","0"
"2013","Alberta","48","Freezing of property, disclosure or audit","0","0","0","0","0","0","0","0","0","0","0","0","0","0"
"2014","Alberta","48","Freezing of property, disclosure or audit","0","0","0","0","0","0","0","0","0","0","0","0","0","0"
"2015","Alberta","48","Freezing of property, disclosure or audit","0","0","0","0","0","0","0","0","0","0","0","0","0","0"
"2016","Alberta","48","Freezing of property, disclosure or audit","0","0","0","0","0","0","0","0","0","0","0","0","0","0"
"2002","Alberta","48","Participate in activity of terrorist group","0","0","0","0","0","0","0","0","0","0","0","0","0","0"
"2003","Alberta","48","Participate in activity of terrorist group","0","0","0","0","0","0","0","0","0","0","0","0","0","0"
"2004","Alberta","48","Participate in activity of terrorist group","0","0","0","0","0","0","0","0","0","0","0","0","0","0"
"2005","Alberta","48","Participate in activity of terrorist group","0","0","0","0","0","0","0","0","0","0","0","0","0","0"
"2006","Alberta","48","Participate in activity of terrorist group","0","0","0","0","0","0","0","0","0","0","0","0","0","0"
"2007","Alberta","48","Participate in activity of terrorist group","1","0","0","0","0.03","0","0","0","0","0","0","0","0","0"
"2008","Alberta","48","Participate in activity of terrorist group","1","0","0","-2.27","0.03","0","0","0","0","0","0","0","0","0"
"2009","Alberta","48","Participate in activity of terrorist group","2","0","0","95.47","0.05","0","0","0","0","0","0","0","0","0"
"2010","Alberta","48","Participate in activity of terrorist group","4","0","0","97.13","0.11","0","0","0","0","0","0","0","0","0"
"2011","Alberta","48","Participate in activity of terrorist group","1","0","0","-75.38","0.03","0","0","0","0","0","0","0","0","0"
"2012","Alberta","48","Participate in activity of terrorist group","3","0","0","193","0.08","0","0","0","0","0","0","0","0","0"
"2013","Alberta","48","Participate in activity of terrorist group","6","0","0","94.2","0.15","0","0","0","0","0","0","0","0","0"
"2014","Alberta","48","Participate in activity of terrorist group","3","0","0","-51.36","0.07","0","0","0","0","0","0","0","0","0"
"2015","Alberta","48","Participate in activity of terrorist group","6","0","0","96.58","0.14","0","0","0","0","0","0","0","0","0"
"2016","Alberta","48","Participate in activity of terrorist group","3","0","0","-50.86","0.07","0","0","0","0","0","0","0","0","0"
"2002","Alberta","48","Facilitate terrorist activity","0","0","0","0","0","0","0","0","0","0","0","0","0","0"
"2003","Alberta","48","Facilitate terrorist activity","0","0","0","0","0","0","0","0","0","0","0","0","0","0"
"2004","Alberta","48","Facilitate terrorist activity","0","0","0","0","0","0","0","0","0","0","0","0","0","0"
"2005","Alberta","48","Facilitate terrorist activity","0","0","0","0","0","0","0","0","0","0","0","0","0","0"
"2006","Alberta","48","Facilitate terrorist activity","2","0","1","0","0.06","0","0","0","0","1","0","0","0","0"
"2007","Alberta","48","Facilitate terrorist activity","0","0","0","-100","0","0","0","0","0","0","0","0","0","0"
"2008","Alberta","48","Facilitate terrorist activity","1","0","0","0","0.03","0","0","0","0","0","0","0","0","0"
"2009","Alberta","48","Facilitate terrorist activity","0","0","0","-100","0","0","0","0","0","0","0","0","0","0"
"2010","Alberta","48","Facilitate terrorist activity","0","0","0","0","0","0","0","0","0","0","0","0","0","0"
"2011","Alberta","48","Facilitate terrorist activity","1","0","0","0","0.03","0","0","0","0","0","0","0","0","0"
"2012","Alberta","48","Facilitate terrorist activity","1","0","0","-2.33","0.03","0","0","0","0","0","0","0","0","0"
"2013","Alberta","48","Facilitate terrorist activity","0","0","0","-100","0","0","0","0","0","0","0","0","0","0"
"2014","Alberta","48","Facilitate terrorist activity","3","0","0","0","0.07","0","0","0","0","0","0","0","0","0"
"2015","Alberta","48","Facilitate terrorist activity","5","0","0","63.82","0.12","0","0","0","0","0","0","0","0","0"
"2016","Alberta","48","Facilitate terrorist activity","2","0","0","-60.69","0.05","0","0","0","0","0","0","0","0","0"
"2002","Alberta","48","Commission or instructing to carry out terrorist activity","0","0","0","0","0","0","0","0","0","0","0","0","0","0"
"2003","Alberta","48","Commission or instructing to carry out terrorist activity","0","0","0","0","0","0","0","0","0","0","0","0","0","0"
"2004","Alberta","48","Commission or instructing to carry out terrorist activity","0","0","0","0","0","0","0","0","0","0","0","0","0","0"
"2005","Alberta","48","Commission or instructing to carry out terrorist activity","0","0","0","0","0","0","0","0","0","0","0","0","0","0"
"2006","Alberta","48","Commission or instructing to carry out terrorist activity","1","1","0","0","0.03","0","0","0","0","1","0","0","0","0"
"2007","Alberta","48","Commission or instructing to carry out terrorist activity","0","0","0","-100","0","0","0","0","0","0","0","0","0","0"
"2008","Alberta","48","Commission or instructing to carry out terrorist activity","0","0","0","0","0","0","0","0","0","0","0","0","0","0"
"2009","Alberta","48","Commission or instructing to carry out terrorist activity","1","0","0","0","0.03","0","0","0","0","0","0","0","0","0"
"2010","Alberta","48","Commission or instructing to carry out terrorist activity","0","0","0","-100","0","0","0","0","0","0","0","0","0","0"
"2011","Alberta","48","Commission or instructing to carry out terrorist activity","0","0","0","0","0","0","0","0","0","0","0","0","0","0"
"2012","Alberta","48","Commission or instructing to carry out terrorist activity","1","0","0","0","0.03","0","0","0","0","0","0","0","0","0"
"2013","Alberta","48","Commission or instructing to carry out terrorist activity","0","0","0","-100","0","0","0","0","0","0","0","0","0","0"
"2014","Alberta","48","Commission or instructing to carry out terrorist activity","1","0","0","0","0.02","0","0","0","0","0","0","0","0","0"
"2015","Alberta","48","Commission or instructing to carry out terrorist activity","0","1","0","-100","0","0.03","0.03","0","0","1","1","1","0","0"
"2016","Alberta","48","Commission or instructing to carry out terrorist activity","1","0","1","0","0.02","0","0","0","0","1","0","0","0","0"
"2002","Alberta","48","Harbour or conceal terrorist","0","0","0","0","0","0","0","0","0","0","0","0","0","0"
"2003","Alberta","48","Harbour or conceal terrorist","0","0","0","0","0","0","0","0","0","0","0","0","0","0"
"2004","Alberta","48","Harbour or conceal terrorist","0","0","0","0","0","0","0","0","0","0","0","0","0","0"
"2005","Alberta","48","Harbour or conceal terrorist","0","0","0","0","0","0","0","0","0","0","0","0","0","0"
"2006","Alberta","48","Harbour or conceal terrorist","0","0","0","0","0","0","0","0","0","0","0","0","0","0"
"2007","Alberta","48","Harbour or conceal terrorist","0","0","0","0","0","0","0","0","0","0","0","0","0","0"
"2008","Alberta","48","Harbour or conceal terrorist","0","0","0","0","0","0","0","0","0","0","0","0","0","0"
"2009","Alberta","48","Harbour or conceal terrorist","0","0","0","0","0","0","0","0","0","0","0","0","0","0"
"2010","Alberta","48","Harbour or conceal terrorist","0","0","0","0","0","0","0","0","0","0","0","0","0","0"
"2011","Alberta","48","Harbour or conceal terrorist","0","0","0","0","0","0","0","0","0","0","0","0","0","0"
"2012","Alberta","48","Harbour or conceal terrorist","0","0","0","0","0","0","0","0","0","0","0","0","0","0"
"2013","Alberta","48","Harbour or conceal terrorist","0","0","0","0","0","0","0","0","0","0","0","0","0","0"
"2014","Alberta","48","Harbour or conceal terrorist","0","0","0","0","0","0","0","0","0","0","0","0","0","0"
"2015","Alberta","48","Harbour or conceal terrorist","0","0","0","0","0","0","0","0","0","0","0","0","0","0"
"2016","Alberta","48","Harbour or conceal terrorist","0","0","0","0","0","0","0","0","0","0","0","0","0","0"
"2005","Alberta","48","Hoax terrorism","0","0","0","0","0","0","0","0","0","0","0","0","0","0"
"2006","Alberta","48","Hoax terrorism","1","0","0","0","0.03","0","0","0","0","0","0","0","0","0"
"2007","Alberta","48","Hoax terrorism","0","0","0","-100","0","0","0","0","0","0","0","0","0","0"
"2008","Alberta","48","Hoax terrorism","1","0","0","0","0.03","0","0","0","0","0","0","0","0","0"
"2009","Alberta","48","Hoax terrorism","4","0","1","290.94","0.11","0","0","0","0","1","0","0","0","0"
"2010","Alberta","48","Hoax terrorism","0","0","0","-100","0","0","0","0","0","0","0","0","0","0"
"2011","Alberta","48","Hoax terrorism","0","0","0","0","0","0","0","0","0","0","0","0","0","0"
"2012","Alberta","48","Hoax terrorism","0","0","0","0","0","0","0","0","0","0","0","0","0","0"
"2013","Alberta","48","Hoax terrorism","0","0","0","0","0","0","0","0","0","0","0","0","0","0"
"2014","Alberta","48","Hoax terrorism","2","0","0","0","0.05","0","0","0","0","0","0","0","0","0"
"2015","Alberta","48","Hoax terrorism","4","1","1","96.58","0.1","0.03","0.03","0","0.36","2","1","1","0","1"
"2016","Alberta","48","Hoax terrorism","1","2","0","-75.43","0.02","0.06","0.06","0","0","2","2","2","0","0"
"2012","Alberta","48","Advocating/Promoting terrorism offence","0","0","0","0","0","0","0","0","0","0","0","0","0","0"
"2013","Alberta","48","Advocating/Promoting terrorism offence","0","0","0","0","0","0","0","0","0","0","0","0","0","0"
"2014","Alberta","48","Advocating/Promoting terrorism offence","0","0","0","0","0","0","0","0","0","0","0","0","0","0"
"2015","Alberta","48","Advocating/Promoting terrorism offence","0","0","0","0","0","0","0","0","0","0","0","0","0","0"
"2016","Alberta","48","Advocating/Promoting terrorism offence","7","0","2","0","0.16","0","0","0","0","2","0","0","0","0"
"1998","Alberta","48","Firearms and other offensive weapons (Part III Criminal Code)","0","0","0","0","0","0","0","0","0","0","0","0","0","0"
"1999","Alberta","48","Firearms and other offensive weapons (Part III Criminal Code)","6","1","4","0","0.2","0","0","0","0","5","0","0","0","0"
"2000","Alberta","48","Firearms and other offensive weapons (Part III Criminal Code)","16","3","1","162.08","0.53","0.04","0.08","0.37","0","4","1","2","1","0"
"2001","Alberta","48","Firearms and other offensive weapons (Part III Criminal Code)","102","22","42","526.44","3.34","0.74","0.78","1.11","0.74","64","17","20","3","2"
"2002","Alberta","48","Firearms and other offensive weapons (Part III Criminal Code)","110","34","18","5.42","3.52","1.27","1.56","3.97","2.53","52","30","41","11","7"
"2003","Alberta","48","Firearms and other offensive weapons (Part III Criminal Code)","114","18","50","1.84","3.58","0.91","0.93","1.07","3.94","68","22","25","3","11"
"2004","Alberta","48","Firearms and other offensive weapons (Part III Criminal Code)","127","19","51","9.48","3.92","0.93","0.91","0.71","3.91","70","23","25","2","11"
"2005","Alberta","48","Firearms and other offensive weapons (Part III Criminal Code)","320","44","58","145.69","9.63","1.06","1.38","4.23","11.63","102","27","39","12","33"
"2006","Alberta","48","Firearms and other offensive weapons (Part III Criminal Code)","379","29","65","15","11.08","0.69","0.79","1.74","9.06","94","18","23","5","26"
"2007","Alberta","48","Firearms and other offensive weapons (Part III Criminal Code)","398","27","57","2.24","11.33","0.74","0.73","0.7","8.02","84","20","22","2","23"
"2008","Alberta","48","Firearms and other offensive weapons (Part III Criminal Code)","438","35","80","7.55","12.18","0.93","1.17","3.51","10.17","115","26","36","10","29"
"2009","Alberta","48","Firearms and other offensive weapons (Part III Criminal Code)","432","31","83","-3.6","11.74","0.91","0.83","0","5.64","114","26","26","0","16"
"2010","Alberta","48","Firearms and other offensive weapons (Part III Criminal Code)","421","31","84","-3.94","11.28","0.93","0.97","1.42","9.23","115","27","31","4","26"
"2011","Alberta","48","Firearms and other offensive weapons (Part III Criminal Code)","457","49","49","6.9","12.06","1.49","1.39","0.36","3.56","98","44","45","1","10"
"2012","Alberta","48","Firearms and other offensive weapons (Part III Criminal Code)","582","37","67","24.38","15","1.09","1.24","2.86","6.43","104","33","41","8","18"
"2013","Alberta","48","Firearms and other offensive weapons (Part III Criminal Code)","479","45","60","-20.08","11.99","1.47","1.35","0","3.58","105","46","46","0","10"
"2014","Alberta","48","Firearms and other offensive weapons (Part III Criminal Code)","446","37","62","-9.42","10.86","0.99","1.17","3.23","4.3","99","32","41","9","12"
"2015","Alberta","48","Firearms and other offensive weapons (Part III Criminal Code)","497","43","48","9.53","11.89","1.22","1.21","1.07","1.79","91","40","43","3","5"
"2016","Alberta","48","Firearms and other offensive weapons (Part III Criminal Code)","449","36","47","-11.21","10.56","0.99","0.91","0","1.06","83","33","33","0","3"
"2012","Alberta","48","Leaving Canada to participate in activity of terrorist group","0","0","0","0","0","0","0","0","0","0","0","0","0","0"
"2013","Alberta","48","Leaving Canada to participate in activity of terrorist group","0","0","0","0","0","0","0","0","0","0","0","0","0","0"
"2014","Alberta","48","Leaving Canada to participate in activity of terrorist group","0","0","0","0","0","0","0","0","0","0","0","0","0","0"
"2015","Alberta","48","Leaving Canada to participate in activity of terrorist group","5","0","1","0","0.12","0","0","0","0","1","0","0","0","0"
"2016","Alberta","48","Leaving Canada to participate in activity of terrorist group","3","0","0","-41.03","0.07","0","0","0","0","0","0","0","0","0"
"2012","Alberta","48","Leaving Canada to facilitate terrorist activity","0","0","0","0","0","0","0","0","0","0","0","0","0","0"
"2013","Alberta","48","Leaving Canada to facilitate terrorist activity","0","0","0","0","0","0","0","0","0","0","0","0","0","0"
"2014","Alberta","48","Leaving Canada to facilitate terrorist activity","0","0","0","0","0","0","0","0","0","0","0","0","0","0"
"2015","Alberta","48","Leaving Canada to facilitate terrorist activity","0","0","0","0","0","0","0","0","0","0","0","0","0","0"
"2016","Alberta","48","Leaving Canada to facilitate terrorist activity","0","0","0","0","0","0","0","0","0","0","0","0","0","0"
"2012","Alberta","48","Leaving Canada to commit offence for terrorist group","0","0","0","0","0","0","0","0","0","0","0","0","0","0"
"2013","Alberta","48","Leaving Canada to commit offence for terrorist group","0","0","0","0","0","0","0","0","0","0","0","0","0","0"
"2014","Alberta","48","Leaving Canada to commit offence for terrorist group","0","0","0","0","0","0","0","0","0","0","0","0","0","0"
"2015","Alberta","48","Leaving Canada to commit offence for terrorist group","0","0","0","0","0","0","0","0","0","0","0","0","0","0"
"2016","Alberta","48","Leaving Canada to commit offence for terrorist group","0","0","0","0","0","0","0","0","0","0","0","0","0","0"
"2012","Alberta","48","Leaving Canada to commit offence that is terrorist activity","0","0","0","0","0","0","0","0","0","0","0","0","0","0"
"2013","Alberta","48","Leaving Canada to commit offence that is terrorist activity","0","0","0","0","0","0","0","0","0","0","0","0","0","0"
"2014","Alberta","48","Leaving Canada to commit offence that is terrorist activity","0","0","0","0","0","0","0","0","0","0","0","0","0","0"
"2015","Alberta","48","Leaving Canada to commit offence that is terrorist activity","1","1","0","0","0.02","0","0.03","0.36","0","1","0","1","1","0"
"2016","Alberta","48","Leaving Canada to commit offence that is terrorist activity","0","0","0","-100","0","0","0","0","0","0","0","0","0","0"
"2012","Alberta","48","Concealing person who carried out terrorist activity that is a terrorism offence for which that person is liable to imprisonment for life","0","0","0","0","0","0","0","0","0","0","0","0","0","0"
"2013","Alberta","48","Concealing person who carried out terrorist activity that is a terrorism offence for which that person is liable to imprisonment for life","0","0","0","0","0","0","0","0","0","0","0","0","0","0"
"2014","Alberta","48","Concealing person who carried out terrorist activity that is a terrorism offence for which that person is liable to imprisonment for life","0","0","0","0","0","0","0","0","0","0","0","0","0","0"
"2015","Alberta","48","Concealing person who carried out terrorist activity that is a terrorism offence for which that person is liable to imprisonment for life","0","0","0","0","0","0","0","0","0","0","0","0","0","0"
"2016","Alberta","48","Concealing person who carried out terrorist activity that is a terrorism offence for which that person is liable to imprisonment for life","1","0","0","0","0.02","0","0","0","0","0","0","0","0","0"
"2012","Alberta","48","Concealing person who carried out terrorist activity that is a terrorism offence for which that person is liable to any punishment other than life","0","0","0","0","0","0","0","0","0","0","0","0","0","0"
"2013","Alberta","48","Concealing person who carried out terrorist activity that is a terrorism offence for which that person is liable to any punishment other than life","0","0","0","0","0","0","0","0","0","0","0","0","0","0"
"2014","Alberta","48","Concealing person who carried out terrorist activity that is a terrorism offence for which that person is liable to any punishment other than life","0","0","0","0","0","0","0","0","0","0","0","0","0","0"
"2015","Alberta","48","Concealing person who carried out terrorist activity that is a terrorism offence for which that person is liable to any punishment other than life","0","0","0","0","0","0","0","0","0","0","0","0","0","0"
"2016","Alberta","48","Concealing person who carried out terrorist activity that is a terrorism offence for which that person is liable to any punishment other than life","0","0","0","0","0","0","0","0","0","0","0","0","0","0"
"2012","Alberta","48","Concealing person who is likely to carry out terrorist activity","0","0","0","0","0","0","0","0","0","0","0","0","0","0"
"2013","Alberta","48","Concealing person who is likely to carry out terrorist activity","0","0","0","0","0","0","0","0","0","0","0","0","0","0"
"2014","Alberta","48","Concealing person who is likely to carry out terrorist activity","0","0","0","0","0","0","0","0","0","0","0","0","0","0"
"2015","Alberta","48","Concealing person who is likely to carry out terrorist activity","0","0","0","0","0","0","0","0","0","0","0","0","0","0"
"2016","Alberta","48","Concealing person who is likely to carry out terrorist activity","0","0","0","0","0","0","0","0","0","0","0","0","0","0"
"1998","Alberta","48","Sexual offences, public morals and disorderly conduct (Part V Criminal Code)","5","3","1","0","0.17","0.05","0.08","0.38","0","4","1","2","1","0"
"1999","Alberta","48","Sexual offences, public morals and disorderly conduct (Part V Criminal Code)","9","4","0","76.72","0.3","0.18","0.16","0","0","4","4","4","0","0"
"2000","Alberta","48","Sexual offences, public morals and disorderly conduct (Part V Criminal Code)","8","1","0","-12.64","0.27","0","0","0","0","1","0","0","0","0"
"2001","Alberta","48","Sexual offences, public morals and disorderly conduct (Part V Criminal Code)","7","0","0","-14.02","0.23","0","0","0","0","0","0","0","0","0"
"2002","Alberta","48","Sexual offences, public morals and disorderly conduct (Part V Criminal Code)","10","0","2","39.64","0.32","0","0","0","0","2","0","0","0","0"
"2003","Alberta","48","Sexual offences, public morals and disorderly conduct (Part V Criminal Code)","7","0","1","-31.21","0.22","0","0","0","0.36","1","0","0","0","1"
"2004","Alberta","48","Sexual offences, public morals and disorderly conduct (Part V Criminal Code)","12","7","2","68.46","0.37","0.32","0.29","0","1.07","9","8","8","0","3"
"2005","Alberta","48","Sexual offences, public morals and disorderly conduct (Part V Criminal Code)","7","2","0","-43.12","0.21","0.04","0.07","0.35","0","2","1","2","1","0"
"2006","Alberta","48","Sexual offences, public morals and disorderly conduct (Part V Criminal Code)","30","2","10","316.15","0.88","0.08","0.07","0","0.7","12","2","2","0","2"
"2007","Alberta","48","Sexual offences, public morals and disorderly conduct (Part V Criminal Code)","38","5","18","23.33","1.08","0.11","0.17","0.7","1.39","23","3","5","2","4"
"2008","Alberta","48","Sexual offences, public morals and disorderly conduct (Part V Criminal Code)","53","6","21","36.3","1.47","0.22","0.2","0","0.35","27","6","6","0","1"
"2009","Alberta","48","Sexual offences, public morals and disorderly conduct (Part V Criminal Code)","70","8","25","29.08","1.9","0.38","0.35","0","0.35","33","11","11","0","1"
"2010","Alberta","48","Sexual offences, public morals and disorderly conduct (Part V Criminal Code)","84","13","26","18.28","2.25","0.52","0.47","0","1.42","39","15","15","0","4"
"2011","Alberta","48","Sexual offences, public morals and disorderly conduct (Part V Criminal Code)","67","8","22","-21.45","1.77","0.2","0.22","0.36","0.36","30","6","7","1","1"
"2012","Alberta","48","Sexual offences, public morals and disorderly conduct (Part V Criminal Code)","56","7","16","-18.37","1.44","0.23","0.21","0","0","23","7","7","0","0"
"2013","Alberta","48","Sexual offences, public morals and disorderly conduct (Part V Criminal Code)","54","2","20","-6.37","1.35","0.06","0.06","0","0.36","22","2","2","0","1"
"2014","Alberta","48","Sexual offences, public morals and disorderly conduct (Part V Criminal Code)","48","3","13","-13.53","1.17","0.09","0.11","0.36","1.08","16","3","4","1","3"
"2015","Alberta","48","Sexual offences, public morals and disorderly conduct (Part V Criminal Code)","44","3","12","-9.9","1.05","0.06","0.08","0.36","0","15","2","3","1","0"
"2016","Alberta","48","Sexual offences, public morals and disorderly conduct (Part V Criminal Code)","65","4","26","45.18","1.53","0.09","0.08","0","0","30","3","3","0","0"
"1998","Alberta","48","Invasion of privacy (Part VI Criminal Code)","4","1","2","0","0.14","0.05","0.04","0","0","3","1","1","0","0"
"1999","Alberta","48","Invasion of privacy (Part VI Criminal Code)","1","0","0","-75.46","0.03","0","0","0","0","0","0","0","0","0"
"2000","Alberta","48","Invasion of privacy (Part VI Criminal Code)","2","0","1","96.56","0.07","0","0","0","0.37","1","0","0","0","1"
"2001","Alberta","48","Invasion of privacy (Part VI Criminal Code)","0","0","0","-100","0","0","0","0","0","0","0","0","0","0"
"2002","Alberta","48","Invasion of privacy (Part VI Criminal Code)","1","1","0","0","0.03","0","0","0","0","1","0","0","0","0"
"2003","Alberta","48","Invasion of privacy (Part VI Criminal Code)","1","0","0","-1.73","0.03","0","0","0","0","0","0","0","0","0"
"2004","Alberta","48","Invasion of privacy (Part VI Criminal Code)","0","0","0","-100","0","0","0","0","0","0","0","0","0","0"
"2005","Alberta","48","Invasion of privacy (Part VI Criminal Code)","0","0","0","0","0","0","0.04","0.35","0","0","0","1","1","0"
"2006","Alberta","48","Invasion of privacy (Part VI Criminal Code)","4","0","0","0","0.12","0","0","0","0","0","0","0","0","0"
"2007","Alberta","48","Invasion of privacy (Part VI Criminal Code)","4","0","3","-2.64","0.11","0","0","0","0","3","0","0","0","0"
"2008","Alberta","48","Invasion of privacy (Part VI Criminal Code)","2","0","0","-51.14","0.06","0","0","0","0","0","0","0","0","0"
"2009","Alberta","48","Invasion of privacy (Part VI Criminal Code)","5","0","1","144.34","0.14","0","0","0","0","1","0","0","0","0"
"2010","Alberta","48","Invasion of privacy (Part VI Criminal Code)","4","0","0","-21.15","0.11","0","0","0","0","0","0","0","0","0"
"2011","Alberta","48","Invasion of privacy (Part VI Criminal Code)","7","1","1","72.34","0.18","0.03","0.03","0","0","2","1","1","0","0"
"2012","Alberta","48","Invasion of privacy (Part VI Criminal Code)","6","0","1","-16.29","0.15","0","0","0","0","1","0","0","0","0"
"2013","Alberta","48","Invasion of privacy (Part VI Criminal Code)","8","1","2","29.47","0.2","0.03","0.03","0","0","3","1","1","0","0"
"2014","Alberta","48","Invasion of privacy (Part VI Criminal Code)","3","0","1","-63.52","0.07","0","0","0","0","1","0","0","0","0"
"2015","Alberta","48","Invasion of privacy (Part VI Criminal Code)","1","0","1","-67.24","0.02","0","0","0","0","1","0","0","0","0"
"2016","Alberta","48","Invasion of privacy (Part VI Criminal Code)","1","0","0","-1.72","0.02","0","0","0","0","0","0","0","0","0"
"1998","Alberta","48","Disorderly houses, gaming and betting","0","0","0","0","0","0","0","0","0","0","0","0","0","0"
"1999","Alberta","48","Disorderly houses, gaming and betting","0","0","0","0","0","0","0","0","0","0","0","0","0","0"
"2000","Alberta","48","Disorderly houses, gaming and betting","0","0","0","0","0","0","0","0","0","0","0","0","0","0"
"2001","Alberta","48","Disorderly houses, gaming and betting","0","0","0","0","0","0","0","0","0","0","0","0","0","0"
"2002","Alberta","48","Disorderly houses, gaming and betting","0","0","0","0","0","0","0","0","0","0","0","0","0","0"
"2003","Alberta","48","Disorderly houses, gaming and betting","0","0","0","0","0","0","0","0","0","0","0","0","0","0"
"2004","Alberta","48","Disorderly houses, gaming and betting","0","0","0","0","0","0","0","0","0","0","0","0","0","0"
"2005","Alberta","48","Disorderly houses, gaming and betting","0","0","0","0","0","0","0","0","0","0","0","0","0","0"
"2006","Alberta","48","Disorderly houses, gaming and betting","0","0","0","0","0","0","0","0","0","0","0","0","0","0"
"2007","Alberta","48","Disorderly houses, gaming and betting","0","0","0","0","0","0","0","0","0","0","0","0","0","0"
"2008","Alberta","48","Disorderly houses, gaming and betting","0","0","0","0","0","0","0","0","0","0","0","0","0","0"
"2009","Alberta","48","Disorderly houses, gaming and betting","0","0","0","0","0","0","0","0","0","0","0","0","0","0"
"2010","Alberta","48","Disorderly houses, gaming and betting","0","0","0","0","0","0","0","0","0","0","0","0","0","0"
"2011","Alberta","48","Disorderly houses, gaming and betting","0","0","0","0","0","0","0","0","0","0","0","0","0","0"
"2012","Alberta","48","Disorderly houses, gaming and betting","0","0","0","0","0","0","0","0","0","0","0","0","0","0"
"2013","Alberta","48","Disorderly houses, gaming and betting","0","0","0","0","0","0","0","0","0","0","0","0","0","0"
"2014","Alberta","48","Disorderly houses, gaming and betting","0","0","0","0","0","0","0","0","0","0","0","0","0","0"
"2015","Alberta","48","Disorderly houses, gaming and betting","0","0","0","0","0","0","0","0","0","0","0","0","0","0"
"2016","Alberta","48","Disorderly houses, gaming and betting","0","0","0","0","0","0","0","0","0","0","0","0","0","0"
"1998","Alberta","48","Offences against the person and reputation (Part VIII Criminal Code)","3477","969","1621","0","119.92","20.76","21.38","26.48","51.81","2590","444","513","69","135"
"1999","Alberta","48","Offences against the person and reputation (Part VIII Criminal Code)","974","139","325","-72.5","32.98","2.56","2.57","2.65","4.54","464","56","63","7","12"
"2000","Alberta","48","Offences against the person and reputation (Part VIII Criminal Code)","412","27","150","-58.43","13.71","0.67","0.64","0.37","5.99","177","15","16","1","16"
"2001","Alberta","48","Offences against the person and reputation (Part VIII Criminal Code)","379","14","134","-9.61","12.39","0.35","0.35","0.37","13.67","148","8","9","1","37"
"2002","Alberta","48","Offences against the person and reputation (Part VIII Criminal Code)","305","4","151","-21.33","9.75","0.08","0.11","0.36","18.43","155","2","3","1","51"
"2003","Alberta","48","Offences against the person and reputation (Part VIII Criminal Code)","174","8","46","-43.94","5.47","0.12","0.19","0.72","3.22","54","3","5","2","9"
"2004","Alberta","48","Offences against the person and reputation (Part VIII Criminal Code)","182","9","45","2.79","5.62","0.2","0.25","0.71","4.98","54","5","7","2","14"
"2005","Alberta","48","Offences against the person and reputation (Part VIII Criminal Code)","280","18","110","50.02","8.43","0.51","0.5","0.35","4.23","128","13","14","1","12"
"2006","Alberta","48","Offences against the person and reputation (Part VIII Criminal Code)","401","32","250","39.06","11.72","1.07","1.03","0.7","9.06","282","28","30","2","26"
"2007","Alberta","48","Offences against the person and reputation (Part VIII Criminal Code)","605","56","304","46.89","17.22","1.48","1.5","1.74","16.73","360","40","45","5","48"
"2008","Alberta","48","Offences against the person and reputation (Part VIII Criminal Code)","574","40","314","-7.28","15.96","1.58","1.63","2.1","17.53","354","44","50","6","50"
"2009","Alberta","48","Offences against the person and reputation (Part VIII Criminal Code)","498","93","261","-15.21","13.54","1.85","1.94","2.82","10.22","354","53","61","8","29"
"2010","Alberta","48","Offences against the person and reputation (Part VIII Criminal Code)","57","1","23","-88.72","1.53","0.03","0.03","0","2.49","24","1","1","0","7"
"2011","Alberta","48","Offences against the person and reputation (Part VIII Criminal Code)","47","7","14","-18.8","1.24","0.24","0.22","0","0.71","21","7","7","0","2"
"2012","Alberta","48","Offences against the person and reputation (Part VIII Criminal Code)","59","6","14","22.6","1.52","0.2","0.21","0.36","1.07","20","6","7","1","3"
"2013","Alberta","48","Offences against the person and reputation (Part VIII Criminal Code)","61","5","14","0.39","1.53","0.16","0.15","0","0","19","5","5","0","0"
"2014","Alberta","48","Offences against the person and reputation (Part VIII Criminal Code)","55","4","18","-12.29","1.34","0.06","0.09","0.36","0.36","22","2","3","1","1"
"2015","Alberta","48","Offences against the person and reputation (Part VIII Criminal Code)","65","6","22","16.16","1.56","0.15","0.14","0","1.43","28","5","5","0","4"
"2016","Alberta","48","Offences against the person and reputation (Part VIII Criminal Code)","65","8","13","-1.72","1.53","0.27","0.25","0","0","21","9","9","0","0"
"2012","Alberta","48","Failure to comply with the regulations/obligations for medical assistance in dying","0","0","0","0","0","0","0","0","0","0","0","0","0","0"
"2013","Alberta","48","Failure to comply with the regulations/obligations for medical assistance in dying","0","0","0","0","0","0","0","0","0","0","0","0","0","0"
"2014","Alberta","48","Failure to comply with the regulations/obligations for medical assistance in dying","0","0","0","0","0","0","0","0","0","0","0","0","0","0"
"2015","Alberta","48","Failure to comply with the regulations/obligations for medical assistance in dying","0","0","0","0","0","0","0","0","0","0","0","0","0","0"
"2016","Alberta","48","Failure to comply with the regulations/obligations for medical assistance in dying","0","0","0","0","0","0","0","0","0","0","0","0","0","0"
"1998","Alberta","48","Offences against rights of property (Part IX Criminal Code)","366","298","7","0","12.62","7.15","10.5","37.99","2.3","305","153","252","99","6"
"1999","Alberta","48","Offences against rights of property (Part IX Criminal Code)","355","261","7","-4.77","12.02","7.49","8.88","20.43","1.89","268","164","218","54","5"
"2000","Alberta","48","Offences against rights of property (Part IX Criminal Code)","274","180","5","-24.14","9.12","4.77","6.7","22.83","2.25","185","107","168","61","6"
"2001","Alberta","48","Offences against rights of property (Part IX Criminal Code)","314","200","7","12.61","10.27","6.58","8.81","27.71","5.91","207","151","226","75","16"
"2002","Alberta","48","Offences against rights of property (Part IX Criminal Code)","366","244","7","13.94","11.7","7.08","9.22","27.46","4.34","251","167","243","76","12"
"2003","Alberta","48","Offences against rights of property (Part IX Criminal Code)","435","295","8","16.8","13.66","8.25","10.36","28.62","2.5","303","199","279","80","7"
"2004","Alberta","48","Offences against rights of property (Part IX Criminal Code)","388","273","10","-12.35","11.98","8.43","9.9","22.77","3.91","283","208","272","64","11"
"2005","Alberta","48","Offences against rights of property (Part IX Criminal Code)","380","292","8","-4.5","11.44","10.11","10.94","18.33","1.41","300","257","309","52","4"
"2006","Alberta","48","Offences against rights of property (Part IX Criminal Code)","257","240","5","-34.33","7.51","6.24","7.28","16.72","0.7","245","164","212","48","2"
"2007","Alberta","48","Offences against rights of property (Part IX Criminal Code)","248","247","3","-6.05","7.06","7.23","7.74","12.55","0.7","250","196","232","36","2"
"2008","Alberta","48","Offences against rights of property (Part IX Criminal Code)","215","201","7","-15.28","5.98","6.68","7.3","13.32","0.7","208","186","224","38","2"
"2009","Alberta","48","Offences against rights of property (Part IX Criminal Code)","163","143","9","-25.9","4.43","4.55","4.81","7.4","0.35","152","130","151","21","1"
"2010","Alberta","48","Offences against rights of property (Part IX Criminal Code)","145","137","3","-12.32","3.88","4.24","4.4","6.04","0.36","140","123","140","17","1"
"2011","Alberta","48","Offences against rights of property (Part IX Criminal Code)","183","176","3","24.29","4.83","5.42","5.57","7.11","0","179","160","180","20","0"
"2012","Alberta","48","Offences against rights of property (Part IX Criminal Code)","170","165","1","-9.27","4.38","4.49","5.14","12.14","0","166","136","170","34","0"
"2013","Alberta","48","Offences against rights of property (Part IX Criminal Code)","192","184","1","9.67","4.8","4.74","5.02","8.23","0.36","185","148","171","23","1"
"2014","Alberta","48","Offences against rights of property (Part IX Criminal Code)","260","253","3","31.74","6.33","7.31","7.24","6.46","0.36","256","235","253","18","1"
"2015","Alberta","48","Offences against rights of property (Part IX Criminal Code)","329","309","7","24.38","7.87","9.48","8.99","3.22","0.72","316","310","319","9","2"
"2016","Alberta","48","Offences against rights of property (Part IX Criminal Code)","358","351","2","6.94","8.42","9.87","9.54","5.65","0.71","353","328","344","16","2"
"1998","Alberta","48","Fraudulent transactions relating to contracts and trade (Part X Criminal Code)","36","11","5","0","1.24","0.23","0.21","0","0","16","5","5","0","0"
"1999","Alberta","48","Fraudulent transactions relating to contracts and trade (Part X Criminal Code)","49","3","10","33.63","1.66","0.14","0.12","0","0","13","3","3","0","0"
"2000","Alberta","48","Fraudulent transactions relating to contracts and trade (Part X Criminal Code)","50","4","9","0.29","1.66","0.13","0.12","0","1.12","13","3","3","0","3"
"2001","Alberta","48","Fraudulent transactions relating to contracts and trade (Part X Criminal Code)","63","4","10","23.81","2.06","0.04","0.08","0.37","1.11","14","1","2","1","3"
"2002","Alberta","48","Fraudulent transactions relating to contracts and trade (Part X Criminal Code)","106","3","20","64.47","3.39","0.04","0.11","0.72","0.72","23","1","3","2","2"
"2003","Alberta","48","Fraudulent transactions relating to contracts and trade (Part X Criminal Code)","101","1","26","-6.36","3.17","0.04","0.04","0","1.07","27","1","1","0","3"
"2004","Alberta","48","Fraudulent transactions relating to contracts and trade (Part X Criminal Code)","94","5","20","-8.54","2.9","0.12","0.11","0","1.42","25","3","3","0","4"
"2005","Alberta","48","Fraudulent transactions relating to contracts and trade (Part X Criminal Code)","69","6","8","-28.42","2.08","0.24","0.21","0","0.7","14","6","6","0","2"
"2006","Alberta","48","Fraudulent transactions relating to contracts and trade (Part X Criminal Code)","30","7","12","-57.78","0.88","0.15","0.24","1.04","0.35","19","4","7","3","1"
"2007","Alberta","48","Fraudulent transactions relating to contracts and trade (Part X Criminal Code)","38","3","16","23.33","1.08","0.11","0.1","0","1.74","19","3","3","0","5"
"2008","Alberta","48","Fraudulent transactions relating to contracts and trade (Part X Criminal Code)","20","8","10","-48.56","0.56","0.22","0.26","0.7","1.4","18","6","8","2","4"
"2009","Alberta","48","Fraudulent transactions relating to contracts and trade (Part X Criminal Code)","35","5","9","71.04","0.95","0.14","0.16","0.35","0","14","4","5","1","0"
"2010","Alberta","48","Fraudulent transactions relating to contracts and trade (Part X Criminal Code)","19","5","2","-46.49","0.51","0.17","0.16","0","0","7","5","5","0","0"
"2011","Alberta","48","Fraudulent transactions relating to contracts and trade (Part X Criminal Code)","27","4","6","39.94","0.71","0.1","0.12","0.36","0","10","3","4","1","0"
"2012","Alberta","48","Fraudulent transactions relating to contracts and trade (Part X Criminal Code)","21","5","3","-24.04","0.54","0.13","0.15","0.36","1.43","8","4","5","1","4"
"2013","Alberta","48","Fraudulent transactions relating to contracts and trade (Part X Criminal Code)","33","4","1","52.59","0.83","0.1","0.12","0.36","0","5","3","4","1","0"
"2014","Alberta","48","Fraudulent transactions relating to contracts and trade (Part X Criminal Code)","38","6","4","12.02","0.92","0.16","0.17","0.36","0","10","5","6","1","0"
"2015","Alberta","48","Fraudulent transactions relating to contracts and trade (Part X Criminal Code)","20","7","2","-48.27","0.48","0.21","0.2","0","0","9","7","7","0","0"
"2016","Alberta","48","Fraudulent transactions relating to contracts and trade (Part X Criminal Code)","22","7","3","8.11","0.52","0.15","0.17","0.35","0","10","5","6","1","0"
"1998","Alberta","48","Willful and forbidden acts in respect of certain property (Part XI Criminal Code)","203","31","18","0","7","0.89","0.88","0.77","1.54","49","19","21","2","4"
"1999","Alberta","48","Willful and forbidden acts in respect of certain property (Part XI Criminal Code)","201","25","44","-2.79","6.81","0.55","0.9","3.78","1.51","69","12","22","10","4"
"2000","Alberta","48","Willful and forbidden acts in respect of certain property (Part XI Criminal Code)","186","17","29","-9.05","6.19","0.49","0.6","1.5","4.12","46","11","15","4","11"
"2001","Alberta","48","Willful and forbidden acts in respect of certain property (Part XI Criminal Code)","452","18","66","138.79","14.78","0.48","0.62","1.85","2.59","84","11","16","5","7"
"2002","Alberta","48","Willful and forbidden acts in respect of certain property (Part XI Criminal Code)","256","23","77","-44.64","8.18","0.59","0.68","1.45","5.78","100","14","18","4","16"
"2003","Alberta","48","Willful and forbidden acts in respect of certain property (Part XI Criminal Code)","239","12","19","-8.25","7.51","0.33","0.37","0.72","3.22","31","8","10","2","9"
"2004","Alberta","48","Willful and forbidden acts in respect of certain property (Part XI Criminal Code)","178","18","16","-26.81","5.49","0.49","0.55","1.07","3.2","34","12","15","3","9"
"2005","Alberta","48","Willful and forbidden acts in respect of certain property (Part XI Criminal Code)","213","19","29","16.68","6.41","0.63","0.74","1.76","1.06","48","16","21","5","3"
"2006","Alberta","48","Willful and forbidden acts in respect of certain property (Part XI Criminal Code)","313","48","87","42.69","9.15","1.6","1.54","1.04","6.27","135","42","45","3","18"
"2007","Alberta","48","Willful and forbidden acts in respect of certain property (Part XI Criminal Code)","332","41","62","3.27","9.45","1.25","1.5","3.83","5.23","103","34","45","11","15"
"2008","Alberta","48","Willful and forbidden acts in respect of certain property (Part XI Criminal Code)","339","49","77","-0.21","9.43","1.51","1.66","3.16","7.01","126","42","51","9","20"
"2009","Alberta","48","Willful and forbidden acts in respect of certain property (Part XI Criminal Code)","373","43","71","7.54","10.14","1.4","1.43","1.76","6.7","114","40","45","5","19"
"2010","Alberta","48","Willful and forbidden acts in respect of certain property (Part XI Criminal Code)","420","54","85","10.99","11.25","1.52","1.66","3.2","4.26","139","44","53","9","12"
"2011","Alberta","48","Willful and forbidden acts in respect of certain property (Part XI Criminal Code)","510","50","118","19.58","13.46","1.46","1.52","2.13","1.78","168","43","49","6","5"
"2012","Alberta","48","Willful and forbidden acts in respect of certain property (Part XI Criminal Code)","459","63","94","-12.1","11.83","1.85","1.97","3.21","4.64","157","56","65","9","13"
"2013","Alberta","48","Willful and forbidden acts in respect of certain property (Part XI Criminal Code)","482","57","80","1.97","12.06","1.63","1.59","1.07","1.07","137","51","54","3","3"
"2014","Alberta","48","Willful and forbidden acts in respect of certain property (Part XI Criminal Code)","474","56","90","-4.33","11.54","1.4","1.63","4.3","1.43","146","45","57","12","4"
"2015","Alberta","48","Willful and forbidden acts in respect of certain property (Part XI Criminal Code)","473","77","69","-1.92","11.32","1.93","2.03","3.22","3.58","146","63","72","9","10"
"2016","Alberta","48","Willful and forbidden acts in respect of certain property (Part XI Criminal Code)","382","59","60","-20.63","8.98","1.65","1.61","1.06","3.18","119","55","58","3","9"
"1998","Alberta","48","Offences relating to currency (Part XII Criminal Code)","43","5","1","0","1.48","0.05","0.04","0","0","6","1","1","0","0"
"1999","Alberta","48","Offences relating to currency (Part XII Criminal Code)","59","4","0","34.71","2","0","0","0","0","4","0","0","0","0"
"2000","Alberta","48","Offences relating to currency (Part XII Criminal Code)","40","1","0","-33.37","1.33","0","0","0","0","1","0","0","0","0"
"2001","Alberta","48","Offences relating to currency (Part XII Criminal Code)","44","0","0","8.09","1.44","0","0","0","0","0","0","0","0","0"
"2002","Alberta","48","Offences relating to currency (Part XII Criminal Code)","93","1","0","106.61","2.97","0.04","0.04","0","0","1","1","1","0","0"
"2003","Alberta","48","Offences relating to currency (Part XII Criminal Code)","71","3","1","-24.98","2.23","0.08","0.07","0","0","4","2","2","0","0"
"2004","Alberta","48","Offences relating to currency (Part XII Criminal Code)","65","2","0","-10.04","2.01","0","0","0","0","2","0","0","0","0"
"2005","Alberta","48","Offences relating to currency (Part XII Criminal Code)","27","1","0","-59.5","0.81","0","0","0","0","1","0","0","0","0"
"2006","Alberta","48","Offences relating to currency (Part XII Criminal Code)","14","2","0","-49.65","0.41","0.08","0.07","0","0","2","2","2","0","0"
"2007","Alberta","48","Offences relating to currency (Part XII Criminal Code)","12","0","0","-16.55","0.34","0","0","0","0","0","0","0","0","0"
"2008","Alberta","48","Offences relating to currency (Part XII Criminal Code)","5","1","1","-59.28","0.14","0","0","0","0","2","0","0","0","0"
"2009","Alberta","48","Offences relating to currency (Part XII Criminal Code)","14","0","1","173.66","0.38","0","0","0","0","1","0","0","0","0"
"2010","Alberta","48","Offences relating to currency (Part XII Criminal Code)","8","2","0","-43.68","0.21","0.03","0.03","0","0","2","1","1","0","0"
"2011","Alberta","48","Offences relating to currency (Part XII Criminal Code)","8","2","0","-1.52","0.21","0.03","0.03","0","0","2","1","1","0","0"
"2012","Alberta","48","Offences relating to currency (Part XII Criminal Code)","3","1","0","-63.38","0.08","0.03","0.03","0","0","1","1","1","0","0"
"2013","Alberta","48","Offences relating to currency (Part XII Criminal Code)","4","1","1","29.47","0.1","0.03","0.03","0","0","2","1","1","0","0"
"2014","Alberta","48","Offences relating to currency (Part XII Criminal Code)","1","0","1","-75.68","0.02","0","0","0","0","1","0","0","0","0"
"2015","Alberta","48","Offences relating to currency (Part XII Criminal Code)","2","1","0","96.58","0.05","0","0","0","0","1","0","0","0","0"
"2016","Alberta","48","Offences relating to currency (Part XII Criminal Code)","10","0","1","391.39","0.24","0","0","0","0","1","0","0","0","0"
"1998","Alberta","48","Proceeds of crime (Part XII.2 Criminal Code)","0","0","0","0","0","0","0","0","0","0","0","0","0","0"
"1999","Alberta","48","Proceeds of crime (Part XII.2 Criminal Code)","3","1","0","0","0.1","0.05","0.04","0","0","1","1","1","0","0"
"2000","Alberta","48","Proceeds of crime (Part XII.2 Criminal Code)","0","0","0","-100","0","0","0","0","0","0","0","0","0","0"
"2001","Alberta","48","Proceeds of crime (Part XII.2 Criminal Code)","1","0","0","0","0.03","0","0","0","0","0","0","0","0","0"
"2002","Alberta","48","Proceeds of crime (Part XII.2 Criminal Code)","4","4","0","291.01","0.13","0.17","0.15","0","0","4","4","4","0","0"
"2003","Alberta","48","Proceeds of crime (Part XII.2 Criminal Code)","2","1","0","-50.86","0.06","0.04","0.07","0.36","0","1","1","2","1","0"
"2004","Alberta","48","Proceeds of crime (Part XII.2 Criminal Code)","6","3","1","194.81","0.19","0.12","0.11","0","0","4","3","3","0","0"
"2005","Alberta","48","Proceeds of crime (Part XII.2 Criminal Code)","19","10","2","208.78","0.57","0.51","0.5","0.35","0","12","13","14","1","0"
"2006","Alberta","48","Proceeds of crime (Part XII.2 Criminal Code)","70","20","6","257.74","2.05","0.57","0.51","0","0","26","15","15","0","0"
"2007","Alberta","48","Proceeds of crime (Part XII.2 Criminal Code)","164","10","7","128.11","4.67","0.41","0.4","0.35","0","17","11","12","1","0"
"2008","Alberta","48","Proceeds of crime (Part XII.2 Criminal Code)","159","7","14","-5.25","4.42","0.29","0.29","0.35","0","21","8","9","1","0"
"2009","Alberta","48","Proceeds of crime (Part XII.2 Criminal Code)","190","4","10","16.79","5.16","0.24","0.22","0","0","14","7","7","0","0"
"2010","Alberta","48","Proceeds of crime (Part XII.2 Criminal Code)","83","7","26","-56.94","2.22","0.38","0.35","0","0.71","33","11","11","0","2"
"2011","Alberta","48","Proceeds of crime (Part XII.2 Criminal Code)","38","10","5","-54.91","1","0.37","0.34","0","0","15","11","11","0","0"
"2012","Alberta","48","Proceeds of crime (Part XII.2 Criminal Code)","30","9","3","-22.9","0.77","0.36","0.36","0.36","0","12","11","12","1","0"
"2013","Alberta","48","Proceeds of crime (Part XII.2 Criminal Code)","28","8","1","-9.37","0.7","0.42","0.38","0","0","9","13","13","0","0"
"2014","Alberta","48","Proceeds of crime (Part XII.2 Criminal Code)","21","2","2","-27.04","0.51","0.09","0.09","0","0","4","3","3","0","0"
"2015","Alberta","48","Proceeds of crime (Part XII.2 Criminal Code)","26","7","1","21.7","0.62","0.12","0.11","0","0","8","4","4","0","0"
"2016","Alberta","48","Proceeds of crime (Part XII.2 Criminal Code)","33","2","2","24.74","0.78","0.03","0.03","0","0","4","1","1","0","0"
"1998","Alberta","48","Attempts, conspiracies, accessories (Part XIII Criminal Code)","164","39","12","0","5.66","0.79","1.08","3.45","2.69","51","17","26","9","7"
"1999","Alberta","48","Attempts, conspiracies, accessories (Part XIII Criminal Code)","145","66","15","-13.2","4.91","1.42","1.63","3.41","2.65","81","31","40","9","7"
"2000","Alberta","48","Attempts, conspiracies, accessories (Part XIII Criminal Code)","113","49","8","-23.41","3.76","0.98","1.12","2.25","0.75","57","22","28","6","2"
"2001","Alberta","48","Attempts, conspiracies, accessories (Part XIII Criminal Code)","139","51","9","20.87","4.55","1.22","1.25","1.48","2.59","60","28","32","4","7"
"2002","Alberta","48","Attempts, conspiracies, accessories (Part XIII Criminal Code)","108","26","15","-24.05","3.45","0.51","0.49","0.36","5.78","41","12","13","1","16"
"2003","Alberta","48","Attempts, conspiracies, accessories (Part XIII Criminal Code)","109","28","19","-0.82","3.42","0.66","0.74","1.43","3.22","47","16","20","4","9"
"2004","Alberta","48","Attempts, conspiracies, accessories (Part XIII Criminal Code)","66","31","5","-40.5","2.04","1.01","1.13","2.13","1.42","36","25","31","6","4"
"2005","Alberta","48","Attempts, conspiracies, accessories (Part XIII Criminal Code)","53","27","4","-21.7","1.6","0.67","0.78","1.76","1.76","31","17","22","5","5"
"2006","Alberta","48","Attempts, conspiracies, accessories (Part XIII Criminal Code)","35","18","8","-35.88","1.02","0.38","0.38","0.35","2.09","26","10","11","1","6"
"2007","Alberta","48","Attempts, conspiracies, accessories (Part XIII Criminal Code)","23","17","1","-36.02","0.65","0.41","0.47","1.05","0","18","11","14","3","0"
"2008","Alberta","48","Attempts, conspiracies, accessories (Part XIII Criminal Code)","33","26","3","40.22","0.92","0.72","0.72","0.7","0.7","29","20","22","2","2"
"2009","Alberta","48","Attempts, conspiracies, accessories (Part XIII Criminal Code)","26","19","3","-23","0.71","0.24","0.35","1.41","0.35","22","7","11","4","1"
"2010","Alberta","48","Attempts, conspiracies, accessories (Part XIII Criminal Code)","23","20","2","-12.81","0.62","0.59","0.57","0.36","0","22","17","18","1","0"
"2011","Alberta","48","Attempts, conspiracies, accessories (Part XIII Criminal Code)","23","15","4","-1.52","0.61","0.34","0.34","0.36","1.07","19","10","11","1","3"
"2012","Alberta","48","Attempts, conspiracies, accessories (Part XIII Criminal Code)","13","8","2","-44.8","0.33","0.23","0.24","0.36","0","10","7","8","1","0"
"2013","Alberta","48","Attempts, conspiracies, accessories (Part XIII Criminal Code)","14","10","2","4.57","0.35","0.58","0.56","0.36","0","12","18","19","1","0"
"2014","Alberta","48","Attempts, conspiracies, accessories (Part XIII Criminal Code)","21","13","2","45.92","0.51","0.37","0.34","0","0","15","12","12","0","0"
"2015","Alberta","48","Attempts, conspiracies, accessories (Part XIII Criminal Code)","7","7","1","-67.24","0.17","0.18","0.17","0","0","8","6","6","0","0"
"2016","Alberta","48","Attempts, conspiracies, accessories (Part XIII Criminal Code)","14","11","1","96.56","0.33","0.36","0.39","0.71","0","12","12","14","2","0"
"2002","Alberta","48","Instruct offence for criminal organization","0","0","0","0","0","0","0","0","0","0","0","0","0","0"
"2003","Alberta","48","Instruct offence for criminal organization","0","0","0","0","0","0","0","0","0","0","0","0","0","0"
"2004","Alberta","48","Instruct offence for criminal organization","0","0","0","0","0","0","0","0","0","0","0","0","0","0"
"2005","Alberta","48","Instruct offence for criminal organization","0","0","0","0","0","0","0","0","0","0","0","0","0","0"
"2006","Alberta","48","Instruct offence for criminal organization","0","0","0","0","0","0","0","0","0","0","0","0","0","0"
"2007","Alberta","48","Instruct offence for criminal organization","0","0","0","0","0","0","0","0","0","0","0","0","0","0"
"2008","Alberta","48","Instruct offence for criminal organization","2","2","0","0","0.06","0.22","0.2","0","0","2","6","6","0","0"
"2009","Alberta","48","Instruct offence for criminal organization","0","0","0","-100","0","0","0","0","0","0","0","0","0","0"
"2010","Alberta","48","Instruct offence for criminal organization","0","1","0","0","0","0.14","0.13","0","0","1","4","4","0","0"
"2011","Alberta","48","Instruct offence for criminal organization","0","0","0","0","0","0","0","0","0","0","0","0","0","0"
"2012","Alberta","48","Instruct offence for criminal organization","0","0","0","0","0","0","0","0","0","0","0","0","0","0"
"2013","Alberta","48","Instruct offence for criminal organization","0","0","0","0","0","0","0","0","0","0","0","0","0","0"
"2014","Alberta","48","Instruct offence for criminal organization","1","0","0","0","0.02","0","0","0","0","0","0","0","0","0"
"2015","Alberta","48","Instruct offence for criminal organization","1","1","0","-1.71","0.02","0.18","0.17","0","0","1","6","6","0","0"
"2016","Alberta","48","Instruct offence for criminal organization","3","4","0","194.84","0.07","0.48","0.44","0","0","4","16","16","0","0"
"2002","Alberta","48","Commit offence for criminal organization","0","0","0","0","0","0","0","0","0","0","0","0","0","0"
"2003","Alberta","48","Commit offence for criminal organization","0","0","0","0","0","0","0","0","0","0","0","0","0","0"
"2004","Alberta","48","Commit offence for criminal organization","1","0","0","0","0.03","0","0","0","0","0","0","0","0","0"
"2005","Alberta","48","Commit offence for criminal organization","0","0","0","-100","0","0","0","0","0","0","0","0","0","0"
"2006","Alberta","48","Commit offence for criminal organization","0","0","0","0","0","0","0","0","0","0","0","0","0","0"
"2007","Alberta","48","Commit offence for criminal organization","0","0","0","0","0","0","0","0","0","0","0","0","0","0"
"2008","Alberta","48","Commit offence for criminal organization","0","0","0","0","0","0","0","0","0","0","0","0","0","0"
"2009","Alberta","48","Commit offence for criminal organization","0","1","0","0","0","0.31","0.29","0","0","1","9","9","0","0"
"2010","Alberta","48","Commit offence for criminal organization","1","1","0","0","0.03","0.17","0.16","0","0","1","5","5","0","0"
"2011","Alberta","48","Commit offence for criminal organization","0","0","0","-100","0","0","0","0","0","0","0","0","0","0"
"2012","Alberta","48","Commit offence for criminal organization","0","0","0","0","0","0","0","0","0","0","0","0","0","0"
"2013","Alberta","48","Commit offence for criminal organization","0","0","0","0","0","0","0","0","0","0","0","0","0","0"
"2014","Alberta","48","Commit offence for criminal organization","2","1","0","0","0.05","0.03","0.03","0","0","1","1","1","0","0"
"2015","Alberta","48","Commit offence for criminal organization","1","0","0","-50.85","0.02","0","0","0","0","0","0","0","0","0"
"2016","Alberta","48","Commit offence for criminal organization","1","0","0","-1.72","0.02","0","0","0","0","0","0","0","0","0"
"2002","Alberta","48","Participate in activities of criminal organization","0","0","0","0","0","0","0","0","0","0","0","0","0","0"
"2003","Alberta","48","Participate in activities of criminal organization","0","0","0","0","0","0","0","0","0","0","0","0","0","0"
"2004","Alberta","48","Participate in activities of criminal organization","0","0","0","0","0","0","0","0","0","0","0","0","0","0"
"2005","Alberta","48","Participate in activities of criminal organization","0","0","0","0","0","0","0","0","0","0","0","0","0","0"
"2006","Alberta","48","Participate in activities of criminal organization","0","0","0","0","0","0","0","0","0","0","0","0","0","0"
"2007","Alberta","48","Participate in activities of criminal organization","0","0","0","0","0","0","0","0","0","0","0","0","0","0"
"2008","Alberta","48","Participate in activities of criminal organization","1","0","1","0","0.03","0","0","0","0","1","0","0","0","0"
"2009","Alberta","48","Participate in activities of criminal organization","3","0","1","193.2","0.08","0","0","0","0","1","0","0","0","0"
"2010","Alberta","48","Participate in activities of criminal organization","0","0","0","-100","0","0","0","0","0","0","0","0","0","0"
"2011","Alberta","48","Participate in activities of criminal organization","0","0","0","0","0","0","0","0","0","0","0","0","0","0"
"2012","Alberta","48","Participate in activities of criminal organization","3","0","0","0","0.08","0","0","0","0","0","0","0","0","0"
"2013","Alberta","48","Participate in activities of criminal organization","3","0","0","-2.9","0.08","0","0","0","0","0","0","0","0","0"
"2014","Alberta","48","Participate in activities of criminal organization","4","0","1","29.71","0.1","0","0","0","0","1","0","0","0","0"
"2015","Alberta","48","Participate in activities of criminal organization","1","0","0","-75.43","0.02","0","0","0","0","0","0","0","0","0"
"2016","Alberta","48","Participate in activities of criminal organization","2","0","0","96.56","0.05","0","0","0","0","0","0","0","0","0"
"2012","Alberta","48","Recruitment of members by a criminal organization","0","0","0","0","0","0","0","0","0","0","0","0","0","0"
"2013","Alberta","48","Recruitment of members by a criminal organization","0","0","0","0","0","0","0","0","0","0","0","0","0","0"
"2014","Alberta","48","Recruitment of members by a criminal organization","0","0","0","0","0","0","0","0","0","0","0","0","0","0"
"2015","Alberta","48","Recruitment of members by a criminal organization","0","0","0","0","0","0","0","0","0","0","0","0","0","0"
"2016","Alberta","48","Recruitment of members by a criminal organization","0","0","0","0","0","0","0","0","0","0","0","0","0","0"
"1998","Alberta","48","All other Criminal Code (includes Part XII.1 Criminal Code)","210","47","116","0","7.24","0.7","0.63","0","3.07","163","15","15","0","8"
"1999","Alberta","48","All other Criminal Code (includes Part XII.1 Criminal Code)","204","40","131","-4.63","6.91","0.59","0.53","0","2.27","171","13","13","0","6"
"2000","Alberta","48","All other Criminal Code (includes Part XII.1 Criminal Code)","217","41","121","4.54","7.22","0.94","0.88","0.37","2.62","162","21","22","1","7"
"2001","Alberta","48","All other Criminal Code (includes Part XII.1 Criminal Code)","193","30","93","-12.6","6.31","0.7","0.62","0","6.28","123","16","16","0","17"
"2002","Alberta","48","All other Criminal Code (includes Part XII.1 Criminal Code)","171","22","89","-13.39","5.47","0.47","0.42","0","5.42","111","11","11","0","15"
"2003","Alberta","48","All other Criminal Code (includes Part XII.1 Criminal Code)","179","13","92","2.87","5.62","0.21","0.19","0","0.72","105","5","5","0","2"
"2004","Alberta","48","All other Criminal Code (includes Part XII.1 Criminal Code)","179","10","67","-1.73","5.53","0.24","0.22","0","1.07","77","6","6","0","3"
"2005","Alberta","48","All other Criminal Code (includes Part XII.1 Criminal Code)","173","12","52","-5.76","5.21","0.08","0.07","0","0.7","64","2","2","0","2"
"2006","Alberta","48","All other Criminal Code (includes Part XII.1 Criminal Code)","47","18","6","-73.62","1.37","0.57","0.55","0.35","0.35","24","15","16","1","1"
"2007","Alberta","48","All other Criminal Code (includes Part XII.1 Criminal Code)","97","41","5","100.94","2.76","1.14","1.03","0","0","46","31","31","0","0"
"2008","Alberta","48","All other Criminal Code (includes Part XII.1 Criminal Code)","158","58","4","59.18","4.39","1.76","1.66","0.7","0","62","49","51","2","0"
"2009","Alberta","48","All other Criminal Code (includes Part XII.1 Criminal Code)","145","47","6","-10.31","3.94","1.26","1.15","0","0.7","53","36","36","0","2"
"2010","Alberta","48","All other Criminal Code (includes Part XII.1 Criminal Code)","162","75","5","10.12","4.34","2.07","2.01","1.42","0.36","80","60","64","4","1"
"2011","Alberta","48","All other Criminal Code (includes Part XII.1 Criminal Code)","104","84","7","-36.78","2.74","1.73","1.67","1.07","0","91","51","54","3","0"
"2012","Alberta","48","All other Criminal Code (includes Part XII.1 Criminal Code)","114","83","16","7.06","2.94","1.98","1.84","0.36","2.14","99","60","61","1","6"
"2013","Alberta","48","All other Criminal Code (includes Part XII.1 Criminal Code)","176","155","5","49.91","4.4","4.03","3.88","2.15","0","160","126","132","6","0"
"2014","Alberta","48","All other Criminal Code (includes Part XII.1 Criminal Code)","99","68","4","-45.28","2.41","1.49","1.43","0.72","0","72","48","50","2","0"
"2015","Alberta","48","All other Criminal Code (includes Part XII.1 Criminal Code)","118","96","5","17.16","2.82","2.23","2.2","1.79","0.36","101","73","78","5","1"
"2016","Alberta","48","All other Criminal Code (includes Part XII.1 Criminal Code)","161","131","12","34.09","3.79","3.61","3.38","0.71","0","143","120","122","2","0"
"1998","Alberta","48","Total Criminal Code traffic violations","15714","14629","455","0","541.96","572.57","510.39","0","0","15084","12247","12247","0","0"
"1999","Alberta","48","Total Criminal Code traffic violations","15146","13319","486","-5.37","512.86","563.13","502.52","0","0","13805","12337","12337","0","0"
"2000","Alberta","48","Total Criminal Code traffic violations","14867","12428","744","-3.53","494.75","540.03","482.55","0.37","0","13172","12104","12105","1","0"
"2001","Alberta","48","Total Criminal Code traffic violations","16837","13914","1157","11.29","550.59","594.16","531.47","0","0.74","15071","13633","13633","0","2"
"2002","Alberta","48","Total Criminal Code traffic violations","15736","13272","1071","-8.64","503.01","561.7","502.76","0.36","0.72","14343","13253","13254","1","2"
"2003","Alberta","48","Total Criminal Code traffic violations","15733","12634","1116","-1.75","494.22","526.45","471.79","0","0","13750","12702","12702","0","0"
"2004","Alberta","48","Total Criminal Code traffic violations","16062","12666","1004","0.32","495.82","512.51","460.1","0","0","13670","12644","12644","0","0"
"2005","Alberta","48","Total Criminal Code traffic violations","16597","11989","1076","0.76","499.58","475.69","427.92","0","0","13065","12088","12088","0","0"
"2006","Alberta","48","Total Criminal Code traffic violations","16794","12646","1136","-1.75","490.86","479.62","432.37","0","0","13782","12599","12599","0","0"
"2007","Alberta","48","Total Criminal Code traffic violations","19859","13791","1180","15.13","565.13","495.25","461.32","140.8","18.82","14971","13426","13830","404","54"
"2008","Alberta","48","Total Criminal Code traffic violations","23472","14806","1663","15.51","652.77","519.32","481.45","111.83","28.75","16469","14462","14781","319","82"
"2009","Alberta","48","Total Criminal Code traffic violations","22475","14134","1945","-6.42","610.88","487.27","451.76","94.09","33.13","16079","13927","14194","267","94"
"2010","Alberta","48","Total Criminal Code traffic violations","21964","14136","2528","-3.67","588.44","480.86","447.79","106.87","37.99","16664","13959","14260","301","107"
"2011","Alberta","48","Total Criminal Code traffic violations","21904","13975","2440","-1.79","577.91","466.17","434.32","100.28","33.78","16415","13751","14033","282","95"
"2012","Alberta","48","Total Criminal Code traffic violations","21118","13470","1798","-5.84","544.17","439.9","411.16","100.67","28.56","15268","13312","13594","282","80"
"2013","Alberta","48","Total Criminal Code traffic violations","20033","12494","1399","-7.89","501.25","394.15","368.68","84.06","22.54","13893","12312","12547","235","63"
"2014","Alberta","48","Total Criminal Code traffic violations","19439","12701","1121","-5.6","473.17","391.47","366.95","83.94","11.84","13822","12593","12827","234","33"
"2015","Alberta","48","Total Criminal Code traffic violations","18454","12280","1068","-6.69","441.52","372.29","349.05","77.25","10.01","13348","12176","12392","216","28"
"2016","Alberta","48","Total Criminal Code traffic violations","17314","11075","905","-7.79","407.11","332.35","310.35","51.95","12.37","11980","11046","11193","147","35"
"1998","Alberta","48","Total impaired driving","12597","11736","375","0","434.46","466.96","416.25","0","0","12111","9988","9988","0","0"
"1999","Alberta","48","Total impaired driving","12274","10632","426","-4.34","415.61","458.6","409.24","0","0","11058","10047","10047","0","0"
"2000","Alberta","48","Total impaired driving","11902","9979","686","-4.7","396.08","444.82","397.44","0","0","10665","9970","9970","0","0"
"2001","Alberta","48","Total impaired driving","13265","10624","1064","9.52","433.78","458.62","410.23","0","0","11688","10523","10523","0","0"
"2002","Alberta","48","Total impaired driving","12185","10132","898","-10.21","389.5","431.96","386.61","0","0","11030","10192","10192","0","0"
"2003","Alberta","48","Total impaired driving","12319","9500","1002","-0.65","386.98","398.13","356.79","0","0","10502","9606","9606","0","0"
"2004","Alberta","48","Total impaired driving","12669","9535","924","1.06","391.08","390.18","350.28","0","0","10459","9626","9626","0","0"
"2005","Alberta","48","Total impaired driving","12636","9080","952","-2.74","380.35","360.35","324.16","0","0","10032","9157","9157","0","0"
"2006","Alberta","48","Total impaired driving","11803","9455","924","-9.3","344.98","357.12","321.93","0","0","10379","9381","9381","0","0"
"2007","Alberta","48","Total impaired driving","14265","10422","915","17.67","405.94","376.03","346.47","67.26","9.06","11337","10194","10387","193","26"
"2008","Alberta","48","Total impaired driving","17075","11216","1304","16.98","474.87","393.81","363.12","63.45","18.23","12520","10967","11148","181","52"
"2009","Alberta","48","Total impaired driving","17051","10819","1647","-2.4","463.46","373.84","344.6","50.04","20.09","12466","10685","10827","142","57"
"2010","Alberta","48","Total impaired driving","16879","10982","2257","-2.43","452.21","374.25","346.61","61.78","29.83","13239","10864","11038","174","84"
"2011","Alberta","48","Total impaired driving","16674","10815","2194","-2.72","439.93","362.71","336.24","58.67","26.31","13009","10699","10864","165","74"
"2012","Alberta","48","Total impaired driving","15833","10244","1548","-7.26","407.99","336.1","311.92","50.69","19.28","11792","10171","10313","142","54"
"2013","Alberta","48","Total impaired driving","14520","9247","1097","-10.95","363.31","294.3","272.47","28.62","16.1","10344","9193","9273","80","45"
"2014","Alberta","48","Total impaired driving","14234","9011","814","-4.63","346.47","279.47","260.01","35.51","6.82","9825","8990","9089","99","19"
"2015","Alberta","48","Total impaired driving","13040","8459","744","-9.95","311.99","257.29","240.01","37.91","4.65","9203","8415","8521","106","13"
"2016","Alberta","48","Total impaired driving","12191","7467","619","-8.12","286.65","224.4","208.56","22.62","6.36","8086","7458","7522","64","18"
"1998","Alberta","48","Impaired operation, causing death","19","15","1","0","0.66","0.56","0.5","0","0","16","12","12","0","0"
"1999","Alberta","48","Impaired operation, causing death","19","20","4","-1.82","0.64","0.64","0.57","0","0","24","14","14","0","0"
"2000","Alberta","48","Impaired operation, causing death","19","21","0","-1.72","0.63","0.85","0.76","0","0","21","19","19","0","0"
"2001","Alberta","48","Impaired operation, causing death","18","13","2","-6.91","0.59","0.57","0.51","0","0","15","13","13","0","0"
"2002","Alberta","48","Impaired operation, causing death","14","17","0","-23.97","0.45","0.81","0.72","0","0","17","19","19","0","0"
"2003","Alberta","48","Impaired operation, causing death","26","21","6","82.5","0.82","0.79","0.71","0","0","27","19","19","0","0"
"2004","Alberta","48","Impaired operation, causing death","23","19","1","-13.07","0.71","0.69","0.62","0","0","20","17","17","0","0"
"2005","Alberta","48","Impaired operation, causing death","21","17","1","-10.97","0.63","0.67","0.6","0","0","18","17","17","0","0"
"2006","Alberta","48","Impaired operation, causing death","33","31","0","52.59","0.96","1.14","1.03","0","0","31","30","30","0","0"
"2007","Alberta","48","Impaired operation, causing death","29","24","3","-14.44","0.83","0.85","0.8","0.35","0","27","23","24","1","0"
"2008","Alberta","48","Impaired operation, causing death","34","25","5","14.58","0.95","0.83","0.81","0.7","0","30","23","25","2","0"
"2009","Alberta","48","Impaired operation, causing death","33","28","3","-5.14","0.9","0.98","0.92","0.35","0","31","28","29","1","0"
"2010","Alberta","48","Impaired operation, causing death","27","20","7","-19.35","0.72","0.62","0.63","0.71","0","27","18","20","2","0"
"2011","Alberta","48","Impaired operation, causing death","20","19","4","-27.05","0.53","0.58","0.59","0.71","0","23","17","19","2","0"
"2012","Alberta","48","Impaired operation, causing death","28","25","5","36.73","0.72","0.73","0.73","0.71","0","30","22","24","2","0"
"2013","Alberta","48","Impaired operation, causing death","29","22","3","0.57","0.73","0.74","0.68","0","0","25","23","23","0","0"
"2014","Alberta","48","Impaired operation, causing death","28","25","3","-6.07","0.68","0.78","0.72","0","0","28","25","25","0","0"
"2015","Alberta","48","Impaired operation, causing death","31","23","7","8.82","0.74","0.64","0.62","0.36","0","30","21","22","1","0"
"2016","Alberta","48","Impaired operation, causing death","20","21","1","-36.59","0.47","0.63","0.58","0","0","22","21","21","0","0"
"2005","Alberta","48","Impaired operation (drugs), causing death","0","0","0","0","0","0","0","0","0","0","0","0","0","0"
"2006","Alberta","48","Impaired operation (drugs), causing death","0","0","0","0","0","0","0","0","0","0","0","0","0","0"
"2007","Alberta","48","Impaired operation (drugs), causing death","0","0","0","0","0","0","0","0","0","0","0","0","0","0"
"2008","Alberta","48","Impaired operation (drugs), causing death","0","0","0","0","0","0","0","0","0","0","0","0","0","0"
"2009","Alberta","48","Impaired operation (drugs), causing death","1","1","0","0","0.03","0.03","0.03","0","0","1","1","1","0","0"
"2010","Alberta","48","Impaired operation (drugs), causing death","0","0","0","-100","0","0","0","0","0","0","0","0","0","0"
"2011","Alberta","48","Impaired operation (drugs), causing death","0","0","0","0","0","0","0","0","0","0","0","0","0","0"
"2012","Alberta","48","Impaired operation (drugs), causing death","0","0","0","0","0","0","0","0","0","0","0","0","0","0"
"2013","Alberta","48","Impaired operation (drugs), causing death","3","3","0","0","0.08","0.1","0.09","0","0","3","3","3","0","0"
"2014","Alberta","48","Impaired operation (drugs), causing death","1","0","1","-67.57","0.02","0","0","0","0","1","0","0","0","0"
"2015","Alberta","48","Impaired operation (drugs), causing death","3","2","1","194.88","0.07","0.03","0.03","0","0","3","1","1","0","0"
"2016","Alberta","48","Impaired operation (drugs), causing death","2","1","1","-34.48","0.05","0.03","0.03","0","0","2","1","1","0","0"
"1998","Alberta","48","Impaired operation, causing bodily harm","146","157","1","0","5.04","4.72","4.21","0","0","158","101","101","0","0"
"1999","Alberta","48","Impaired operation, causing bodily harm","146","146","5","-1.82","4.94","4.43","3.95","0","0","151","97","97","0","0"
"2000","Alberta","48","Impaired operation, causing bodily harm","125","123","0","-15.86","4.16","4.77","4.27","0","0","123","107","107","0","0"
"2001","Alberta","48","Impaired operation, causing bodily harm","130","126","1","2.19","4.25","5.27","4.72","0","0","127","121","121","0","0"
"2002","Alberta","48","Impaired operation, causing bodily harm","109","120","6","-18.04","3.48","5.13","4.59","0","0","126","121","121","0","0"
"2003","Alberta","48","Impaired operation, causing bodily harm","103","102","3","-7.14","3.24","4.35","3.9","0","0","105","105","105","0","0"
"2004","Alberta","48","Impaired operation, causing bodily harm","102","105","3","-2.69","3.15","4.13","3.71","0","0","108","102","102","0","0"
"2005","Alberta","48","Impaired operation, causing bodily harm","90","79","3","-13.96","2.71","3.15","2.83","0","0","82","80","80","0","0"
"2006","Alberta","48","Impaired operation, causing bodily harm","108","96","5","16.52","3.16","3.62","3.26","0","0","101","95","95","0","0"
"2007","Alberta","48","Impaired operation, causing bodily harm","135","119","6","21.7","3.84","4.32","4.07","1.74","0","125","117","122","5","0"
"2008","Alberta","48","Impaired operation, causing bodily harm","115","105","5","-16.75","3.2","3.52","3.42","2.45","0","110","98","105","7","0"
"2009","Alberta","48","Impaired operation, causing bodily harm","89","81","8","-24.36","2.42","2.55","2.45","1.41","0","89","73","77","4","0"
"2010","Alberta","48","Impaired operation, causing bodily harm","93","79","6","3","2.49","2.82","2.64","0.71","0.36","85","82","84","2","1"
"2011","Alberta","48","Impaired operation, causing bodily harm","96","89","5","1.66","2.53","2.88","2.75","1.42","0","94","85","89","4","0"
"2012","Alberta","48","Impaired operation, causing bodily harm","86","82","8","-12.51","2.22","2.84","2.6","0","0","90","86","86","0","0"
"2013","Alberta","48","Impaired operation, causing bodily harm","63","57","2","-28.87","1.58","1.79","1.73","1.07","0","59","56","59","3","0"
"2014","Alberta","48","Impaired operation, causing bodily harm","72","64","3","11.18","1.75","1.99","1.89","0.72","0","67","64","66","2","0"
"2015","Alberta","48","Impaired operation, causing bodily harm","78","66","8","6.48","1.87","1.99","1.89","0.72","0.36","74","65","67","2","1"
"2016","Alberta","48","Impaired operation, causing bodily harm","54","45","5","-31.96","1.27","1.32","1.28","0.71","0","50","44","46","2","0"
"2005","Alberta","48","Impaired operation (drugs), causing bodily harm","0","0","0","0","0","0","0","0","0","0","0","0","0","0"
"2006","Alberta","48","Impaired operation (drugs), causing bodily harm","0","0","0","0","0","0","0","0","0","0","0","0","0","0"
"2007","Alberta","48","Impaired operation (drugs), causing bodily harm","0","0","0","0","0","0","0","0","0","0","0","0","0","0"
"2008","Alberta","48","Impaired operation (drugs), causing bodily harm","0","0","0","0","0","0.04","0.03","0","0","0","1","1","0","0"
"2009","Alberta","48","Impaired operation (drugs), causing bodily harm","1","1","0","0","0.03","0.03","0.03","0","0","1","1","1","0","0"
"2010","Alberta","48","Impaired operation (drugs), causing bodily harm","2","1","0","97.13","0.05","0.03","0.03","0","0","1","1","1","0","0"
"2011","Alberta","48","Impaired operation (drugs), causing bodily harm","3","4","0","47.72","0.08","0.1","0.09","0","0","4","3","3","0","0"
"2012","Alberta","48","Impaired operation (drugs), causing bodily harm","0","0","0","-100","0","0","0","0","0","0","0","0","0","0"
"2013","Alberta","48","Impaired operation (drugs), causing bodily harm","1","1","0","0","0.03","0.03","0.03","0","0","1","1","1","0","0"
"2014","Alberta","48","Impaired operation (drugs), causing bodily harm","6","4","1","483.69","0.15","0.12","0.11","0","0","5","4","4","0","0"
"2015","Alberta","48","Impaired operation (drugs), causing bodily harm","3","3","0","-50.85","0.07","0.06","0.08","0.36","0","3","2","3","1","0"
"2016","Alberta","48","Impaired operation (drugs), causing bodily harm","2","1","0","-34.48","0.05","0.03","0.03","0","0","1","1","1","0","0"
"1998","Alberta","48","Impaired operation of motor vehicle, vessel or aircraft","11853","10993","367","0","408.8","449.33","400.54","0","0","11360","9611","9611","0","0"
"1999","Alberta","48","Impaired operation of motor vehicle, vessel or aircraft","11488","9877","414","-4.85","388.99","436.55","389.56","0","0","10291","9564","9564","0","0"
"2000","Alberta","48","Impaired operation of motor vehicle, vessel or aircraft","11278","9356","682","-3.52","375.32","423.89","378.74","0","0","10038","9501","9501","0","0"
"2001","Alberta","48","Impaired operation of motor vehicle, vessel or aircraft","12596","9938","1058","9.75","411.9","435.91","389.92","0","0","10996","10002","10002","0","0"
"2002","Alberta","48","Impaired operation of motor vehicle, vessel or aircraft","11608","9560","889","-9.92","371.06","412.42","369.12","0","0","10449","9731","9731","0","0"
"2003","Alberta","48","Impaired operation of motor vehicle, vessel or aircraft","11761","8944","991","-0.43","369.45","378.69","339.37","0","0","9935","9137","9137","0","0"
"2004","Alberta","48","Impaired operation of motor vehicle, vessel or aircraft","12020","8881","915","0.43","371.05","367.19","329.64","0","0","9796","9059","9059","0","0"
"2005","Alberta","48","Impaired operation of motor vehicle, vessel or aircraft","12085","8548","946","-1.96","363.76","340.91","306.67","0","0","9494","8663","8663","0","0"
"2006","Alberta","48","Impaired operation of motor vehicle, vessel or aircraft","11313","8990","913","-9.1","330.66","340.1","306.59","0","0","9903","8934","8934","0","0"
"2007","Alberta","48","Impaired operation of motor vehicle, vessel or aircraft","13702","9886","902","17.92","389.92","356.88","328.93","64.82","9.06","10788","9675","9861","186","26"
"2008","Alberta","48","Impaired operation of motor vehicle, vessel or aircraft","16275","10572","1244","16.08","452.62","371.84","342.73","58.54","17.53","11816","10355","10522","167","50"
"2009","Alberta","48","Impaired operation of motor vehicle, vessel or aircraft","16099","10146","1519","-3.32","437.58","351.03","323.53","46.52","18.32","11665","10033","10165","132","52"
"2010","Alberta","48","Impaired operation of motor vehicle, vessel or aircraft","15780","10250","2049","-3.39","422.76","349.58","323.78","57.88","24.85","12299","10148","10311","163","70"
"2011","Alberta","48","Impaired operation of motor vehicle, vessel or aircraft","15508","10026","1957","-3.22","409.16","336.23","311.76","55.12","19.91","11983","9918","10073","155","56"
"2012","Alberta","48","Impaired operation of motor vehicle, vessel or aircraft","14636","9325","1393","-7.83","377.14","305.97","283.91","45.7","15.35","10718","9259","9387","128","43"
"2013","Alberta","48","Impaired operation of motor vehicle, vessel or aircraft","13398","8402","991","-11.11","335.23","267.37","247.62","26.83","13.95","9393","8352","8427","75","39"
"2014","Alberta","48","Impaired operation of motor vehicle, vessel or aircraft","12909","8098","704","-6.27","314.22","251.21","233.75","32.29","5.38","8802","8081","8171","90","15"
"2015","Alberta","48","Impaired operation of motor vehicle, vessel or aircraft","11762","7531","626","-10.44","281.41","229.01","213.62","33.62","2.86","8157","7490","7584","94","8"
"2016","Alberta","48","Impaired operation of motor vehicle, vessel or aircraft","11000","6628","550","-8.09","258.65","199.18","185.16","20.5","4.24","7178","6620","6678","58","12"
"2005","Alberta","48","Impaired operation (drugs) vehicle, vessel, aircraft","0","0","0","0","0","0","0","0","0","0","0","0","0","0"
"2006","Alberta","48","Impaired operation (drugs) vehicle, vessel, aircraft","0","0","0","0","0","0","0","0","0","0","0","0","0","0"
"2007","Alberta","48","Impaired operation (drugs) vehicle, vessel, aircraft","0","0","0","0","0","0","0","0","0","0","0","0","0","0"
"2008","Alberta","48","Impaired operation (drugs) vehicle, vessel, aircraft","151","31","36","0","4.2","0.93","0.91","0.7","0.7","67","26","28","2","2"
"2009","Alberta","48","Impaired operation (drugs) vehicle, vessel, aircraft","338","76","111","118.77","9.19","2.69","2.48","0.35","1.76","187","77","78","1","5"
"2010","Alberta","48","Impaired operation (drugs) vehicle, vessel, aircraft","472","135","189","37.64","12.65","4.37","4.11","1.42","4.62","324","127","131","4","13"
"2011","Alberta","48","Impaired operation (drugs) vehicle, vessel, aircraft","479","122","218","-0.06","12.64","4","3.74","1.07","6.4","340","118","121","3","18"
"2012","Alberta","48","Impaired operation (drugs) vehicle, vessel, aircraft","382","122","133","-22.11","9.84","3.83","3.72","2.5","3.57","255","116","123","7","10"
"2013","Alberta","48","Impaired operation (drugs) vehicle, vessel, aircraft","350","100","91","-11.03","8.76","3.17","2.91","0","2.15","191","99","99","0","6"
"2014","Alberta","48","Impaired operation (drugs) vehicle, vessel, aircraft","541","153","96","50.37","13.17","4.51","4.35","2.51","1.43","249","145","152","7","4"
"2015","Alberta","48","Impaired operation (drugs) vehicle, vessel, aircraft","456","137","89","-17.15","10.91","4.13","3.92","1.43","1.43","226","135","139","4","4"
"2016","Alberta","48","Impaired operation (drugs) vehicle, vessel, aircraft","477","147","55","2.8","11.22","4.48","4.16","0.35","2.12","202","149","150","1","6"
"1998","Alberta","48","Impaired operation, failure to provide breath sample","562","552","6","0","19.38","11.73","10.46","0","0","558","251","251","0","0"
"1999","Alberta","48","Impaired operation, failure to provide breath sample","600","568","3","4.82","20.32","16.61","14.83","0","0","571","364","364","0","0"
"2000","Alberta","48","Impaired operation, failure to provide breath sample","472","471","4","-22.69","15.71","15.04","13.43","0","0","475","337","337","0","0"
"2001","Alberta","48","Impaired operation, failure to provide breath sample","503","528","3","4.72","16.45","16.39","14.66","0","0","531","376","376","0","0"
"2002","Alberta","48","Impaired operation, failure to provide breath sample","443","425","2","-13.91","14.16","13.27","11.87","0","0","427","313","313","0","0"
"2003","Alberta","48","Impaired operation, failure to provide breath sample","423","426","2","-6.17","13.29","14.05","12.59","0","0","428","339","339","0","0"
"2004","Alberta","48","Impaired operation, failure to provide breath sample","517","525","4","20.11","15.96","18","16.16","0","0","529","444","444","0","0"
"2005","Alberta","48","Impaired operation, failure to provide breath sample","433","428","2","-18.33","13.03","15.31","13.77","0","0","430","389","389","0","0"
"2006","Alberta","48","Impaired operation, failure to provide breath sample","342","333","6","-23.31","10","12.07","10.88","0","0","339","317","317","0","0"
"2007","Alberta","48","Impaired operation, failure to provide breath sample","392","386","4","11.6","11.16","13.69","12.41","0.35","0","390","371","372","1","0"
"2008","Alberta","48","Impaired operation, failure to provide breath sample","477","462","14","18.92","13.27","16.02","14.59","0.7","0","476","446","448","2","0"
"2009","Alberta","48","Impaired operation, failure to provide breath sample","470","464","6","-3.7","12.77","15.74","14.45","1.41","0","470","450","454","4","0"
"2010","Alberta","48","Impaired operation, failure to provide breath sample","498","491","5","4.44","13.34","16.6","15.23","1.07","0","496","482","485","3","0"
"2011","Alberta","48","Impaired operation, failure to provide breath sample","559","547","9","10.54","14.75","18.58","16.99","0.36","0","556","548","549","1","0"
"2012","Alberta","48","Impaired operation, failure to provide breath sample","693","682","9","21.08","17.86","22.5","20.75","1.79","0.36","691","681","686","5","1"
"2013","Alberta","48","Impaired operation, failure to provide breath sample","675","661","10","-5.42","16.89","21.06","19.39","0.72","0","671","658","660","2","0"
"2014","Alberta","48","Impaired operation, failure to provide breath sample","673","664","6","-3.01","16.38","20.77","19.11","0","0","670","668","668","0","0"
"2015","Alberta","48","Impaired operation, failure to provide breath sample","701","692","12","2.38","16.77","21.28","19.72","1.43","0","704","696","700","4","0"
"2016","Alberta","48","Impaired operation, failure to provide breath sample","629","619","7","-11.82","14.79","18.59","17.22","1.06","0","626","618","621","3","0"
"2005","Alberta","48","Failure to comply or refusal (drugs)","0","0","0","0","0","0","0","0","0","0","0","0","0","0"
"2006","Alberta","48","Failure to comply or refusal (drugs)","0","0","0","0","0","0","0","0","0","0","0","0","0","0"
"2007","Alberta","48","Failure to comply or refusal (drugs)","0","0","0","0","0","0","0","0","0","0","0","0","0","0"
"2008","Alberta","48","Failure to comply or refusal (drugs)","0","0","0","0","0","0","0","0","0","0","0","0","0","0"
"2009","Alberta","48","Failure to comply or refusal (drugs)","4","4","0","0","0.11","0.14","0.13","0","0","4","4","4","0","0"
"2010","Alberta","48","Failure to comply or refusal (drugs)","4","4","0","-1.43","0.11","0.14","0.13","0","0","4","4","4","0","0"
"2011","Alberta","48","Failure to comply or refusal (drugs)","6","6","0","47.72","0.16","0.2","0.19","0","0","6","6","6","0","0"
"2012","Alberta","48","Failure to comply or refusal (drugs)","3","3","0","-51.17","0.08","0.1","0.09","0","0","3","3","3","0","0"
"2013","Alberta","48","Failure to comply or refusal (drugs)","0","0","0","-100","0","0","0","0","0","0","0","0","0","0"
"2014","Alberta","48","Failure to comply or refusal (drugs)","2","2","0","0","0.05","0.06","0.06","0","0","2","2","2","0","0"
"2015","Alberta","48","Failure to comply or refusal (drugs)","3","3","0","47.44","0.07","0.09","0.08","0","0","3","3","3","0","0"
"2016","Alberta","48","Failure to comply or refusal (drugs)","1","1","0","-67.24","0.02","0.03","0.03","0","0","1","1","1","0","0"
"1998","Alberta","48","Impaired operation, failure to provide blood sample","17","19","0","0","0.59","0.61","0.54","0","0","19","13","13","0","0"
"1999","Alberta","48","Impaired operation, failure to provide blood sample","21","21","0","21.28","0.71","0.37","0.33","0","0","21","8","8","0","0"
"2000","Alberta","48","Impaired operation, failure to provide blood sample","8","8","0","-62.56","0.27","0.27","0.24","0","0","8","6","6","0","0"
"2001","Alberta","48","Impaired operation, failure to provide blood sample","18","19","0","121.09","0.59","0.48","0.43","0","0","19","11","11","0","0"
"2002","Alberta","48","Impaired operation, failure to provide blood sample","11","10","1","-40.26","0.35","0.34","0.3","0","0","11","8","8","0","0"
"2003","Alberta","48","Impaired operation, failure to provide blood sample","6","7","0","-46.4","0.19","0.25","0.22","0","0","7","6","6","0","0"
"2004","Alberta","48","Impaired operation, failure to provide blood sample","7","5","1","14.65","0.22","0.16","0.15","0","0","6","4","4","0","0"
"2005","Alberta","48","Impaired operation, failure to provide blood sample","7","8","0","-2.49","0.21","0.31","0.28","0","0","8","8","8","0","0"
"2006","Alberta","48","Impaired operation, failure to provide blood sample","7","5","0","-2.9","0.2","0.19","0.17","0","0","5","5","5","0","0"
"2007","Alberta","48","Impaired operation, failure to provide blood sample","7","7","0","-2.64","0.2","0.3","0.27","0","0","7","8","8","0","0"
"2008","Alberta","48","Impaired operation, failure to provide blood sample","23","21","0","221.1","0.64","0.65","0.62","0.35","0","21","18","19","1","0"
"2009","Alberta","48","Impaired operation, failure to provide blood sample","14","16","0","-40.51","0.38","0.56","0.51","0","0","16","16","16","0","0"
"2010","Alberta","48","Impaired operation, failure to provide blood sample","3","2","1","-78.88","0.08","0.07","0.06","0","0","3","2","2","0","0"
"2011","Alberta","48","Impaired operation, failure to provide blood sample","2","1","1","-34.35","0.05","0.03","0.03","0","0","2","1","1","0","0"
"2012","Alberta","48","Impaired operation, failure to provide blood sample","5","5","0","144.17","0.13","0.13","0.12","0","0","5","4","4","0","0"
"2013","Alberta","48","Impaired operation, failure to provide blood sample","1","1","0","-80.58","0.03","0.03","0.03","0","0","1","1","1","0","0"
"2014","Alberta","48","Impaired operation, failure to provide blood sample","1","0","0","-2.72","0.02","0","0","0","0","0","0","0","0","0"
"2015","Alberta","48","Impaired operation, failure to provide blood sample","3","2","1","194.88","0.07","0.06","0.06","0","0","3","2","2","0","0"
"2016","Alberta","48","Impaired operation, failure to provide blood sample","6","4","0","96.56","0.14","0.09","0.08","0","0","4","3","3","0","0"
"2005","Alberta","48","Failure to provide blood sample (drugs)","0","0","0","0","0","0","0","0","0","0","0","0","0","0"
"2006","Alberta","48","Failure to provide blood sample (drugs)","0","0","0","0","0","0","0","0","0","0","0","0","0","0"
"2007","Alberta","48","Failure to provide blood sample (drugs)","0","0","0","0","0","0","0","0","0","0","0","0","0","0"
"2008","Alberta","48","Failure to provide blood sample (drugs)","0","0","0","0","0","0","0","0","0","0","0","0","0","0"
"2009","Alberta","48","Failure to provide blood sample (drugs)","2","2","0","0","0.05","0.07","0.06","0","0","2","2","2","0","0"
"2010","Alberta","48","Failure to provide blood sample (drugs)","0","0","0","-100","0","0","0","0","0","0","0","0","0","0"
"2011","Alberta","48","Failure to provide blood sample (drugs)","1","1","0","0","0.03","0.1","0.09","0","0","1","3","3","0","0"
"2012","Alberta","48","Failure to provide blood sample (drugs)","0","0","0","-100","0","0","0","0","0","0","0","0","0","0"
"2013","Alberta","48","Failure to provide blood sample (drugs)","0","0","0","0","0","0","0","0","0","0","0","0","0","0"
"2014","Alberta","48","Failure to provide blood sample (drugs)","1","1","0","0","0.02","0.03","0.03","0","0","1","1","1","0","0"
"2015","Alberta","48","Failure to provide blood sample (drugs)","0","0","0","-100","0","0","0","0","0","0","0","0","0","0"
"2016","Alberta","48","Failure to provide blood sample (drugs)","0","0","0","0","0","0","0","0","0","0","0","0","0","0"
"1998","Alberta","48","Total other Criminal Code traffic violations","3117","2893","80","0","107.5","105.61","94.14","0","0","2973","2259","2259","0","0"
"1999","Alberta","48","Total other Criminal Code traffic violations","2872","2687","60","-9.54","97.25","104.53","93.28","0","0","2747","2290","2290","0","0"
"2000","Alberta","48","Total other Criminal Code traffic violations","2965","2449","58","1.46","98.67","95.21","85.11","0.37","0","2507","2134","2135","1","0"
"2001","Alberta","48","Total other Criminal Code traffic violations","3572","3290","93","18.38","116.81","135.54","121.24","0","0.74","3383","3110","3110","0","2"
"2002","Alberta","48","Total other Criminal Code traffic violations","3551","3140","173","-2.82","113.51","129.73","116.15","0.36","0.72","3313","3061","3062","1","2"
"2003","Alberta","48","Total other Criminal Code traffic violations","3414","3134","114","-5.52","107.24","128.32","114.99","0","0","3248","3096","3096","0","0"
"2004","Alberta","48","Total other Criminal Code traffic violations","3393","3131","80","-2.34","104.74","122.33","109.82","0","0","3211","3018","3018","0","0"
"2005","Alberta","48","Total other Criminal Code traffic violations","3961","2909","124","13.83","119.23","115.34","103.76","0","0","3033","2931","2931","0","0"
"2006","Alberta","48","Total other Criminal Code traffic violations","4991","3191","212","22.35","145.88","122.5","110.43","0","0","3403","3218","3218","0","0"
"2007","Alberta","48","Total other Criminal Code traffic violations","5594","3369","265","9.13","159.19","119.22","114.85","73.54","9.76","3634","3232","3443","211","28"
"2008","Alberta","48","Total other Criminal Code traffic violations","6397","3590","359","11.76","177.9","125.5","118.34","48.38","10.52","3949","3495","3633","138","30"
"2009","Alberta","48","Total other Criminal Code traffic violations","5424","3315","298","-17.13","147.43","113.43","107.16","44.05","13.04","3613","3242","3367","125","37"
"2010","Alberta","48","Total other Criminal Code traffic violations","5085","3154","271","-7.59","136.23","106.62","101.18","45.09","8.17","3425","3095","3222","127","23"
"2011","Alberta","48","Total other Criminal Code traffic violations","5230","3160","246","1.29","137.99","103.47","98.08","41.61","7.47","3406","3052","3169","117","21"
"2012","Alberta","48","Total other Criminal Code traffic violations","5285","3226","250","-1.31","136.18","103.79","99.24","49.98","9.28","3476","3141","3281","140","26"
"2013","Alberta","48","Total other Criminal Code traffic violations","5513","3247","302","1.29","137.94","99.85","96.2","55.45","6.44","3549","3119","3274","155","18"
"2014","Alberta","48","Total other Criminal Code traffic violations","5205","3690","307","-8.15","126.7","112","106.93","48.43","5.02","3997","3603","3738","135","14"
"2015","Alberta","48","Total other Criminal Code traffic violations","5414","3821","324","2.24","129.53","114.99","109.04","39.34","5.36","4145","3761","3871","110","15"
"2016","Alberta","48","Total other Criminal Code traffic violations","5123","3608","286","-7","120.46","107.96","101.79","29.33","6.01","3894","3588","3671","83","17"
"1998","Alberta","48","Dangerous operation, causing death","29","31","1","0","1","1.22","1.08","0","0","32","26","26","0","0"
"1999","Alberta","48","Dangerous operation, causing death","23","24","2","-22.13","0.78","0.87","0.77","0","0","26","19","19","0","0"
"2000","Alberta","48","Dangerous operation, causing death","21","20","2","-10.27","0.7","0.67","0.6","0","0","22","15","15","0","0"
"2001","Alberta","48","Dangerous operation, causing death","23","33","1","7.62","0.75","1.22","1.09","0","0","34","28","28","0","0"
"2002","Alberta","48","Dangerous operation, causing death","21","31","0","-10.75","0.67","1.31","1.18","0","0","31","31","31","0","0"
"2003","Alberta","48","Dangerous operation, causing death","21","27","1","-1.73","0.66","1.08","0.97","0","0","28","26","26","0","0"
"2004","Alberta","48","Dangerous operation, causing death","25","26","0","16.99","0.77","1.22","1.09","0","0","26","30","30","0","0"
"2005","Alberta","48","Dangerous operation, causing death","16","16","0","-37.59","0.48","0.67","0.6","0","0","16","17","17","0","0"
"2006","Alberta","48","Dangerous operation, causing death","23","21","1","39.58","0.67","0.99","0.89","0","0","22","26","26","0","0"
"2007","Alberta","48","Dangerous operation, causing death","25","15","3","5.83","0.71","0.55","0.5","0","0","18","15","15","0","0"
"2008","Alberta","48","Dangerous operation, causing death","17","17","4","-33.55","0.47","0.47","0.46","0.35","0","21","13","14","1","0"
"2009","Alberta","48","Dangerous operation, causing death","12","15","1","-31.01","0.33","0.45","0.51","1.06","0","16","13","16","3","0"
"2010","Alberta","48","Dangerous operation, causing death","7","11","0","-42.5","0.19","0.34","0.31","0","0","11","10","10","0","0"
"2011","Alberta","48","Dangerous operation, causing death","12","11","0","68.82","0.32","0.31","0.34","0.71","0","11","9","11","2","0"
"2012","Alberta","48","Dangerous operation, causing death","13","13","0","5.81","0.33","0.46","0.42","0","0","13","14","14","0","0"
"2013","Alberta","48","Dangerous operation, causing death","9","9","0","-32.78","0.23","0.26","0.26","0.36","0","9","8","9","1","0"
"2014","Alberta","48","Dangerous operation, causing death","9","5","0","-2.72","0.22","0.16","0.14","0","0","5","5","5","0","0"
"2015","Alberta","48","Dangerous operation, causing death","8","9","1","-12.63","0.19","0.24","0.25","0.36","0","10","8","9","1","0"
"2016","Alberta","48","Dangerous operation, causing death","6","4","1","-26.29","0.14","0.12","0.11","0","0","5","4","4","0","0"
"1998","Alberta","48","Dangerous operation, causing bodily harm","133","136","3","0","4.59","2.95","2.63","0","0","139","63","63","0","0"
"1999","Alberta","48","Dangerous operation, causing bodily harm","108","113","2","-20.28","3.66","3.97","3.54","0","0","115","87","87","0","0"
"2000","Alberta","48","Dangerous operation, causing bodily harm","73","78","0","-33.57","2.43","2.9","2.59","0","0","78","65","65","0","0"
"2001","Alberta","48","Dangerous operation, causing bodily harm","109","107","2","46.72","3.56","4.92","4.41","0","0","109","113","113","0","0"
"2002","Alberta","48","Dangerous operation, causing bodily harm","106","106","2","-4.94","3.39","4.49","4.02","0","0","108","106","106","0","0"
"2003","Alberta","48","Dangerous operation, causing bodily harm","116","109","5","7.54","3.64","4.89","4.38","0","0","114","118","118","0","0"
"2004","Alberta","48","Dangerous operation, causing bodily harm","70","67","2","-40.7","2.16","2.63","2.37","0","0","69","65","65","0","0"
"2005","Alberta","48","Dangerous operation, causing bodily harm","81","72","1","12.83","2.44","2.72","2.44","0","0","73","69","69","0","0"
"2006","Alberta","48","Dangerous operation, causing bodily harm","107","102","3","28.27","3.13","3.54","3.19","0","0","105","93","93","0","0"
"2007","Alberta","48","Dangerous operation, causing bodily harm","99","87","5","-9.92","2.82","2.88","2.87","2.79","0","92","78","86","8","0"
"2008","Alberta","48","Dangerous operation, causing bodily harm","109","104","3","7.6","3.03","3.38","3.39","3.51","0","107","94","104","10","0"
"2009","Alberta","48","Dangerous operation, causing bodily harm","97","86","5","-13.02","2.64","2.94","2.86","2.11","0.35","91","84","90","6","1"
"2010","Alberta","48","Dangerous operation, causing bodily harm","88","75","4","-10.58","2.36","2.65","2.51","1.07","0.36","79","77","80","3","1"
"2011","Alberta","48","Dangerous operation, causing bodily harm","100","92","7","11.91","2.64","2.85","2.79","2.13","0.36","99","84","90","6","1"
"2012","Alberta","48","Dangerous operation, causing bodily harm","88","87","7","-14.05","2.27","2.71","2.69","2.5","1.07","94","82","89","7","3"
"2013","Alberta","48","Dangerous operation, causing bodily harm","89","80","0","-1.8","2.23","2.5","2.47","2.15","0","80","78","84","6","0"
"2014","Alberta","48","Dangerous operation, causing bodily harm","83","72","3","-9.28","2.02","2.18","2.15","1.79","0","75","70","75","5","0"
"2015","Alberta","48","Dangerous operation, causing bodily harm","68","60","6","-19.47","1.63","1.8","1.72","0.72","0.72","66","59","61","2","2"
"2016","Alberta","48","Dangerous operation, causing bodily harm","60","60","3","-13.28","1.41","1.96","1.83","0.35","0","63","65","66","1","0"
"1998","Alberta","48","Dangerous operation of motor vehicle, vessel or aircraft","1111","1023","38","0","38.32","36.14","32.21","0","0","1061","773","773","0","0"
"1999","Alberta","48","Dangerous operation of motor vehicle, vessel or aircraft","1147","1081","32","1.36","38.84","41.17","36.74","0","0","1113","902","902","0","0"
"2000","Alberta","48","Dangerous operation of motor vehicle, vessel or aircraft","1082","954","32","-7.29","36.01","36.05","32.21","0","0","986","808","808","0","0"
"2001","Alberta","48","Dangerous operation of motor vehicle, vessel or aircraft","1402","1326","49","27.33","45.85","57.14","51.11","0","0","1375","1311","1311","0","0"
"2002","Alberta","48","Dangerous operation of motor vehicle, vessel or aircraft","1382","1213","74","-3.64","44.18","51.96","46.51","0","0","1287","1226","1226","0","0"
"2003","Alberta","48","Dangerous operation of motor vehicle, vessel or aircraft","1289","1186","68","-8.34","40.49","51.81","46.43","0","0","1254","1250","1250","0","0"
"2004","Alberta","48","Dangerous operation of motor vehicle, vessel or aircraft","1355","1259","45","3.3","41.83","50.22","45.09","0","0","1304","1239","1239","0","0"
"2005","Alberta","48","Dangerous operation of motor vehicle, vessel or aircraft","1383","1102","72","-0.48","41.63","46.12","41.49","0","0","1174","1172","1172","0","0"
"2006","Alberta","48","Dangerous operation of motor vehicle, vessel or aircraft","1521","1246","87","6.79","44.46","49.87","44.96","0","0","1333","1310","1310","0","0"
"2007","Alberta","48","Dangerous operation of motor vehicle, vessel or aircraft","1627","1249","87","4.15","46.3","43.64","43.33","40.43","4.88","1336","1183","1299","116","14"
"2008","Alberta","48","Dangerous operation of motor vehicle, vessel or aircraft","1756","1320","103","5.48","48.84","46.68","44.79","26.29","3.16","1423","1300","1375","75","9"
"2009","Alberta","48","Dangerous operation of motor vehicle, vessel or aircraft","1607","1231","113","-10.56","43.68","42.3","40.23","19.38","5.64","1344","1209","1264","55","16"
"2010","Alberta","48","Dangerous operation of motor vehicle, vessel or aircraft","1490","1094","110","-8.61","39.92","36.72","35.64","24.5","4.62","1204","1066","1135","69","13"
"2011","Alberta","48","Dangerous operation of motor vehicle, vessel or aircraft","1497","1163","93","-1.06","39.5","38.65","36.92","18.85","2.49","1256","1140","1193","53","7"
"2012","Alberta","48","Dangerous operation of motor vehicle, vessel or aircraft","1487","1204","79","-2.99","38.32","38.73","37.99","29.99","5.71","1283","1172","1256","84","16"
"2013","Alberta","48","Dangerous operation of motor vehicle, vessel or aircraft","1427","1069","124","-6.82","35.71","33.26","32.67","26.11","1.79","1193","1039","1112","73","5"
"2014","Alberta","48","Dangerous operation of motor vehicle, vessel or aircraft","1556","1246","77","6.08","37.87","37.58","36.79","27.62","2.51","1323","1209","1286","77","7"
"2015","Alberta","48","Dangerous operation of motor vehicle, vessel or aircraft","1581","1198","63","-0.13","37.83","35.96","34.93","22.89","0.36","1261","1176","1240","64","1"
"2016","Alberta","48","Dangerous operation of motor vehicle, vessel or aircraft","1601","1219","73","-0.48","37.65","36.89","35.05","13.43","3.89","1292","1226","1264","38","11"
"2000","Alberta","48","Dangerous operation evading police, causing death","0","0","0","0","0","0","0","0","0","0","0","0","0","0"
"2001","Alberta","48","Dangerous operation evading police, causing death","0","0","0","0","0","0","0","0","0","0","0","0","0","0"
"2002","Alberta","48","Dangerous operation evading police, causing death","0","0","0","0","0","0","0","0","0","0","0","0","0","0"
"2003","Alberta","48","Dangerous operation evading police, causing death","0","0","0","0","0","0","0","0","0","0","0","0","0","0"
"2004","Alberta","48","Dangerous operation evading police, causing death","1","1","0","0","0.03","0","0","0","0","1","0","0","0","0"
"2005","Alberta","48","Dangerous operation evading police, causing death","0","0","0","-100","0","0","0","0","0","0","0","0","0","0"
"2006","Alberta","48","Dangerous operation evading police, causing death","0","0","0","0","0","0","0","0","0","0","0","0","0","0"
"2007","Alberta","48","Dangerous operation evading police, causing death","1","1","0","0","0.03","0.04","0.03","0","0","1","1","1","0","0"
"2008","Alberta","48","Dangerous operation evading police, causing death","0","1","0","-100","0","0.07","0.07","0","0","1","2","2","0","0"
"2009","Alberta","48","Dangerous operation evading police, causing death","0","0","0","0","0","0","0","0","0","0","0","0","0","0"
"2010","Alberta","48","Dangerous operation evading police, causing death","0","0","0","0","0","0","0","0","0","0","0","0","0","0"
"2011","Alberta","48","Dangerous operation evading police, causing death","0","0","0","0","0","0","0","0","0","0","0","0","0","0"
"2012","Alberta","48","Dangerous operation evading police, causing death","1","1","0","0","0.03","0.03","0.03","0","0","1","1","1","0","0"
"2013","Alberta","48","Dangerous operation evading police, causing death","0","0","0","-100","0","0","0","0","0","0","0","0","0","0"
"2014","Alberta","48","Dangerous operation evading police, causing death","0","0","0","0","0","0","0","0","0","0","0","0","0","0"
"2015","Alberta","48","Dangerous operation evading police, causing death","1","1","0","0","0.02","0.03","0.03","0","0","1","1","1","0","0"
"2016","Alberta","48","Dangerous operation evading police, causing death","0","0","0","-100","0","0","0","0","0","0","0","0","0","0"
"2000","Alberta","48","Dangerous operation evading police, causing bodily harm","0","0","0","0","0","0","0","0","0","0","0","0","0","0"
"2001","Alberta","48","Dangerous operation evading police, causing bodily harm","5","5","0","0","0.16","0.13","0.12","0","0","5","3","3","0","0"
"2002","Alberta","48","Dangerous operation evading police, causing bodily harm","2","2","0","-60.9","0.06","0.08","0.08","0","0","2","2","2","0","0"
"2003","Alberta","48","Dangerous operation evading police, causing bodily harm","8","8","0","293.09","0.25","0.29","0.26","0","0","8","7","7","0","0"
"2004","Alberta","48","Dangerous operation evading police, causing bodily harm","1","1","0","-87.72","0.03","0.04","0.04","0","0","1","1","1","0","0"
"2005","Alberta","48","Dangerous operation evading police, causing bodily harm","5","5","0","387.55","0.15","0.16","0.14","0","0","5","4","4","0","0"
"2006","Alberta","48","Dangerous operation evading police, causing bodily harm","7","7","0","35.94","0.2","0.23","0.21","0","0","7","6","6","0","0"
"2007","Alberta","48","Dangerous operation evading police, causing bodily harm","9","9","0","25.18","0.26","0.41","0.37","0","0","9","11","11","0","0"
"2008","Alberta","48","Dangerous operation evading police, causing bodily harm","4","4","1","-56.57","0.11","0.14","0.13","0","0.35","5","4","4","0","1"
"2009","Alberta","48","Dangerous operation evading police, causing bodily harm","6","6","0","46.6","0.16","0.14","0.16","0.35","0","6","4","5","1","0"
"2010","Alberta","48","Dangerous operation evading police, causing bodily harm","3","3","0","-50.72","0.08","0.1","0.09","0","0","3","3","3","0","0"
"2011","Alberta","48","Dangerous operation evading police, causing bodily harm","4","4","0","31.31","0.11","0.07","0.06","0","0","4","2","2","0","0"
"2012","Alberta","48","Dangerous operation evading police, causing bodily harm","4","4","0","-2.33","0.1","0.13","0.12","0","0","4","4","4","0","0"
"2013","Alberta","48","Dangerous operation evading police, causing bodily harm","5","5","0","21.38","0.13","0.16","0.15","0","0","5","5","5","0","0"
"2014","Alberta","48","Dangerous operation evading police, causing bodily harm","4","4","0","-22.17","0.1","0.22","0.26","0.72","0","4","7","9","2","0"
"2015","Alberta","48","Dangerous operation evading police, causing bodily harm","5","5","0","22.87","0.12","0.15","0.14","0","0","5","5","5","0","0"
"2016","Alberta","48","Dangerous operation evading police, causing bodily harm","6","6","0","17.93","0.14","0.18","0.17","0","0","6","6","6","0","0"
"2000","Alberta","48","Dangerous operation of motor vehicle evading police","27","26","0","0","0.9","0.85","0.76","0","0","26","19","19","0","0"
"2001","Alberta","48","Dangerous operation of motor vehicle evading police","257","229","1","835.33","8.4","8.45","7.56","0","0","230","194","194","0","0"
"2002","Alberta","48","Dangerous operation of motor vehicle evading police","284","228","12","8.02","9.08","9.03","8.08","0","0","240","213","213","0","0"
"2003","Alberta","48","Dangerous operation of motor vehicle evading police","251","208","7","-13.15","7.88","7.54","6.76","0","0","215","182","182","0","0"
"2004","Alberta","48","Dangerous operation of motor vehicle evading police","256","208","3","0.23","7.9","6.93","6.22","0","0","211","171","171","0","0"
"2005","Alberta","48","Dangerous operation of motor vehicle evading police","284","228","3","8.17","8.55","8.46","7.61","0","0","231","215","215","0","0"
"2006","Alberta","48","Dangerous operation of motor vehicle evading police","258","201","8","-11.79","7.54","7.77","7","0","0","209","204","204","0","0"
"2007","Alberta","48","Dangerous operation of motor vehicle evading police","341","246","8","28.69","9.7","8.56","8.91","12.2","0.35","254","232","267","35","1"
"2008","Alberta","48","Dangerous operation of motor vehicle evading police","340","242","16","-2.56","9.46","8.22","8.18","7.71","1.4","258","229","251","22","4"
"2009","Alberta","48","Dangerous operation of motor vehicle evading police","260","203","7","-25.26","7.07","6.58","6.75","8.46","3.52","210","188","212","24","10"
"2010","Alberta","48","Dangerous operation of motor vehicle evading police","245","191","13","-7.12","6.56","6.75","6.66","5.68","0.36","204","196","212","16","1"
"2011","Alberta","48","Dangerous operation of motor vehicle evading police","239","190","3","-3.93","6.31","5.86","6.04","7.82","0.71","193","173","195","22","2"
"2012","Alberta","48","Dangerous operation of motor vehicle evading police","241","185","12","-1.52","6.21","5.88","6.14","8.93","0.36","197","178","203","25","1"
"2013","Alberta","48","Dangerous operation of motor vehicle evading police","311","231","9","25.3","7.78","6.43","7.02","13.59","0.72","240","201","239","38","2"
"2014","Alberta","48","Dangerous operation of motor vehicle evading police","394","254","16","23.24","9.59","7.27","7.52","10.4","0","270","234","263","29","0"
"2015","Alberta","48","Dangerous operation of motor vehicle evading police","592","347","16","47.69","14.16","10.73","10.45","7.15","1.07","363","351","371","20","3"
"2016","Alberta","48","Dangerous operation of motor vehicle evading police","804","379","20","33.47","18.9","11.25","11.06","8.83","1.41","399","374","399","25","4"
"1998","Alberta","48","Total fail to stop or remain","318","240","11","0","10.97","7.06","6.29","0","0","251","151","151","0","0"
"1999","Alberta","48","Total fail to stop or remain","221","154","16","-31.77","7.48","4.98","4.44","0","0","170","109","109","0","0"
"2000","Alberta","48","Total fail to stop or remain","253","169","12","12.51","8.42","6.51","5.82","0","0","181","146","146","0","0"
"2001","Alberta","48","Total fail to stop or remain","275","211","12","6.81","8.99","7.63","6.82","0","0","223","175","175","0","0"
"2002","Alberta","48","Total fail to stop or remain","276","213","16","-1.89","8.82","8.31","7.43","0","0","229","196","196","0","0"
"2003","Alberta","48","Total fail to stop or remain","260","190","19","-7.43","8.17","7.09","6.35","0","0","209","171","171","0","0"
"2004","Alberta","48","Total fail to stop or remain","288","198","18","8.85","8.89","7.34","6.59","0","0","216","181","181","0","0"
"2005","Alberta","48","Total fail to stop or remain","841","176","33","184.74","25.31","6.73","6.05","0","0","209","171","171","0","0"
"2006","Alberta","48","Total fail to stop or remain","1719","291","95","98.48","50.24","10.05","9.06","0","0","386","264","264","0","0"
"2007","Alberta","48","Total fail to stop or remain","2000","324","139","13.28","56.91","10.29","10.47","12.2","3.83","463","279","314","35","11"
"2008","Alberta","48","Total fail to stop or remain","2525","317","208","23.38","70.22","9.62","9.41","7.36","4.56","525","268","289","21","13"
"2009","Alberta","48","Total fail to stop or remain","1859","260","146","-28.04","50.53","8.22","8.4","10.22","2.82","406","235","264","29","8"
"2010","Alberta","48","Total fail to stop or remain","1640","249","119","-13.04","43.94","7.3","7.44","8.88","2.49","368","212","237","25","7"
"2011","Alberta","48","Total fail to stop or remain","1850","245","125","11.09","48.81","7.29","7.24","6.76","2.84","370","215","234","19","8"
"2012","Alberta","48","Total fail to stop or remain","1861","251","113","-1.75","47.95","7.14","7.11","6.78","1.79","364","216","235","19","5"
"2013","Alberta","48","Total fail to stop or remain","1937","238","138","1.07","48.47","6.24","6.44","8.59","3.58","376","195","219","24","10"
"2014","Alberta","48","Total fail to stop or remain","1094","175","156","-45.06","26.63","4.79","4.61","2.51","2.15","331","154","161","7","6"
"2015","Alberta","48","Total fail to stop or remain","1052","189","213","-5.48","25.17","5.26","5.01","2.15","2.15","402","172","178","6","6"
"2016","Alberta","48","Total fail to stop or remain","765","170","155","-28.53","17.99","4.72","4.55","2.47","0.71","325","157","164","7","2"
"1998","Alberta","48","Driving while prohibited","1499","1462","4","0","51.7","58.25","51.93","0","0","1466","1246","1246","0","0"
"1999","Alberta","48","Driving while prohibited","1352","1311","6","-11.45","45.78","53.54","47.78","0","0","1317","1173","1173","0","0"
"2000","Alberta","48","Driving while prohibited","1435","1189","11","4.31","47.75","47.92","42.81","0","0","1200","1074","1074","0","0"
"2001","Alberta","48","Driving while prohibited","1375","1378","9","-5.84","44.96","56.05","50.13","0","0","1387","1286","1286","0","0"
"2002","Alberta","48","Driving while prohibited","1373","1343","17","-2.39","43.89","54.5","48.78","0","0","1360","1286","1286","0","0"
"2003","Alberta","48","Driving while prohibited","1422","1405","8","1.78","44.67","55.58","49.81","0","0","1413","1341","1341","0","0"
"2004","Alberta","48","Driving while prohibited","1368","1370","10","-5.46","42.23","53.91","48.4","0","0","1380","1330","1330","0","0"
"2005","Alberta","48","Driving while prohibited","1337","1309","11","-4.7","40.24","50.45","45.38","0","0","1320","1282","1282","0","0"
"2006","Alberta","48","Driving while prohibited","1355","1323","17","-1.59","39.6","50.06","45.13","0","0","1340","1315","1315","0","0"
"2007","Alberta","48","Driving while prohibited","1487","1437","23","6.85","42.32","52.82","48.33","5.92","0.7","1460","1432","1449","17","2"
"2008","Alberta","48","Driving while prohibited","1620","1582","20","6.47","45.05","56.84","51.86","3.16","0.35","1602","1583","1592","9","1"
"2009","Alberta","48","Driving while prohibited","1553","1509","22","-6.31","42.21","52.59","48.06","2.47","0","1531","1503","1510","7","0"
"2010","Alberta","48","Driving while prohibited","1588","1527","22","0.79","42.54","52.53","48.33","4.97","0","1549","1525","1539","14","0"
"2011","Alberta","48","Driving while prohibited","1498","1450","14","-7.1","39.52","48.24","44.44","4.62","0.71","1464","1423","1436","13","2"
"2012","Alberta","48","Driving while prohibited","1562","1476","38","1.84","40.25","48.54","44.55","1.43","0.36","1514","1469","1473","4","1"
"2013","Alberta","48","Driving while prohibited","1689","1611","28","5","42.26","50.87","47.01","3.93","0","1639","1589","1600","11","0"
"2014","Alberta","48","Driving while prohibited","2016","1928","51","16.12","49.07","59.65","55.3","5.02","0","1979","1919","1933","14","0"
"2015","Alberta","48","Driving while prohibited","2080","2009","22","1.41","49.76","60.66","56.33","5.72","0","2031","1984","2000","16","0"
"2016","Alberta","48","Driving while prohibited","1847","1765","31","-12.73","43.43","52.68","48.83","3.53","0","1796","1751","1761","10","0"
"1998","Alberta","48","Other Criminal Code traffic violations","27","1","23","0","0.93","0","0","0","0","24","0","0","0","0"
"1999","Alberta","48","Other Criminal Code traffic violations","21","4","2","-23.64","0.71","0","0","0","0","6","0","0","0","0"
"2000","Alberta","48","Other Criminal Code traffic violations","74","13","1","246.32","2.46","0.31","0.32","0.37","0","14","7","8","1","0"
"2001","Alberta","48","Other Criminal Code traffic violations","126","1","19","67.31","4.12","0","0","0","0.74","20","0","0","0","2"
"2002","Alberta","48","Other Criminal Code traffic violations","107","4","52","-16.99","3.42","0.04","0.08","0.36","0.72","56","1","2","1","2"
"2003","Alberta","48","Other Criminal Code traffic violations","47","1","6","-56.83","1.48","0.04","0.04","0","0","7","1","1","0","0"
"2004","Alberta","48","Other Criminal Code traffic violations","29","1","2","-39.37","0.9","0.04","0.04","0","0","3","1","1","0","0"
"2005","Alberta","48","Other Criminal Code traffic violations","14","1","4","-52.93","0.42","0.04","0.04","0","0","5","1","1","0","0"
"2006","Alberta","48","Other Criminal Code traffic violations","1","0","1","-93.06","0.03","0","0","0","0","1","0","0","0","0"
"2007","Alberta","48","Other Criminal Code traffic violations","5","1","0","386.81","0.14","0.04","0.03","0","0","1","1","1","0","0"
"2008","Alberta","48","Other Criminal Code traffic violations","4","0","2","-21.82","0.11","0","0","0","0","2","0","0","0","0"
"2009","Alberta","48","Other Criminal Code traffic violations","5","1","1","22.17","0.14","0.03","0.03","0","0","2","1","1","0","0"
"2010","Alberta","48","Other Criminal Code traffic violations","4","0","2","-21.15","0.11","0","0","0","0","2","0","0","0","0"
"2011","Alberta","48","Other Criminal Code traffic violations","4","1","1","-1.52","0.11","0.03","0.03","0","0","2","1","1","0","0"
"2012","Alberta","48","Other Criminal Code traffic violations","2","0","1","-51.17","0.05","0","0","0","0","1","0","0","0","0"
"2013","Alberta","48","Other Criminal Code traffic violations","3","0","0","45.65","0.08","0","0","0","0","0","0","0","0","0"
"2014","Alberta","48","Other Criminal Code traffic violations","3","0","0","-2.72","0.07","0","0","0","0","0","0","0","0","0"
"2015","Alberta","48","Other Criminal Code traffic violations","1","0","0","-67.24","0.02","0","0","0","0","0","0","0","0","0"
"2016","Alberta","48","Other Criminal Code traffic violations","2","0","1","96.56","0.05","0","0","0","0","1","0","0","0","0"
"2005","Alberta","48","Causing death by criminal negligence while street racing","0","0","0","0","0","0","0","0","0","0","0","0","0","0"
"2006","Alberta","48","Causing death by criminal negligence while street racing","0","0","0","0","0","0","0","0","0","0","0","0","0","0"
"2007","Alberta","48","Causing death by criminal negligence while street racing","0","0","0","0","0","0","0","0","0","0","0","0","0","0"
"2008","Alberta","48","Causing death by criminal negligence while street racing","0","0","0","0","0","0","0","0","0","0","0","0","0","0"
"2009","Alberta","48","Causing death by criminal negligence while street racing","1","1","0","0","0.03","0.03","0.03","0","0","1","1","1","0","0"
"2010","Alberta","48","Causing death by criminal negligence while street racing","0","0","0","-100","0","0","0","0","0","0","0","0","0","0"
"2011","Alberta","48","Causing death by criminal negligence while street racing","0","0","0","0","0","0","0","0","0","0","0","0","0","0"
"2012","Alberta","48","Causing death by criminal negligence while street racing","0","0","0","0","0","0","0","0","0","0","0","0","0","0"
"2013","Alberta","48","Causing death by criminal negligence while street racing","0","0","0","0","0","0","0","0","0","0","0","0","0","0"
"2014","Alberta","48","Causing death by criminal negligence while street racing","0","0","0","0","0","0","0","0","0","0","0","0","0","0"
"2015","Alberta","48","Causing death by criminal negligence while street racing","0","0","0","0","0","0","0","0","0","0","0","0","0","0"
"2016","Alberta","48","Causing death by criminal negligence while street racing","0","0","0","0","0","0","0","0","0","0","0","0","0","0"
"2005","Alberta","48","Causing bodily harm by criminal negligence while street racing","0","0","0","0","0","0","0","0","0","0","0","0","0","0"
"2006","Alberta","48","Causing bodily harm by criminal negligence while street racing","0","0","0","0","0","0","0","0","0","0","0","0","0","0"
"2007","Alberta","48","Causing bodily harm by criminal negligence while street racing","0","0","0","0","0","0","0","0","0","0","0","0","0","0"
"2008","Alberta","48","Causing bodily harm by criminal negligence while street racing","0","0","0","0","0","0","0","0","0","0","0","0","0","0"
"2009","Alberta","48","Causing bodily harm by criminal negligence while street racing","0","0","0","0","0","0","0","0","0","0","0","0","0","0"
"2010","Alberta","48","Causing bodily harm by criminal negligence while street racing","0","0","0","0","0","0","0","0","0","0","0","0","0","0"
"2011","Alberta","48","Causing bodily harm by criminal negligence while street racing","0","0","0","0","0","0","0","0","0","0","0","0","0","0"
"2012","Alberta","48","Causing bodily harm by criminal negligence while street racing","2","2","0","0","0.05","0.03","0.06","0.36","0","2","1","2","1","0"
"2013","Alberta","48","Causing bodily harm by criminal negligence while street racing","0","0","0","-100","0","0","0","0","0","0","0","0","0","0"
"2014","Alberta","48","Causing bodily harm by criminal negligence while street racing","0","0","0","0","0","0","0","0","0","0","0","0","0","0"
"2015","Alberta","48","Causing bodily harm by criminal negligence while street racing","1","0","0","0","0.02","0","0","0","0","0","0","0","0","0"
"2016","Alberta","48","Causing bodily harm by criminal negligence while street racing","1","2","0","-1.72","0.02","0.06","0.06","0","0","2","2","2","0","0"
"2005","Alberta","48","Dangerous operation causing death while street racing","0","0","0","0","0","0","0","0","0","0","0","0","0","0"
"2006","Alberta","48","Dangerous operation causing death while street racing","0","0","0","0","0","0","0","0","0","0","0","0","0","0"
"2007","Alberta","48","Dangerous operation causing death while street racing","0","0","0","0","0","0","0","0","0","0","0","0","0","0"
"2008","Alberta","48","Dangerous operation causing death while street racing","0","0","0","0","0","0","0","0","0","0","0","0","0","0"
"2009","Alberta","48","Dangerous operation causing death while street racing","0","0","0","0","0","0","0","0","0","0","0","0","0","0"
"2010","Alberta","48","Dangerous operation causing death while street racing","1","1","0","0","0.03","0.07","0.06","0","0","1","2","2","0","0"
"2011","Alberta","48","Dangerous operation causing death while street racing","1","1","0","-1.52","0.03","0.07","0.09","0.36","0","1","2","3","1","0"
"2012","Alberta","48","Dangerous operation causing death while street racing","0","0","0","-100","0","0","0","0","0","0","0","0","0","0"
"2013","Alberta","48","Dangerous operation causing death while street racing","0","0","0","0","0","0","0","0","0","0","0","0","0","0"
"2014","Alberta","48","Dangerous operation causing death while street racing","1","1","0","0","0.02","0.03","0.03","0","0","1","1","1","0","0"
"2015","Alberta","48","Dangerous operation causing death while street racing","0","0","0","-100","0","0","0","0","0","0","0","0","0","0"
"2016","Alberta","48","Dangerous operation causing death while street racing","0","0","0","0","0","0","0","0","0","0","0","0","0","0"
"2005","Alberta","48","Dangerous operation causing bodily harm while street racing","0","0","0","0","0","0","0","0","0","0","0","0","0","0"
"2006","Alberta","48","Dangerous operation causing bodily harm while street racing","0","0","0","0","0","0","0","0","0","0","0","0","0","0"
"2007","Alberta","48","Dangerous operation causing bodily harm while street racing","0","0","0","0","0","0","0","0","0","0","0","0","0","0"
"2008","Alberta","48","Dangerous operation causing bodily harm while street racing","2","2","0","0","0.06","0.07","0.07","0","0","2","2","2","0","0"
"2009","Alberta","48","Dangerous operation causing bodily harm while street racing","1","1","0","-51.13","0.03","0.03","0.03","0","0","1","1","1","0","0"
"2010","Alberta","48","Dangerous operation causing bodily harm while street racing","0","0","0","-100","0","0","0","0","0","0","0","0","0","0"
"2011","Alberta","48","Dangerous operation causing bodily harm while street racing","0","0","0","0","0","0","0","0","0","0","0","0","0","0"
"2012","Alberta","48","Dangerous operation causing bodily harm while street racing","0","1","0","0","0","0.03","0.03","0","0","1","1","1","0","0"
"2013","Alberta","48","Dangerous operation causing bodily harm while street racing","2","2","0","0","0.05","0.06","0.06","0","0","2","2","2","0","0"
"2014","Alberta","48","Dangerous operation causing bodily harm while street racing","1","0","0","-51.36","0.02","0","0","0","0","0","0","0","0","0"
"2015","Alberta","48","Dangerous operation causing bodily harm while street racing","1","2","0","-1.71","0.02","0.09","0.08","0","0","2","3","3","0","0"
"2016","Alberta","48","Dangerous operation causing bodily harm while street racing","0","0","0","-100","0","0","0","0","0","0","0","0","0","0"
"2005","Alberta","48","Dangerous operation of motor vehicle while street racing","0","0","0","0","0","0","0","0","0","0","0","0","0","0"
"2006","Alberta","48","Dangerous operation of motor vehicle while street racing","0","0","0","0","0","0","0","0","0","0","0","0","0","0"
"2007","Alberta","48","Dangerous operation of motor vehicle while street racing","0","0","0","0","0","0","0","0","0","0","0","0","0","0"
"2008","Alberta","48","Dangerous operation of motor vehicle while street racing","20","1","2","0","0.56","0","0","0","0.7","3","0","0","0","2"
"2009","Alberta","48","Dangerous operation of motor vehicle while street racing","23","2","3","12.4","0.63","0.1","0.1","0","0.7","5","3","3","0","2"
"2010","Alberta","48","Dangerous operation of motor vehicle while street racing","19","3","1","-18.57","0.51","0.14","0.13","0","0.36","4","4","4","0","1"
"2011","Alberta","48","Dangerous operation of motor vehicle while street racing","25","3","3","29.58","0.66","0.1","0.12","0.36","0.36","6","3","4","1","1"
"2012","Alberta","48","Dangerous operation of motor vehicle while street racing","24","2","0","-6.24","0.62","0.1","0.09","0","0","2","3","3","0","0"
"2013","Alberta","48","Dangerous operation of motor vehicle while street racing","41","2","3","65.88","1.03","0.06","0.12","0.72","0.36","5","2","4","2","1"
"2014","Alberta","48","Dangerous operation of motor vehicle while street racing","44","5","4","4.4","1.07","0.12","0.14","0.36","0.36","9","4","5","1","1"
"2015","Alberta","48","Dangerous operation of motor vehicle while street racing","24","1","3","-46.39","0.57","0.06","0.08","0.36","1.07","4","2","3","1","3"
"2016","Alberta","48","Dangerous operation of motor vehicle while street racing","31","3","2","26.94","0.73","0.09","0.14","0.71","0","5","3","5","2","0"
"1998","Alberta","48","Total Federal Statute violations","9147","5260","1614","0","315.47","182.75","215.5","484.3","91.72","6874","3909","5171","1262","239"
"1999","Alberta","48","Total Federal Statute violations","9740","5678","1439","4.54","329.81","200.7","232.17","493.09","98.39","7117","4397","5700","1303","260"
"2000","Alberta","48","Total Federal Statute violations","10404","5990","1585","4.98","346.23","226.38","255.36","498.49","202.47","7575","5074","6406","1332","541"
"2001","Alberta","48","Total Federal Statute violations","13885","6039","3589","31.14","454.05","215.78","250.04","540.6","288.96","9628","4951","6414","1463","782"
"2002","Alberta","48","Total Federal Statute violations","12580","6181","2588","-11.44","402.13","210.18","243.83","530.72","285.41","8769","4959","6428","1469","790"
"2003","Alberta","48","Total Federal Statute violations","10250","5638","2015","-19.93","321.98","194.42","215.35","396.02","282.26","7653","4691","5798","1107","789"
"2004","Alberta","48","Total Federal Statute violations","10853","5596","2172","4.05","335.02","198.33","221.17","421.65","297.82","7768","4893","6078","1185","837"
"2005","Alberta","48","Total Federal Statute violations","10992","6149","1866","-1.24","330.87","222.62","239.94","395.1","243.19","8015","5657","6778","1121","690"
"2006","Alberta","48","Total Federal Statute violations","10939","6874","2103","-3.37","319.73","245.46","264.59","439.57","308.95","8977","6448","7710","1262","887"
"2007","Alberta","48","Total Federal Statute violations","11903","7091","2341","5.94","338.73","247.51","272.69","510.57","288.92","9432","6710","8175","1465","829"
"2008","Alberta","48","Total Federal Statute violations","12862","7347","2694","5.6","357.7","245.29","279.8","616.65","315.51","10041","6831","8590","1759","900"
"2009","Alberta","48","Total Federal Statute violations","13304","7417","2670","1.09","361.61","241.17","267","527.19","318.92","10087","6893","8389","1496","905"
"2010","Alberta","48","Total Federal Statute violations","14663","8109","3012","8.64","392.84","262.53","285.6","523.37","351.16","11121","7621","9095","1474","989"
"2011","Alberta","48","Total Federal Statute violations","14290","7596","3090","-4.03","377.03","248.15","270.51","504.96","351.34","10686","7320","8740","1420","988"
"2012","Alberta","48","Total Federal Statute violations","14551","7534","3171","-0.55","374.95","235.28","253.03","444.82","370.57","10705","7120","8366","1246","1038"
"2013","Alberta","48","Total Federal Statute violations","14438","7299","3169","-3.65","361.26","236.48","249.91","399.92","369.52","10468","7387","8505","1118","1033"
"2014","Alberta","48","Total Federal Statute violations","15587","7911","3291","5.02","379.4","245.43","256.27","381.33","317.84","11202","7895","8958","1063","886"
"2015","Alberta","48","Total Federal Statute violations","15337","7541","3172","-3.28","366.94","240.35","245","299.34","306.14","10713","7861","8698","837","856"
"2016","Alberta","48","Total Federal Statute violations","14219","7094","2875","-8.89","334.34","226.32","225.23","212.37","250.18","9969","7522","8123","601","708"
"1998","Alberta","48","Total Drug violations","5353","3867","655","0","184.62","164.43","166.41","182.67","67.16","4522","3517","3993","476","175"
"1999","Alberta","48","Total Drug violations","5800","4181","801","6.38","196.39","176.33","179.92","209.65","79.85","4982","3863","4417","554","211"
"2000","Alberta","48","Total Drug violations","6979","4829","827","18.26","232.25","208.94","214.15","257.85","165.79","5656","4683","5372","689","443"
"2001","Alberta","48","Total Drug violations","7221","4761","939","1.67","236.13","197.95","208.25","295.61","225.03","5700","4542","5342","800","609"
"2002","Alberta","48","Total Drug violations","7529","4837","1021","1.92","240.67","192.42","200.4","268.43","231.58","5858","4540","5283","743","641"
"2003","Alberta","48","Total Drug violations","7533","4660","1269","-1.68","236.63","183.65","187.05","216.43","220.01","5929","4431","5036","605","615"
"2004","Alberta","48","Total Drug violations","8404","4682","1507","9.63","259.43","182.2","188.16","240.54","246.58","6189","4495","5171","676","693"
"2005","Alberta","48","Total Drug violations","8566","5251","1213","-0.61","257.84","203.41","205.99","229.09","208.65","6464","5169","5819","650","592"
"2006","Alberta","48","Total Drug violations","8869","6035","1365","0.54","259.22","230.43","233.29","259.49","274.12","7400","6053","6798","745","787"
"2007","Alberta","48","Total Drug violations","9380","6008","1445","2.97","266.93","229.44","233.13","268","241.87","7453","6220","6989","769","694"
"2008","Alberta","48","Total Drug violations","10037","6051","1736","4.57","279.13","224.9","232.01","301.49","251.36","7787","6263","7123","860","717"
"2009","Alberta","48","Total Drug violations","10631","6163","2003","3.52","288.96","221.02","223.65","250.2","263.95","8166","6317","7027","710","749"
"2010","Alberta","48","Total Drug violations","11661","6493","2272","8.12","312.41","237.42","238.34","247.83","281.21","8765","6892","7590","698","792"
"2011","Alberta","48","Total Drug violations","11679","6150","2438","-1.37","308.14","226.66","230.46","270.26","298.35","8588","6686","7446","760","839"
"2012","Alberta","48","Total Drug violations","11887","6138","2605","-0.59","306.31","214.96","216.35","231.34","323.44","8743","6505","7153","648","906"
"2013","Alberta","48","Total Drug violations","12171","6234","2693","-0.58","304.53","222.36","222.67","226.08","345.91","8927","6946","7578","632","967"
"2014","Alberta","48","Total Drug violations","13290","6919","2816","6.23","323.49","234.73","232.84","210.93","288.42","9735","7551","8139","588","804"
"2015","Alberta","48","Total Drug violations","12832","6525","2719","-5.1","307.01","224.42","219.85","166.3","271.81","9244","7340","7805","465","760"
"2016","Alberta","48","Total Drug violations","11722","6183","2430","-10.22","275.63","209.86","202.41","114.84","225.1","8613","6975","7300","325","637"
"1998","Alberta","48","Possession, cannabis","2523","1844","458","0","87.02","70.31","72.1","86.73","58.71","2302","1504","1730","226","153"
"1999","Alberta","48","Possession, cannabis","2837","1909","580","10.4","96.06","73.08","76.82","107.85","67.36","2489","1601","1886","285","178"
"2000","Alberta","48","Possession, cannabis","3575","2265","616","23.85","118.97","87.22","92.76","139.22","151.19","2881","1955","2327","372","404"
"2001","Alberta","48","Possession, cannabis","3723","2250","744","2.33","121.75","76.84","85.92","162.95","193.99","2994","1763","2204","441","525"
"2002","Alberta","48","Possession, cannabis","3770","2161","816","-1.01","120.51","70.95","79.35","151.01","201.95","2977","1674","2092","418","559"
"2003","Alberta","48","Possession, cannabis","3463","1658","1004","-9.73","108.78","54.09","58.39","95.52","190.68","2662","1305","1572","267","533"
"2004","Alberta","48","Possession, cannabis","3861","1700","1229","9.56","119.19","53.26","59.82","117.42","232.71","2929","1314","1644","330","654"
"2005","Alberta","48","Possession, cannabis","3641","1840","899","-8.05","109.6","61.78","67.9","122.65","176.58","2739","1570","1918","348","501"
"2006","Alberta","48","Possession, cannabis","3717","2267","969","-0.87","108.64","80.13","85.86","138.28","233.37","3236","2105","2502","397","670"
"2007","Alberta","48","Possession, cannabis","4083","2406","1047","6.95","116.19","85.28","91.2","147.07","206.67","3453","2312","2734","422","593"
"2008","Alberta","48","Possession, cannabis","4776","2769","1315","14.31","132.82","95.77","103.87","183","212.09","4084","2667","3189","522","605"
"2009","Alberta","48","Possession, cannabis","5038","2682","1512","3.1","136.94","91.32","97.68","161.75","227.3","4194","2610","3069","459","645"
"2010","Alberta","48","Possession, cannabis","5802","2935","1743","13.51","155.44","99.83","104.41","151.61","252.45","4678","2898","3325","427","711"
"2011","Alberta","48","Possession, cannabis","6203","2919","1908","5.29","163.66","96.85","103.47","172.82","271.32","4827","2857","3343","486","763"
"2012","Alberta","48","Possession, cannabis","6255","2849","2046","-1.51","161.18","92.66","98.3","159.22","293.45","4895","2804","3250","446","822"
"2013","Alberta","48","Possession, cannabis","6405","2745","2208","-0.57","160.26","88.2","92.91","145.59","321.94","4953","2755","3162","407","900"
"2014","Alberta","48","Possession, cannabis","6498","2813","2293","-1.31","158.17","87.38","91.26","135.96","267.61","5106","2811","3190","379","746"
"2015","Alberta","48","Possession, cannabis","5754","2305","2215","-12.96","137.67","72.04","74.14","98.71","244.98","4520","2356","2632","276","685"
"2016","Alberta","48","Possession, cannabis","4405","1648","1863","-24.76","103.58","50.76","51.63","61.84","204.95","3511","1687","1862","175","580"
"1998","Alberta","48","Possession, cocaine","293","254","26","0","10.11","11.45","11.29","9.98","0","280","245","271","26","0"
"1999","Alberta","48","Possession, cocaine","280","227","20","-6.18","9.48","10.27","9.69","4.92","0.38","247","225","238","13","1"
"2000","Alberta","48","Possession, cocaine","280","226","15","-1.72","9.32","9.5","8.89","3.74","0","241","213","223","10","0"
"2001","Alberta","48","Possession, cocaine","384","302","29","34.76","12.56","13.68","12.79","5.17","0.37","331","314","328","14","1"
"2002","Alberta","48","Possession, cocaine","532","444","27","35.43","17.01","19.71","18.09","4.34","0.36","471","465","477","12","1"
"2003","Alberta","48","Possession, cocaine","554","413","43","2.34","17.4","16.45","15.27","5.01","1.07","456","397","411","14","3"
"2004","Alberta","48","Possession, cocaine","808","549","82","43.32","24.94","20.75","19.76","11.03","1.07","631","512","543","31","3"
"2005","Alberta","48","Possession, cocaine","1000","750","76","20.68","30.1","30.34","28.25","9.52","2.82","826","771","798","27","8"
"2006","Alberta","48","Possession, cocaine","1294","990","139","25.65","37.82","40.31","37.68","13.58","4.88","1129","1059","1098","39","14"
"2007","Alberta","48","Possession, cocaine","1381","1043","136","3.91","39.3","40.94","38.66","17.08","4.18","1179","1110","1159","49","12"
"2008","Alberta","48","Possession, cocaine","1234","814","166","-12.68","34.32","30.99","29.38","13.67","5.96","980","863","902","39","17"
"2009","Alberta","48","Possession, cocaine","913","575","116","-27.69","24.82","21.83","20.18","3.52","2.11","691","624","634","10","6"
"2010","Alberta","48","Possession, cocaine","916","564","118","-1.11","24.54","20.81","19.34","4.26","0.71","682","604","616","12","2"
"2011","Alberta","48","Possession, cocaine","885","568","128","-4.85","23.35","20.78","19.44","5.33","2.13","696","613","628","15","6"
"2012","Alberta","48","Possession, cocaine","1065","665","131","17.53","27.44","23.4","21.96","6.43","2.5","796","708","726","18","7"
"2013","Alberta","48","Possession, cocaine","1061","662","137","-3.26","26.55","23.31","22.07","8.23","2.15","799","728","751","23","6"
"2014","Alberta","48","Possession, cocaine","1298","761","162","19.01","31.59","24.53","23.46","11.12","4.3","923","789","820","31","12"
"2015","Alberta","48","Possession, cocaine","1202","707","154","-8.98","28.76","23.05","21.83","7.51","3.93","861","754","775","21","11"
"2016","Alberta","48","Possession, cocaine","1029","656","99","-15.87","24.2","20.94","19.63","4.24","2.47","755","696","708","12","7"
"1998","Alberta","48","Total, possession, other Controlled Drugs and Substances Act drugs","260","226","29","0","8.97","7.15","6.83","4.22","1.92","255","153","164","11","5"
"1999","Alberta","48","Total, possession, other Controlled Drugs and Substances Act drugs","301","216","36","13.66","10.19","6.89","6.6","4.16","2.65","252","151","162","11","7"
"2000","Alberta","48","Total, possession, other Controlled Drugs and Substances Act drugs","328","197","30","7.1","10.92","7.72","8.05","10.85","2.99","227","173","202","29","8"
"2001","Alberta","48","Total, possession, other Controlled Drugs and Substances Act drugs","350","216","34","4.86","11.45","8.02","8.42","11.82","8.13","250","184","216","32","22"
"2002","Alberta","48","Total, possession, other Controlled Drugs and Substances Act drugs","373","226","45","4.17","11.92","7.97","8.35","11.56","6.5","271","188","220","32","18"
"2003","Alberta","48","Total, possession, other Controlled Drugs and Substances Act drugs","456","250","80","20.14","14.32","8.79","8.99","10.73","6.44","330","212","242","30","18"
"2004","Alberta","48","Total, possession, other Controlled Drugs and Substances Act drugs","454","230","63","-2.16","14.01","7.74","7.53","5.69","2.13","293","191","207","16","6"
"2005","Alberta","48","Total, possession, other Controlled Drugs and Substances Act drugs","583","320","83","25.22","17.55","11.06","11.12","11.63","7.05","403","281","314","33","20"
"2006","Alberta","48","Total, possession, other Controlled Drugs and Substances Act drugs","539","332","79","-10.23","15.75","11.38","11.39","11.49","11.49","411","299","332","33","33"
"2007","Alberta","48","Total, possession, other Controlled Drugs and Substances Act drugs","514","300","95","-7.15","14.63","10.4","10.74","13.94","12.89","395","282","322","40","37"
"2008","Alberta","48","Total, possession, other Controlled Drugs and Substances Act drugs","548","339","77","4.19","15.24","11.13","11.76","17.88","10.17","416","310","361","51","29"
"2009","Alberta","48","Total, possession, other Controlled Drugs and Substances Act drugs","575","324","116","2.55","15.63","11.06","11.43","15.15","13.74","440","316","359","43","39"
"2010","Alberta","48","Total, possession, other Controlled Drugs and Substances Act drugs","691","383","116","18.45","18.51","13.88","13.6","10.65","9.23","499","403","433","30","26"
"2011","Alberta","48","Total, possession, other Controlled Drugs and Substances Act drugs","648","373","116","-7.65","17.1","13.26","13.15","12.09","8.18","489","391","425","34","23"
"2012","Alberta","48","Total, possession, other Controlled Drugs and Substances Act drugs","694","441","100","4.6","17.88","14.94","14.15","5.71","10","541","452","468","16","28"
"2013","Alberta","48","Total, possession, other Controlled Drugs and Substances Act drugs","854","572","107","19.49","21.37","19.56","18.51","6.8","7.51","679","611","630","19","21"
"2014","Alberta","48","Total, possession, other Controlled Drugs and Substances Act drugs","1403","982","136","59.82","34.15","31.83","30.15","10.76","6.82","1118","1024","1054","30","19"
"2015","Alberta","48","Total, possession, other Controlled Drugs and Substances Act drugs","1873","1363","167","31.22","44.81","41.52","39.74","18.95","7.51","1530","1358","1411","53","21"
"2016","Alberta","48","Total, possession, other Controlled Drugs and Substances Act drugs","2555","1863","290","34.06","60.08","57.56","54.35","16.61","9.54","2153","1913","1960","47","27"
"1998","Alberta","48","Heroin, possession","13","10","2","0","0.45","0.42","0.38","0","0","12","9","9","0","0"
"1999","Alberta","48","Heroin, possession","12","10","1","-9.37","0.41","0.37","0.33","0","0","11","8","8","0","0"
"2000","Alberta","48","Heroin, possession","16","11","1","31.04","0.53","0.36","0.4","0.75","1.12","12","8","10","2","3"
"2001","Alberta","48","Heroin, possession","5","1","0","-69.29","0.16","0","0","0","0","1","0","0","0","0"
"2002","Alberta","48","Heroin, possession","4","1","0","-21.8","0.13","0.04","0.04","0","0","1","1","1","0","0"
"2003","Alberta","48","Heroin, possession","1","2","0","-75.43","0.03","0.08","0.07","0","0","2","2","2","0","0"
"2004","Alberta","48","Heroin, possession","5","1","0","391.35","0.15","0.04","0.04","0","0","1","1","1","0","0"
"2005","Alberta","48","Heroin, possession","6","2","0","17.01","0.18","0.08","0.07","0","0","2","2","2","0","0"
"2006","Alberta","48","Heroin, possession","18","15","1","191.31","0.53","0.57","0.55","0.35","0","16","15","16","1","0"
"2007","Alberta","48","Heroin, possession","9","3","2","-51.32","0.26","0.07","0.1","0.35","0","5","2","3","1","0"
"2008","Alberta","48","Heroin, possession","6","3","2","-34.85","0.17","0.14","0.13","0","0","5","4","4","0","0"
"2009","Alberta","48","Heroin, possession","15","6","7","144.34","0.41","0.24","0.22","0","0","13","7","7","0","0"
"2010","Alberta","48","Heroin, possession","10","5","3","-34.29","0.27","0.17","0.16","0","0","8","5","5","0","0"
"2011","Alberta","48","Heroin, possession","12","6","3","18.18","0.32","0.17","0.15","0","0","9","5","5","0","0"
"2012","Alberta","48","Heroin, possession","28","20","5","127.89","0.72","0.59","0.54","0","0","25","18","18","0","0"
"2013","Alberta","48","Heroin, possession","35","22","6","21.38","0.88","0.67","0.65","0.36","0","28","21","22","1","0"
"2014","Alberta","48","Heroin, possession","82","48","12","127.92","2","1.71","1.57","0","0","60","55","55","0","0"
"2015","Alberta","48","Heroin, possession","106","64","13","27.06","2.54","2.17","2.03","0.36","0","77","71","72","1","0"
"2016","Alberta","48","Heroin, possession","150","93","11","39.07","3.53","3.01","2.77","0","0.35","104","100","100","0","1"
"1998","Alberta","48","Other Controlled Drugs and Substances Act, possession","247","216","27","0","8.52","6.73","6.46","4.22","1.92","243","144","155","11","5"
"1999","Alberta","48","Other Controlled Drugs and Substances Act, possession","289","206","35","14.87","9.79","6.53","6.27","4.16","2.65","241","143","154","11","7"
"2000","Alberta","48","Other Controlled Drugs and Substances Act, possession","312","186","29","6.1","10.38","7.36","7.65","10.1","1.87","215","165","192","27","5"
"2001","Alberta","48","Other Controlled Drugs and Substances Act, possession","345","215","34","8.66","11.28","8.02","8.42","11.82","8.13","249","184","216","32","22"
"2002","Alberta","48","Other Controlled Drugs and Substances Act, possession","369","225","45","4.55","11.8","7.93","8.31","11.56","6.5","270","187","219","32","18"
"2003","Alberta","48","Other Controlled Drugs and Substances Act, possession","455","248","80","21.17","14.29","8.7","8.91","10.73","6.44","328","210","240","30","18"
"2004","Alberta","48","Other Controlled Drugs and Substances Act, possession","449","229","63","-3.03","13.86","7.7","7.5","5.69","2.13","292","190","206","16","6"
"2005","Alberta","48","Other Controlled Drugs and Substances Act, possession","577","318","83","25.31","17.37","10.98","11.04","11.63","7.05","401","279","312","33","20"
"2006","Alberta","48","Other Controlled Drugs and Substances Act, possession","521","317","78","-12.32","15.23","10.81","10.84","11.15","11.49","395","284","316","32","33"
"2007","Alberta","48","Other Controlled Drugs and Substances Act, possession","505","297","93","-5.63","14.37","10.33","10.64","13.59","12.89","390","280","319","39","37"
"2008","Alberta","48","Other Controlled Drugs and Substances Act, possession","506","306","72","-2.08","14.07","10.09","10.65","16.13","9.82","378","281","327","46","28"
"2009","Alberta","48","Other Controlled Drugs and Substances Act, possession","442","227","100","-14.63","12.01","8.33","8.34","8.46","11.63","327","238","262","24","33"
"2010","Alberta","48","Other Controlled Drugs and Substances Act, possession","444","209","77","-0.99","11.9","7.72","7.6","6.39","4.62","286","224","242","18","13"
"2011","Alberta","48","Other Controlled Drugs and Substances Act, possession","392","192","81","-13.05","10.34","7.12","7.24","8.53","7.47","273","210","234","24","21"
"2012","Alberta","48","Other Controlled Drugs and Substances Act, possession","380","207","62","-5.32","9.79","7.07","6.9","5","8.93","269","214","228","14","25"
"2013","Alberta","48","Other Controlled Drugs and Substances Act, possession","386","217","73","-1.37","9.66","7.78","7.35","2.5","6.44","290","243","250","7","18"
"2014","Alberta","48","Other Controlled Drugs and Substances Act, possession","528","308","64","33.07","12.85","9.82","9.53","6.1","5.74","372","316","333","17","16"
"2015","Alberta","48","Other Controlled Drugs and Substances Act, possession","608","353","90","13.19","14.55","11.13","10.68","5.36","6.08","443","364","379","15","17"
"2016","Alberta","48","Other Controlled Drugs and Substances Act, possession","769","439","161","24.3","18.08","14.05","13.28","4.24","6.36","600","467","479","12","18"
"2005","Alberta","48","Methamphetamines (crystal meth), possession","0","0","0","0","0","0","0","0","0","0","0","0","0","0"
"2006","Alberta","48","Methamphetamines (crystal meth), possession","0","0","0","0","0","0","0","0","0","0","0","0","0","0"
"2007","Alberta","48","Methamphetamines (crystal meth), possession","0","0","0","0","0","0","0","0","0","0","0","0","0","0"
"2008","Alberta","48","Methamphetamines (crystal meth), possession","17","13","1","0","0.47","0.47","0.42","0","0","14","13","13","0","0"
"2009","Alberta","48","Methamphetamines (crystal meth), possession","43","33","2","147.21","1.17","1.08","1.02","0.35","0","35","31","32","1","0"
"2010","Alberta","48","Methamphetamines (crystal meth), possession","139","115","11","218.62","3.72","4.27","3.96","0.71","0","126","124","126","2","0"
"2011","Alberta","48","Methamphetamines (crystal meth), possession","193","141","22","36.74","5.09","5.05","4.74","1.42","0.36","163","149","153","4","1"
"2012","Alberta","48","Methamphetamines (crystal meth), possession","252","195","24","27.52","6.49","6.71","6.14","0","0.71","219","203","203","0","2"
"2013","Alberta","48","Methamphetamines (crystal meth), possession","410","319","24","57.98","10.26","10.69","10.11","3.58","0.72","343","334","344","10","2"
"2014","Alberta","48","Methamphetamines (crystal meth), possession","756","610","55","79.38","18.4","19.9","18.65","4.3","1.08","665","640","652","12","3"
"2015","Alberta","48","Methamphetamines (crystal meth), possession","1128","927","62","46.66","26.99","27.79","26.59","12.52","1.43","989","909","944","35","4"
"2016","Alberta","48","Methamphetamines (crystal meth), possession","1611","1313","111","40.36","37.88","40.08","37.88","12.01","2.47","1424","1332","1366","34","7"
"2005","Alberta","48","Methylenedioxyamphetamine (ecstasy), possession","0","0","0","0","0","0","0","0","0","0","0","0","0","0"
"2006","Alberta","48","Methylenedioxyamphetamine (ecstasy), possession","0","0","0","0","0","0","0","0","0","0","0","0","0","0"
"2007","Alberta","48","Methylenedioxyamphetamine (ecstasy), possession","0","0","0","0","0","0","0","0","0","0","0","0","0","0"
"2008","Alberta","48","Methylenedioxyamphetamine (ecstasy), possession","19","17","2","0","0.53","0.43","0.55","1.75","0.35","19","12","17","5","1"
"2009","Alberta","48","Methylenedioxyamphetamine (ecstasy), possession","75","58","7","285.8","2.04","1.4","1.85","6.34","2.11","65","40","58","18","6"
"2010","Alberta","48","Methylenedioxyamphetamine (ecstasy), possession","98","54","25","28.79","2.63","1.72","1.88","3.55","4.62","79","50","60","10","13"
"2011","Alberta","48","Methylenedioxyamphetamine (ecstasy), possession","51","34","10","-48.75","1.35","0.92","1.02","2.13","0.36","44","27","33","6","1"
"2012","Alberta","48","Methylenedioxyamphetamine (ecstasy), possession","34","19","9","-34.89","0.88","0.56","0.57","0.71","0.36","28","17","19","2","1"
"2013","Alberta","48","Methylenedioxyamphetamine (ecstasy), possession","23","14","4","-34.31","0.58","0.42","0.41","0.36","0.36","18","13","14","1","1"
"2014","Alberta","48","Methylenedioxyamphetamine (ecstasy), possession","37","16","5","56.5","0.9","0.4","0.4","0.36","0","21","13","14","1","0"
"2015","Alberta","48","Methylenedioxyamphetamine (ecstasy), possession","31","19","2","-17.65","0.74","0.43","0.45","0.72","0","21","14","16","2","0"
"2016","Alberta","48","Methylenedioxyamphetamine (ecstasy), possession","25","18","7","-20.74","0.59","0.42","0.42","0.35","0.35","25","14","15","1","1"
"2005","Alberta","48","Total cannabis, trafficking, production or distribution","1112","623","72","-15.81","33.47","27.23","28.11","35.95","15.51","695","692","794","102","44"
"2006","Alberta","48","Total cannabis, trafficking, production or distribution","878","563","75","-23.33","25.66","22.23","23.75","37.62","12.54","638","584","692","108","36"
"2007","Alberta","48","Total cannabis, trafficking, production or distribution","925","458","91","2.57","26.32","20.77","21.88","32.41","12.2","549","563","656","93","35"
"2008","Alberta","48","Total cannabis, trafficking, production or distribution","1070","565","81","13.05","29.76","23.34","25.05","41.72","17.53","646","650","769","119","50"
"2009","Alberta","48","Total cannabis, trafficking, production or distribution","1290","643","128","17.83","35.06","27.36","27.94","33.83","14.1","771","782","878","96","40"
"2010","Alberta","48","Total cannabis, trafficking, production or distribution","1557","857","161","18.97","41.71","33.69","34.86","46.87","13.14","1018","978","1110","132","37"
"2011","Alberta","48","Total cannabis, trafficking, production or distribution","1476","840","140","-6.64","38.94","32.95","34.39","49.43","12.09","980","972","1111","139","34"
"2012","Alberta","48","Total cannabis, trafficking, production or distribution","1245","613","143","-17.62","32.08","23.23","24.26","35.34","13.92","756","703","802","99","39"
"2013","Alberta","48","Total cannabis, trafficking, production or distribution","1222","630","113","-4.69","30.58","24.49","25.5","36.84","11.45","743","765","868","103","32"
"2014","Alberta","48","Total cannabis, trafficking, production or distribution","1118","592","89","-11","27.21","20.77","21.26","26.9","7.89","681","668","743","75","22"
"2015","Alberta","48","Total cannabis, trafficking, production or distribution","886","405","66","-22.1","21.2","15.13","15.18","15.74","12.52","471","495","539","44","35"
"2016","Alberta","48","Total cannabis, trafficking, production or distribution","741","346","54","-17.81","17.42","12.91","12.7","10.25","3.89","400","429","458","29","11"
"1998","Alberta","48","Total cannabis, trafficking, production or distribution","1175","685","78","0","40.52","36.19","34.8","23.41","5.76","763","774","835","61","15"
"1999","Alberta","48","Total cannabis, trafficking, production or distribution","1039","703","97","-13.19","35.18","34.87","33.93","26.11","8.33","800","764","833","69","22"
"2000","Alberta","48","Total cannabis, trafficking, production or distribution","1398","925","84","32.24","46.52","45.73","45.24","41.17","8.61","1009","1025","1135","110","23"
"2001","Alberta","48","Total cannabis, trafficking, production or distribution","1314","832","72","-7.64","42.97","42.71","44.87","63.19","18.48","904","980","1151","171","50"
"2002","Alberta","48","Total cannabis, trafficking, production or distribution","1273","857","78","-5.3","40.69","42.72","43.47","49.86","16.62","935","1008","1146","138","46"
"2003","Alberta","48","Total cannabis, trafficking, production or distribution","1337","919","89","3.21","42","42.94","44.24","55.45","19.68","1008","1036","1191","155","55"
"2004","Alberta","48","Total cannabis, trafficking, production or distribution","1288","793","63","-5.33","39.76","37.57","39.99","61.2","8.18","856","927","1099","172","23"
"1998","Alberta","48","Cannabis, trafficking","889","558","51","0","30.66","28.66","27.88","21.49","5.76","609","613","669","56","15"
"1999","Alberta","48","Cannabis, trafficking","836","624","70","-7.67","28.31","30.4","29.86","25.35","7.57","694","666","733","67","20"
"2000","Alberta","48","Cannabis, trafficking","1169","849","64","37.43","38.9","41.18","41.02","39.67","8.61","913","923","1029","106","23"
"2001","Alberta","48","Cannabis, trafficking","1120","740","61","-5.85","36.63","37.09","39.57","60.6","18.11","801","851","1015","164","49"
"2002","Alberta","48","Cannabis, trafficking","1097","779","61","-4.26","35.07","37.72","38.88","48.77","15.9","840","890","1025","135","44"
"2003","Alberta","48","Cannabis, trafficking","1112","820","58","-0.38","34.93","36.64","38.41","53.66","19.32","878","884","1034","150","54"
"2004","Alberta","48","Cannabis, trafficking","1076","722","40","-4.91","33.22","33.72","36.39","59.78","8.18","762","832","1000","168","23"
"2005","Alberta","48","Cannabis, trafficking","965","593","55","-12.55","29.05","25.54","26.59","35.95","15.51","648","649","751","102","44"
"2006","Alberta","48","Cannabis, trafficking","775","531","49","-22.02","22.65","20.94","22.48","36.57","12.54","580","550","655","105","36"
"2007","Alberta","48","Cannabis, trafficking","813","446","70","2.14","23.14","20.14","21.31","32.41","12.2","516","546","639","93","35"
"2008","Alberta","48","Cannabis, trafficking","951","544","61","14.32","26.45","22.37","24.17","41.72","15.42","605","623","742","119","44"
"2009","Alberta","48","Cannabis, trafficking","1115","615","92","14.59","30.31","26.24","26.89","33.48","14.1","707","750","845","95","40"
"2010","Alberta","48","Cannabis, trafficking","1365","835","102","20.67","36.57","32.62","33.85","46.51","11.36","937","947","1078","131","32"
"2011","Alberta","48","Cannabis, trafficking","1311","799","112","-5.42","34.59","31.43","32.93","48.72","11.73","911","927","1064","137","33"
"2012","Alberta","48","Cannabis, trafficking","1057","570","77","-21.26","27.24","21.51","22.62","34.63","13.21","647","651","748","97","37"
"2013","Alberta","48","Cannabis, trafficking","1061","597","62","-2.53","26.55","23.15","24.21","36.13","11.09","659","723","824","101","31"
"2014","Alberta","48","Cannabis, trafficking","982","555","58","-9.96","23.9","19.4","20","26.9","7.89","613","624","699","75","22"
"2015","Alberta","48","Cannabis, trafficking","747","369","49","-25.23","17.87","13.85","14","15.74","12.16","418","453","497","44","34"
"2016","Alberta","48","Cannabis, trafficking","635","323","33","-16.46","14.93","12.16","11.98","9.89","3.89","356","404","432","28","11"
"1998","Alberta","48","Cannabis, importation and exportation","6","4","1","0","0.21","0.14","0.13","0","0","5","3","3","0","0"
"1999","Alberta","48","Cannabis, importation and exportation","1","0","0","-83.64","0.03","0","0","0","0","0","0","0","0","0"
"2000","Alberta","48","Cannabis, importation and exportation","2","0","0","96.56","0.07","0","0","0","0","0","0","0","0","0"
"2001","Alberta","48","Cannabis, importation and exportation","3","1","0","47.4","0.1","0.04","0.04","0","0","1","1","1","0","0"
"2002","Alberta","48","Cannabis, importation and exportation","3","1","0","-2.25","0.1","0.08","0.08","0","0","1","2","2","0","0"
"2003","Alberta","48","Cannabis, importation and exportation","10","1","0","227.57","0.31","0.04","0.04","0","0","1","1","1","0","0"
"2004","Alberta","48","Cannabis, importation and exportation","0","1","0","-100","0","0.04","0.04","0","0","1","1","1","0","0"
"2005","Alberta","48","Cannabis, importation and exportation","1","0","1","0","0.03","0","0","0","0","1","0","0","0","0"
"2006","Alberta","48","Cannabis, importation and exportation","4","3","1","288.41","0.12","0.11","0.1","0","0","4","3","3","0","0"
"2007","Alberta","48","Cannabis, importation and exportation","5","2","0","21.7","0.14","0.07","0.07","0","0","2","2","2","0","0"
"2008","Alberta","48","Cannabis, importation and exportation","5","3","0","-2.27","0.14","0.18","0.16","0","0","3","5","5","0","0"
"2009","Alberta","48","Cannabis, importation and exportation","11","5","1","115.02","0.3","0.17","0.16","0","0","6","5","5","0","0"
"2010","Alberta","48","Cannabis, importation and exportation","5","2","4","-55.2","0.13","0.1","0.09","0","0","6","3","3","0","0"
"2011","Alberta","48","Cannabis, importation and exportation","14","5","5","175.74","0.37","0.2","0.19","0","0","10","6","6","0","0"
"2012","Alberta","48","Cannabis, importation and exportation","50","8","38","248.81","1.29","0.26","0.24","0","0","46","8","8","0","0"
"2013","Alberta","48","Cannabis, importation and exportation","33","4","24","-35.91","0.83","0.1","0.09","0","0","28","3","3","0","0"
"2014","Alberta","48","Cannabis, importation and exportation","34","16","14","0.23","0.83","0.62","0.57","0","0","30","20","20","0","0"
"2015","Alberta","48","Cannabis, importation and exportation","30","18","8","-13.27","0.72","0.61","0.56","0","0","26","20","20","0","0"
"2016","Alberta","48","Cannabis, importation and exportation","12","6","6","-60.69","0.28","0.18","0.17","0","0","12","6","6","0","0"
"1998","Alberta","48","Cannabis, production","280","123","26","0","9.66","7.39","6.79","1.92","0","149","158","163","5","0"
"1999","Alberta","48","Cannabis, production","202","79","27","-29.17","6.84","4.47","4.07","0.76","0.76","106","98","100","2","2"
"2000","Alberta","48","Cannabis, production","227","76","20","10.44","7.55","4.55","4.23","1.5","0","96","102","106","4","0"
"2001","Alberta","48","Cannabis, production","191","91","11","-17.32","6.25","5.58","5.26","2.59","0.37","102","128","135","7","1"
"2002","Alberta","48","Cannabis, production","173","77","17","-11.46","5.53","4.92","4.51","1.08","0.72","94","116","119","3","2"
"2003","Alberta","48","Cannabis, production","215","98","31","22.13","6.75","6.26","5.79","1.79","0.36","129","151","156","5","1"
"2004","Alberta","48","Cannabis, production","212","70","23","-3.1","6.54","3.81","3.57","1.42","0","93","94","98","4","0"
"2005","Alberta","48","Cannabis, production","146","30","16","-32.85","4.39","1.69","1.52","0","0","46","43","43","0","0"
"2006","Alberta","48","Cannabis, production","99","29","25","-34.16","2.89","1.18","1.17","1.04","0","54","31","34","3","0"
"2007","Alberta","48","Cannabis, production","107","10","21","5.23","3.04","0.55","0.5","0","0","31","15","15","0","0"
"2008","Alberta","48","Cannabis, production","114","18","20","4.12","3.17","0.79","0.72","0","2.1","38","22","22","0","6"
"2009","Alberta","48","Cannabis, production","164","23","35","40.6","4.46","0.94","0.89","0.35","0","58","27","28","1","0"
"2010","Alberta","48","Cannabis, production","187","20","55","12.39","5.01","0.96","0.91","0.36","1.78","75","28","29","1","5"
"2011","Alberta","48","Cannabis, production","151","36","23","-20.48","3.98","1.32","1.27","0.71","0.36","59","39","41","2","1"
"2012","Alberta","48","Cannabis, production","138","35","28","-10.74","3.56","1.45","1.39","0.71","0.71","63","44","46","2","2"
"2013","Alberta","48","Cannabis, production","128","29","27","-9.94","3.2","1.25","1.2","0.72","0.36","56","39","41","2","1"
"2014","Alberta","48","Cannabis, production","102","21","17","-22.48","2.48","0.75","0.69","0","0","38","24","24","0","0"
"2015","Alberta","48","Cannabis, production","109","18","9","5.04","2.61","0.67","0.62","0","0.36","27","22","22","0","1"
"2016","Alberta","48","Cannabis, production","94","17","15","-15.25","2.21","0.57","0.55","0.35","0","32","19","20","1","0"
"1998","Alberta","48","Total cocaine, trafficking, production or distribution","798","662","44","0","27.52","30.06","31.8","46.05","0","706","643","763","120","0"
"1999","Alberta","48","Total cocaine, trafficking, production or distribution","1015","897","42","24.88","34.37","42.09","44.07","60.55","0","939","922","1082","160","0"
"2000","Alberta","48","Total cocaine, trafficking, production or distribution","979","907","56","-5.21","32.58","42.96","43.85","51.27","1.5","963","963","1100","137","4"
"2001","Alberta","48","Total cocaine, trafficking, production or distribution","1009","848","37","1.28","33","40.92","40.39","35.84","1.48","885","939","1036","97","4"
"2002","Alberta","48","Total cocaine, trafficking, production or distribution","1140","870","44","10.44","36.44","36.75","37.17","40.82","1.81","914","867","980","113","5"
"2003","Alberta","48","Total cocaine, trafficking, production or distribution","1278","1113","37","10.17","40.15","45.26","44.61","38.99","1.07","1150","1092","1201","109","3"
"2004","Alberta","48","Total cocaine, trafficking, production or distribution","1537","1137","43","18.18","47.45","50.91","49.56","37.72","1.78","1180","1256","1362","106","5"
"2005","Alberta","48","Total cocaine, trafficking, production or distribution","1738","1440","61","10.26","52.31","61.31","58.69","35.25","3.88","1501","1558","1658","100","11"
"2006","Alberta","48","Total cocaine, trafficking, production or distribution","1937","1594","70","8.22","56.61","65.1","62.39","37.62","5.22","1664","1710","1818","108","15"
"2007","Alberta","48","Total cocaine, trafficking, production or distribution","2025","1587","56","1.79","57.63","62.97","60.88","41.12","1.39","1643","1707","1825","118","4"
"2008","Alberta","48","Total cocaine, trafficking, production or distribution","1921","1332","64","-7.29","53.42","53.29","51.46","33.65","1.75","1396","1484","1580","96","5"
"2009","Alberta","48","Total cocaine, trafficking, production or distribution","2187","1650","88","11.27","59.44","56.16","53.28","24.32","2.11","1738","1605","1674","69","6"
"2010","Alberta","48","Total cocaine, trafficking, production or distribution","1985","1444","95","-10.54","53.18","56.08","53.01","21.3","0","1539","1628","1688","60","0"
"2011","Alberta","48","Total cocaine, trafficking, production or distribution","1855","1192","92","-7.97","48.94","51.12","48.84","24.89","3.56","1284","1508","1578","70","10"
"2012","Alberta","48","Total cocaine, trafficking, production or distribution","1949","1264","131","2.62","50.22","47.98","45.25","15.71","1.07","1395","1452","1496","44","3"
"2013","Alberta","48","Total cocaine, trafficking, production or distribution","1890","1272","78","-5.84","47.29","50.97","48.57","21.82","2.15","1350","1592","1653","61","6"
"2014","Alberta","48","Total cocaine, trafficking, production or distribution","1979","1219","79","1.86","48.17","47.38","45.31","21.52","0","1298","1524","1584","60","0"
"2015","Alberta","48","Total cocaine, trafficking, production or distribution","1761","1011","68","-12.54","42.13","42.78","40.73","16.81","1.07","1079","1399","1446","47","3"
"2016","Alberta","48","Total cocaine, trafficking, production or distribution","1546","842","62","-13.72","36.35","34.24","32.58","13.07","0.71","904","1138","1175","37","2"
"1998","Alberta","48","Cocaine, trafficking","791","662","42","0","27.28","30.06","31.8","46.05","0","704","643","763","120","0"
"1999","Alberta","48","Cocaine, trafficking","1014","897","41","25.86","34.33","42.09","44.07","60.55","0","938","922","1082","160","0"
"2000","Alberta","48","Cocaine, trafficking","975","904","56","-5.5","32.45","42.79","43.65","50.9","1.5","960","959","1095","136","4"
"2001","Alberta","48","Cocaine, trafficking","1008","847","36","1.59","32.96","40.88","40.35","35.84","1.48","883","938","1035","97","4"
"2002","Alberta","48","Cocaine, trafficking","1136","869","44","10.16","36.31","36.7","37.14","40.82","1.81","913","866","979","113","5"
"2003","Alberta","48","Cocaine, trafficking","1276","1112","37","10.38","40.08","45.18","44.53","38.99","1.07","1149","1090","1199","109","3"
"2004","Alberta","48","Cocaine, trafficking","1525","1132","43","17.45","47.08","50.71","49.38","37.72","1.78","1175","1251","1357","106","5"
"2005","Alberta","48","Cocaine, trafficking","1733","1439","60","10.81","52.16","61.27","58.66","35.25","3.88","1499","1557","1657","100","11"
"2006","Alberta","48","Cocaine, trafficking","1931","1593","69","8.2","56.44","65.02","62.32","37.62","5.22","1662","1708","1816","108","15"
"2007","Alberta","48","Cocaine, trafficking","2015","1584","54","1.6","57.34","62.86","60.78","41.12","1.39","1638","1704","1822","118","4"
"2008","Alberta","48","Cocaine, trafficking","1910","1329","62","-7.37","53.12","53.25","51.43","33.65","1.75","1391","1483","1579","96","5"
"2009","Alberta","48","Cocaine, trafficking","2172","1647","87","11.14","59.04","55.98","53.12","24.32","2.11","1734","1600","1669","69","6"
"2010","Alberta","48","Cocaine, trafficking","1967","1439","91","-10.74","52.7","55.74","52.69","21.3","0","1530","1618","1678","60","0"
"2011","Alberta","48","Cocaine, trafficking","1838","1186","91","-7.98","48.49","50.92","48.62","24.54","3.56","1277","1502","1571","69","10"
"2012","Alberta","48","Cocaine, trafficking","1935","1259","131","2.82","49.86","47.82","45.1","15.71","1.07","1390","1447","1491","44","3"
"2013","Alberta","48","Cocaine, trafficking","1882","1271","76","-5.56","47.09","50.93","48.54","21.82","2.15","1347","1591","1652","61","6"
"2014","Alberta","48","Cocaine, trafficking","1965","1217","77","1.57","47.83","47.25","45.2","21.52","0","1294","1520","1580","60","0"
"2015","Alberta","48","Cocaine, trafficking","1749","1009","66","-12.51","41.85","42.71","40.67","16.81","1.07","1075","1397","1444","47","3"
"2016","Alberta","48","Cocaine, trafficking","1536","841","62","-13.69","36.12","34.24","32.58","13.07","0.71","903","1138","1175","37","2"
"1998","Alberta","48","Cocaine, importation and exportation","7","0","2","0","0.24","0","0","0","0","2","0","0","0","0"
"1999","Alberta","48","Cocaine, importation and exportation","1","0","1","-85.97","0.03","0","0","0","0","1","0","0","0","0"
"2000","Alberta","48","Cocaine, importation and exportation","4","3","0","293.12","0.13","0.18","0.2","0.37","0","3","4","5","1","0"
"2001","Alberta","48","Cocaine, importation and exportation","1","1","1","-75.43","0.03","0.04","0.04","0","0","2","1","1","0","0"
"2002","Alberta","48","Cocaine, importation and exportation","4","1","0","291.01","0.13","0.04","0.04","0","0","1","1","1","0","0"
"2003","Alberta","48","Cocaine, importation and exportation","2","1","0","-50.86","0.06","0.08","0.07","0","0","1","2","2","0","0"
"2004","Alberta","48","Cocaine, importation and exportation","12","5","0","489.61","0.37","0.2","0.18","0","0","5","5","5","0","0"
"2005","Alberta","48","Cocaine, importation and exportation","5","1","1","-59.37","0.15","0.04","0.04","0","0","2","1","1","0","0"
"2006","Alberta","48","Cocaine, importation and exportation","6","1","1","16.52","0.18","0.08","0.07","0","0","2","2","2","0","0"
"2007","Alberta","48","Cocaine, importation and exportation","10","3","2","62.27","0.28","0.11","0.1","0","0","5","3","3","0","0"
"2008","Alberta","48","Cocaine, importation and exportation","8","0","2","-21.82","0.22","0","0","0","0","2","0","0","0","0"
"2009","Alberta","48","Cocaine, importation and exportation","12","1","1","46.6","0.33","0.03","0.03","0","0","2","1","1","0","0"
"2010","Alberta","48","Cocaine, importation and exportation","9","0","3","-26.07","0.24","0","0","0","0","3","0","0","0","0"
"2011","Alberta","48","Cocaine, importation and exportation","11","3","1","20.36","0.29","0.07","0.09","0.36","0","4","2","3","1","0"
"2012","Alberta","48","Cocaine, importation and exportation","11","2","0","-2.33","0.28","0.07","0.06","0","0","2","2","2","0","0"
"2013","Alberta","48","Cocaine, importation and exportation","6","0","2","-47.04","0.15","0","0","0","0","2","0","0","0","0"
"2014","Alberta","48","Cocaine, importation and exportation","10","0","2","62.14","0.24","0","0","0","0","2","0","0","0","0"
"2015","Alberta","48","Cocaine, importation and exportation","9","1","1","-11.54","0.22","0.03","0.03","0","0","2","1","1","0","0"
"2016","Alberta","48","Cocaine, importation and exportation","9","0","0","-1.72","0.21","0","0","0","0","0","0","0","0","0"
"2005","Alberta","48","Cocaine, production","0","0","0","0","0","0","0","0","0","0","0","0","0","0"
"2006","Alberta","48","Cocaine, production","0","0","0","0","0","0","0","0","0","0","0","0","0","0"
"2007","Alberta","48","Cocaine, production","0","0","0","0","0","0","0","0","0","0","0","0","0","0"
"2008","Alberta","48","Cocaine, production","3","3","0","0","0.08","0.04","0.03","0","0","3","1","1","0","0"
"2009","Alberta","48","Cocaine, production","3","2","0","-2.27","0.08","0.14","0.13","0","0","2","4","4","0","0"
"2010","Alberta","48","Cocaine, production","9","5","1","195.7","0.24","0.34","0.31","0","0","6","10","10","0","0"
"2011","Alberta","48","Cocaine, production","6","3","0","-34.35","0.16","0.14","0.12","0","0","3","4","4","0","0"
"2012","Alberta","48","Cocaine, production","3","3","0","-51.17","0.08","0.1","0.09","0","0","3","3","3","0","0"
"2013","Alberta","48","Cocaine, production","2","1","0","-35.27","0.05","0.03","0.03","0","0","1","1","1","0","0"
"2014","Alberta","48","Cocaine, production","4","2","0","94.56","0.1","0.12","0.11","0","0","2","4","4","0","0"
"2015","Alberta","48","Cocaine, production","3","1","1","-26.28","0.07","0.03","0.03","0","0","2","1","1","0","0"
"2016","Alberta","48","Cocaine, production","1","1","0","-67.24","0.02","0","0","0","0","1","0","0","0","0"
"1998","Alberta","48","Total other Controlled Drugs and Substances Act drugs, trafficking, production or distribution","304","196","20","0","10.48","9.26","9.59","12.28","0.77","216","198","230","32","2"
"1999","Alberta","48","Total other Controlled Drugs and Substances Act drugs, trafficking, production or distribution","328","229","26","5.93","11.11","9.13","8.8","6.05","1.14","255","200","216","16","3"
"2000","Alberta","48","Total other Controlled Drugs and Substances Act drugs, trafficking, production or distribution","419","309","26","25.55","13.94","15.79","15.35","11.6","1.5","335","354","385","31","4"
"2001","Alberta","48","Total other Controlled Drugs and Substances Act drugs, trafficking, production or distribution","441","313","23","3.42","14.42","15.78","15.87","16.63","2.59","336","362","407","45","7"
"2002","Alberta","48","Total other Controlled Drugs and Substances Act drugs, trafficking, production or distribution","441","279","11","-2.25","14.1","14.33","13.96","10.84","4.34","290","338","368","30","12"
"2003","Alberta","48","Total other Controlled Drugs and Substances Act drugs, trafficking, production or distribution","445","307","16","-0.84","13.98","16.12","15.56","10.73","1.07","323","389","419","30","3"
"2004","Alberta","48","Total other Controlled Drugs and Substances Act drugs, trafficking, production or distribution","456","273","27","0.7","14.08","11.96","11.5","7.47","0.71","300","295","316","21","2"
"2005","Alberta","48","Total other Controlled Drugs and Substances Act drugs, trafficking, production or distribution","492","278","22","5.21","14.81","11.69","11.93","14.1","2.82","300","297","337","40","8"
"2006","Alberta","48","Total other Controlled Drugs and Substances Act drugs, trafficking, production or distribution","504","289","33","-0.53","14.73","11.27","12.22","20.9","6.62","322","296","356","60","19"
"2007","Alberta","48","Total other Controlled Drugs and Substances Act drugs, trafficking, production or distribution","452","214","20","-12.68","12.86","9.07","9.77","16.38","4.53","234","246","293","47","13"
"2008","Alberta","48","Total other Controlled Drugs and Substances Act drugs, trafficking, production or distribution","488","232","33","5.51","13.57","10.38","10.49","11.57","3.86","265","289","322","33","11"
"2009","Alberta","48","Total other Controlled Drugs and Substances Act drugs, trafficking, production or distribution","628","289","43","25.77","17.07","13.3","13.14","11.63","4.58","332","380","413","33","13"
"2010","Alberta","48","Total other Controlled Drugs and Substances Act drugs, trafficking, production or distribution","710","310","39","11.44","19.02","13.12","13.13","13.14","5.68","349","381","418","37","16"
"2011","Alberta","48","Total other Controlled Drugs and Substances Act drugs, trafficking, production or distribution","612","258","54","-15.11","16.15","11.7","11.17","5.69","1.07","312","345","361","16","3"
"2012","Alberta","48","Total other Controlled Drugs and Substances Act drugs, trafficking, production or distribution","676","305","54","7.88","17.42","12.72","12.4","8.93","2.5","359","385","410","25","7"
"2013","Alberta","48","Total other Controlled Drugs and Substances Act drugs, trafficking, production or distribution","737","352","50","5.86","18.44","15.81","15.07","6.8","0.72","402","494","513","19","2"
"2014","Alberta","48","Total other Controlled Drugs and Substances Act drugs, trafficking, production or distribution","990","552","56","30.68","24.1","22.85","21.4","4.66","1.79","608","735","748","13","5"
"2015","Alberta","48","Total other Controlled Drugs and Substances Act drugs, trafficking, production or distribution","1353","734","49","34.33","32.37","29.9","28.22","8.58","1.79","783","978","1002","24","5"
"2016","Alberta","48","Total other Controlled Drugs and Substances Act drugs, trafficking, production or distribution","1444","828","62","4.89","33.95","33.46","31.53","8.83","3.53","890","1112","1137","25","10"
"1998","Alberta","48","Heroin, trafficking","18","11","0","0","0.62","0.94","0.88","0.38","0","11","20","21","1","0"
"1999","Alberta","48","Heroin, trafficking","60","57","0","227.26","2.03","1.96","1.79","0.38","0","57","43","44","1","0"
"2000","Alberta","48","Heroin, trafficking","17","20","0","-72.15","0.57","1.12","1","0","0","20","25","25","0","0"
"2001","Alberta","48","Heroin, trafficking","14","11","1","-19.08","0.46","0.48","0.43","0","0","12","11","11","0","0"
"2002","Alberta","48","Heroin, trafficking","5","4","0","-65.09","0.16","0.21","0.27","0.72","0","4","5","7","2","0"
"2003","Alberta","48","Heroin, trafficking","4","4","0","-21.38","0.13","0.17","0.19","0.36","0","4","4","5","1","0"
"2004","Alberta","48","Heroin, trafficking","2","2","0","-50.87","0.06","0.08","0.07","0","0","2","2","2","0","0"
"2005","Alberta","48","Heroin, trafficking","5","4","0","143.77","0.15","0.2","0.18","0","0","4","5","5","0","0"
"2006","Alberta","48","Heroin, trafficking","19","18","0","268.99","0.56","0.99","0.96","0.7","0","18","26","28","2","0"
"2007","Alberta","48","Heroin, trafficking","7","6","0","-64.13","0.2","0.48","0.5","0.7","0","6","13","15","2","0"
"2008","Alberta","48","Heroin, trafficking","8","7","0","11.69","0.22","0.36","0.33","0","0","7","10","10","0","0"
"2009","Alberta","48","Heroin, trafficking","5","4","0","-38.92","0.14","0.14","0.13","0","0","4","4","4","0","0"
"2010","Alberta","48","Heroin, trafficking","7","6","0","37.99","0.19","0.17","0.16","0","0","6","5","5","0","0"
"2011","Alberta","48","Heroin, trafficking","28","20","2","293.92","0.74","0.54","0.53","0.36","0","22","16","17","1","0"
"2012","Alberta","48","Heroin, trafficking","50","33","2","74.4","1.29","1.42","1.33","0.36","0","35","43","44","1","0"
"2013","Alberta","48","Heroin, trafficking","60","51","1","16.52","1.5","2.43","2.26","0.36","0","52","76","77","1","0"
"2014","Alberta","48","Heroin, trafficking","101","77","6","63.76","2.46","3.67","3.49","1.43","0","83","118","122","4","0"
"2015","Alberta","48","Heroin, trafficking","154","125","3","49.87","3.68","5.47","5.1","0.72","0","128","179","181","2","0"
"2016","Alberta","48","Heroin, trafficking","149","122","5","-4.91","3.5","5.75","5.38","1.06","0","127","191","194","3","0"
"1998","Alberta","48","Other Controlled Drugs and Substances Act, trafficking","260","177","12","0","8.97","8.09","8.5","11.9","0.77","189","173","204","31","2"
"1999","Alberta","48","Other Controlled Drugs and Substances Act, trafficking","254","165","20","-4.09","8.6","6.89","6.76","5.68","0.76","185","151","166","15","2"
"2000","Alberta","48","Other Controlled Drugs and Substances Act, trafficking","390","283","26","50.9","12.98","14.37","14.03","11.23","1.5","309","322","352","30","4"
"2001","Alberta","48","Other Controlled Drugs and Substances Act, trafficking","404","288","21","1.79","13.21","14.69","14.74","15.15","2.59","309","337","378","41","7"
"2002","Alberta","48","Other Controlled Drugs and Substances Act, trafficking","413","269","9","-0.07","13.2","13.65","13.28","10.12","4.34","278","322","350","28","12"
"2003","Alberta","48","Other Controlled Drugs and Substances Act, trafficking","403","292","9","-4.11","12.66","15.04","14.52","10.02","1.07","301","363","391","28","3"
"2004","Alberta","48","Other Controlled Drugs and Substances Act, trafficking","411","264","17","0.22","12.69","11.55","11.13","7.47","0.71","281","285","306","21","2"
"2005","Alberta","48","Other Controlled Drugs and Substances Act, trafficking","450","267","22","6.76","13.55","10.98","11.29","14.1","2.82","289","279","319","40","8"
"2006","Alberta","48","Other Controlled Drugs and Substances Act, trafficking","461","267","31","-0.52","13.47","10.01","10.98","19.85","6.62","298","263","320","57","19"
"2007","Alberta","48","Other Controlled Drugs and Substances Act, trafficking","428","201","20","-9.61","12.18","8.12","8.84","15.68","4.53","221","220","265","45","13"
"2008","Alberta","48","Other Controlled Drugs and Substances Act, trafficking","438","196","32","0.01","12.18","8.73","8.92","10.87","3.16","228","243","274","31","9"
"2009","Alberta","48","Other Controlled Drugs and Substances Act, trafficking","469","203","35","4.65","12.75","9.2","9.07","7.75","4.23","238","263","285","22","12"
"2010","Alberta","48","Other Controlled Drugs and Substances Act, trafficking","459","179","25","-3.53","12.3","7.2","7.38","9.23","0.36","204","209","235","26","1"
"2011","Alberta","48","Other Controlled Drugs and Substances Act, trafficking","396","125","39","-15.04","10.45","6.07","5.88","3.91","1.07","164","179","190","11","3"
"2012","Alberta","48","Other Controlled Drugs and Substances Act, trafficking","434","163","27","7.04","11.18","6.05","6.05","6.07","2.14","190","183","200","17","6"
"2013","Alberta","48","Other Controlled Drugs and Substances Act, trafficking","407","139","22","-8.94","10.18","6.31","5.99","2.5","0.72","161","197","204","7","2"
"2014","Alberta","48","Other Controlled Drugs and Substances Act, trafficking","482","192","24","15.21","11.73","7.24","6.89","2.87","1.43","216","233","241","8","4"
"2015","Alberta","48","Other Controlled Drugs and Substances Act, trafficking","634","223","24","29.29","15.17","9.11","8.68","3.58","1.43","247","298","308","10","4"
"2016","Alberta","48","Other Controlled Drugs and Substances Act, trafficking","643","294","37","-0.33","15.12","11.82","11.12","2.83","3.18","331","393","401","8","9"
"2005","Alberta","48","Methamphetamines (crystal meth), trafficking","0","0","0","0","0","0","0","0","0","0","0","0","0","0"
"2006","Alberta","48","Methamphetamines (crystal meth), trafficking","0","0","0","0","0","0","0","0","0","0","0","0","0","0"
"2007","Alberta","48","Methamphetamines (crystal meth), trafficking","0","0","0","0","0","0","0","0","0","0","0","0","0","0"
"2008","Alberta","48","Methamphetamines (crystal meth), trafficking","12","12","0","0","0.33","0.72","0.65","0","0","12","20","20","0","0"
"2009","Alberta","48","Methamphetamines (crystal meth), trafficking","44","31","2","258.36","1.2","1.78","1.72","1.06","0","33","51","54","3","0"
"2010","Alberta","48","Methamphetamines (crystal meth), trafficking","84","66","3","88.17","2.25","3.58","3.33","0.71","0","69","104","106","2","0"
"2011","Alberta","48","Methamphetamines (crystal meth), trafficking","103","85","3","20.76","2.72","4.14","3.81","0.36","0","88","122","123","1","0"
"2012","Alberta","48","Methamphetamines (crystal meth), trafficking","126","87","6","19.48","3.25","4.33","4.08","1.43","0","93","131","135","4","0"
"2013","Alberta","48","Methamphetamines (crystal meth), trafficking","200","146","7","54.13","5","6.56","6.32","3.58","0","153","205","215","10","0"
"2014","Alberta","48","Methamphetamines (crystal meth), trafficking","333","249","9","61.97","8.11","10.82","9.98","0.36","0.36","258","348","349","1","1"
"2015","Alberta","48","Methamphetamines (crystal meth), trafficking","513","367","12","51.42","12.27","14.68","13.86","4.29","0.36","379","480","492","12","1"
"2016","Alberta","48","Methamphetamines (crystal meth), trafficking","602","404","12","15.33","14.16","15.59","14.75","4.95","0.35","416","518","532","14","1"
"2005","Alberta","48","Methylenedioxyamphetamine (ecstasy), trafficking","0","0","0","0","0","0","0","0","0","0","0","0","0","0"
"2006","Alberta","48","Methylenedioxyamphetamine (ecstasy), trafficking","0","0","0","0","0","0","0","0","0","0","0","0","0","0"
"2007","Alberta","48","Methylenedioxyamphetamine (ecstasy), trafficking","0","0","0","0","0","0","0","0","0","0","0","0","0","0"
"2008","Alberta","48","Methylenedioxyamphetamine (ecstasy), trafficking","9","8","0","0","0.25","0.22","0.26","0.7","0.7","8","6","8","2","2"
"2009","Alberta","48","Methylenedioxyamphetamine (ecstasy), trafficking","40","29","1","334.38","1.09","1.05","1.15","2.11","0.35","30","30","36","6","1"
"2010","Alberta","48","Methylenedioxyamphetamine (ecstasy), trafficking","76","47","7","87.28","2.04","1.48","1.6","2.84","4.62","54","43","51","8","13"
"2011","Alberta","48","Methylenedioxyamphetamine (ecstasy), trafficking","37","17","0","-52.06","0.98","0.51","0.53","0.71","0","17","15","17","2","0"
"2012","Alberta","48","Methylenedioxyamphetamine (ecstasy), trafficking","24","15","1","-36.65","0.62","0.59","0.6","0.71","0.36","16","18","20","2","1"
"2013","Alberta","48","Methylenedioxyamphetamine (ecstasy), trafficking","25","10","3","1.15","0.63","0.29","0.29","0.36","0","13","9","10","1","0"
"2014","Alberta","48","Methylenedioxyamphetamine (ecstasy), trafficking","23","14","2","-10.5","0.56","0.4","0.37","0","0","16","13","13","0","0"
"2015","Alberta","48","Methylenedioxyamphetamine (ecstasy), trafficking","16","7","2","-31.62","0.38","0.24","0.23","0","0","9","8","8","0","0"
"2016","Alberta","48","Methylenedioxyamphetamine (ecstasy), trafficking","9","2","1","-44.72","0.21","0.06","0.06","0","0","3","2","2","0","0"
"1998","Alberta","48","Heroin, importation and exportation","3","1","0","0","0.1","0.05","0.04","0","0","1","1","1","0","0"
"1999","Alberta","48","Heroin, importation and exportation","1","0","0","-67.27","0.03","0","0","0","0","0","0","0","0","0"
"2000","Alberta","48","Heroin, importation and exportation","0","0","0","-100","0","0","0","0","0","0","0","0","0","0"
"2001","Alberta","48","Heroin, importation and exportation","3","0","0","0","0.1","0","0","0","0","0","0","0","0","0"
"2002","Alberta","48","Heroin, importation and exportation","0","0","0","-100","0","0","0","0","0","0","0","0","0","0"
"2003","Alberta","48","Heroin, importation and exportation","0","1","0","0","0","0.04","0.04","0","0","1","1","1","0","0"
"2004","Alberta","48","Heroin, importation and exportation","1","1","0","0","0.03","0.04","0.04","0","0","1","1","1","0","0"
"2005","Alberta","48","Heroin, importation and exportation","2","0","0","95.02","0.06","0","0","0","0","0","0","0","0","0"
"2006","Alberta","48","Heroin, importation and exportation","1","1","0","-51.45","0.03","0.11","0.1","0","0","1","3","3","0","0"
"2007","Alberta","48","Heroin, importation and exportation","0","0","0","-100","0","0","0","0","0","0","0","0","0","0"
"2008","Alberta","48","Heroin, importation and exportation","0","0","0","0","0","0","0","0","0","0","0","0","0","0"
"2009","Alberta","48","Heroin, importation and exportation","1","0","0","0","0.03","0","0","0","0","0","0","0","0","0"
"2010","Alberta","48","Heroin, importation and exportation","2","0","0","97.13","0.05","0","0","0","0","0","0","0","0","0"
"2011","Alberta","48","Heroin, importation and exportation","1","0","0","-50.76","0.03","0","0","0","0","0","0","0","0","0"
"2012","Alberta","48","Heroin, importation and exportation","4","0","1","290.67","0.1","0","0","0","0","1","0","0","0","0"
"2013","Alberta","48","Heroin, importation and exportation","4","0","0","-2.9","0.1","0","0","0","0","0","0","0","0","0"
"2014","Alberta","48","Heroin, importation and exportation","5","0","0","21.6","0.12","0","0","0","0","0","0","0","0","0"
"2015","Alberta","48","Heroin, importation and exportation","2","1","0","-60.68","0.05","0.03","0.03","0","0","1","1","1","0","0"
"2016","Alberta","48","Heroin, importation and exportation","2","0","1","-1.72","0.05","0","0","0","0","1","0","0","0","0"
"1998","Alberta","48","Other Controlled Drugs and Substances Act, importation and exportation","23","7","8","0","0.79","0.19","0.17","0","0","15","4","4","0","0"
"1999","Alberta","48","Other Controlled Drugs and Substances Act, importation and exportation","13","7","6","-44.51","0.44","0.27","0.24","0","0.38","13","6","6","0","1"
"2000","Alberta","48","Other Controlled Drugs and Substances Act, importation and exportation","12","6","0","-9.28","0.4","0.31","0.32","0.37","0","6","7","8","1","0"
"2001","Alberta","48","Other Controlled Drugs and Substances Act, importation and exportation","20","14","1","63.77","0.65","0.61","0.7","1.48","0","15","14","18","4","0"
"2002","Alberta","48","Other Controlled Drugs and Substances Act, importation and exportation","23","6","2","12.41","0.74","0.47","0.42","0","0","8","11","11","0","0"
"2003","Alberta","48","Other Controlled Drugs and Substances Act, importation and exportation","38","10","7","62.36","1.19","0.87","0.82","0.36","0","17","21","22","1","0"
"2004","Alberta","48","Other Controlled Drugs and Substances Act, importation and exportation","42","6","10","8.61","1.3","0.28","0.25","0","0","16","7","7","0","0"
"2005","Alberta","48","Other Controlled Drugs and Substances Act, importation and exportation","35","7","0","-18.74","1.05","0.51","0.46","0","0","7","13","13","0","0"
"2006","Alberta","48","Other Controlled Drugs and Substances Act, importation and exportation","23","3","2","-36.19","0.67","0.15","0.17","0.35","0","5","4","5","1","0"
"2007","Alberta","48","Other Controlled Drugs and Substances Act, importation and exportation","17","7","0","-28.04","0.48","0.48","0.43","0","0","7","13","13","0","0"
"2008","Alberta","48","Other Controlled Drugs and Substances Act, importation and exportation","20","8","1","14.97","0.56","0.32","0.29","0","0","9","9","9","0","0"
"2009","Alberta","48","Other Controlled Drugs and Substances Act, importation and exportation","51","7","4","149.22","1.39","0.24","0.25","0.35","0","11","7","8","1","0"
"2010","Alberta","48","Other Controlled Drugs and Substances Act, importation and exportation","50","1","1","-3.37","1.34","0.07","0.06","0","0","2","2","2","0","0"
"2011","Alberta","48","Other Controlled Drugs and Substances Act, importation and exportation","24","2","7","-52.73","0.63","0.07","0.06","0","0","9","2","2","0","0"
"2012","Alberta","48","Other Controlled Drugs and Substances Act, importation and exportation","28","4","16","13.94","0.72","0.13","0.12","0","0","20","4","4","0","0"
"2013","Alberta","48","Other Controlled Drugs and Substances Act, importation and exportation","21","3","15","-27.17","0.53","0.1","0.09","0","0","18","3","3","0","0"
"2014","Alberta","48","Other Controlled Drugs and Substances Act, importation and exportation","34","16","13","57.5","0.83","0.5","0.46","0","0","29","16","16","0","0"
"2015","Alberta","48","Other Controlled Drugs and Substances Act, importation and exportation","20","9","6","-42.18","0.48","0.28","0.25","0","0","15","9","9","0","0"
"2016","Alberta","48","Other Controlled Drugs and Substances Act, importation and exportation","14","2","5","-31.21","0.33","0.06","0.06","0","0","7","2","2","0","0"
"2005","Alberta","48","Methamphetamines (crystal meth), importation and exportation","0","0","0","0","0","0","0","0","0","0","0","0","0","0"
"2006","Alberta","48","Methamphetamines (crystal meth), importation and exportation","0","0","0","0","0","0","0","0","0","0","0","0","0","0"
"2007","Alberta","48","Methamphetamines (crystal meth), importation and exportation","0","0","0","0","0","0","0","0","0","0","0","0","0","0"
"2008","Alberta","48","Methamphetamines (crystal meth), importation and exportation","0","0","0","0","0","0","0","0","0","0","0","0","0","0"
"2009","Alberta","48","Methamphetamines (crystal meth), importation and exportation","0","0","0","0","0","0","0","0","0","0","0","0","0","0"
"2010","Alberta","48","Methamphetamines (crystal meth), importation and exportation","1","1","0","0","0.03","0.03","0.03","0","0","1","1","1","0","0"
"2011","Alberta","48","Methamphetamines (crystal meth), importation and exportation","1","0","0","-1.52","0.03","0","0","0","0","0","0","0","0","0"
"2012","Alberta","48","Methamphetamines (crystal meth), importation and exportation","1","0","1","-2.33","0.03","0","0","0","0","1","0","0","0","0"
"2013","Alberta","48","Methamphetamines (crystal meth), importation and exportation","2","0","0","94.2","0.05","0","0","0","0","0","0","0","0","0"
"2014","Alberta","48","Methamphetamines (crystal meth), importation and exportation","2","0","1","-2.72","0.05","0","0","0","0","1","0","0","0","0"
"2015","Alberta","48","Methamphetamines (crystal meth), importation and exportation","1","0","1","-50.85","0.02","0","0","0","0","1","0","0","0","0"
"2016","Alberta","48","Methamphetamines (crystal meth), importation and exportation","1","1","0","-1.72","0.02","0.03","0.03","0","0","1","1","1","0","0"
"2005","Alberta","48","Methylenedioxyamphetamine (ecstasy), importation and exportation","0","0","0","0","0","0","0","0","0","0","0","0","0","0"
"2006","Alberta","48","Methylenedioxyamphetamine (ecstasy), importation and exportation","0","0","0","0","0","0","0","0","0","0","0","0","0","0"
"2007","Alberta","48","Methylenedioxyamphetamine (ecstasy), importation and exportation","0","0","0","0","0","0","0","0","0","0","0","0","0","0"
"2008","Alberta","48","Methylenedioxyamphetamine (ecstasy), importation and exportation","0","0","0","0","0","0","0","0","0","0","0","0","0","0"
"2009","Alberta","48","Methylenedioxyamphetamine (ecstasy), importation and exportation","1","1","0","0","0.03","0.03","0.03","0","0","1","1","1","0","0"
"2010","Alberta","48","Methylenedioxyamphetamine (ecstasy), importation and exportation","2","0","0","97.13","0.05","0","0","0","0","0","0","0","0","0"
"2011","Alberta","48","Methylenedioxyamphetamine (ecstasy), importation and exportation","0","0","1","-100","0","0","0","0","0","1","0","0","0","0"
"2012","Alberta","48","Methylenedioxyamphetamine (ecstasy), importation and exportation","0","0","0","0","0","0","0","0","0","0","0","0","0","0"
"2013","Alberta","48","Methylenedioxyamphetamine (ecstasy), importation and exportation","0","0","0","0","0","0","0","0","0","0","0","0","0","0"
"2014","Alberta","48","Methylenedioxyamphetamine (ecstasy), importation and exportation","0","0","0","0","0","0","0","0","0","0","0","0","0","0"
"2015","Alberta","48","Methylenedioxyamphetamine (ecstasy), importation and exportation","0","0","0","0","0","0","0","0","0","0","0","0","0","0"
"2016","Alberta","48","Methylenedioxyamphetamine (ecstasy), importation and exportation","1","0","0","0","0.02","0","0","0","0","0","0","0","0","0"
"2005","Alberta","48","Heroin, production","0","0","0","0","0","0","0","0","0","0","0","0","0","0"
"2006","Alberta","48","Heroin, production","0","0","0","0","0","0","0","0","0","0","0","0","0","0"
"2007","Alberta","48","Heroin, production","0","0","0","0","0","0","0","0","0","0","0","0","0","0"
"2008","Alberta","48","Heroin, production","0","0","0","0","0","0","0","0","0","0","0","0","0","0"
"2009","Alberta","48","Heroin, production","0","0","0","0","0","0","0","0","0","0","0","0","0","0"
"2010","Alberta","48","Heroin, production","0","0","0","0","0","0","0","0","0","0","0","0","0","0"
"2011","Alberta","48","Heroin, production","0","0","0","0","0","0","0","0","0","0","0","0","0","0"
"2012","Alberta","48","Heroin, production","0","0","0","0","0","0","0","0","0","0","0","0","0","0"
"2013","Alberta","48","Heroin, production","0","0","0","0","0","0","0","0","0","0","0","0","0","0"
"2014","Alberta","48","Heroin, production","0","0","0","0","0","0","0","0","0","0","0","0","0","0"
"2015","Alberta","48","Heroin, production","0","0","0","0","0","0","0","0","0","0","0","0","0","0"
"2016","Alberta","48","Heroin, production","0","0","0","0","0","0","0","0","0","0","0","0","0","0"
"2005","Alberta","48","Other Controlled Drugs and Substances Act, production","0","0","0","0","0","0","0","0","0","0","0","0","0","0"
"2006","Alberta","48","Other Controlled Drugs and Substances Act, production","0","0","0","0","0","0","0","0","0","0","0","0","0","0"
"2007","Alberta","48","Other Controlled Drugs and Substances Act, production","0","0","0","0","0","0","0","0","0","0","0","0","0","0"
"2008","Alberta","48","Other Controlled Drugs and Substances Act, production","1","1","0","0","0.03","0.04","0.03","0","0","1","1","1","0","0"
"2009","Alberta","48","Other Controlled Drugs and Substances Act, production","16","14","1","1463.76","0.43","0.84","0.8","0.35","0","15","24","25","1","0"
"2010","Alberta","48","Other Controlled Drugs and Substances Act, production","22","10","3","35.53","0.59","0.59","0.57","0.36","0.71","13","17","18","1","2"
"2011","Alberta","48","Other Controlled Drugs and Substances Act, production","14","8","1","-37.33","0.37","0.34","0.34","0.36","0","9","10","11","1","0"
"2012","Alberta","48","Other Controlled Drugs and Substances Act, production","5","2","0","-65.12","0.13","0.13","0.15","0.36","0","2","4","5","1","0"
"2013","Alberta","48","Other Controlled Drugs and Substances Act, production","8","2","2","55.36","0.2","0.1","0.09","0","0","4","3","3","0","0"
"2014","Alberta","48","Other Controlled Drugs and Substances Act, production","5","4","0","-39.2","0.12","0.22","0.2","0","0","4","7","7","0","0"
"2015","Alberta","48","Other Controlled Drugs and Substances Act, production","5","2","0","-1.71","0.12","0.09","0.08","0","0","2","3","3","0","0"
"2016","Alberta","48","Other Controlled Drugs and Substances Act, production","5","1","1","-1.72","0.12","0.03","0.03","0","0","2","1","1","0","0"
"2005","Alberta","48","Methamphetamines (crystal meth), production","0","0","0","0","0","0","0","0","0","0","0","0","0","0"
"2006","Alberta","48","Methamphetamines (crystal meth), production","0","0","0","0","0","0","0","0","0","0","0","0","0","0"
"2007","Alberta","48","Methamphetamines (crystal meth), production","0","0","0","0","0","0","0","0","0","0","0","0","0","0"
"2008","Alberta","48","Methamphetamines (crystal meth), production","0","0","0","0","0","0","0","0","0","0","0","0","0","0"
"2009","Alberta","48","Methamphetamines (crystal meth), production","1","0","0","0","0.03","0","0","0","0","0","0","0","0","0"
"2010","Alberta","48","Methamphetamines (crystal meth), production","6","0","0","491.4","0.16","0","0","0","0","0","0","0","0","0"
"2011","Alberta","48","Methamphetamines (crystal meth), production","8","1","1","31.31","0.21","0.03","0.03","0","0","2","1","1","0","0"
"2012","Alberta","48","Methamphetamines (crystal meth), production","4","1","0","-51.17","0.1","0.07","0.06","0","0","1","2","2","0","0"
"2013","Alberta","48","Methamphetamines (crystal meth), production","6","1","0","45.65","0.15","0.03","0.03","0","0","1","1","1","0","0"
"2014","Alberta","48","Methamphetamines (crystal meth), production","5","0","0","-18.93","0.12","0","0","0","0","0","0","0","0","0"
"2015","Alberta","48","Methamphetamines (crystal meth), production","8","0","1","57.27","0.19","0","0","0","0","1","0","0","0","0"
"2016","Alberta","48","Methamphetamines (crystal meth), production","17","2","0","108.84","0.4","0.12","0.11","0","0","2","4","4","0","0"
"2005","Alberta","48","Methylenedioxyamphetamine (ecstasy), production","0","0","0","0","0","0","0","0","0","0","0","0","0","0"
"2006","Alberta","48","Methylenedioxyamphetamine (ecstasy), production","0","0","0","0","0","0","0","0","0","0","0","0","0","0"
"2007","Alberta","48","Methylenedioxyamphetamine (ecstasy), production","0","0","0","0","0","0","0","0","0","0","0","0","0","0"
"2008","Alberta","48","Methylenedioxyamphetamine (ecstasy), production","0","0","0","0","0","0","0","0","0","0","0","0","0","0"
"2009","Alberta","48","Methylenedioxyamphetamine (ecstasy), production","0","0","0","0","0","0","0","0","0","0","0","0","0","0"
"2010","Alberta","48","Methylenedioxyamphetamine (ecstasy), production","1","0","0","0","0.03","0","0","0","0","0","0","0","0","0"
"2011","Alberta","48","Methylenedioxyamphetamine (ecstasy), production","0","0","0","-100","0","0","0","0","0","0","0","0","0","0"
"2012","Alberta","48","Methylenedioxyamphetamine (ecstasy), production","0","0","0","0","0","0","0","0","0","0","0","0","0","0"
"2013","Alberta","48","Methylenedioxyamphetamine (ecstasy), production","4","0","0","0","0.1","0","0","0","0","0","0","0","0","0"
"2014","Alberta","48","Methylenedioxyamphetamine (ecstasy), production","0","0","1","-100","0","0","0","0","0","1","0","0","0","0"
"2015","Alberta","48","Methylenedioxyamphetamine (ecstasy), production","0","0","0","0","0","0","0","0","0","0","0","0","0","0"
"2016","Alberta","48","Methylenedioxyamphetamine (ecstasy), production","1","0","0","0","0.02","0","0","0","0","0","0","0","0","0"
"2005","Alberta","48","Precursor or equipment (crystal meth, ecstasy)","0","0","0","0","0","0","0","0","0","0","0","0","0","0"
"2006","Alberta","48","Precursor or equipment (crystal meth, ecstasy)","0","0","0","0","0","0","0","0","0","0","0","0","0","0"
"2007","Alberta","48","Precursor or equipment (crystal meth, ecstasy)","0","0","0","0","0","0","0","0","0","0","0","0","0","0"
"2008","Alberta","48","Precursor or equipment (crystal meth, ecstasy)","0","0","0","0","0","0","0","0","0","0","0","0","0","0"
"2009","Alberta","48","Precursor or equipment (crystal meth, ecstasy)","0","0","0","0","0","0","0","0","0","0","0","0","0","0"
"2010","Alberta","48","Precursor or equipment (crystal meth, ecstasy)","0","0","0","0","0","0","0","0","0","0","0","0","0","0"
"2011","Alberta","48","Precursor or equipment (crystal meth, ecstasy)","0","0","0","0","0","0","0","0","0","0","0","0","0","0"
"2012","Alberta","48","Precursor or equipment (crystal meth, ecstasy)","3","1","0","0","0.08","0.03","0.03","0","0","1","1","1","0","0"
"2013","Alberta","48","Precursor or equipment (crystal meth, ecstasy)","2","1","0","-35.27","0.05","0.03","0.03","0","0","1","1","1","0","0"
"2014","Alberta","48","Precursor or equipment (crystal meth, ecstasy)","4","0","1","94.56","0.1","0","0","0","0","1","0","0","0","0"
"2015","Alberta","48","Precursor or equipment (crystal meth, ecstasy)","3","0","0","-26.28","0.07","0","0","0","0","0","0","0","0","0"
"2016","Alberta","48","Precursor or equipment (crystal meth, ecstasy)","2","0","0","-34.48","0.05","0","0","0","0","0","0","0","0","0"
"1998","Alberta","48","Youth Criminal Justice Act","2927","1141","585","0","100.95","10.15","40.47","289.35","23.41","1726","217","971","754","61"
"1999","Alberta","48","Youth Criminal Justice Act","2973","1156","442","-0.28","100.67","11.23","40.37","281.93","16.65","1598","246","991","745","44"
"2000","Alberta","48","Youth Criminal Justice Act","2513","1011","484","-16.93","83.63","9.37","33.72","238.02","36.3","1495","210","846","636","97"
"2001","Alberta","48","Youth Criminal Justice Act","3979","1105","1008","55.59","130.12","10.68","34.58","237.23","33.63","2113","245","887","642","91"
"2002","Alberta","48","Youth Criminal Justice Act","3428","1246","606","-15.78","109.58","12.12","38.08","259.4","50.58","1852","286","1004","718","140"
"2003","Alberta","48","Youth Criminal Justice Act","1826","858","319","-47.65","57.36","6.3","23.88","175.65","49.73","1177","152","643","491","139"
"2004","Alberta","48","Youth Criminal Justice Act","1590","786","276","-14.43","49.08","7.74","24.96","176.13","34.87","1062","191","686","495","98"
"2005","Alberta","48","Youth Criminal Justice Act","1337","749","155","-18.01","40.24","9.84","24.92","160.01","25.02","904","250","704","454","71"
"2006","Alberta","48","Youth Criminal Justice Act","806","571","150","-41.46","23.56","6.43","19.77","141.76","11.84","721","169","576","407","34"
"2007","Alberta","48","Youth Criminal Justice Act","701","625","60","-15.32","19.95","6.2","20.35","154.04","13.94","685","168","610","442","40"
"2008","Alberta","48","Youth Criminal Justice Act","867","759","69","20.87","24.11","8.12","25.18","191.76","23.14","828","226","773","547","66"
"2009","Alberta","48","Youth Criminal Justice Act","1056","841","146","19.04","28.7","9.24","25.11","185.01","21.14","987","264","789","525","60"
"2010","Alberta","48","Youth Criminal Justice Act","1194","1093","108","11.45","31.99","9.09","27.1","212.68","25.21","1201","264","863","599","71"
"2011","Alberta","48","Youth Criminal Justice Act","1160","1070","91","-4.32","30.61","10","26.62","200.92","20.62","1161","295","860","565","58"
"2012","Alberta","48","Youth Criminal Justice Act","1118","966","102","-5.87","28.81","9.05","23.89","184.21","20.35","1068","274","790","516","57"
"2013","Alberta","48","Youth Criminal Justice Act","838","744","38","-27.22","20.97","5.54","17.57","152.03","11.09","782","173","598","425","31"
"2014","Alberta","48","Youth Criminal Justice Act","843","710","54","-2.14","20.52","2.92","15.19","156.77","15.43","764","94","531","437","43"
"2015","Alberta","48","Youth Criminal Justice Act","724","587","52","-15.58","17.32","3.52","13.1","125.17","11.09","639","115","465","350","31"
"2016","Alberta","48","Youth Criminal Justice Act","544","422","39","-26.16","12.79","3.01","9.23","82.33","10.6","461","100","333","233","30"
"1998","Alberta","48","Total other Federal Statutes","867","252","374","0","29.9","8.18","8.63","12.28","1.15","626","175","207","32","3"
"1999","Alberta","48","Total other Federal Statutes","967","341","196","9.5","32.74","13.15","11.89","1.51","1.89","537","288","292","4","5"
"2000","Alberta","48","Total other Federal Statutes","912","150","274","-7.31","30.35","8.08","7.49","2.62","0.37","424","181","188","7","1"
"2001","Alberta","48","Total other Federal Statutes","2685","173","1642","189.3","87.8","7.15","7.21","7.76","30.3","1815","164","185","21","82"
"2002","Alberta","48","Total other Federal Statutes","1623","98","961","-40.91","51.88","5.64","5.35","2.89","3.25","1059","133","141","8","9"
"2003","Alberta","48","Total other Federal Statutes","891","120","427","-46.05","27.99","4.48","4.42","3.94","12.52","547","108","119","11","35"
"2004","Alberta","48","Total other Federal Statutes","859","128","389","-5.26","26.52","8.39","8.04","4.98","16.37","517","207","221","14","46"
"2005","Alberta","48","Total other Federal Statutes","1089","149","498","23.62","32.78","9.37","9.03","5.99","9.52","647","238","255","17","27"
"2006","Alberta","48","Total other Federal Statutes","1264","268","588","12.71","36.94","8.6","11.53","38.31","22.99","856","226","336","110","66"
"2007","Alberta","48","Total other Federal Statutes","1822","458","836","40.34","51.85","11.88","19.21","88.52","33.11","1294","322","576","254","95"
"2008","Alberta","48","Total other Federal Statutes","1958","537","889","5.02","54.45","12.28","22.61","123.4","41.02","1426","342","694","352","117"
"2009","Alberta","48","Total other Federal Statutes","1617","413","521","-19.29","43.95","10.92","18.24","91.98","33.83","934","312","573","261","96"
"2010","Alberta","48","Total other Federal Statutes","1808","523","632","10.21","48.44","16.02","20.16","62.85","44.74","1155","465","642","177","126"
"2011","Alberta","48","Total other Federal Statutes","1451","376","561","-20.97","38.28","11.49","13.43","33.78","32.36","937","339","434","95","91"
"2012","Alberta","48","Total other Federal Statutes","1546","430","464","4.06","39.84","11.27","12.79","29.27","26.78","894","341","423","82","75"
"2013","Alberta","48","Total other Federal Statutes","1429","321","438","-10.25","35.76","8.58","9.67","21.82","12.52","759","268","329","61","35"
"2014","Alberta","48","Total other Federal Statutes","1454","282","421","-1.02","35.39","7.77","8.24","13.63","13.99","703","250","288","38","39"
"2015","Alberta","48","Total other Federal Statutes","1781","429","401","20.4","42.61","12.41","12.06","7.87","23.25","830","406","428","22","65"
"2016","Alberta","48","Total other Federal Statutes","1953","489","406","7.77","45.92","13.45","13.59","15.19","14.49","895","447","490","43","41"
"1998","Alberta","48","Bankruptcy Act","38","32","19","0","1.31","0.28","0.25","0","0","51","6","6","0","0"
"1999","Alberta","48","Bankruptcy Act","14","39","0","-63.83","0.47","0.32","0.29","0","0","39","7","7","0","0"
"2000","Alberta","48","Bankruptcy Act","16","14","4","12.32","0.53","0.18","0.16","0","0","18","4","4","0","0"
"2001","Alberta","48","Bankruptcy Act","4","7","8","-75.43","0.13","0.04","0.04","0","0","15","1","1","0","0"
"2002","Alberta","48","Bankruptcy Act","14","4","4","242.13","0.45","0.17","0.15","0","0","8","4","4","0","0"
"2003","Alberta","48","Bankruptcy Act","11","15","4","-22.79","0.35","0.41","0.37","0","0","19","10","10","0","0"
"2004","Alberta","48","Bankruptcy Act","3","7","0","-73.2","0.09","0.04","0.04","0","0","7","1","1","0","0"
"2005","Alberta","48","Bankruptcy Act","4","1","0","30.01","0.12","0.04","0.04","0","0","1","1","1","0","0"
"2006","Alberta","48","Bankruptcy Act","2","0","0","-51.45","0.06","0","0","0","0","0","0","0","0","0"
"2007","Alberta","48","Bankruptcy Act","3","4","0","46.04","0.09","0.11","0.1","0","0","4","3","3","0","0"
"2008","Alberta","48","Bankruptcy Act","2","0","0","-34.85","0.06","0","0","0","0","0","0","0","0","0"
"2009","Alberta","48","Bankruptcy Act","1","1","1","-51.13","0.03","0.03","0.03","0","0","2","1","1","0","0"
"2010","Alberta","48","Bankruptcy Act","2","0","0","97.13","0.05","0","0","0","0","0","0","0","0","0"
"2011","Alberta","48","Bankruptcy Act","5","1","0","146.2","0.13","0.03","0.03","0","0","1","1","1","0","0"
"2012","Alberta","48","Bankruptcy Act","4","1","0","-21.87","0.1","0.03","0.03","0","0","1","1","1","0","0"
"2013","Alberta","48","Bankruptcy Act","3","0","1","-27.17","0.08","0","0","0","0","1","0","0","0","0"
"2014","Alberta","48","Bankruptcy Act","9","0","0","191.85","0.22","0","0","0","0","0","0","0","0","0"
"2015","Alberta","48","Bankruptcy Act","3","2","1","-67.24","0.07","0.06","0.06","0","0","3","2","2","0","0"
"2016","Alberta","48","Bankruptcy Act","5","0","2","63.8","0.12","0","0","0","0","2","0","0","0","0"
"1998","Alberta","48","Income Tax Act","0","0","0","0","0","0","0","0","0","0","0","0","0","0"
"1999","Alberta","48","Income Tax Act","2","0","0","0","0.07","0","0","0","0","0","0","0","0","0"
"2000","Alberta","48","Income Tax Act","0","0","0","-100","0","0","0","0","0","0","0","0","0","0"
"2001","Alberta","48","Income Tax Act","0","0","0","0","0","0","0","0","0","0","0","0","0","0"
"2002","Alberta","48","Income Tax Act","1","0","0","0","0.03","0","0","0","0","0","0","0","0","0"
"2003","Alberta","48","Income Tax Act","1","0","1","-1.73","0.03","0","0","0","0","1","0","0","0","0"
"2004","Alberta","48","Income Tax Act","1","0","1","-1.73","0.03","0.04","0.04","0","0","1","1","1","0","0"
"2005","Alberta","48","Income Tax Act","3","0","0","192.53","0.09","0.04","0.04","0","0","0","1","1","0","0"
"2006","Alberta","48","Income Tax Act","7","0","3","126.57","0.2","0.08","0.07","0","0","3","2","2","0","0"
"2007","Alberta","48","Income Tax Act","5","0","10","-30.46","0.14","0.07","0.07","0","0","10","2","2","0","0"
"2008","Alberta","48","Income Tax Act","4","0","3","-21.82","0.11","0.07","0.07","0","0","3","2","2","0","0"
"2009","Alberta","48","Income Tax Act","0","0","0","-100","0","0","0","0","0","0","0","0","0","0"
"2010","Alberta","48","Income Tax Act","5","0","1","0","0.13","0","0","0","0","1","0","0","0","0"
"2011","Alberta","48","Income Tax Act","2","0","0","-60.61","0.05","0","0","0","0","0","0","0","0","0"
"2012","Alberta","48","Income Tax Act","1","0","2","-51.17","0.03","0","0","0","0","2","0","0","0","0"
"2013","Alberta","48","Income Tax Act","3","0","1","191.3","0.08","0","0","0","0","1","0","0","0","0"
"2014","Alberta","48","Income Tax Act","1","0","0","-67.57","0.02","0","0","0","0","0","0","0","0","0"
"2015","Alberta","48","Income Tax Act","3","0","0","194.88","0.07","0","0","0","0","0","0","0","0","0"
"2016","Alberta","48","Income Tax Act","2","0","0","-34.48","0.05","0","0","0","0","0","0","0","0","0"
"1998","Alberta","48","Canada Shipping Act","24","0","12","0","0.83","0","0","0","0","12","0","0","0","0"
"1999","Alberta","48","Canada Shipping Act","38","9","6","55.45","1.29","0.41","0.37","0","0","15","9","9","0","0"
"2000","Alberta","48","Canada Shipping Act","42","9","1","8.63","1.4","0.31","0.36","0.75","0","10","7","9","2","0"
"2001","Alberta","48","Canada Shipping Act","30","1","12","-29.81","0.98","0.04","0.04","0","0","13","1","1","0","0"
"2002","Alberta","48","Canada Shipping Act","92","0","70","199.77","2.94","0.17","0.15","0","1.45","70","4","4","0","4"
"2003","Alberta","48","Canada Shipping Act","123","4","100","31.38","3.86","0.66","0.59","0","2.5","104","16","16","0","7"
"2004","Alberta","48","Canada Shipping Act","77","4","47","-38.48","2.38","0.2","0.18","0","0","51","5","5","0","0"
"2005","Alberta","48","Canada Shipping Act","21","0","10","-73.41","0.63","0","0","0","1.06","10","0","0","0","3"
"2006","Alberta","48","Canada Shipping Act","25","2","9","15.6","0.73","0.08","0.07","0","0.7","11","2","2","0","2"
"2007","Alberta","48","Canada Shipping Act","27","3","21","5.15","0.77","0.15","0.13","0","0","24","4","4","0","0"
"2008","Alberta","48","Canada Shipping Act","51","0","47","84.6","1.42","0","0","0","0.35","47","0","0","0","1"
"2009","Alberta","48","Canada Shipping Act","25","3","7","-52.09","0.68","0.1","0.1","0","0","10","3","3","0","0"
"2010","Alberta","48","Canada Shipping Act","15","5","5","-40.86","0.4","0.24","0.22","0","0","10","7","7","0","0"
"2011","Alberta","48","Canada Shipping Act","30","2","7","96.96","0.79","0.07","0.06","0","0","9","2","2","0","0"
"2012","Alberta","48","Canada Shipping Act","29","8","13","-5.59","0.75","0.26","0.24","0","0","21","8","8","0","0"
"2013","Alberta","48","Canada Shipping Act","20","4","8","-33.03","0.5","0.13","0.12","0","0","12","4","4","0","0"
"2014","Alberta","48","Canada Shipping Act","85","3","56","313.45","2.07","0.06","0.06","0","0.36","59","2","2","0","1"
"2015","Alberta","48","Canada Shipping Act","13","4","6","-84.97","0.31","0.18","0.17","0","0.36","10","6","6","0","1"
"2016","Alberta","48","Canada Shipping Act","14","1","5","5.84","0.33","0.03","0.03","0","0.35","6","1","1","0","1"
"2004","Alberta","48","Canada Health Act","1","0","1","-83.62","0.03","0","0","0","0","1","0","0","0","0"
"2005","Alberta","48","Canada Health Act","2","1","0","95.02","0.06","0.04","0.04","0","0","1","1","1","0","0"
"2006","Alberta","48","Canada Health Act","3","2","0","45.65","0.09","0.08","0.07","0","0","2","2","2","0","0"
"2007","Alberta","48","Canada Health Act","3","3","0","-2.64","0.09","0.11","0.1","0","0","3","3","3","0","0"
"2008","Alberta","48","Canada Health Act","1","1","0","-67.42","0.03","0.04","0.03","0","0","1","1","1","0","0"
"2009","Alberta","48","Canada Health Act","4","0","3","290.94","0.11","0","0","0","0.35","3","0","0","0","1"
"2010","Alberta","48","Canada Health Act","1","1","0","-75.36","0.03","0","0","0","0","1","0","0","0","0"
"2011","Alberta","48","Canada Health Act","4","1","0","293.92","0.11","0","0","0","0","1","0","0","0","0"
"2012","Alberta","48","Canada Health Act","2","0","1","-51.17","0.05","0","0","0","0.36","1","0","0","0","1"
"2013","Alberta","48","Canada Health Act","2","0","0","-2.9","0.05","0","0","0","0","0","0","0","0","0"
"2014","Alberta","48","Canada Health Act","0","0","0","-100","0","0","0","0","0","0","0","0","0","0"
"2015","Alberta","48","Canada Health Act","1","0","0","0","0.02","0","0","0","0","0","0","0","0","0"
"2016","Alberta","48","Canada Health Act","0","0","0","-100","0","0","0","0","0","0","0","0","0","0"
"1998","Alberta","48","Canada Health Act","9","5","0","0","0.31","0.37","0.33","0","0","5","8","8","0","0"
"1999","Alberta","48","Canada Health Act","24","20","0","161.81","0.81","1.19","1.06","0","0","20","26","26","0","0"
"2000","Alberta","48","Canada Health Act","10","2","0","-59.05","0.33","0.09","0.08","0","0","2","2","2","0","0"
"2001","Alberta","48","Canada Health Act","19","11","1","86.7","0.62","0.61","0.55","0","0","12","14","14","0","0"
"2002","Alberta","48","Canada Health Act","1","0","0","-94.86","0.03","0","0","0","0","0","0","0","0","0"
"2003","Alberta","48","Canada Health Act","6","4","0","489.63","0.19","0.17","0.15","0","0","4","4","4","0","0"
"1998","Alberta","48","Customs Act","86","2","56","0","2.97","0","0","0","0","58","0","0","0","0"
"1999","Alberta","48","Customs Act","49","1","13","-44.06","1.66","0.05","0.04","0","0","14","1","1","0","0"
"2000","Alberta","48","Customs Act","55","0","10","10.31","1.83","0","0","0","0","10","0","0","0","0"
"2001","Alberta","48","Customs Act","51","0","12","-8.88","1.67","0","0","0","0","12","0","0","0","0"
"2002","Alberta","48","Customs Act","74","2","7","41.84","2.37","0.04","0.04","0","0","9","1","1","0","0"
"2003","Alberta","48","Customs Act","72","2","19","-4.38","2.26","0.17","0.15","0","0","21","4","4","0","0"
"2004","Alberta","48","Customs Act","55","4","19","-24.93","1.7","0.12","0.11","0","0","23","3","3","0","0"
"2005","Alberta","48","Customs Act","94","7","30","66.65","2.83","0.28","0.25","0","0","37","7","7","0","0"
"2006","Alberta","48","Customs Act","114","6","72","17.76","3.33","0.23","0.21","0","0.35","78","6","6","0","1"
"2007","Alberta","48","Customs Act","55","1","29","-53.03","1.57","0.04","0.03","0","0","30","1","1","0","0"
"2008","Alberta","48","Customs Act","33","2","17","-41.36","0.92","0.04","0.03","0","0","19","1","1","0","0"
"2009","Alberta","48","Customs Act","39","0","12","15.5","1.06","0","0","0","0","12","0","0","0","0"
"2010","Alberta","48","Customs Act","41","2","27","3.62","1.1","0.1","0.09","0","0.71","29","3","3","0","2"
"2011","Alberta","48","Customs Act","43","2","18","3.28","1.13","0.07","0.06","0","0","20","2","2","0","0"
"2012","Alberta","48","Customs Act","35","1","20","-20.5","0.9","0.03","0.03","0","0","21","1","1","0","0"
"2013","Alberta","48","Customs Act","29","0","20","-19.54","0.73","0","0","0","0","20","0","0","0","0"
"2014","Alberta","48","Customs Act","37","2","12","24.12","0.9","0.03","0.03","0","0","14","1","1","0","0"
"2015","Alberta","48","Customs Act","46","2","21","22.2","1.1","0.06","0.06","0","0.72","23","2","2","0","2"
"2016","Alberta","48","Customs Act","23","2","11","-50.86","0.54","0.03","0.03","0","0","13","1","1","0","0"
"1998","Alberta","48","Competition Act","0","0","0","0","0","0","0","0","0","0","0","0","0","0"
"1999","Alberta","48","Competition Act","0","0","0","0","0","0","0","0","0","0","0","0","0","0"
"2000","Alberta","48","Competition Act","1","1","0","0","0.03","0.09","0.08","0","0","1","2","2","0","0"
"2001","Alberta","48","Competition Act","6","0","1","489.59","0.2","0","0","0","0","1","0","0","0","0"
"2002","Alberta","48","Competition Act","3","0","0","-51.12","0.1","0","0","0","0","0","0","0","0","0"
"2003","Alberta","48","Competition Act","0","0","0","-100","0","0","0","0","0","0","0","0","0","0"
"2004","Alberta","48","Competition Act","0","0","0","0","0","0","0","0","0","0","0","0","0","0"
"2005","Alberta","48","Competition Act","0","0","0","0","0","0","0","0","0","0","0","0","0","0"
"2006","Alberta","48","Competition Act","1","1","0","0","0.03","0","0","0","0","1","0","0","0","0"
"2007","Alberta","48","Competition Act","0","0","0","-100","0","0","0","0","0","0","0","0","0","0"
"2008","Alberta","48","Competition Act","0","0","0","0","0","0","0","0","0","0","0","0","0","0"
"2009","Alberta","48","Competition Act","1","0","0","0","0.03","0","0","0","0","0","0","0","0","0"
"2010","Alberta","48","Competition Act","0","0","0","-100","0","0","0","0","0","0","0","0","0","0"
"2011","Alberta","48","Competition Act","0","0","0","0","0","0","0","0","0","0","0","0","0","0"
"2012","Alberta","48","Competition Act","0","0","0","0","0","0","0","0","0","0","0","0","0","0"
"2013","Alberta","48","Competition Act","0","0","0","0","0","0","0","0","0","0","0","0","0","0"
"2014","Alberta","48","Competition Act","0","0","0","0","0","0","0","0","0","0","0","0","0","0"
"2015","Alberta","48","Competition Act","0","0","0","0","0","0","0","0","0","0","0","0","0","0"
"2016","Alberta","48","Competition Act","0","0","0","0","0","0","0","0","0","0","0","0","0","0"
"1998","Alberta","48","Excise Act","39","14","7","0","1.35","0.33","0.29","0","0","21","7","7","0","0"
"1999","Alberta","48","Excise Act","24","3","6","-39.58","0.81","0.14","0.12","0","0","9","3","3","0","0"
"2000","Alberta","48","Excise Act","10","1","1","-59.05","0.33","0.04","0.04","0","0","2","1","1","0","0"
"2001","Alberta","48","Excise Act","22","4","9","116.18","0.72","0.17","0.16","0","0","13","4","4","0","0"
"2002","Alberta","48","Excise Act","24","5","4","6.64","0.77","0.21","0.19","0","0","9","5","5","0","0"
"2003","Alberta","48","Excise Act","18","5","5","-26.3","0.57","0.17","0.19","0.36","0","10","4","5","1","0"
"2004","Alberta","48","Excise Act","8","6","1","-56.32","0.25","0.2","0.22","0.36","0","7","5","6","1","0"
"2005","Alberta","48","Excise Act","16","2","4","95.02","0.48","0.04","0.07","0.35","0","6","1","2","1","0"
"2006","Alberta","48","Excise Act","16","4","2","-2.9","0.47","0.08","0.14","0.7","0","6","2","4","2","0"
"2007","Alberta","48","Excise Act","30","7","8","82.56","0.85","0.22","0.3","1.05","0","15","6","9","3","0"
"2008","Alberta","48","Excise Act","39","8","15","27.05","1.08","0.32","0.33","0.35","0","23","9","10","1","0"
"2009","Alberta","48","Excise Act","72","8","23","80.43","1.96","0.31","0.29","0","0.35","31","9","9","0","1"
"2010","Alberta","48","Excise Act","40","4","23","-45.24","1.07","0.17","0.16","0","0.71","27","5","5","0","2"
"2011","Alberta","48","Excise Act","21","1","17","-48.3","0.55","0.03","0.03","0","0","18","1","1","0","0"
"2012","Alberta","48","Excise Act","21","3","10","-2.33","0.54","0.07","0.06","0","0","13","2","2","0","0"
"2013","Alberta","48","Excise Act","7","1","4","-67.63","0.18","0.06","0.06","0","0","5","2","2","0","0"
"2014","Alberta","48","Excise Act","19","1","19","164.05","0.46","0.03","0.03","0","0","20","1","1","0","0"
"2015","Alberta","48","Excise Act","29","1","25","50.03","0.69","0.03","0.03","0","0","26","1","1","0","0"
"2016","Alberta","48","Excise Act","13","0","10","-55.94","0.31","0","0","0","0.35","10","0","0","0","1"
"1998","Alberta","48","Total Immigration and Refugee Protection Act","400","47","258","0","13.8","2.06","1.83","0","0.38","305","44","44","0","1"
"1999","Alberta","48","Total Immigration and Refugee Protection Act","305","108","147","-25.14","10.33","1.37","1.22","0","0.38","255","30","30","0","1"
"2000","Alberta","48","Total Immigration and Refugee Protection Act","182","28","72","-41.35","6.06","1.25","1.16","0.37","0.37","100","28","29","1","1"
"2001","Alberta","48","Total Immigration and Refugee Protection Act","130","12","36","-29.81","4.25","0.44","0.39","0","0","48","10","10","0","0"
"2002","Alberta","48","Total Immigration and Refugee Protection Act","116","7","30","-12.78","3.71","0.34","0.3","0","0.72","37","8","8","0","2"
"2003","Alberta","48","Total Immigration and Refugee Protection Act","96","11","20","-18.67","3.02","0.5","0.45","0","0","31","12","12","0","0"
"2004","Alberta","48","Total Immigration and Refugee Protection Act","145","23","18","48.43","4.48","0.85","0.76","0","0","41","21","21","0","0"
"2005","Alberta","48","Total Immigration and Refugee Protection Act","76","23","13","-48.89","2.29","0.98","0.89","0","0.7","36","25","25","0","2"
"2006","Alberta","48","Total Immigration and Refugee Protection Act","39","5","16","-50.17","1.14","0.19","0.17","0","0","21","5","5","0","0"
"2007","Alberta","48","Total Immigration and Refugee Protection Act","21","1","12","-47.57","0.6","0.04","0.03","0","0","13","1","1","0","0"
"2008","Alberta","48","Total Immigration and Refugee Protection Act","29","2","12","34.96","0.81","0","0","0","0","14","0","0","0","0"
"2009","Alberta","48","Total Immigration and Refugee Protection Act","29","0","10","-2.27","0.79","0","0","0","0","10","0","0","0","0"
"2010","Alberta","48","Total Immigration and Refugee Protection Act","33","1","25","12.16","0.88","0.03","0.03","0","0.36","26","1","1","0","1"
"2011","Alberta","48","Total Immigration and Refugee Protection Act","28","2","18","-16.44","0.74","0.07","0.06","0","0","20","2","2","0","0"
"2012","Alberta","48","Total Immigration and Refugee Protection Act","23","0","9","-19.77","0.59","0","0","0","0","9","0","0","0","0"
"2013","Alberta","48","Total Immigration and Refugee Protection Act","30","0","14","26.65","0.75","0","0","0","0","14","0","0","0","0"
"2014","Alberta","48","Total Immigration and Refugee Protection Act","32","2","12","3.77","0.78","0.06","0.06","0","0","14","2","2","0","0"
"2015","Alberta","48","Total Immigration and Refugee Protection Act","35","4","12","7.51","0.84","0.18","0.17","0","0","16","6","6","0","0"
"2016","Alberta","48","Total Immigration and Refugee Protection Act","18","1","12","-49.46","0.42","0.03","0.03","0","0","13","1","1","0","0"
"1998","Alberta","48","Firearms Act","0","0","0","0","0","0","0","0","0","0","0","0","0","0"
"1999","Alberta","48","Firearms Act","19","3","4","0","0.64","0.14","0.12","0","0","7","3","3","0","0"
"2000","Alberta","48","Firearms Act","69","3","6","256.91","2.3","0.13","0.12","0","0","9","3","3","0","0"
"2001","Alberta","48","Firearms Act","70","6","16","-0.31","2.29","0.22","0.23","0.37","1.85","22","5","6","1","5"
"2002","Alberta","48","Firearms Act","73","4","13","1.94","2.33","0.25","0.23","0","0.36","17","6","6","0","1"
"2003","Alberta","48","Firearms Act","79","12","17","6.35","2.48","0.29","0.3","0.36","1.07","29","7","8","1","3"
"2004","Alberta","48","Firearms Act","57","7","23","-29.1","1.76","0.49","0.44","0","2.85","30","12","12","0","8"
"2005","Alberta","48","Firearms Act","107","11","19","83.04","3.22","0.2","0.21","0.35","1.06","30","5","6","1","3"
"2006","Alberta","48","Firearms Act","134","2","33","21.6","3.92","0.04","0.03","0","2.44","35","1","1","0","7"
"2007","Alberta","48","Firearms Act","174","6","41","26.43","4.95","0.15","0.13","0","1.74","47","4","4","0","5"
"2008","Alberta","48","Firearms Act","201","10","61","12.89","5.59","0.29","0.26","0","5.26","71","8","8","0","15"
"2009","Alberta","48","Firearms Act","244","6","69","18.64","6.63","0.17","0.16","0","4.23","75","5","5","0","12"
"2010","Alberta","48","Firearms Act","239","5","89","-3.45","6.4","0.24","0.22","0","3.55","94","7","7","0","10"
"2011","Alberta","48","Firearms Act","232","7","63","-4.4","6.12","0.24","0.22","0","4.27","70","7","7","0","12"
"2012","Alberta","48","Firearms Act","267","3","53","12.4","6.88","0.03","0.09","0.71","1.07","56","1","3","2","3"
"2013","Alberta","48","Firearms Act","329","4","53","19.65","8.23","0.13","0.12","0","5.01","57","4","4","0","14"
"2014","Alberta","48","Firearms Act","320","5","63","-5.38","7.79","0.19","0.17","0","1.79","68","6","6","0","5"
"2015","Alberta","48","Firearms Act","394","7","44","21.02","9.43","0.18","0.17","0","1.79","51","6","6","0","5"
"2016","Alberta","48","Firearms Act","413","8","46","3.02","9.71","0.24","0.25","0.35","1.77","54","8","9","1","5"
"2002","Alberta","48","National Defence Act","0","0","0","0","0","0","0","0","0","0","0","0","0","0"
"2003","Alberta","48","National Defence Act","0","0","0","0","0","0","0","0","0","0","0","0","0","0"
"2004","Alberta","48","National Defence Act","0","0","0","0","0","0","0","0","0","0","0","0","0","0"
"2005","Alberta","48","National Defence Act","0","0","0","0","0","0","0","0","0","0","0","0","0","0"
"2006","Alberta","48","National Defence Act","0","0","0","0","0","0","0","0","0","0","0","0","0","0"
"2007","Alberta","48","National Defence Act","0","0","0","0","0","0","0","0","0","0","0","0","0","0"
"2008","Alberta","48","National Defence Act","0","0","0","0","0","0","0","0","0","0","0","0","0","0"
"2009","Alberta","48","National Defence Act","0","0","0","0","0","0","0","0","0","0","0","0","0","0"
"2010","Alberta","48","National Defence Act","0","0","0","0","0","0","0","0","0","0","0","0","0","0"
"2011","Alberta","48","National Defence Act","0","0","0","0","0","0","0","0","0","0","0","0","0","0"
"2012","Alberta","48","National Defence Act","0","0","0","0","0","0","0","0","0","0","0","0","0","0"
"2013","Alberta","48","National Defence Act","0","0","0","0","0","0","0","0","0","0","0","0","0","0"
"2014","Alberta","48","National Defence Act","0","0","0","0","0","0","0","0","0","0","0","0","0","0"
"2015","Alberta","48","National Defence Act","0","0","0","0","0","0","0","0","0","0","0","0","0","0"
"2016","Alberta","48","National Defence Act","1","0","1","0","0.02","0","0","0","0","1","0","0","0","0"
"1998","Alberta","48","Other federal statutes","271","152","22","0","9.35","5.14","5.92","12.28","0.77","174","110","142","32","2"
"1999","Alberta","48","Other federal statutes","492","158","20","78.24","16.66","9.54","8.68","1.51","1.51","178","209","213","4","4"
"2000","Alberta","48","Other federal statutes","527","92","180","5.27","17.54","5.98","5.5","1.5","0","272","134","138","4","0"
"2001","Alberta","48","Other federal statutes","2353","132","1547","338.74","76.95","5.62","5.81","7.39","28.45","1679","129","149","20","77"
"2002","Alberta","48","Other federal statutes","1225","76","833","-49.11","39.16","4.45","4.29","2.89","0.72","909","105","113","8","2"
"2003","Alberta","48","Other federal statutes","485","67","261","-61.09","15.24","2.11","2.23","3.22","8.94","328","51","60","9","25"
"2004","Alberta","48","Other federal statutes","512","77","279","3.74","15.81","6.44","6.26","4.63","13.52","356","159","172","13","38"
"2005","Alberta","48","Other federal statutes","766","104","422","45.88","23.06","7.75","7.5","5.29","6.7","526","197","212","15","19"
"2006","Alberta","48","Other federal statutes","923","246","453","17","26.98","7.84","10.78","37.62","19.51","699","206","314","108","56"
"2007","Alberta","48","Other federal statutes","1504","433","715","58.65","42.8","10.99","18.31","87.48","31.37","1148","298","549","251","90"
"2008","Alberta","48","Other federal statutes","1598","514","734","3.84","44.44","11.53","21.89","123.05","35.41","1248","321","672","351","101"
"2009","Alberta","48","Other federal statutes","1202","395","396","-26.48","32.67","10.29","17.66","91.98","28.9","791","294","555","261","82"
"2010","Alberta","48","Other federal statutes","1432","505","462","17.43","38.36","15.23","19.44","62.85","39.41","967","442","619","177","111"
"2011","Alberta","48","Other federal statutes","1086","360","438","-25.31","28.65","10.98","12.97","33.78","28.09","798","324","419","95","79"
"2012","Alberta","48","Other federal statutes","1164","414","356","4.68","29.99","10.84","12.34","28.56","25.35","770","328","408","80","71"
"2013","Alberta","48","Other federal statutes","1006","312","337","-16.08","25.17","8.26","9.37","21.82","7.51","649","258","319","61","21"
"2014","Alberta","48","Other federal statutes","951","269","259","-8.04","23.15","7.4","7.9","13.63","11.84","528","238","276","38","33"
"2015","Alberta","48","Other federal statutes","1257","409","292","29.92","30.07","11.71","11.41","7.87","20.39","701","383","405","22","57"
"2016","Alberta","48","Other federal statutes","1464","477","319","14.46","34.42","13.12","13.25","14.84","12.01","796","436","478","42","34"
"1998","Chestermere, Alberta, Royal Canadian Mounted Police, municipal","48005","Total, all violations","0","0","0","0","0","0","0","0","0","0","0","0","0","0"
"1999","Chestermere, Alberta, Royal Canadian Mounted Police, municipal","48005","Total, all violations","0","0","0","0","0","0","0","0","0","0","0","0","0","0"
"2000","Chestermere, Alberta, Royal Canadian Mounted Police, municipal","48005","Total, all violations","0","0","0","0","0","0","0","0","0","0","0","0","0","0"
"2001","Chestermere, Alberta, Royal Canadian Mounted Police, municipal","48005","Total, all violations","0","0","0","0","0","0","0","0","0","0","0","0","0","0"
"2002","Chestermere, Alberta, Royal Canadian Mounted Police, municipal","48005","Total, all violations","0","0","0","0","0","0","0","0","0","0","0","0","0","0"
"2003","Chestermere, Alberta, Royal Canadian Mounted Police, municipal","48005","Total, all violations","0","0","0","0","0","0","0","0","0","0","0","0","0","0"
"2004","Chestermere, Alberta, Royal Canadian Mounted Police, municipal","48005","Total, all violations","0","0","0","0","0","0","0","0","0","0","0","0","0","0"
"2005","Chestermere, Alberta, Royal Canadian Mounted Police, municipal","48005","Total, all violations","266","74","66","0","3070.88","1039.5","1117.08","1709.4","2197.8","140","65","79","14","18"
"2006","Chestermere, Alberta, Royal Canadian Mounted Police, municipal","48005","Total, all violations","829","131","218","159.82","7978.83","1378.56","1545.04","2758.62","6600.99","349","102","130","28","67"
"2007","Chestermere, Alberta, Royal Canadian Mounted Police, municipal","48005","Total, all violations","1117","115","477","23.21","9831.02","948.63","1074.45","2005.47","16590.7","592","77","99","22","182"
"2008","Chestermere, Alberta, Royal Canadian Mounted Police, municipal","48005","Total, all violations","1253","139","474","3.01","10126.89","1083.15","1085.55","1103.57","10865.87","613","96","109","13","128"
"2009","Chestermere, Alberta, Royal Canadian Mounted Police, municipal","48005","Total, all violations","1088","131","350","-20.02","8099.46","1035.09","1043.76","1110.23","9357.65","481","100","114","14","118"
"2010","Chestermere, Alberta, Royal Canadian Mounted Police, municipal","48005","Total, all violations","922","103","265","-21.04","6395.23","840.01","887.75","1251.84","7142.86","368","87","104","17","97"
"2011","Chestermere, Alberta, Royal Canadian Mounted Police, municipal","48005","Total, all violations","851","130","225","-13.51","5531","1005.53","1087.04","1739.13","5217.39","355","111","135","24","72"
"2012","Chestermere, Alberta, Royal Canadian Mounted Police, municipal","48005","Total, all violations","834","119","229","-4.85","5262.83","895.44","954.69","1440.92","6340.06","348","102","122","20","88"
"2013","Chestermere, Alberta, Royal Canadian Mounted Police, municipal","48005","Total, all violations","803","123","171","-6.96","4896.64","879.64","870.09","789.1","4304.16","294","104","115","11","60"
"2014","Chestermere, Alberta, Royal Canadian Mounted Police, municipal","48005","Total, all violations","854","96","183","2.99","5042.81","702.56","703.81","714.8","3431.02","279","86","96","10","48"
"2015","Chestermere, Alberta, Royal Canadian Mounted Police, municipal","48005","Total, all violations","1047","170","155","19.91","6046.78","1391.22","1321.84","707.71","2193.91","325","174","184","10","31"
"2016","Chestermere, Alberta, Royal Canadian Mounted Police, municipal","48005","Total, all violations","976","128","179","-9.06","5499.21","992.5","1011.16","1176.47","3321.8","307","127","144","17","48"
"1998","Chestermere, Alberta, Royal Canadian Mounted Police, municipal","48005","Total, all Criminal Code violations (including traffic)","0","0","0","0","0","0","0","0","0","0","0","0","0","0"
"1999","Chestermere, Alberta, Royal Canadian Mounted Police, municipal","48005","Total, all Criminal Code violations (including traffic)","0","0","0","0","0","0","0","0","0","0","0","0","0","0"
"2000","Chestermere, Alberta, Royal Canadian Mounted Police, municipal","48005","Total, all Criminal Code violations (including traffic)","0","0","0","0","0","0","0","0","0","0","0","0","0","0"
"2001","Chestermere, Alberta, Royal Canadian Mounted Police, municipal","48005","Total, all Criminal Code violations (including traffic)","0","0","0","0","0","0","0","0","0","0","0","0","0","0"
"2002","Chestermere, Alberta, Royal Canadian Mounted Police, municipal","48005","Total, all Criminal Code violations (including traffic)","0","0","0","0","0","0","0","0","0","0","0","0","0","0"
"2003","Chestermere, Alberta, Royal Canadian Mounted Police, municipal","48005","Total, all Criminal Code violations (including traffic)","0","0","0","0","0","0","0","0","0","0","0","0","0","0"
"2004","Chestermere, Alberta, Royal Canadian Mounted Police, municipal","48005","Total, all Criminal Code violations (including traffic)","0","0","0","0","0","0","0","0","0","0","0","0","0","0"
"2005","Chestermere, Alberta, Royal Canadian Mounted Police, municipal","48005","Total, all Criminal Code violations (including traffic)","252","69","60","0","2909.26","1007.52","1046.38","1343.1","1709.4","129","63","74","11","14"
"2006","Chestermere, Alberta, Royal Canadian Mounted Police, municipal","48005","Total, all Criminal Code violations (including traffic)","799","123","205","164.33","7690.09","1310.99","1461.85","2561.58","5123.15","328","97","123","26","52"
"2007","Chestermere, Alberta, Royal Canadian Mounted Police, municipal","48005","Total, all Criminal Code violations (including traffic)","1017","108","420","16.4","8950.89","862.39","987.63","1914.31","14038.29","528","70","91","21","154"
"2008","Chestermere, Alberta, Royal Canadian Mounted Police, municipal","48005","Total, all Criminal Code violations (including traffic)","1156","133","400","4.38","9342.92","1015.46","1015.84","1018.68","9677.42","533","90","102","12","114"
"2009","Chestermere, Alberta, Royal Canadian Mounted Police, municipal","48005","Total, all Criminal Code violations (including traffic)","996","118","303","-20.64","7414.58","900.53","878.96","713.72","6978.59","421","87","96","9","88"
"2010","Chestermere, Alberta, Royal Canadian Mounted Police, municipal","48005","Total, all Criminal Code violations (including traffic)","842","91","229","-21.23","5840.33","733.8","776.78","1104.57","5964.65","320","76","91","15","81"
"2011","Chestermere, Alberta, Royal Canadian Mounted Police, municipal","48005","Total, all Criminal Code violations (including traffic)","760","107","200","-15.42","4939.56","797.17","885.74","1594.2","4855.07","307","88","110","22","67"
"2012","Chestermere, Alberta, Royal Canadian Mounted Police, municipal","48005","Total, all Criminal Code violations (including traffic)","762","103","207","-2.65","4808.48","781.32","774.71","720.46","4899.14","310","89","99","10","68"
"2013","Chestermere, Alberta, Royal Canadian Mounted Police, municipal","48005","Total, all Criminal Code violations (including traffic)","741","107","149","-6.03","4518.57","752.77","749.04","717.36","3515.06","256","89","99","10","49"
"2014","Chestermere, Alberta, Royal Canadian Mounted Police, municipal","48005","Total, all Criminal Code violations (including traffic)","794","90","168","3.76","4688.51","653.54","637.83","500.36","3216.58","258","80","87","7","45"
"2015","Chestermere, Alberta, Royal Canadian Mounted Police, municipal","48005","Total, all Criminal Code violations (including traffic)","992","153","134","22.2","5729.14","1199.33","1120.69","424.63","1910.83","287","150","156","6","27"
"2016","Chestermere, Alberta, Royal Canadian Mounted Police, municipal","48005","Total, all Criminal Code violations (including traffic)","903","113","150","-11.19","5087.9","812.75","821.57","899.65","3044.98","263","104","117","13","44"
"1998","Chestermere, Alberta, Royal Canadian Mounted Police, municipal","48005","Total, all Criminal Code violations (excluding traffic)","0","0","0","0","0","0","0","0","0","0","0","0","0","0"
"1999","Chestermere, Alberta, Royal Canadian Mounted Police, municipal","48005","Total, all Criminal Code violations (excluding traffic)","0","0","0","0","0","0","0","0","0","0","0","0","0","0"
"2000","Chestermere, Alberta, Royal Canadian Mounted Police, municipal","48005","Total, all Criminal Code violations (excluding traffic)","0","0","0","0","0","0","0","0","0","0","0","0","0","0"
"2001","Chestermere, Alberta, Royal Canadian Mounted Police, municipal","48005","Total, all Criminal Code violations (excluding traffic)","0","0","0","0","0","0","0","0","0","0","0","0","0","0"
"2002","Chestermere, Alberta, Royal Canadian Mounted Police, municipal","48005","Total, all Criminal Code violations (excluding traffic)","0","0","0","0","0","0","0","0","0","0","0","0","0","0"
"2003","Chestermere, Alberta, Royal Canadian Mounted Police, municipal","48005","Total, all Criminal Code violations (excluding traffic)","0","0","0","0","0","0","0","0","0","0","0","0","0","0"
"2004","Chestermere, Alberta, Royal Canadian Mounted Police, municipal","48005","Total, all Criminal Code violations (excluding traffic)","0","0","0","0","0","0","0","0","0","0","0","0","0","0"
"2005","Chestermere, Alberta, Royal Canadian Mounted Police, municipal","48005","Total, all Criminal Code violations (excluding traffic)","234","55","59","0","2701.45","783.62","848.42","1343.1","1709.4","114","49","60","11","14"
"2006","Chestermere, Alberta, Royal Canadian Mounted Police, municipal","48005","Total, all Criminal Code violations (excluding traffic)","724","87","186","157.94","6968.24","770.37","986.45","2561.58","5123.15","273","57","83","26","52"
"2007","Chestermere, Alberta, Royal Canadian Mounted Police, municipal","48005","Total, all Criminal Code violations (excluding traffic)","917","90","361","15.82","8070.76","677.59","803.13","1732","13764.81","451","55","74","19","151"
"2008","Chestermere, Alberta, Royal Canadian Mounted Police, municipal","48005","Total, all Criminal Code violations (excluding traffic)","1009","117","340","1.04","8154.85","834.93","856.49","1018.68","9592.53","457","74","86","12","113"
"2009","Chestermere, Alberta, Royal Canadian Mounted Police, municipal","48005","Total, all Criminal Code violations (excluding traffic)","872","97","256","-20.4","6491.48","693.51","686.69","634.42","6661.38","353","67","75","8","84"
"2010","Chestermere, Alberta, Royal Canadian Mounted Police, municipal","48005","Total, all Criminal Code violations (excluding traffic)","752","76","194","-19.65","5216.06","588.97","640.2","1030.93","5891.02","270","61","75","14","80"
"2011","Chestermere, Alberta, Royal Canadian Mounted Police, municipal","48005","Total, all Criminal Code violations (excluding traffic)","656","81","170","-18.26","4263.62","570.7","668.33","1449.28","4782.61","251","63","83","20","66"
"2012","Chestermere, Alberta, Royal Canadian Mounted Police, municipal","48005","Total, all Criminal Code violations (excluding traffic)","646","71","178","-4.39","4076.48","509.17","524.3","648.41","4610.95","249","58","67","9","64"
"2013","Chestermere, Alberta, Royal Canadian Mounted Police, municipal","48005","Total, all Criminal Code violations (excluding traffic)","639","74","142","-4.41","3896.58","482.11","499.36","645.62","3443.33","216","57","66","9","48"
"2014","Chestermere, Alberta, Royal Canadian Mounted Police, municipal","48005","Total, all Criminal Code violations (excluding traffic)","711","65","163","7.75","4198.41","449.31","454.55","500.36","3216.58","228","55","62","7","45"
"2015","Chestermere, Alberta, Royal Canadian Mounted Police, municipal","48005","Total, all Criminal Code violations (excluding traffic)","908","106","132","24.9","5244.01","831.53","790.23","424.63","1910.83","238","104","110","6","27"
"2016","Chestermere, Alberta, Royal Canadian Mounted Police, municipal","48005","Total, all Criminal Code violations (excluding traffic)","851","82","149","-8.56","4794.91","562.68","596.87","899.65","3044.98","231","72","85","13","44"
"1998","Chestermere, Alberta, Royal Canadian Mounted Police, municipal","48005","Total violent Criminal Code violations","0","0","0","0","0","0","0","0","0","0","0","0","0","0"
"1999","Chestermere, Alberta, Royal Canadian Mounted Police, municipal","48005","Total violent Criminal Code violations","0","0","0","0","0","0","0","0","0","0","0","0","0","0"
"2000","Chestermere, Alberta, Royal Canadian Mounted Police, municipal","48005","Total violent Criminal Code violations","0","0","0","0","0","0","0","0","0","0","0","0","0","0"
"2001","Chestermere, Alberta, Royal Canadian Mounted Police, municipal","48005","Total violent Criminal Code violations","0","0","0","0","0","0","0","0","0","0","0","0","0","0"
"2002","Chestermere, Alberta, Royal Canadian Mounted Police, municipal","48005","Total violent Criminal Code violations","0","0","0","0","0","0","0","0","0","0","0","0","0","0"
"2003","Chestermere, Alberta, Royal Canadian Mounted Police, municipal","48005","Total violent Criminal Code violations","0","0","0","0","0","0","0","0","0","0","0","0","0","0"
"2004","Chestermere, Alberta, Royal Canadian Mounted Police, municipal","48005","Total violent Criminal Code violations","0","0","0","0","0","0","0","0","0","0","0","0","0","0"
"2005","Chestermere, Alberta, Royal Canadian Mounted Police, municipal","48005","Total violent Criminal Code violations","72","26","20","0","831.22","383.82","395.93","488.4","610.5","46","24","28","4","5"
"2006","Chestermere, Alberta, Royal Canadian Mounted Police, municipal","48005","Total violent Criminal Code violations","133","44","47","54","1280.08","418.98","439.74","591.13","1773.4","91","31","37","6","18"
"2007","Chestermere, Alberta, Royal Canadian Mounted Police, municipal","48005","Total violent Criminal Code violations","159","36","102","9.32","1399.4","332.64","358.15","546.95","4010.94","138","27","33","6","44"
"2008","Chestermere, Alberta, Royal Canadian Mounted Police, municipal","48005","Total violent Criminal Code violations","181","53","86","4.53","1462.86","394.9","418.29","594.23","2037.35","139","35","42","7","24"
"2009","Chestermere, Alberta, Royal Canadian Mounted Police, municipal","48005","Total violent Criminal Code violations","131","58","62","-33.34","975.21","351.93","320.45","79.3","1665.34","120","34","35","1","21"
"2010","Chestermere, Alberta, Royal Canadian Mounted Police, municipal","48005","Total violent Criminal Code violations","159","44","77","13.09","1102.86","366.9","367.05","368.19","1546.39","121","38","43","5","21"
"2011","Chestermere, Alberta, Royal Canadian Mounted Police, municipal","48005","Total violent Criminal Code violations","127","35","71","-25.16","825.43","262.7","265.72","289.86","1304.35","106","29","33","4","18"
"2012","Chestermere, Alberta, Royal Canadian Mounted Police, municipal","48005","Total violent Criminal Code violations","135","36","77","3.21","851.9","263.37","258.24","216.14","1224.78","113","30","33","3","17"
"2013","Chestermere, Alberta, Royal Canadian Mounted Police, municipal","48005","Total violent Criminal Code violations","108","39","44","-22.69","658.58","253.74","279.94","502.15","1147.78","83","30","37","7","16"
"2014","Chestermere, Alberta, Royal Canadian Mounted Police, municipal","48005","Total violent Criminal Code violations","84","28","39","-24.68","496.01","204.23","212.61","285.92","786.28","67","25","29","4","11"
"2015","Chestermere, Alberta, Royal Canadian Mounted Police, municipal","48005","Total violent Criminal Code violations","100","46","32","16.43","577.53","335.81","316.09","141.54","707.71","78","42","44","2","10"
"2016","Chestermere, Alberta, Royal Canadian Mounted Police, municipal","48005","Total violent Criminal Code violations","129","40","46","25.85","726.84","281.34","280.88","276.82","415.22","86","36","40","4","6"
"1998","Chestermere, Alberta, Royal Canadian Mounted Police, municipal","48005","Homicide","0","0","0","0","0","0","0","0","0","0","0","0","0","0"
"1999","Chestermere, Alberta, Royal Canadian Mounted Police, municipal","48005","Homicide","0","0","0","0","0","0","0","0","0","0","0","0","0","0"
"2000","Chestermere, Alberta, Royal Canadian Mounted Police, municipal","48005","Homicide","0","0","0","0","0","0","0","0","0","0","0","0","0","0"
"2001","Chestermere, Alberta, Royal Canadian Mounted Police, municipal","48005","Homicide","0","0","0","0","0","0","0","0","0","0","0","0","0","0"
"2002","Chestermere, Alberta, Royal Canadian Mounted Police, municipal","48005","Homicide","0","0","0","0","0","0","0","0","0","0","0","0","0","0"
"2003","Chestermere, Alberta, Royal Canadian Mounted Police, municipal","48005","Homicide","0","0","0","0","0","0","0","0","0","0","0","0","0","0"
"2004","Chestermere, Alberta, Royal Canadian Mounted Police, municipal","48005","Homicide","0","0","0","0","0","0","0","0","0","0","0","0","0","0"
"2005","Chestermere, Alberta, Royal Canadian Mounted Police, municipal","48005","Homicide","0","0","0","0","0","0","0","0","0","0","0","0","0","0"
"2006","Chestermere, Alberta, Royal Canadian Mounted Police, municipal","48005","Homicide","0","0","0","0","0","0","0","0","0","0","0","0","0","0"
"2007","Chestermere, Alberta, Royal Canadian Mounted Police, municipal","48005","Homicide","1","0","0","0","8.8","0","0","0","0","0","0","0","0","0"
"2008","Chestermere, Alberta, Royal Canadian Mounted Police, municipal","48005","Homicide","1","0","0","-8.17","8.08","0","0","0","0","0","0","0","0","0"
"2009","Chestermere, Alberta, Royal Canadian Mounted Police, municipal","48005","Homicide","0","0","0","-100","0","0","0","0","0","0","0","0","0","0"
"2010","Chestermere, Alberta, Royal Canadian Mounted Police, municipal","48005","Homicide","0","0","0","0","0","0","0","0","0","0","0","0","0","0"
"2011","Chestermere, Alberta, Royal Canadian Mounted Police, municipal","48005","Homicide","0","0","0","0","0","0","0","0","0","0","0","0","0","0"
"2012","Chestermere, Alberta, Royal Canadian Mounted Police, municipal","48005","Homicide","0","0","0","0","0","0","0","0","0","0","0","0","0","0"
"2013","Chestermere, Alberta, Royal Canadian Mounted Police, municipal","48005","Homicide","0","0","0","0","0","0","0","0","0","0","0","0","0","0"
"2014","Chestermere, Alberta, Royal Canadian Mounted Police, municipal","48005","Homicide","0","0","0","0","0","0","0","0","0","0","0","0","0","0"
"2015","Chestermere, Alberta, Royal Canadian Mounted Police, municipal","48005","Homicide","0","0","0","0","0","0","0","0","0","0","0","0","0","0"
"2016","Chestermere, Alberta, Royal Canadian Mounted Police, municipal","48005","Homicide","0","0","0","0","0","0","0","0","0","0","0","0","0","0"
"1998","Chestermere, Alberta, Royal Canadian Mounted Police, municipal","48005","Murder, first degree","0","0","0","0","0","0","0","0","0","0","0","0","0","0"
"1999","Chestermere, Alberta, Royal Canadian Mounted Police, municipal","48005","Murder, first degree","0","0","0","0","0","0","0","0","0","0","0","0","0","0"
"2000","Chestermere, Alberta, Royal Canadian Mounted Police, municipal","48005","Murder, first degree","0","0","0","0","0","0","0","0","0","0","0","0","0","0"
"2001","Chestermere, Alberta, Royal Canadian Mounted Police, municipal","48005","Murder, first degree","0","0","0","0","0","0","0","0","0","0","0","0","0","0"
"2002","Chestermere, Alberta, Royal Canadian Mounted Police, municipal","48005","Murder, first degree","0","0","0","0","0","0","0","0","0","0","0","0","0","0"
"2003","Chestermere, Alberta, Royal Canadian Mounted Police, municipal","48005","Murder, first degree","0","0","0","0","0","0","0","0","0","0","0","0","0","0"
"2004","Chestermere, Alberta, Royal Canadian Mounted Police, municipal","48005","Murder, first degree","0","0","0","0","0","0","0","0","0","0","0","0","0","0"
"2005","Chestermere, Alberta, Royal Canadian Mounted Police, municipal","48005","Murder, first degree","0","0","0","0","0","0","0","0","0","0","0","0","0","0"
"2006","Chestermere, Alberta, Royal Canadian Mounted Police, municipal","48005","Murder, first degree","0","0","0","0","0","0","0","0","0","0","0","0","0","0"
"2007","Chestermere, Alberta, Royal Canadian Mounted Police, municipal","48005","Murder, first degree","0","0","0","0","0","0","0","0","0","0","0","0","0","0"
"2008","Chestermere, Alberta, Royal Canadian Mounted Police, municipal","48005","Murder, first degree","1","0","0","0","8.08","0","0","0","0","0","0","0","0","0"
"2009","Chestermere, Alberta, Royal Canadian Mounted Police, municipal","48005","Murder, first degree","0","0","0","-100","0","0","0","0","0","0","0","0","0","0"
"2010","Chestermere, Alberta, Royal Canadian Mounted Police, municipal","48005","Murder, first degree","0","0","0","0","0","0","0","0","0","0","0","0","0","0"
"2011","Chestermere, Alberta, Royal Canadian Mounted Police, municipal","48005","Murder, first degree","0","0","0","0","0","0","0","0","0","0","0","0","0","0"
"2012","Chestermere, Alberta, Royal Canadian Mounted Police, municipal","48005","Murder, first degree","0","0","0","0","0","0","0","0","0","0","0","0","0","0"
"2013","Chestermere, Alberta, Royal Canadian Mounted Police, municipal","48005","Murder, first degree","0","0","0","0","0","0","0","0","0","0","0","0","0","0"
"2014","Chestermere, Alberta, Royal Canadian Mounted Police, municipal","48005","Murder, first degree","0","0","0","0","0","0","0","0","0","0","0","0","0","0"
"2015","Chestermere, Alberta, Royal Canadian Mounted Police, municipal","48005","Murder, first degree","0","0","0","0","0","0","0","0","0","0","0","0","0","0"
"2016","Chestermere, Alberta, Royal Canadian Mounted Police, municipal","48005","Murder, first degree","0","0","0","0","0","0","0","0","0","0","0","0","0","0"
"1998","Chestermere, Alberta, Royal Canadian Mounted Police, municipal","48005","Murder, second degree","0","0","0","0","0","0","0","0","0","0","0","0","0","0"
"1999","Chestermere, Alberta, Royal Canadian Mounted Police, municipal","48005","Murder, second degree","0","0","0","0","0","0","0","0","0","0","0","0","0","0"
"2000","Chestermere, Alberta, Royal Canadian Mounted Police, municipal","48005","Murder, second degree","0","0","0","0","0","0","0","0","0","0","0","0","0","0"
"2001","Chestermere, Alberta, Royal Canadian Mounted Police, municipal","48005","Murder, second degree","0","0","0","0","0","0","0","0","0","0","0","0","0","0"
"2002","Chestermere, Alberta, Royal Canadian Mounted Police, municipal","48005","Murder, second degree","0","0","0","0","0","0","0","0","0","0","0","0","0","0"
"2003","Chestermere, Alberta, Royal Canadian Mounted Police, municipal","48005","Murder, second degree","0","0","0","0","0","0","0","0","0","0","0","0","0","0"
"2004","Chestermere, Alberta, Royal Canadian Mounted Police, municipal","48005","Murder, second degree","0","0","0","0","0","0","0","0","0","0","0","0","0","0"
"2005","Chestermere, Alberta, Royal Canadian Mounted Police, municipal","48005","Murder, second degree","0","0","0","0","0","0","0","0","0","0","0","0","0","0"
"2006","Chestermere, Alberta, Royal Canadian Mounted Police, municipal","48005","Murder, second degree","0","0","0","0","0","0","0","0","0","0","0","0","0","0"
"2007","Chestermere, Alberta, Royal Canadian Mounted Police, municipal","48005","Murder, second degree","1","0","0","0","8.8","0","0","0","0","0","0","0","0","0"
"2008","Chestermere, Alberta, Royal Canadian Mounted Police, municipal","48005","Murder, second degree","0","0","0","-100","0","0","0","0","0","0","0","0","0","0"
"2009","Chestermere, Alberta, Royal Canadian Mounted Police, municipal","48005","Murder, second degree","0","0","0","0","0","0","0","0","0","0","0","0","0","0"
"2010","Chestermere, Alberta, Royal Canadian Mounted Police, municipal","48005","Murder, second degree","0","0","0","0","0","0","0","0","0","0","0","0","0","0"
"2011","Chestermere, Alberta, Royal Canadian Mounted Police, municipal","48005","Murder, second degree","0","0","0","0","0","0","0","0","0","0","0","0","0","0"
"2012","Chestermere, Alberta, Royal Canadian Mounted Police, municipal","48005","Murder, second degree","0","0","0","0","0","0","0","0","0","0","0","0","0","0"
"2013","Chestermere, Alberta, Royal Canadian Mounted Police, municipal","48005","Murder, second degree","0","0","0","0","0","0","0","0","0","0","0","0","0","0"
"2014","Chestermere, Alberta, Royal Canadian Mounted Police, municipal","48005","Murder, second degree","0","0","0","0","0","0","0","0","0","0","0","0","0","0"
"2015","Chestermere, Alberta, Royal Canadian Mounted Police, municipal","48005","Murder, second degree","0","0","0","0","0","0","0","0","0","0","0","0","0","0"
"2016","Chestermere, Alberta, Royal Canadian Mounted Police, municipal","48005","Murder, second degree","0","0","0","0","0","0","0","0","0","0","0","0","0","0"
"1998","Chestermere, Alberta, Royal Canadian Mounted Police, municipal","48005","Manslaughter","0","0","0","0","0","0","0","0","0","0","0","0","0","0"
"1999","Chestermere, Alberta, Royal Canadian Mounted Police, municipal","48005","Manslaughter","0","0","0","0","0","0","0","0","0","0","0","0","0","0"
"2000","Chestermere, Alberta, Royal Canadian Mounted Police, municipal","48005","Manslaughter","0","0","0","0","0","0","0","0","0","0","0","0","0","0"
"2001","Chestermere, Alberta, Royal Canadian Mounted Police, municipal","48005","Manslaughter","0","0","0","0","0","0","0","0","0","0","0","0","0","0"
"2002","Chestermere, Alberta, Royal Canadian Mounted Police, municipal","48005","Manslaughter","0","0","0","0","0","0","0","0","0","0","0","0","0","0"
"2003","Chestermere, Alberta, Royal Canadian Mounted Police, municipal","48005","Manslaughter","0","0","0","0","0","0","0","0","0","0","0","0","0","0"
"2004","Chestermere, Alberta, Royal Canadian Mounted Police, municipal","48005","Manslaughter","0","0","0","0","0","0","0","0","0","0","0","0","0","0"
"2005","Chestermere, Alberta, Royal Canadian Mounted Police, municipal","48005","Manslaughter","0","0","0","0","0","0","0","0","0","0","0","0","0","0"
"2006","Chestermere, Alberta, Royal Canadian Mounted Police, municipal","48005","Manslaughter","0","0","0","0","0","0","0","0","0","0","0","0","0","0"
"2007","Chestermere, Alberta, Royal Canadian Mounted Police, municipal","48005","Manslaughter","0","0","0","0","0","0","0","0","0","0","0","0","0","0"
"2008","Chestermere, Alberta, Royal Canadian Mounted Police, municipal","48005","Manslaughter","0","0","0","0","0","0","0","0","0","0","0","0","0","0"
"2009","Chestermere, Alberta, Royal Canadian Mounted Police, municipal","48005","Manslaughter","0","0","0","0","0","0","0","0","0","0","0","0","0","0"
"2010","Chestermere, Alberta, Royal Canadian Mounted Police, municipal","48005","Manslaughter","0","0","0","0","0","0","0","0","0","0","0","0","0","0"
"2011","Chestermere, Alberta, Royal Canadian Mounted Police, municipal","48005","Manslaughter","0","0","0","0","0","0","0","0","0","0","0","0","0","0"
"2012","Chestermere, Alberta, Royal Canadian Mounted Police, municipal","48005","Manslaughter","0","0","0","0","0","0","0","0","0","0","0","0","0","0"
"2013","Chestermere, Alberta, Royal Canadian Mounted Police, municipal","48005","Manslaughter","0","0","0","0","0","0","0","0","0","0","0","0","0","0"
"2014","Chestermere, Alberta, Royal Canadian Mounted Police, municipal","48005","Manslaughter","0","0","0","0","0","0","0","0","0","0","0","0","0","0"
"2015","Chestermere, Alberta, Royal Canadian Mounted Police, municipal","48005","Manslaughter","0","0","0","0","0","0","0","0","0","0","0","0","0","0"
"2016","Chestermere, Alberta, Royal Canadian Mounted Police, municipal","48005","Manslaughter","0","0","0","0","0","0","0","0","0","0","0","0","0","0"
"1998","Chestermere, Alberta, Royal Canadian Mounted Police, municipal","48005","Infanticide","0","0","0","0","0","0","0","0","0","0","0","0","0","0"
"1999","Chestermere, Alberta, Royal Canadian Mounted Police, municipal","48005","Infanticide","0","0","0","0","0","0","0","0","0","0","0","0","0","0"
"2000","Chestermere, Alberta, Royal Canadian Mounted Police, municipal","48005","Infanticide","0","0","0","0","0","0","0","0","0","0","0","0","0","0"
"2001","Chestermere, Alberta, Royal Canadian Mounted Police, municipal","48005","Infanticide","0","0","0","0","0","0","0","0","0","0","0","0","0","0"
"2002","Chestermere, Alberta, Royal Canadian Mounted Police, municipal","48005","Infanticide","0","0","0","0","0","0","0","0","0","0","0","0","0","0"
"2003","Chestermere, Alberta, Royal Canadian Mounted Police, municipal","48005","Infanticide","0","0","0","0","0","0","0","0","0","0","0","0","0","0"
"2004","Chestermere, Alberta, Royal Canadian Mounted Police, municipal","48005","Infanticide","0","0","0","0","0","0","0","0","0","0","0","0","0","0"
"2005","Chestermere, Alberta, Royal Canadian Mounted Police, municipal","48005","Infanticide","0","0","0","0","0","0","0","0","0","0","0","0","0","0"
"2006","Chestermere, Alberta, Royal Canadian Mounted Police, municipal","48005","Infanticide","0","0","0","0","0","0","0","0","0","0","0","0","0","0"
"2007","Chestermere, Alberta, Royal Canadian Mounted Police, municipal","48005","Infanticide","0","0","0","0","0","0","0","0","0","0","0","0","0","0"
"2008","Chestermere, Alberta, Royal Canadian Mounted Police, municipal","48005","Infanticide","0","0","0","0","0","0","0","0","0","0","0","0","0","0"
"2009","Chestermere, Alberta, Royal Canadian Mounted Police, municipal","48005","Infanticide","0","0","0","0","0","0","0","0","0","0","0","0","0","0"
"2010","Chestermere, Alberta, Royal Canadian Mounted Police, municipal","48005","Infanticide","0","0","0","0","0","0","0","0","0","0","0","0","0","0"
"2011","Chestermere, Alberta, Royal Canadian Mounted Police, municipal","48005","Infanticide","0","0","0","0","0","0","0","0","0","0","0","0","0","0"
"2012","Chestermere, Alberta, Royal Canadian Mounted Police, municipal","48005","Infanticide","0","0","0","0","0","0","0","0","0","0","0","0","0","0"
"2013","Chestermere, Alberta, Royal Canadian Mounted Police, municipal","48005","Infanticide","0","0","0","0","0","0","0","0","0","0","0","0","0","0"
"2014","Chestermere, Alberta, Royal Canadian Mounted Police, municipal","48005","Infanticide","0","0","0","0","0","0","0","0","0","0","0","0","0","0"
"2015","Chestermere, Alberta, Royal Canadian Mounted Police, municipal","48005","Infanticide","0","0","0","0","0","0","0","0","0","0","0","0","0","0"
"2016","Chestermere, Alberta, Royal Canadian Mounted Police, municipal","48005","Infanticide","0","0","0","0","0","0","0","0","0","0","0","0","0","0"
"1998","Chestermere, Alberta, Royal Canadian Mounted Police, municipal","48005","Total other violations causing death","0","0","0","0","0","0","0","0","0","0","0","0","0","0"
"1999","Chestermere, Alberta, Royal Canadian Mounted Police, municipal","48005","Total other violations causing death","0","0","0","0","0","0","0","0","0","0","0","0","0","0"
"2000","Chestermere, Alberta, Royal Canadian Mounted Police, municipal","48005","Total other violations causing death","0","0","0","0","0","0","0","0","0","0","0","0","0","0"
"2001","Chestermere, Alberta, Royal Canadian Mounted Police, municipal","48005","Total other violations causing death","0","0","0","0","0","0","0","0","0","0","0","0","0","0"
"2002","Chestermere, Alberta, Royal Canadian Mounted Police, municipal","48005","Total other violations causing death","0","0","0","0","0","0","0","0","0","0","0","0","0","0"
"2003","Chestermere, Alberta, Royal Canadian Mounted Police, municipal","48005","Total other violations causing death","0","0","0","0","0","0","0","0","0","0","0","0","0","0"
"2004","Chestermere, Alberta, Royal Canadian Mounted Police, municipal","48005","Total other violations causing death","0","0","0","0","0","0","0","0","0","0","0","0","0","0"
"2005","Chestermere, Alberta, Royal Canadian Mounted Police, municipal","48005","Total other violations causing death","0","0","0","0","0","0","0","0","0","0","0","0","0","0"
"2006","Chestermere, Alberta, Royal Canadian Mounted Police, municipal","48005","Total other violations causing death","0","0","0","0","0","0","0","0","0","0","0","0","0","0"
"2007","Chestermere, Alberta, Royal Canadian Mounted Police, municipal","48005","Total other violations causing death","0","0","0","0","0","0","0","0","0","0","0","0","0","0"
"2008","Chestermere, Alberta, Royal Canadian Mounted Police, municipal","48005","Total other violations causing death","0","0","0","0","0","0","0","0","0","0","0","0","0","0"
"2009","Chestermere, Alberta, Royal Canadian Mounted Police, municipal","48005","Total other violations causing death","0","0","0","0","0","0","0","0","0","0","0","0","0","0"
"2010","Chestermere, Alberta, Royal Canadian Mounted Police, municipal","48005","Total other violations causing death","0","0","0","0","0","0","0","0","0","0","0","0","0","0"
"2011","Chestermere, Alberta, Royal Canadian Mounted Police, municipal","48005","Total other violations causing death","0","0","0","0","0","0","0","0","0","0","0","0","0","0"
"2012","Chestermere, Alberta, Royal Canadian Mounted Police, municipal","48005","Total other violations causing death","0","0","0","0","0","0","0","0","0","0","0","0","0","0"
"2013","Chestermere, Alberta, Royal Canadian Mounted Police, municipal","48005","Total other violations causing death","0","0","0","0","0","0","0","0","0","0","0","0","0","0"
"2014","Chestermere, Alberta, Royal Canadian Mounted Police, municipal","48005","Total other violations causing death","0","0","0","0","0","0","0","0","0","0","0","0","0","0"
"2015","Chestermere, Alberta, Royal Canadian Mounted Police, municipal","48005","Total other violations causing death","0","0","0","0","0","0","0","0","0","0","0","0","0","0"
"2016","Chestermere, Alberta, Royal Canadian Mounted Police, municipal","48005","Total other violations causing death","0","0","0","0","0","0","0","0","0","0","0","0","0","0"
"1998","Chestermere, Alberta, Royal Canadian Mounted Police, municipal","48005","Criminal negligence causing death","0","0","0","0","0","0","0","0","0","0","0","0","0","0"
"1999","Chestermere, Alberta, Royal Canadian Mounted Police, municipal","48005","Criminal negligence causing death","0","0","0","0","0","0","0","0","0","0","0","0","0","0"
"2000","Chestermere, Alberta, Royal Canadian Mounted Police, municipal","48005","Criminal negligence causing death","0","0","0","0","0","0","0","0","0","0","0","0","0","0"
"2001","Chestermere, Alberta, Royal Canadian Mounted Police, municipal","48005","Criminal negligence causing death","0","0","0","0","0","0","0","0","0","0","0","0","0","0"
"2002","Chestermere, Alberta, Royal Canadian Mounted Police, municipal","48005","Criminal negligence causing death","0","0","0","0","0","0","0","0","0","0","0","0","0","0"
"2003","Chestermere, Alberta, Royal Canadian Mounted Police, municipal","48005","Criminal negligence causing death","0","0","0","0","0","0","0","0","0","0","0","0","0","0"
"2004","Chestermere, Alberta, Royal Canadian Mounted Police, municipal","48005","Criminal negligence causing death","0","0","0","0","0","0","0","0","0","0","0","0","0","0"
"2005","Chestermere, Alberta, Royal Canadian Mounted Police, municipal","48005","Criminal negligence causing death","0","0","0","0","0","0","0","0","0","0","0","0","0","0"
"2006","Chestermere, Alberta, Royal Canadian Mounted Police, municipal","48005","Criminal negligence causing death","0","0","0","0","0","0","0","0","0","0","0","0","0","0"
"2007","Chestermere, Alberta, Royal Canadian Mounted Police, municipal","48005","Criminal negligence causing death","0","0","0","0","0","0","0","0","0","0","0","0","0","0"
"2008","Chestermere, Alberta, Royal Canadian Mounted Police, municipal","48005","Criminal negligence causing death","0","0","0","0","0","0","0","0","0","0","0","0","0","0"
"2009","Chestermere, Alberta, Royal Canadian Mounted Police, municipal","48005","Criminal negligence causing death","0","0","0","0","0","0","0","0","0","0","0","0","0","0"
"2010","Chestermere, Alberta, Royal Canadian Mounted Police, municipal","48005","Criminal negligence causing death","0","0","0","0","0","0","0","0","0","0","0","0","0","0"
"2011","Chestermere, Alberta, Royal Canadian Mounted Police, municipal","48005","Criminal negligence causing death","0","0","0","0","0","0","0","0","0","0","0","0","0","0"
"2012","Chestermere, Alberta, Royal Canadian Mounted Police, municipal","48005","Criminal negligence causing death","0","0","0","0","0","0","0","0","0","0","0","0","0","0"
"2013","Chestermere, Alberta, Royal Canadian Mounted Police, municipal","48005","Criminal negligence causing death","0","0","0","0","0","0","0","0","0","0","0","0","0","0"
"2014","Chestermere, Alberta, Royal Canadian Mounted Police, municipal","48005","Criminal negligence causing death","0","0","0","0","0","0","0","0","0","0","0","0","0","0"
"2015","Chestermere, Alberta, Royal Canadian Mounted Police, municipal","48005","Criminal negligence causing death","0","0","0","0","0","0","0","0","0","0","0","0","0","0"
"2016","Chestermere, Alberta, Royal Canadian Mounted Police, municipal","48005","Criminal negligence causing death","0","0","0","0","0","0","0","0","0","0","0","0","0","0"
"1998","Chestermere, Alberta, Royal Canadian Mounted Police, municipal","48005","Other related violations causing death","0","0","0","0","0","0","0","0","0","0","0","0","0","0"
"1999","Chestermere, Alberta, Royal Canadian Mounted Police, municipal","48005","Other related violations causing death","0","0","0","0","0","0","0","0","0","0","0","0","0","0"
"2000","Chestermere, Alberta, Royal Canadian Mounted Police, municipal","48005","Other related violations causing death","0","0","0","0","0","0","0","0","0","0","0","0","0","0"
"2001","Chestermere, Alberta, Royal Canadian Mounted Police, municipal","48005","Other related violations causing death","0","0","0","0","0","0","0","0","0","0","0","0","0","0"
"2002","Chestermere, Alberta, Royal Canadian Mounted Police, municipal","48005","Other related violations causing death","0","0","0","0","0","0","0","0","0","0","0","0","0","0"
"2003","Chestermere, Alberta, Royal Canadian Mounted Police, municipal","48005","Other related violations causing death","0","0","0","0","0","0","0","0","0","0","0","0","0","0"
"2004","Chestermere, Alberta, Royal Canadian Mounted Police, municipal","48005","Other related violations causing death","0","0","0","0","0","0","0","0","0","0","0","0","0","0"
"2005","Chestermere, Alberta, Royal Canadian Mounted Police, municipal","48005","Other related violations causing death","0","0","0","0","0","0","0","0","0","0","0","0","0","0"
"2006","Chestermere, Alberta, Royal Canadian Mounted Police, municipal","48005","Other related violations causing death","0","0","0","0","0","0","0","0","0","0","0","0","0","0"
"2007","Chestermere, Alberta, Royal Canadian Mounted Police, municipal","48005","Other related violations causing death","0","0","0","0","0","0","0","0","0","0","0","0","0","0"
"2008","Chestermere, Alberta, Royal Canadian Mounted Police, municipal","48005","Other related violations causing death","0","0","0","0","0","0","0","0","0","0","0","0","0","0"
"2009","Chestermere, Alberta, Royal Canadian Mounted Police, municipal","48005","Other related violations causing death","0","0","0","0","0","0","0","0","0","0","0","0","0","0"
"2010","Chestermere, Alberta, Royal Canadian Mounted Police, municipal","48005","Other related violations causing death","0","0","0","0","0","0","0","0","0","0","0","0","0","0"
"2011","Chestermere, Alberta, Royal Canadian Mounted Police, municipal","48005","Other related violations causing death","0","0","0","0","0","0","0","0","0","0","0","0","0","0"
"2012","Chestermere, Alberta, Royal Canadian Mounted Police, municipal","48005","Other related violations causing death","0","0","0","0","0","0","0","0","0","0","0","0","0","0"
"2013","Chestermere, Alberta, Royal Canadian Mounted Police, municipal","48005","Other related violations causing death","0","0","0","0","0","0","0","0","0","0","0","0","0","0"
"2014","Chestermere, Alberta, Royal Canadian Mounted Police, municipal","48005","Other related violations causing death","0","0","0","0","0","0","0","0","0","0","0","0","0","0"
"2015","Chestermere, Alberta, Royal Canadian Mounted Police, municipal","48005","Other related violations causing death","0","0","0","0","0","0","0","0","0","0","0","0","0","0"
"2016","Chestermere, Alberta, Royal Canadian Mounted Police, municipal","48005","Other related violations causing death","0","0","0","0","0","0","0","0","0","0","0","0","0","0"
"1998","Chestermere, Alberta, Royal Canadian Mounted Police, municipal","48005","Attempted murder","0","0","0","0","0","0","0","0","0","0","0","0","0","0"
"1999","Chestermere, Alberta, Royal Canadian Mounted Police, municipal","48005","Attempted murder","0","0","0","0","0","0","0","0","0","0","0","0","0","0"
"2000","Chestermere, Alberta, Royal Canadian Mounted Police, municipal","48005","Attempted murder","0","0","0","0","0","0","0","0","0","0","0","0","0","0"
"2001","Chestermere, Alberta, Royal Canadian Mounted Police, municipal","48005","Attempted murder","0","0","0","0","0","0","0","0","0","0","0","0","0","0"
"2002","Chestermere, Alberta, Royal Canadian Mounted Police, municipal","48005","Attempted murder","0","0","0","0","0","0","0","0","0","0","0","0","0","0"
"2003","Chestermere, Alberta, Royal Canadian Mounted Police, municipal","48005","Attempted murder","0","0","0","0","0","0","0","0","0","0","0","0","0","0"
"2004","Chestermere, Alberta, Royal Canadian Mounted Police, municipal","48005","Attempted murder","0","0","0","0","0","0","0","0","0","0","0","0","0","0"
"2005","Chestermere, Alberta, Royal Canadian Mounted Police, municipal","48005","Attempted murder","0","0","0","0","0","0","0","0","0","0","0","0","0","0"
"2006","Chestermere, Alberta, Royal Canadian Mounted Police, municipal","48005","Attempted murder","0","0","0","0","0","0","0","0","0","0","0","0","0","0"
"2007","Chestermere, Alberta, Royal Canadian Mounted Police, municipal","48005","Attempted murder","0","0","0","0","0","0","0","0","0","0","0","0","0","0"
"2008","Chestermere, Alberta, Royal Canadian Mounted Police, municipal","48005","Attempted murder","0","0","0","0","0","0","0","0","0","0","0","0","0","0"
"2009","Chestermere, Alberta, Royal Canadian Mounted Police, municipal","48005","Attempted murder","0","0","0","0","0","0","0","0","0","0","0","0","0","0"
"2010","Chestermere, Alberta, Royal Canadian Mounted Police, municipal","48005","Attempted murder","0","0","0","0","0","0","0","0","0","0","0","0","0","0"
"2011","Chestermere, Alberta, Royal Canadian Mounted Police, municipal","48005","Attempted murder","0","0","0","0","0","0","0","0","0","0","0","0","0","0"
"2012","Chestermere, Alberta, Royal Canadian Mounted Police, municipal","48005","Attempted murder","0","0","0","0","0","0","0","0","0","0","0","0","0","0"
"2013","Chestermere, Alberta, Royal Canadian Mounted Police, municipal","48005","Attempted murder","0","0","0","0","0","0","0","0","0","0","0","0","0","0"
"2014","Chestermere, Alberta, Royal Canadian Mounted Police, municipal","48005","Attempted murder","0","0","0","0","0","0","0","0","0","0","0","0","0","0"
"2015","Chestermere, Alberta, Royal Canadian Mounted Police, municipal","48005","Attempted murder","0","0","0","0","0","0","0","0","0","0","0","0","0","0"
"2016","Chestermere, Alberta, Royal Canadian Mounted Police, municipal","48005","Attempted murder","0","0","0","0","0","0","0","0","0","0","0","0","0","0"
"1998","Chestermere, Alberta, Royal Canadian Mounted Police, municipal","48005","Sexual assault, level 3, aggravated","0","0","0","0","0","0","0","0","0","0","0","0","0","0"
"1999","Chestermere, Alberta, Royal Canadian Mounted Police, municipal","48005","Sexual assault, level 3, aggravated","0","0","0","0","0","0","0","0","0","0","0","0","0","0"
"2000","Chestermere, Alberta, Royal Canadian Mounted Police, municipal","48005","Sexual assault, level 3, aggravated","0","0","0","0","0","0","0","0","0","0","0","0","0","0"
"2001","Chestermere, Alberta, Royal Canadian Mounted Police, municipal","48005","Sexual assault, level 3, aggravated","0","0","0","0","0","0","0","0","0","0","0","0","0","0"
"2002","Chestermere, Alberta, Royal Canadian Mounted Police, municipal","48005","Sexual assault, level 3, aggravated","0","0","0","0","0","0","0","0","0","0","0","0","0","0"
"2003","Chestermere, Alberta, Royal Canadian Mounted Police, municipal","48005","Sexual assault, level 3, aggravated","0","0","0","0","0","0","0","0","0","0","0","0","0","0"
"2004","Chestermere, Alberta, Royal Canadian Mounted Police, municipal","48005","Sexual assault, level 3, aggravated","0","0","0","0","0","0","0","0","0","0","0","0","0","0"
"2005","Chestermere, Alberta, Royal Canadian Mounted Police, municipal","48005","Sexual assault, level 3, aggravated","1","0","0","0","11.54","0","0","0","0","0","0","0","0","0"
"2006","Chestermere, Alberta, Royal Canadian Mounted Police, municipal","48005","Sexual assault, level 3, aggravated","0","0","0","-100","0","0","0","0","0","0","0","0","0","0"
"2007","Chestermere, Alberta, Royal Canadian Mounted Police, municipal","48005","Sexual assault, level 3, aggravated","0","0","0","0","0","0","0","0","0","0","0","0","0","0"
"2008","Chestermere, Alberta, Royal Canadian Mounted Police, municipal","48005","Sexual assault, level 3, aggravated","0","0","0","0","0","0","0","0","0","0","0","0","0","0"
"2009","Chestermere, Alberta, Royal Canadian Mounted Police, municipal","48005","Sexual assault, level 3, aggravated","0","0","0","0","0","0","0","0","0","0","0","0","0","0"
"2010","Chestermere, Alberta, Royal Canadian Mounted Police, municipal","48005","Sexual assault, level 3, aggravated","0","0","0","0","0","0","0","0","0","0","0","0","0","0"
"2011","Chestermere, Alberta, Royal Canadian Mounted Police, municipal","48005","Sexual assault, level 3, aggravated","0","0","0","0","0","0","0","0","0","0","0","0","0","0"
"2012","Chestermere, Alberta, Royal Canadian Mounted Police, municipal","48005","Sexual assault, level 3, aggravated","0","0","0","0","0","0","0","0","0","0","0","0","0","0"
"2013","Chestermere, Alberta, Royal Canadian Mounted Police, municipal","48005","Sexual assault, level 3, aggravated","0","0","0","0","0","0","0","0","0","0","0","0","0","0"
"2014","Chestermere, Alberta, Royal Canadian Mounted Police, municipal","48005","Sexual assault, level 3, aggravated","0","0","0","0","0","0","0","0","0","0","0","0","0","0"
"2015","Chestermere, Alberta, Royal Canadian Mounted Police, municipal","48005","Sexual assault, level 3, aggravated","0","0","0","0","0","0","0","0","0","0","0","0","0","0"
"2016","Chestermere, Alberta, Royal Canadian Mounted Police, municipal","48005","Sexual assault, level 3, aggravated","0","0","0","0","0","0","0","0","0","0","0","0","0","0"
"1998","Chestermere, Alberta, Royal Canadian Mounted Police, municipal","48005","Sexual assault, level 2, weapon or bodily harm","0","0","0","0","0","0","0","0","0","0","0","0","0","0"
"1999","Chestermere, Alberta, Royal Canadian Mounted Police, municipal","48005","Sexual assault, level 2, weapon or bodily harm","0","0","0","0","0","0","0","0","0","0","0","0","0","0"
"2000","Chestermere, Alberta, Royal Canadian Mounted Police, municipal","48005","Sexual assault, level 2, weapon or bodily harm","0","0","0","0","0","0","0","0","0","0","0","0","0","0"
"2001","Chestermere, Alberta, Royal Canadian Mounted Police, municipal","48005","Sexual assault, level 2, weapon or bodily harm","0","0","0","0","0","0","0","0","0","0","0","0","0","0"
"2002","Chestermere, Alberta, Royal Canadian Mounted Police, municipal","48005","Sexual assault, level 2, weapon or bodily harm","0","0","0","0","0","0","0","0","0","0","0","0","0","0"
"2003","Chestermere, Alberta, Royal Canadian Mounted Police, municipal","48005","Sexual assault, level 2, weapon or bodily harm","0","0","0","0","0","0","0","0","0","0","0","0","0","0"
"2004","Chestermere, Alberta, Royal Canadian Mounted Police, municipal","48005","Sexual assault, level 2, weapon or bodily harm","0","0","0","0","0","0","0","0","0","0","0","0","0","0"
"2005","Chestermere, Alberta, Royal Canadian Mounted Police, municipal","48005","Sexual assault, level 2, weapon or bodily harm","0","0","0","0","0","0","0","0","0","0","0","0","0","0"
"2006","Chestermere, Alberta, Royal Canadian Mounted Police, municipal","48005","Sexual assault, level 2, weapon or bodily harm","0","0","0","0","0","0","0","0","0","0","0","0","0","0"
"2007","Chestermere, Alberta, Royal Canadian Mounted Police, municipal","48005","Sexual assault, level 2, weapon or bodily harm","0","0","0","0","0","0","0","0","0","0","0","0","0","0"
"2008","Chestermere, Alberta, Royal Canadian Mounted Police, municipal","48005","Sexual assault, level 2, weapon or bodily harm","1","1","0","0","8.08","11.28","9.96","0","0","1","1","1","0","0"
"2009","Chestermere, Alberta, Royal Canadian Mounted Police, municipal","48005","Sexual assault, level 2, weapon or bodily harm","1","0","0","-7.89","7.44","0","0","0","0","0","0","0","0","0"
"2010","Chestermere, Alberta, Royal Canadian Mounted Police, municipal","48005","Sexual assault, level 2, weapon or bodily harm","0","0","0","-100","0","0","0","0","0","0","0","0","0","0"
"2011","Chestermere, Alberta, Royal Canadian Mounted Police, municipal","48005","Sexual assault, level 2, weapon or bodily harm","0","0","0","0","0","0","0","0","0","0","0","0","0","0"
"2012","Chestermere, Alberta, Royal Canadian Mounted Police, municipal","48005","Sexual assault, level 2, weapon or bodily harm","0","0","0","0","0","0","0","0","0","0","0","0","0","0"
"2013","Chestermere, Alberta, Royal Canadian Mounted Police, municipal","48005","Sexual assault, level 2, weapon or bodily harm","0","0","0","0","0","0","0","0","0","0","0","0","0","0"
"2014","Chestermere, Alberta, Royal Canadian Mounted Police, municipal","48005","Sexual assault, level 2, weapon or bodily harm","0","0","0","0","0","0","0","0","0","0","0","0","0","0"
"2015","Chestermere, Alberta, Royal Canadian Mounted Police, municipal","48005","Sexual assault, level 2, weapon or bodily harm","0","0","0","0","0","0","0","0","0","0","0","0","0","0"
"2016","Chestermere, Alberta, Royal Canadian Mounted Police, municipal","48005","Sexual assault, level 2, weapon or bodily harm","0","0","0","0","0","0","0","0","0","0","0","0","0","0"
"1998","Chestermere, Alberta, Royal Canadian Mounted Police, municipal","48005","Sexual assault, level 1","0","0","0","0","0","0","0","0","0","0","0","0","0","0"
"1999","Chestermere, Alberta, Royal Canadian Mounted Police, municipal","48005","Sexual assault, level 1","0","0","0","0","0","0","0","0","0","0","0","0","0","0"
"2000","Chestermere, Alberta, Royal Canadian Mounted Police, municipal","48005","Sexual assault, level 1","0","0","0","0","0","0","0","0","0","0","0","0","0","0"
"2001","Chestermere, Alberta, Royal Canadian Mounted Police, municipal","48005","Sexual assault, level 1","0","0","0","0","0","0","0","0","0","0","0","0","0","0"
"2002","Chestermere, Alberta, Royal Canadian Mounted Police, municipal","48005","Sexual assault, level 1","0","0","0","0","0","0","0","0","0","0","0","0","0","0"
"2003","Chestermere, Alberta, Royal Canadian Mounted Police, municipal","48005","Sexual assault, level 1","0","0","0","0","0","0","0","0","0","0","0","0","0","0"
"2004","Chestermere, Alberta, Royal Canadian Mounted Police, municipal","48005","Sexual assault, level 1","0","0","0","0","0","0","0","0","0","0","0","0","0","0"
"2005","Chestermere, Alberta, Royal Canadian Mounted Police, municipal","48005","Sexual assault, level 1","3","1","0","0","34.63","0","14.14","122.1","0","1","0","1","1","0"
"2006","Chestermere, Alberta, Royal Canadian Mounted Police, municipal","48005","Sexual assault, level 1","4","3","1","11.16","38.5","13.52","23.77","98.52","98.52","4","1","2","1","1"
"2007","Chestermere, Alberta, Royal Canadian Mounted Police, municipal","48005","Sexual assault, level 1","6","2","3","37.17","52.81","12.32","10.85","0","91.16","5","1","1","0","1"
"2008","Chestermere, Alberta, Royal Canadian Mounted Police, municipal","48005","Sexual assault, level 1","4","3","1","-38.78","32.33","11.28","29.88","169.78","0","4","1","3","2","0"
"2009","Chestermere, Alberta, Royal Canadian Mounted Police, municipal","48005","Sexual assault, level 1","0","0","0","-100","0","0","0","0","0","0","0","0","0","0"
"2010","Chestermere, Alberta, Royal Canadian Mounted Police, municipal","48005","Sexual assault, level 1","4","0","1","0","27.75","0","0","0","0","1","0","0","0","0"
"2011","Chestermere, Alberta, Royal Canadian Mounted Police, municipal","48005","Sexual assault, level 1","7","4","1","63.98","45.5","27.18","24.16","0","0","5","3","3","0","0"
"2012","Chestermere, Alberta, Royal Canadian Mounted Police, municipal","48005","Sexual assault, level 1","5","2","2","-30.65","31.55","26.34","23.48","0","0","4","3","3","0","0"
"2013","Chestermere, Alberta, Royal Canadian Mounted Police, municipal","48005","Sexual assault, level 1","4","2","2","-22.69","24.39","16.92","15.13","0","0","4","2","2","0","0"
"2014","Chestermere, Alberta, Royal Canadian Mounted Police, municipal","48005","Sexual assault, level 1","3","1","2","-27.37","17.71","8.17","7.33","0","142.96","3","1","1","0","2"
"2015","Chestermere, Alberta, Royal Canadian Mounted Police, municipal","48005","Sexual assault, level 1","3","0","2","-2.19","17.33","0","0","0","70.77","2","0","0","0","1"
"2016","Chestermere, Alberta, Royal Canadian Mounted Police, municipal","48005","Sexual assault, level 1","6","1","3","95.12","33.81","7.81","7.02","0","0","4","1","1","0","0"
"1998","Chestermere, Alberta, Royal Canadian Mounted Police, municipal","48005","Total sexual violations against children","0","0","0","0","0","0","0","0","0","0","0","0","0","0"
"1999","Chestermere, Alberta, Royal Canadian Mounted Police, municipal","48005","Total sexual violations against children","0","0","0","0","0","0","0","0","0","0","0","0","0","0"
"2000","Chestermere, Alberta, Royal Canadian Mounted Police, municipal","48005","Total sexual violations against children","0","0","0","0","0","0","0","0","0","0","0","0","0","0"
"2001","Chestermere, Alberta, Royal Canadian Mounted Police, municipal","48005","Total sexual violations against children","0","0","0","0","0","0","0","0","0","0","0","0","0","0"
"2002","Chestermere, Alberta, Royal Canadian Mounted Police, municipal","48005","Total sexual violations against children","0","0","0","0","0","0","0","0","0","0","0","0","0","0"
"2003","Chestermere, Alberta, Royal Canadian Mounted Police, municipal","48005","Total sexual violations against children","0","0","0","0","0","0","0","0","0","0","0","0","0","0"
"2004","Chestermere, Alberta, Royal Canadian Mounted Police, municipal","48005","Total sexual violations against children","0","0","0","0","0","0","0","0","0","0","0","0","0","0"
"2005","Chestermere, Alberta, Royal Canadian Mounted Police, municipal","48005","Total sexual violations against children","0","0","0","0","0","0","0","0","0","0","0","0","0","0"
"2006","Chestermere, Alberta, Royal Canadian Mounted Police, municipal","48005","Total sexual violations against children","0","0","0","0","0","0","0","0","0","0","0","0","0","0"
"2007","Chestermere, Alberta, Royal Canadian Mounted Police, municipal","48005","Total sexual violations against children","0","0","0","0","0","0","0","0","0","0","0","0","0","0"
"2008","Chestermere, Alberta, Royal Canadian Mounted Police, municipal","48005","Total sexual violations against children","0","0","0","0","0","0","0","0","0","0","0","0","0","0"
"2009","Chestermere, Alberta, Royal Canadian Mounted Police, municipal","48005","Total sexual violations against children","0","0","0","0","0","0","0","0","0","0","0","0","0","0"
"2010","Chestermere, Alberta, Royal Canadian Mounted Police, municipal","48005","Total sexual violations against children","2","0","0","0","13.87","0","0","0","0","0","0","0","0","0"
"2011","Chestermere, Alberta, Royal Canadian Mounted Police, municipal","48005","Total sexual violations against children","2","1","1","-6.3","13","0","8.05","72.46","0","2","0","1","1","0"
"2012","Chestermere, Alberta, Royal Canadian Mounted Police, municipal","48005","Total sexual violations against children","0","0","0","-100","0","0","0","0","0","0","0","0","0","0"
"2013","Chestermere, Alberta, Royal Canadian Mounted Police, municipal","48005","Total sexual violations against children","0","0","0","0","0","0","0","0","0","0","0","0","0","0"
"2014","Chestermere, Alberta, Royal Canadian Mounted Police, municipal","48005","Total sexual violations against children","2","1","1","0","11.81","0","7.33","71.48","71.48","2","0","1","1","1"
"2015","Chestermere, Alberta, Royal Canadian Mounted Police, municipal","48005","Total sexual violations against children","2","2","0","-2.19","11.55","15.99","14.37","0","0","2","2","2","0","0"
"2016","Chestermere, Alberta, Royal Canadian Mounted Police, municipal","48005","Total sexual violations against children","2","0","0","-2.44","11.27","0","0","0","0","0","0","0","0","0"
"1999","Chestermere, Alberta, Royal Canadian Mounted Police, municipal","48005","Sexual interference","0","0","0","0","0","0","0","0","0","0","0","0","0","0"
"2000","Chestermere, Alberta, Royal Canadian Mounted Police, municipal","48005","Sexual interference","0","0","0","0","0","0","0","0","0","0","0","0","0","0"
"2001","Chestermere, Alberta, Royal Canadian Mounted Police, municipal","48005","Sexual interference","0","0","0","0","0","0","0","0","0","0","0","0","0","0"
"2002","Chestermere, Alberta, Royal Canadian Mounted Police, municipal","48005","Sexual interference","0","0","0","0","0","0","0","0","0","0","0","0","0","0"
"2003","Chestermere, Alberta, Royal Canadian Mounted Police, municipal","48005","Sexual interference","0","0","0","0","0","0","0","0","0","0","0","0","0","0"
"2004","Chestermere, Alberta, Royal Canadian Mounted Police, municipal","48005","Sexual interference","0","0","0","0","0","0","0","0","0","0","0","0","0","0"
"2005","Chestermere, Alberta, Royal Canadian Mounted Police, municipal","48005","Sexual interference","0","0","0","0","0","0","0","0","0","0","0","0","0","0"
"2006","Chestermere, Alberta, Royal Canadian Mounted Police, municipal","48005","Sexual interference","0","0","0","0","0","0","0","0","0","0","0","0","0","0"
"2007","Chestermere, Alberta, Royal Canadian Mounted Police, municipal","48005","Sexual interference","0","0","0","0","0","0","0","0","0","0","0","0","0","0"
"2008","Chestermere, Alberta, Royal Canadian Mounted Police, municipal","48005","Sexual interference","0","0","0","0","0","0","0","0","0","0","0","0","0","0"
"2009","Chestermere, Alberta, Royal Canadian Mounted Police, municipal","48005","Sexual interference","0","0","0","0","0","0","0","0","0","0","0","0","0","0"
"2010","Chestermere, Alberta, Royal Canadian Mounted Police, municipal","48005","Sexual interference","1","0","0","0","6.94","0","0","0","0","0","0","0","0","0"
"2011","Chestermere, Alberta, Royal Canadian Mounted Police, municipal","48005","Sexual interference","0","0","1","-100","0","0","0","0","0","1","0","0","0","0"
"2012","Chestermere, Alberta, Royal Canadian Mounted Police, municipal","48005","Sexual interference","0","0","0","0","0","0","0","0","0","0","0","0","0","0"
"2013","Chestermere, Alberta, Royal Canadian Mounted Police, municipal","48005","Sexual interference","0","0","0","0","0","0","0","0","0","0","0","0","0","0"
"2014","Chestermere, Alberta, Royal Canadian Mounted Police, municipal","48005","Sexual interference","1","1","0","0","5.9","0","7.33","71.48","0","1","0","1","1","0"
"2015","Chestermere, Alberta, Royal Canadian Mounted Police, municipal","48005","Sexual interference","1","1","0","-2.19","5.78","8","7.18","0","0","1","1","1","0","0"
"2016","Chestermere, Alberta, Royal Canadian Mounted Police, municipal","48005","Sexual interference","0","0","0","-100","0","0","0","0","0","0","0","0","0","0"
"2003","Chestermere, Alberta, Royal Canadian Mounted Police, municipal","48005","Invitation to sexual touching","0","0","0","0","0","0","0","0","0","0","0","0","0","0"
"2004","Chestermere, Alberta, Royal Canadian Mounted Police, municipal","48005","Invitation to sexual touching","0","0","0","0","0","0","0","0","0","0","0","0","0","0"
"2005","Chestermere, Alberta, Royal Canadian Mounted Police, municipal","48005","Invitation to sexual touching","0","0","0","0","0","0","0","0","0","0","0","0","0","0"
"2006","Chestermere, Alberta, Royal Canadian Mounted Police, municipal","48005","Invitation to sexual touching","0","0","0","0","0","0","0","0","0","0","0","0","0","0"
"2007","Chestermere, Alberta, Royal Canadian Mounted Police, municipal","48005","Invitation to sexual touching","0","0","0","0","0","0","0","0","0","0","0","0","0","0"
"2008","Chestermere, Alberta, Royal Canadian Mounted Police, municipal","48005","Invitation to sexual touching","0","0","0","0","0","0","0","0","0","0","0","0","0","0"
"2009","Chestermere, Alberta, Royal Canadian Mounted Police, municipal","48005","Invitation to sexual touching","0","0","0","0","0","0","0","0","0","0","0","0","0","0"
"2010","Chestermere, Alberta, Royal Canadian Mounted Police, municipal","48005","Invitation to sexual touching","0","0","0","0","0","0","0","0","0","0","0","0","0","0"
"2011","Chestermere, Alberta, Royal Canadian Mounted Police, municipal","48005","Invitation to sexual touching","1","1","0","0","6.5","0","8.05","72.46","0","1","0","1","1","0"
"2012","Chestermere, Alberta, Royal Canadian Mounted Police, municipal","48005","Invitation to sexual touching","0","0","0","-100","0","0","0","0","0","0","0","0","0","0"
"2013","Chestermere, Alberta, Royal Canadian Mounted Police, municipal","48005","Invitation to sexual touching","0","0","0","0","0","0","0","0","0","0","0","0","0","0"
"2014","Chestermere, Alberta, Royal Canadian Mounted Police, municipal","48005","Invitation to sexual touching","1","0","1","0","5.9","0","0","0","71.48","1","0","0","0","1"
"2015","Chestermere, Alberta, Royal Canadian Mounted Police, municipal","48005","Invitation to sexual touching","1","1","0","-2.19","5.78","8","7.18","0","0","1","1","1","0","0"
"2016","Chestermere, Alberta, Royal Canadian Mounted Police, municipal","48005","Invitation to sexual touching","0","0","0","-100","0","0","0","0","0","0","0","0","0","0"
"2003","Chestermere, Alberta, Royal Canadian Mounted Police, municipal","48005","Sexual exploitation","0","0","0","0","0","0","0","0","0","0","0","0","0","0"
"2004","Chestermere, Alberta, Royal Canadian Mounted Police, municipal","48005","Sexual exploitation","0","0","0","0","0","0","0","0","0","0","0","0","0","0"
"2005","Chestermere, Alberta, Royal Canadian Mounted Police, municipal","48005","Sexual exploitation","0","0","0","0","0","0","0","0","0","0","0","0","0","0"
"2006","Chestermere, Alberta, Royal Canadian Mounted Police, municipal","48005","Sexual exploitation","0","0","0","0","0","0","0","0","0","0","0","0","0","0"
"2007","Chestermere, Alberta, Royal Canadian Mounted Police, municipal","48005","Sexual exploitation","0","0","0","0","0","0","0","0","0","0","0","0","0","0"
"2008","Chestermere, Alberta, Royal Canadian Mounted Police, municipal","48005","Sexual exploitation","0","0","0","0","0","0","0","0","0","0","0","0","0","0"
"2009","Chestermere, Alberta, Royal Canadian Mounted Police, municipal","48005","Sexual exploitation","0","0","0","0","0","0","0","0","0","0","0","0","0","0"
"2010","Chestermere, Alberta, Royal Canadian Mounted Police, municipal","48005","Sexual exploitation","0","0","0","0","0","0","0","0","0","0","0","0","0","0"
"2011","Chestermere, Alberta, Royal Canadian Mounted Police, municipal","48005","Sexual exploitation","1","0","0","0","6.5","0","0","0","0","0","0","0","0","0"
"2012","Chestermere, Alberta, Royal Canadian Mounted Police, municipal","48005","Sexual exploitation","0","0","0","-100","0","0","0","0","0","0","0","0","0","0"
"2013","Chestermere, Alberta, Royal Canadian Mounted Police, municipal","48005","Sexual exploitation","0","0","0","0","0","0","0","0","0","0","0","0","0","0"
"2014","Chestermere, Alberta, Royal Canadian Mounted Police, municipal","48005","Sexual exploitation","0","0","0","0","0","0","0","0","0","0","0","0","0","0"
"2015","Chestermere, Alberta, Royal Canadian Mounted Police, municipal","48005","Sexual exploitation","0","0","0","0","0","0","0","0","0","0","0","0","0","0"
"2016","Chestermere, Alberta, Royal Canadian Mounted Police, municipal","48005","Sexual exploitation","0","0","0","0","0","0","0","0","0","0","0","0","0","0"
"2005","Chestermere, Alberta, Royal Canadian Mounted Police, municipal","48005","Making sexually explicit material available to children","0","0","0","0","0","0","0","0","0","0","0","0","0","0"
"2006","Chestermere, Alberta, Royal Canadian Mounted Police, municipal","48005","Making sexually explicit material available to children","0","0","0","0","0","0","0","0","0","0","0","0","0","0"
"2007","Chestermere, Alberta, Royal Canadian Mounted Police, municipal","48005","Making sexually explicit material available to children","0","0","0","0","0","0","0","0","0","0","0","0","0","0"
"2008","Chestermere, Alberta, Royal Canadian Mounted Police, municipal","48005","Making sexually explicit material available to children","0","0","0","0","0","0","0","0","0","0","0","0","0","0"
"2009","Chestermere, Alberta, Royal Canadian Mounted Police, municipal","48005","Making sexually explicit material available to children","0","0","0","0","0","0","0","0","0","0","0","0","0","0"
"2010","Chestermere, Alberta, Royal Canadian Mounted Police, municipal","48005","Making sexually explicit material available to children","0","0","0","0","0","0","0","0","0","0","0","0","0","0"
"2011","Chestermere, Alberta, Royal Canadian Mounted Police, municipal","48005","Making sexually explicit material available to children","0","0","0","0","0","0","0","0","0","0","0","0","0","0"
"2012","Chestermere, Alberta, Royal Canadian Mounted Police, municipal","48005","Making sexually explicit material available to children","0","0","0","0","0","0","0","0","0","0","0","0","0","0"
"2013","Chestermere, Alberta, Royal Canadian Mounted Police, municipal","48005","Making sexually explicit material available to children","0","0","0","0","0","0","0","0","0","0","0","0","0","0"
"2014","Chestermere, Alberta, Royal Canadian Mounted Police, municipal","48005","Making sexually explicit material available to children","0","0","0","0","0","0","0","0","0","0","0","0","0","0"
"2015","Chestermere, Alberta, Royal Canadian Mounted Police, municipal","48005","Making sexually explicit material available to children","0","0","0","0","0","0","0","0","0","0","0","0","0","0"
"2016","Chestermere, Alberta, Royal Canadian Mounted Police, municipal","48005","Making sexually explicit material available to children","1","0","0","0","5.63","0","0","0","0","0","0","0","0","0"
"2012","Chestermere, Alberta, Royal Canadian Mounted Police, municipal","48005","Parent or guardian procuring sexual activity: person procured under the age of 16 years","0","0","0","0","0","0","0","0","0","0","0","0","0","0"
"2013","Chestermere, Alberta, Royal Canadian Mounted Police, municipal","48005","Parent or guardian procuring sexual activity: person procured under the age of 16 years","0","0","0","0","0","0","0","0","0","0","0","0","0","0"
"2014","Chestermere, Alberta, Royal Canadian Mounted Police, municipal","48005","Parent or guardian procuring sexual activity: person procured under the age of 16 years","0","0","0","0","0","0","0","0","0","0","0","0","0","0"
"2012","Chestermere, Alberta, Royal Canadian Mounted Police, municipal","48005","Parent or guardian procuring sexual activity","0","0","0","0","0","0","0","0","0","0","0","0","0","0"
"2013","Chestermere, Alberta, Royal Canadian Mounted Police, municipal","48005","Parent or guardian procuring sexual activity","0","0","0","0","0","0","0","0","0","0","0","0","0","0"
"2014","Chestermere, Alberta, Royal Canadian Mounted Police, municipal","48005","Parent or guardian procuring sexual activity","0","0","0","0","0","0","0","0","0","0","0","0","0","0"
"2015","Chestermere, Alberta, Royal Canadian Mounted Police, municipal","48005","Parent or guardian procuring sexual activity","0","0","0","0","0","0","0","0","0","0","0","0","0","0"
"2016","Chestermere, Alberta, Royal Canadian Mounted Police, municipal","48005","Parent or guardian procuring sexual activity","0","0","0","0","0","0","0","0","0","0","0","0","0","0"
"2012","Chestermere, Alberta, Royal Canadian Mounted Police, municipal","48005","Householder permitting illegal sexual activity: person under the age of 16 years","0","0","0","0","0","0","0","0","0","0","0","0","0","0"
"2013","Chestermere, Alberta, Royal Canadian Mounted Police, municipal","48005","Householder permitting illegal sexual activity: person under the age of 16 years","0","0","0","0","0","0","0","0","0","0","0","0","0","0"
"2014","Chestermere, Alberta, Royal Canadian Mounted Police, municipal","48005","Householder permitting illegal sexual activity: person under the age of 16 years","0","0","0","0","0","0","0","0","0","0","0","0","0","0"
"2012","Chestermere, Alberta, Royal Canadian Mounted Police, municipal","48005","Householder permitting prohibited sexual activity","0","0","0","0","0","0","0","0","0","0","0","0","0","0"
"2013","Chestermere, Alberta, Royal Canadian Mounted Police, municipal","48005","Householder permitting prohibited sexual activity","0","0","0","0","0","0","0","0","0","0","0","0","0","0"
"2014","Chestermere, Alberta, Royal Canadian Mounted Police, municipal","48005","Householder permitting prohibited sexual activity","0","0","0","0","0","0","0","0","0","0","0","0","0","0"
"2015","Chestermere, Alberta, Royal Canadian Mounted Police, municipal","48005","Householder permitting prohibited sexual activity","0","0","0","0","0","0","0","0","0","0","0","0","0","0"
"2016","Chestermere, Alberta, Royal Canadian Mounted Police, municipal","48005","Householder permitting prohibited sexual activity","0","0","0","0","0","0","0","0","0","0","0","0","0","0"
"1998","Chestermere, Alberta, Royal Canadian Mounted Police, municipal","48005","Luring a child via a computer","0","0","0","0","0","0","0","0","0","0","0","0","0","0"
"1999","Chestermere, Alberta, Royal Canadian Mounted Police, municipal","48005","Luring a child via a computer","0","0","0","0","0","0","0","0","0","0","0","0","0","0"
"2000","Chestermere, Alberta, Royal Canadian Mounted Police, municipal","48005","Luring a child via a computer","0","0","0","0","0","0","0","0","0","0","0","0","0","0"
"2001","Chestermere, Alberta, Royal Canadian Mounted Police, municipal","48005","Luring a child via a computer","0","0","0","0","0","0","0","0","0","0","0","0","0","0"
"2002","Chestermere, Alberta, Royal Canadian Mounted Police, municipal","48005","Luring a child via a computer","0","0","0","0","0","0","0","0","0","0","0","0","0","0"
"2003","Chestermere, Alberta, Royal Canadian Mounted Police, municipal","48005","Luring a child via a computer","0","0","0","0","0","0","0","0","0","0","0","0","0","0"
"2004","Chestermere, Alberta, Royal Canadian Mounted Police, municipal","48005","Luring a child via a computer","0","0","0","0","0","0","0","0","0","0","0","0","0","0"
"2005","Chestermere, Alberta, Royal Canadian Mounted Police, municipal","48005","Luring a child via a computer","0","0","0","0","0","0","0","0","0","0","0","0","0","0"
"2006","Chestermere, Alberta, Royal Canadian Mounted Police, municipal","48005","Luring a child via a computer","0","0","0","0","0","0","0","0","0","0","0","0","0","0"
"2007","Chestermere, Alberta, Royal Canadian Mounted Police, municipal","48005","Luring a child via a computer","0","0","0","0","0","0","0","0","0","0","0","0","0","0"
"2008","Chestermere, Alberta, Royal Canadian Mounted Police, municipal","48005","Luring a child via a computer","0","0","0","0","0","0","0","0","0","0","0","0","0","0"
"2009","Chestermere, Alberta, Royal Canadian Mounted Police, municipal","48005","Luring a child via a computer","0","0","0","0","0","0","0","0","0","0","0","0","0","0"
"2010","Chestermere, Alberta, Royal Canadian Mounted Police, municipal","48005","Luring a child via a computer","1","0","0","0","6.94","0","0","0","0","0","0","0","0","0"
"2011","Chestermere, Alberta, Royal Canadian Mounted Police, municipal","48005","Luring a child via a computer","0","0","0","-100","0","0","0","0","0","0","0","0","0","0"
"2012","Chestermere, Alberta, Royal Canadian Mounted Police, municipal","48005","Luring a child via a computer","0","0","0","0","0","0","0","0","0","0","0","0","0","0"
"2013","Chestermere, Alberta, Royal Canadian Mounted Police, municipal","48005","Luring a child via a computer","0","0","0","0","0","0","0","0","0","0","0","0","0","0"
"2014","Chestermere, Alberta, Royal Canadian Mounted Police, municipal","48005","Luring a child via a computer","0","0","0","0","0","0","0","0","0","0","0","0","0","0"
"2015","Chestermere, Alberta, Royal Canadian Mounted Police, municipal","48005","Luring a child via a computer","0","0","0","0","0","0","0","0","0","0","0","0","0","0"
"2016","Chestermere, Alberta, Royal Canadian Mounted Police, municipal","48005","Luring a child via a computer","1","0","0","0","5.63","0","0","0","0","0","0","0","0","0"
"1998","Chestermere, Alberta, Royal Canadian Mounted Police, municipal","48005","Assault, level 3, aggravated","0","0","0","0","0","0","0","0","0","0","0","0","0","0"
"1999","Chestermere, Alberta, Royal Canadian Mounted Police, municipal","48005","Assault, level 3, aggravated","0","0","0","0","0","0","0","0","0","0","0","0","0","0"
"2000","Chestermere, Alberta, Royal Canadian Mounted Police, municipal","48005","Assault, level 3, aggravated","0","0","0","0","0","0","0","0","0","0","0","0","0","0"
"2001","Chestermere, Alberta, Royal Canadian Mounted Police, municipal","48005","Assault, level 3, aggravated","0","0","0","0","0","0","0","0","0","0","0","0","0","0"
"2002","Chestermere, Alberta, Royal Canadian Mounted Police, municipal","48005","Assault, level 3, aggravated","0","0","0","0","0","0","0","0","0","0","0","0","0","0"
"2003","Chestermere, Alberta, Royal Canadian Mounted Police, municipal","48005","Assault, level 3, aggravated","0","0","0","0","0","0","0","0","0","0","0","0","0","0"
"2004","Chestermere, Alberta, Royal Canadian Mounted Police, municipal","48005","Assault, level 3, aggravated","0","0","0","0","0","0","0","0","0","0","0","0","0","0"
"2005","Chestermere, Alberta, Royal Canadian Mounted Police, municipal","48005","Assault, level 3, aggravated","2","2","0","0","23.09","31.98","28.28","0","0","2","2","2","0","0"
"2006","Chestermere, Alberta, Royal Canadian Mounted Police, municipal","48005","Assault, level 3, aggravated","3","0","0","25.05","28.87","0","0","0","0","0","0","0","0","0"
"2007","Chestermere, Alberta, Royal Canadian Mounted Police, municipal","48005","Assault, level 3, aggravated","0","0","0","-100","0","0","0","0","0","0","0","0","0","0"
"2008","Chestermere, Alberta, Royal Canadian Mounted Police, municipal","48005","Assault, level 3, aggravated","1","1","0","0","8.08","0","9.96","84.89","0","1","0","1","1","0"
"2009","Chestermere, Alberta, Royal Canadian Mounted Police, municipal","48005","Assault, level 3, aggravated","0","0","0","-100","0","0","0","0","0","0","0","0","0","0"
"2010","Chestermere, Alberta, Royal Canadian Mounted Police, municipal","48005","Assault, level 3, aggravated","0","0","0","0","0","0","0","0","0","0","0","0","0","0"
"2011","Chestermere, Alberta, Royal Canadian Mounted Police, municipal","48005","Assault, level 3, aggravated","0","0","0","0","0","0","0","0","0","0","0","0","0","0"
"2012","Chestermere, Alberta, Royal Canadian Mounted Police, municipal","48005","Assault, level 3, aggravated","1","0","1","0","6.31","0","0","0","72.05","1","0","0","0","1"
"2013","Chestermere, Alberta, Royal Canadian Mounted Police, municipal","48005","Assault, level 3, aggravated","1","0","0","-3.37","6.1","0","0","0","0","0","0","0","0","0"
"2014","Chestermere, Alberta, Royal Canadian Mounted Police, municipal","48005","Assault, level 3, aggravated","0","0","0","-100","0","0","0","0","0","0","0","0","0","0"
"2015","Chestermere, Alberta, Royal Canadian Mounted Police, municipal","48005","Assault, level 3, aggravated","0","0","0","0","0","0","0","0","0","0","0","0","0","0"
"2016","Chestermere, Alberta, Royal Canadian Mounted Police, municipal","48005","Assault, level 3, aggravated","0","0","0","0","0","0","0","0","0","0","0","0","0","0"
"1998","Chestermere, Alberta, Royal Canadian Mounted Police, municipal","48005","Assault, level 2, weapon or bodily harm","0","0","0","0","0","0","0","0","0","0","0","0","0","0"
"1999","Chestermere, Alberta, Royal Canadian Mounted Police, municipal","48005","Assault, level 2, weapon or bodily harm","0","0","0","0","0","0","0","0","0","0","0","0","0","0"
"2000","Chestermere, Alberta, Royal Canadian Mounted Police, municipal","48005","Assault, level 2, weapon or bodily harm","0","0","0","0","0","0","0","0","0","0","0","0","0","0"
"2001","Chestermere, Alberta, Royal Canadian Mounted Police, municipal","48005","Assault, level 2, weapon or bodily harm","0","0","0","0","0","0","0","0","0","0","0","0","0","0"
"2002","Chestermere, Alberta, Royal Canadian Mounted Police, municipal","48005","Assault, level 2, weapon or bodily harm","0","0","0","0","0","0","0","0","0","0","0","0","0","0"
"2003","Chestermere, Alberta, Royal Canadian Mounted Police, municipal","48005","Assault, level 2, weapon or bodily harm","0","0","0","0","0","0","0","0","0","0","0","0","0","0"
"2004","Chestermere, Alberta, Royal Canadian Mounted Police, municipal","48005","Assault, level 2, weapon or bodily harm","0","0","0","0","0","0","0","0","0","0","0","0","0","0"
"2005","Chestermere, Alberta, Royal Canadian Mounted Police, municipal","48005","Assault, level 2, weapon or bodily harm","5","1","1","0","57.72","15.99","14.14","0","0","2","1","1","0","0"
"2006","Chestermere, Alberta, Royal Canadian Mounted Police, municipal","48005","Assault, level 2, weapon or bodily harm","22","8","3","266.82","211.74","40.55","83.19","394.09","98.52","11","3","7","4","1"
"2007","Chestermere, Alberta, Royal Canadian Mounted Police, municipal","48005","Assault, level 2, weapon or bodily harm","25","11","15","3.91","220.03","86.24","108.53","273.47","273.47","26","7","10","3","3"
"2008","Chestermere, Alberta, Royal Canadian Mounted Police, municipal","48005","Assault, level 2, weapon or bodily harm","12","4","2","-55.92","96.99","33.85","29.88","0","0","6","3","3","0","0"
"2009","Chestermere, Alberta, Royal Canadian Mounted Police, municipal","48005","Assault, level 2, weapon or bodily harm","8","6","1","-38.59","59.55","51.75","45.78","0","0","7","5","5","0","0"
"2010","Chestermere, Alberta, Royal Canadian Mounted Police, municipal","48005","Assault, level 2, weapon or bodily harm","13","4","6","51.41","90.17","28.97","25.61","0","73.64","10","3","3","0","1"
"2011","Chestermere, Alberta, Royal Canadian Mounted Police, municipal","48005","Assault, level 2, weapon or bodily harm","11","2","6","-20.71","71.49","27.18","24.16","0","72.46","8","3","3","0","1"
"2012","Chestermere, Alberta, Royal Canadian Mounted Police, municipal","48005","Assault, level 2, weapon or bodily harm","9","3","5","-20.56","56.79","17.56","23.48","72.05","72.05","8","2","3","1","1"
"2013","Chestermere, Alberta, Royal Canadian Mounted Police, municipal","48005","Assault, level 2, weapon or bodily harm","12","4","2","28.85","73.18","25.37","30.26","71.74","0","6","3","4","1","0"
"2014","Chestermere, Alberta, Royal Canadian Mounted Police, municipal","48005","Assault, level 2, weapon or bodily harm","7","3","1","-43.51","41.33","16.34","29.33","142.96","0","4","2","4","2","0"
"2015","Chestermere, Alberta, Royal Canadian Mounted Police, municipal","48005","Assault, level 2, weapon or bodily harm","5","4","0","-30.14","28.88","23.99","28.74","70.77","0","4","3","4","1","0"
"2016","Chestermere, Alberta, Royal Canadian Mounted Police, municipal","48005","Assault, level 2, weapon or bodily harm","6","4","0","17.07","33.81","31.26","28.09","0","0","4","4","4","0","0"
"1998","Chestermere, Alberta, Royal Canadian Mounted Police, municipal","48005","Assault, level 1","0","0","0","0","0","0","0","0","0","0","0","0","0","0"
"1999","Chestermere, Alberta, Royal Canadian Mounted Police, municipal","48005","Assault, level 1","0","0","0","0","0","0","0","0","0","0","0","0","0","0"
"2000","Chestermere, Alberta, Royal Canadian Mounted Police, municipal","48005","Assault, level 1","0","0","0","0","0","0","0","0","0","0","0","0","0","0"
"2001","Chestermere, Alberta, Royal Canadian Mounted Police, municipal","48005","Assault, level 1","0","0","0","0","0","0","0","0","0","0","0","0","0","0"
"2002","Chestermere, Alberta, Royal Canadian Mounted Police, municipal","48005","Assault, level 1","0","0","0","0","0","0","0","0","0","0","0","0","0","0"
"2003","Chestermere, Alberta, Royal Canadian Mounted Police, municipal","48005","Assault, level 1","0","0","0","0","0","0","0","0","0","0","0","0","0","0"
"2004","Chestermere, Alberta, Royal Canadian Mounted Police, municipal","48005","Assault, level 1","0","0","0","0","0","0","0","0","0","0","0","0","0","0"
"2005","Chestermere, Alberta, Royal Canadian Mounted Police, municipal","48005","Assault, level 1","40","15","11","0","461.79","239.88","226.24","122.1","244.2","26","15","16","1","2"
"2006","Chestermere, Alberta, Royal Canadian Mounted Police, municipal","48005","Assault, level 1","53","22","24","10.46","510.11","229.76","213.93","98.52","591.13","46","17","18","1","6"
"2007","Chestermere, Alberta, Royal Canadian Mounted Police, municipal","48005","Assault, level 1","74","21","49","27.68","651.29","209.44","217.06","273.47","2825.89","70","17","20","3","31"
"2008","Chestermere, Alberta, Royal Canadian Mounted Police, municipal","48005","Assault, level 1","84","24","48","4.24","678.9","180.53","189.22","254.67","424.45","72","16","19","3","5"
"2009","Chestermere, Alberta, Royal Canadian Mounted Police, municipal","48005","Assault, level 1","69","25","41","-24.34","513.66","196.67","173.96","0","634.42","66","19","19","0","8"
"2010","Chestermere, Alberta, Royal Canadian Mounted Police, municipal","48005","Assault, level 1","61","28","28","-17.63","423.11","231.73","247.55","368.19","736.38","56","24","29","5","10"
"2011","Chestermere, Alberta, Royal Canadian Mounted Police, municipal","48005","Assault, level 1","52","22","24","-20.12","337.97","172.12","169.1","144.93","217.39","46","19","21","2","3"
"2012","Chestermere, Alberta, Royal Canadian Mounted Police, municipal","48005","Assault, level 1","51","23","24","-4.78","321.83","184.36","172.16","72.05","144.09","47","21","22","1","2"
"2013","Chestermere, Alberta, Royal Canadian Mounted Police, municipal","48005","Assault, level 1","50","20","24","-5.26","304.9","152.25","166.45","286.94","502.15","44","18","22","4","7"
"2014","Chestermere, Alberta, Royal Canadian Mounted Police, municipal","48005","Assault, level 1","42","22","15","-18.66","248.01","171.55","161.29","71.48","214.44","37","21","22","1","3"
"2015","Chestermere, Alberta, Royal Canadian Mounted Police, municipal","48005","Assault, level 1","50","27","18","16.43","288.77","215.88","193.97","0","424.63","45","27","27","0","6"
"2016","Chestermere, Alberta, Royal Canadian Mounted Police, municipal","48005","Assault, level 1","57","27","23","11.22","321.16","211","189.59","0","276.82","50","27","27","0","4"
"1998","Chestermere, Alberta, Royal Canadian Mounted Police, municipal","48005","Total assaults against a peace officer","0","0","0","0","0","0","0","0","0","0","0","0","0","0"
"1999","Chestermere, Alberta, Royal Canadian Mounted Police, municipal","48005","Total assaults against a peace officer","0","0","0","0","0","0","0","0","0","0","0","0","0","0"
"2000","Chestermere, Alberta, Royal Canadian Mounted Police, municipal","48005","Total assaults against a peace officer","0","0","0","0","0","0","0","0","0","0","0","0","0","0"
"2001","Chestermere, Alberta, Royal Canadian Mounted Police, municipal","48005","Total assaults against a peace officer","0","0","0","0","0","0","0","0","0","0","0","0","0","0"
"2002","Chestermere, Alberta, Royal Canadian Mounted Police, municipal","48005","Total assaults against a peace officer","0","0","0","0","0","0","0","0","0","0","0","0","0","0"
"2003","Chestermere, Alberta, Royal Canadian Mounted Police, municipal","48005","Total assaults against a peace officer","0","0","0","0","0","0","0","0","0","0","0","0","0","0"
"2004","Chestermere, Alberta, Royal Canadian Mounted Police, municipal","48005","Total assaults against a peace officer","0","0","0","0","0","0","0","0","0","0","0","0","0","0"
"2005","Chestermere, Alberta, Royal Canadian Mounted Police, municipal","48005","Total assaults against a peace officer","1","1","0","0","11.54","15.99","14.14","0","0","1","1","1","0","0"
"2006","Chestermere, Alberta, Royal Canadian Mounted Police, municipal","48005","Total assaults against a peace officer","1","1","0","-16.63","9.62","13.52","11.88","0","0","1","1","1","0","0"
"2007","Chestermere, Alberta, Royal Canadian Mounted Police, municipal","48005","Total assaults against a peace officer","4","1","3","265.78","35.21","12.32","10.85","0","0","4","1","1","0","0"
"2008","Chestermere, Alberta, Royal Canadian Mounted Police, municipal","48005","Total assaults against a peace officer","0","0","0","-100","0","11.28","19.92","84.89","0","0","1","2","1","0"
"2009","Chestermere, Alberta, Royal Canadian Mounted Police, municipal","48005","Total assaults against a peace officer","19","19","0","0","141.44","20.7","18.31","0","0","19","2","2","0","0"
"2010","Chestermere, Alberta, Royal Canadian Mounted Police, municipal","48005","Total assaults against a peace officer","11","6","1","-46.06","76.3","48.28","42.68","0","73.64","7","5","5","0","1"
"2011","Chestermere, Alberta, Royal Canadian Mounted Police, municipal","48005","Total assaults against a peace officer","2","2","0","-82.96","13","27.18","24.16","0","0","2","3","3","0","0"
"2012","Chestermere, Alberta, Royal Canadian Mounted Police, municipal","48005","Total assaults against a peace officer","0","0","0","-100","0","0","0","0","0","0","0","0","0","0"
"2013","Chestermere, Alberta, Royal Canadian Mounted Police, municipal","48005","Total assaults against a peace officer","1","1","0","0","6.1","8.46","7.57","0","0","1","1","1","0","0"
"2014","Chestermere, Alberta, Royal Canadian Mounted Police, municipal","48005","Total assaults against a peace officer","0","0","0","-100","0","0","0","0","0","0","0","0","0","0"
"2015","Chestermere, Alberta, Royal Canadian Mounted Police, municipal","48005","Total assaults against a peace officer","2","1","0","0","11.55","8","7.18","0","0","1","1","1","0","0"
"2016","Chestermere, Alberta, Royal Canadian Mounted Police, municipal","48005","Total assaults against a peace officer","0","0","0","-100","0","0","0","0","0","0","0","0","0","0"
"1998","Chestermere, Alberta, Royal Canadian Mounted Police, municipal","48005","Total other assaults","0","0","0","0","0","0","0","0","0","0","0","0","0","0"
"1999","Chestermere, Alberta, Royal Canadian Mounted Police, municipal","48005","Total other assaults","0","0","0","0","0","0","0","0","0","0","0","0","0","0"
"2000","Chestermere, Alberta, Royal Canadian Mounted Police, municipal","48005","Total other assaults","0","0","0","0","0","0","0","0","0","0","0","0","0","0"
"2001","Chestermere, Alberta, Royal Canadian Mounted Police, municipal","48005","Total other assaults","0","0","0","0","0","0","0","0","0","0","0","0","0","0"
"2002","Chestermere, Alberta, Royal Canadian Mounted Police, municipal","48005","Total other assaults","0","0","0","0","0","0","0","0","0","0","0","0","0","0"
"2003","Chestermere, Alberta, Royal Canadian Mounted Police, municipal","48005","Total other assaults","0","0","0","0","0","0","0","0","0","0","0","0","0","0"
"2004","Chestermere, Alberta, Royal Canadian Mounted Police, municipal","48005","Total other assaults","0","0","0","0","0","0","0","0","0","0","0","0","0","0"
"2005","Chestermere, Alberta, Royal Canadian Mounted Police, municipal","48005","Total other assaults","1","1","0","0","11.54","15.99","14.14","0","0","1","1","1","0","0"
"2006","Chestermere, Alberta, Royal Canadian Mounted Police, municipal","48005","Total other assaults","0","0","0","-100","0","0","0","0","0","0","0","0","0","0"
"2007","Chestermere, Alberta, Royal Canadian Mounted Police, municipal","48005","Total other assaults","0","0","0","0","0","0","0","0","0","0","0","0","0","0"
"2008","Chestermere, Alberta, Royal Canadian Mounted Police, municipal","48005","Total other assaults","0","0","0","0","0","0","0","0","0","0","0","0","0","0"
"2009","Chestermere, Alberta, Royal Canadian Mounted Police, municipal","48005","Total other assaults","0","0","0","0","0","0","0","0","0","0","0","0","0","0"
"2010","Chestermere, Alberta, Royal Canadian Mounted Police, municipal","48005","Total other assaults","0","0","0","0","0","0","0","0","0","0","0","0","0","0"
"2011","Chestermere, Alberta, Royal Canadian Mounted Police, municipal","48005","Total other assaults","0","0","0","0","0","0","0","0","0","0","0","0","0","0"
"2012","Chestermere, Alberta, Royal Canadian Mounted Police, municipal","48005","Total other assaults","0","0","0","0","0","0","0","0","0","0","0","0","0","0"
"2013","Chestermere, Alberta, Royal Canadian Mounted Police, municipal","48005","Total other assaults","0","0","0","0","0","0","0","0","0","0","0","0","0","0"
"2014","Chestermere, Alberta, Royal Canadian Mounted Police, municipal","48005","Total other assaults","0","0","0","0","0","0","0","0","0","0","0","0","0","0"
"2015","Chestermere, Alberta, Royal Canadian Mounted Police, municipal","48005","Total other assaults","0","0","0","0","0","0","0","0","0","0","0","0","0","0"
"2016","Chestermere, Alberta, Royal Canadian Mounted Police, municipal","48005","Total other assaults","0","0","0","0","0","0","0","0","0","0","0","0","0","0"
"1998","Chestermere, Alberta, Royal Canadian Mounted Police, municipal","48005","Unlawfully causing bodily harm","0","0","0","0","0","0","0","0","0","0","0","0","0","0"
"1999","Chestermere, Alberta, Royal Canadian Mounted Police, municipal","48005","Unlawfully causing bodily harm","0","0","0","0","0","0","0","0","0","0","0","0","0","0"
"2000","Chestermere, Alberta, Royal Canadian Mounted Police, municipal","48005","Unlawfully causing bodily harm","0","0","0","0","0","0","0","0","0","0","0","0","0","0"
"2001","Chestermere, Alberta, Royal Canadian Mounted Police, municipal","48005","Unlawfully causing bodily harm","0","0","0","0","0","0","0","0","0","0","0","0","0","0"
"2002","Chestermere, Alberta, Royal Canadian Mounted Police, municipal","48005","Unlawfully causing bodily harm","0","0","0","0","0","0","0","0","0","0","0","0","0","0"
"2003","Chestermere, Alberta, Royal Canadian Mounted Police, municipal","48005","Unlawfully causing bodily harm","0","0","0","0","0","0","0","0","0","0","0","0","0","0"
"2004","Chestermere, Alberta, Royal Canadian Mounted Police, municipal","48005","Unlawfully causing bodily harm","0","0","0","0","0","0","0","0","0","0","0","0","0","0"
"2005","Chestermere, Alberta, Royal Canadian Mounted Police, municipal","48005","Unlawfully causing bodily harm","0","0","0","0","0","0","0","0","0","0","0","0","0","0"
"2006","Chestermere, Alberta, Royal Canadian Mounted Police, municipal","48005","Unlawfully causing bodily harm","0","0","0","0","0","0","0","0","0","0","0","0","0","0"
"2007","Chestermere, Alberta, Royal Canadian Mounted Police, municipal","48005","Unlawfully causing bodily harm","0","0","0","0","0","0","0","0","0","0","0","0","0","0"
"2008","Chestermere, Alberta, Royal Canadian Mounted Police, municipal","48005","Unlawfully causing bodily harm","0","0","0","0","0","0","0","0","0","0","0","0","0","0"
"2009","Chestermere, Alberta, Royal Canadian Mounted Police, municipal","48005","Unlawfully causing bodily harm","0","0","0","0","0","0","0","0","0","0","0","0","0","0"
"2010","Chestermere, Alberta, Royal Canadian Mounted Police, municipal","48005","Unlawfully causing bodily harm","0","0","0","0","0","0","0","0","0","0","0","0","0","0"
"2011","Chestermere, Alberta, Royal Canadian Mounted Police, municipal","48005","Unlawfully causing bodily harm","0","0","0","0","0","0","0","0","0","0","0","0","0","0"
"2012","Chestermere, Alberta, Royal Canadian Mounted Police, municipal","48005","Unlawfully causing bodily harm","0","0","0","0","0","0","0","0","0","0","0","0","0","0"
"2013","Chestermere, Alberta, Royal Canadian Mounted Police, municipal","48005","Unlawfully causing bodily harm","0","0","0","0","0","0","0","0","0","0","0","0","0","0"
"2014","Chestermere, Alberta, Royal Canadian Mounted Police, municipal","48005","Unlawfully causing bodily harm","0","0","0","0","0","0","0","0","0","0","0","0","0","0"
"2015","Chestermere, Alberta, Royal Canadian Mounted Police, municipal","48005","Unlawfully causing bodily harm","0","0","0","0","0","0","0","0","0","0","0","0","0","0"
"2016","Chestermere, Alberta, Royal Canadian Mounted Police, municipal","48005","Unlawfully causing bodily harm","0","0","0","0","0","0","0","0","0","0","0","0","0","0"
"1998","Chestermere, Alberta, Royal Canadian Mounted Police, municipal","48005","Criminal negligence causing bodily harm","0","0","0","0","0","0","0","0","0","0","0","0","0","0"
"1999","Chestermere, Alberta, Royal Canadian Mounted Police, municipal","48005","Criminal negligence causing bodily harm","0","0","0","0","0","0","0","0","0","0","0","0","0","0"
"2000","Chestermere, Alberta, Royal Canadian Mounted Police, municipal","48005","Criminal negligence causing bodily harm","0","0","0","0","0","0","0","0","0","0","0","0","0","0"
"2001","Chestermere, Alberta, Royal Canadian Mounted Police, municipal","48005","Criminal negligence causing bodily harm","0","0","0","0","0","0","0","0","0","0","0","0","0","0"
"2002","Chestermere, Alberta, Royal Canadian Mounted Police, municipal","48005","Criminal negligence causing bodily harm","0","0","0","0","0","0","0","0","0","0","0","0","0","0"
"2003","Chestermere, Alberta, Royal Canadian Mounted Police, municipal","48005","Criminal negligence causing bodily harm","0","0","0","0","0","0","0","0","0","0","0","0","0","0"
"2004","Chestermere, Alberta, Royal Canadian Mounted Police, municipal","48005","Criminal negligence causing bodily harm","0","0","0","0","0","0","0","0","0","0","0","0","0","0"
"2005","Chestermere, Alberta, Royal Canadian Mounted Police, municipal","48005","Criminal negligence causing bodily harm","0","0","0","0","0","0","0","0","0","0","0","0","0","0"
"2006","Chestermere, Alberta, Royal Canadian Mounted Police, municipal","48005","Criminal negligence causing bodily harm","0","0","0","0","0","0","0","0","0","0","0","0","0","0"
"2007","Chestermere, Alberta, Royal Canadian Mounted Police, municipal","48005","Criminal negligence causing bodily harm","0","0","0","0","0","0","0","0","0","0","0","0","0","0"
"2008","Chestermere, Alberta, Royal Canadian Mounted Police, municipal","48005","Criminal negligence causing bodily harm","0","0","0","0","0","0","0","0","0","0","0","0","0","0"
"2009","Chestermere, Alberta, Royal Canadian Mounted Police, municipal","48005","Criminal negligence causing bodily harm","0","0","0","0","0","0","0","0","0","0","0","0","0","0"
"2010","Chestermere, Alberta, Royal Canadian Mounted Police, municipal","48005","Criminal negligence causing bodily harm","0","0","0","0","0","0","0","0","0","0","0","0","0","0"
"2011","Chestermere, Alberta, Royal Canadian Mounted Police, municipal","48005","Criminal negligence causing bodily harm","0","0","0","0","0","0","0","0","0","0","0","0","0","0"
"2012","Chestermere, Alberta, Royal Canadian Mounted Police, municipal","48005","Criminal negligence causing bodily harm","0","0","0","0","0","0","0","0","0","0","0","0","0","0"
"2013","Chestermere, Alberta, Royal Canadian Mounted Police, municipal","48005","Criminal negligence causing bodily harm","0","0","0","0","0","0","0","0","0","0","0","0","0","0"
"2014","Chestermere, Alberta, Royal Canadian Mounted Police, municipal","48005","Criminal negligence causing bodily harm","0","0","0","0","0","0","0","0","0","0","0","0","0","0"
"2015","Chestermere, Alberta, Royal Canadian Mounted Police, municipal","48005","Criminal negligence causing bodily harm","0","0","0","0","0","0","0","0","0","0","0","0","0","0"
"2016","Chestermere, Alberta, Royal Canadian Mounted Police, municipal","48005","Criminal negligence causing bodily harm","0","0","0","0","0","0","0","0","0","0","0","0","0","0"
"1998","Chestermere, Alberta, Royal Canadian Mounted Police, municipal","48005","Other assaults","0","0","0","0","0","0","0","0","0","0","0","0","0","0"
"1999","Chestermere, Alberta, Royal Canadian Mounted Police, municipal","48005","Other assaults","0","0","0","0","0","0","0","0","0","0","0","0","0","0"
"2000","Chestermere, Alberta, Royal Canadian Mounted Police, municipal","48005","Other assaults","0","0","0","0","0","0","0","0","0","0","0","0","0","0"
"2001","Chestermere, Alberta, Royal Canadian Mounted Police, municipal","48005","Other assaults","0","0","0","0","0","0","0","0","0","0","0","0","0","0"
"2002","Chestermere, Alberta, Royal Canadian Mounted Police, municipal","48005","Other assaults","0","0","0","0","0","0","0","0","0","0","0","0","0","0"
"2003","Chestermere, Alberta, Royal Canadian Mounted Police, municipal","48005","Other assaults","0","0","0","0","0","0","0","0","0","0","0","0","0","0"
"2004","Chestermere, Alberta, Royal Canadian Mounted Police, municipal","48005","Other assaults","0","0","0","0","0","0","0","0","0","0","0","0","0","0"
"2005","Chestermere, Alberta, Royal Canadian Mounted Police, municipal","48005","Other assaults","1","1","0","0","11.54","15.99","14.14","0","0","1","1","1","0","0"
"2006","Chestermere, Alberta, Royal Canadian Mounted Police, municipal","48005","Other assaults","0","0","0","-100","0","0","0","0","0","0","0","0","0","0"
"2007","Chestermere, Alberta, Royal Canadian Mounted Police, municipal","48005","Other assaults","0","0","0","0","0","0","0","0","0","0","0","0","0","0"
"2008","Chestermere, Alberta, Royal Canadian Mounted Police, municipal","48005","Other assaults","0","0","0","0","0","0","0","0","0","0","0","0","0","0"
"2009","Chestermere, Alberta, Royal Canadian Mounted Police, municipal","48005","Other assaults","0","0","0","0","0","0","0","0","0","0","0","0","0","0"
"2010","Chestermere, Alberta, Royal Canadian Mounted Police, municipal","48005","Other assaults","0","0","0","0","0","0","0","0","0","0","0","0","0","0"
"2011","Chestermere, Alberta, Royal Canadian Mounted Police, municipal","48005","Other assaults","0","0","0","0","0","0","0","0","0","0","0","0","0","0"
"2012","Chestermere, Alberta, Royal Canadian Mounted Police, municipal","48005","Other assaults","0","0","0","0","0","0","0","0","0","0","0","0","0","0"
"2013","Chestermere, Alberta, Royal Canadian Mounted Police, municipal","48005","Other assaults","0","0","0","0","0","0","0","0","0","0","0","0","0","0"
"2014","Chestermere, Alberta, Royal Canadian Mounted Police, municipal","48005","Other assaults","0","0","0","0","0","0","0","0","0","0","0","0","0","0"
"2015","Chestermere, Alberta, Royal Canadian Mounted Police, municipal","48005","Other assaults","0","0","0","0","0","0","0","0","0","0","0","0","0","0"
"2016","Chestermere, Alberta, Royal Canadian Mounted Police, municipal","48005","Other assaults","0","0","0","0","0","0","0","0","0","0","0","0","0","0"
"1998","Chestermere, Alberta, Royal Canadian Mounted Police, municipal","48005","Total firearms, use of, discharge, pointing","0","0","0","0","0","0","0","0","0","0","0","0","0","0"
"1999","Chestermere, Alberta, Royal Canadian Mounted Police, municipal","48005","Total firearms, use of, discharge, pointing","0","0","0","0","0","0","0","0","0","0","0","0","0","0"
"2000","Chestermere, Alberta, Royal Canadian Mounted Police, municipal","48005","Total firearms, use of, discharge, pointing","0","0","0","0","0","0","0","0","0","0","0","0","0","0"
"2001","Chestermere, Alberta, Royal Canadian Mounted Police, municipal","48005","Total firearms, use of, discharge, pointing","0","0","0","0","0","0","0","0","0","0","0","0","0","0"
"2002","Chestermere, Alberta, Royal Canadian Mounted Police, municipal","48005","Total firearms, use of, discharge, pointing","0","0","0","0","0","0","0","0","0","0","0","0","0","0"
"2003","Chestermere, Alberta, Royal Canadian Mounted Police, municipal","48005","Total firearms, use of, discharge, pointing","0","0","0","0","0","0","0","0","0","0","0","0","0","0"
"2004","Chestermere, Alberta, Royal Canadian Mounted Police, municipal","48005","Total firearms, use of, discharge, pointing","0","0","0","0","0","0","0","0","0","0","0","0","0","0"
"2005","Chestermere, Alberta, Royal Canadian Mounted Police, municipal","48005","Total firearms, use of, discharge, pointing","0","0","0","0","0","0","0","0","0","0","0","0","0","0"
"2006","Chestermere, Alberta, Royal Canadian Mounted Police, municipal","48005","Total firearms, use of, discharge, pointing","0","0","0","0","0","0","0","0","0","0","0","0","0","0"
"2007","Chestermere, Alberta, Royal Canadian Mounted Police, municipal","48005","Total firearms, use of, discharge, pointing","0","0","0","0","0","0","0","0","0","0","0","0","0","0"
"2008","Chestermere, Alberta, Royal Canadian Mounted Police, municipal","48005","Total firearms, use of, discharge, pointing","0","0","0","0","0","0","0","0","0","0","0","0","0","0"
"2009","Chestermere, Alberta, Royal Canadian Mounted Police, municipal","48005","Total firearms, use of, discharge, pointing","1","0","1","0","7.44","0","0","0","237.91","1","0","0","0","3"
"2010","Chestermere, Alberta, Royal Canadian Mounted Police, municipal","48005","Total firearms, use of, discharge, pointing","1","0","1","-6.83","6.94","0","0","0","73.64","1","0","0","0","1"
"2011","Chestermere, Alberta, Royal Canadian Mounted Police, municipal","48005","Total firearms, use of, discharge, pointing","0","0","0","-100","0","0","0","0","0","0","0","0","0","0"
"2012","Chestermere, Alberta, Royal Canadian Mounted Police, municipal","48005","Total firearms, use of, discharge, pointing","1","0","0","0","6.31","0","0","0","0","0","0","0","0","0"
"2013","Chestermere, Alberta, Royal Canadian Mounted Police, municipal","48005","Total firearms, use of, discharge, pointing","0","0","0","-100","0","0","0","0","0","0","0","0","0","0"
"2014","Chestermere, Alberta, Royal Canadian Mounted Police, municipal","48005","Total firearms, use of, discharge, pointing","0","0","0","0","0","0","0","0","0","0","0","0","0","0"
"2015","Chestermere, Alberta, Royal Canadian Mounted Police, municipal","48005","Total firearms, use of, discharge, pointing","3","0","3","0","17.33","0","0","0","0","3","0","0","0","0"
"2016","Chestermere, Alberta, Royal Canadian Mounted Police, municipal","48005","Total firearms, use of, discharge, pointing","0","0","0","-100","0","0","0","0","0","0","0","0","0","0"
"1998","Chestermere, Alberta, Royal Canadian Mounted Police, municipal","48005","Discharge firearm with intent","0","0","0","0","0","0","0","0","0","0","0","0","0","0"
"1999","Chestermere, Alberta, Royal Canadian Mounted Police, municipal","48005","Discharge firearm with intent","0","0","0","0","0","0","0","0","0","0","0","0","0","0"
"2000","Chestermere, Alberta, Royal Canadian Mounted Police, municipal","48005","Discharge firearm with intent","0","0","0","0","0","0","0","0","0","0","0","0","0","0"
"2001","Chestermere, Alberta, Royal Canadian Mounted Police, municipal","48005","Discharge firearm with intent","0","0","0","0","0","0","0","0","0","0","0","0","0","0"
"2002","Chestermere, Alberta, Royal Canadian Mounted Police, municipal","48005","Discharge firearm with intent","0","0","0","0","0","0","0","0","0","0","0","0","0","0"
"2003","Chestermere, Alberta, Royal Canadian Mounted Police, municipal","48005","Discharge firearm with intent","0","0","0","0","0","0","0","0","0","0","0","0","0","0"
"2004","Chestermere, Alberta, Royal Canadian Mounted Police, municipal","48005","Discharge firearm with intent","0","0","0","0","0","0","0","0","0","0","0","0","0","0"
"2005","Chestermere, Alberta, Royal Canadian Mounted Police, municipal","48005","Discharge firearm with intent","0","0","0","0","0","0","0","0","0","0","0","0","0","0"
"2006","Chestermere, Alberta, Royal Canadian Mounted Police, municipal","48005","Discharge firearm with intent","0","0","0","0","0","0","0","0","0","0","0","0","0","0"
"2007","Chestermere, Alberta, Royal Canadian Mounted Police, municipal","48005","Discharge firearm with intent","0","0","0","0","0","0","0","0","0","0","0","0","0","0"
"2008","Chestermere, Alberta, Royal Canadian Mounted Police, municipal","48005","Discharge firearm with intent","0","0","0","0","0","0","0","0","0","0","0","0","0","0"
"2009","Chestermere, Alberta, Royal Canadian Mounted Police, municipal","48005","Discharge firearm with intent","0","0","0","0","0","0","0","0","0","0","0","0","0","0"
"2010","Chestermere, Alberta, Royal Canadian Mounted Police, municipal","48005","Discharge firearm with intent","0","0","0","0","0","0","0","0","0","0","0","0","0","0"
"2011","Chestermere, Alberta, Royal Canadian Mounted Police, municipal","48005","Discharge firearm with intent","0","0","0","0","0","0","0","0","0","0","0","0","0","0"
"2012","Chestermere, Alberta, Royal Canadian Mounted Police, municipal","48005","Discharge firearm with intent","1","0","0","0","6.31","0","0","0","0","0","0","0","0","0"
"2013","Chestermere, Alberta, Royal Canadian Mounted Police, municipal","48005","Discharge firearm with intent","0","0","0","-100","0","0","0","0","0","0","0","0","0","0"
"2014","Chestermere, Alberta, Royal Canadian Mounted Police, municipal","48005","Discharge firearm with intent","0","0","0","0","0","0","0","0","0","0","0","0","0","0"
"2015","Chestermere, Alberta, Royal Canadian Mounted Police, municipal","48005","Discharge firearm with intent","0","0","0","0","0","0","0","0","0","0","0","0","0","0"
"2016","Chestermere, Alberta, Royal Canadian Mounted Police, municipal","48005","Discharge firearm with intent","0","0","0","0","0","0","0","0","0","0","0","0","0","0"
"1998","Chestermere, Alberta, Royal Canadian Mounted Police, municipal","48005","Using firearm in commission of offence","0","0","0","0","0","0","0","0","0","0","0","0","0","0"
"1999","Chestermere, Alberta, Royal Canadian Mounted Police, municipal","48005","Using firearm in commission of offence","0","0","0","0","0","0","0","0","0","0","0","0","0","0"
"2000","Chestermere, Alberta, Royal Canadian Mounted Police, municipal","48005","Using firearm in commission of offence","0","0","0","0","0","0","0","0","0","0","0","0","0","0"
"2001","Chestermere, Alberta, Royal Canadian Mounted Police, municipal","48005","Using firearm in commission of offence","0","0","0","0","0","0","0","0","0","0","0","0","0","0"
"2002","Chestermere, Alberta, Royal Canadian Mounted Police, municipal","48005","Using firearm in commission of offence","0","0","0","0","0","0","0","0","0","0","0","0","0","0"
"2003","Chestermere, Alberta, Royal Canadian Mounted Police, municipal","48005","Using firearm in commission of offence","0","0","0","0","0","0","0","0","0","0","0","0","0","0"
"2004","Chestermere, Alberta, Royal Canadian Mounted Police, municipal","48005","Using firearm in commission of offence","0","0","0","0","0","0","0","0","0","0","0","0","0","0"
"2005","Chestermere, Alberta, Royal Canadian Mounted Police, municipal","48005","Using firearm in commission of offence","0","0","0","0","0","0","0","0","0","0","0","0","0","0"
"2006","Chestermere, Alberta, Royal Canadian Mounted Police, municipal","48005","Using firearm in commission of offence","0","0","0","0","0","0","0","0","0","0","0","0","0","0"
"2007","Chestermere, Alberta, Royal Canadian Mounted Police, municipal","48005","Using firearm in commission of offence","0","0","0","0","0","0","0","0","0","0","0","0","0","0"
"2008","Chestermere, Alberta, Royal Canadian Mounted Police, municipal","48005","Using firearm in commission of offence","0","0","0","0","0","0","0","0","0","0","0","0","0","0"
"2009","Chestermere, Alberta, Royal Canadian Mounted Police, municipal","48005","Using firearm in commission of offence","0","0","0","0","0","0","0","0","0","0","0","0","0","0"
"2010","Chestermere, Alberta, Royal Canadian Mounted Police, municipal","48005","Using firearm in commission of offence","1","0","1","0","6.94","0","0","0","73.64","1","0","0","0","1"
"2011","Chestermere, Alberta, Royal Canadian Mounted Police, municipal","48005","Using firearm in commission of offence","0","0","0","-100","0","0","0","0","0","0","0","0","0","0"
"2012","Chestermere, Alberta, Royal Canadian Mounted Police, municipal","48005","Using firearm in commission of offence","0","0","0","0","0","0","0","0","0","0","0","0","0","0"
"2013","Chestermere, Alberta, Royal Canadian Mounted Police, municipal","48005","Using firearm in commission of offence","0","0","0","0","0","0","0","0","0","0","0","0","0","0"
"2014","Chestermere, Alberta, Royal Canadian Mounted Police, municipal","48005","Using firearm in commission of offence","0","0","0","0","0","0","0","0","0","0","0","0","0","0"
"2015","Chestermere, Alberta, Royal Canadian Mounted Police, municipal","48005","Using firearm in commission of offence","0","0","0","0","0","0","0","0","0","0","0","0","0","0"
"2016","Chestermere, Alberta, Royal Canadian Mounted Police, municipal","48005","Using firearm in commission of offence","0","0","0","0","0","0","0","0","0","0","0","0","0","0"
"1998","Chestermere, Alberta, Royal Canadian Mounted Police, municipal","48005","Pointing a firearm","0","0","0","0","0","0","0","0","0","0","0","0","0","0"
"1999","Chestermere, Alberta, Royal Canadian Mounted Police, municipal","48005","Pointing a firearm","0","0","0","0","0","0","0","0","0","0","0","0","0","0"
"2000","Chestermere, Alberta, Royal Canadian Mounted Police, municipal","48005","Pointing a firearm","0","0","0","0","0","0","0","0","0","0","0","0","0","0"
"2001","Chestermere, Alberta, Royal Canadian Mounted Police, municipal","48005","Pointing a firearm","0","0","0","0","0","0","0","0","0","0","0","0","0","0"
"2002","Chestermere, Alberta, Royal Canadian Mounted Police, municipal","48005","Pointing a firearm","0","0","0","0","0","0","0","0","0","0","0","0","0","0"
"2003","Chestermere, Alberta, Royal Canadian Mounted Police, municipal","48005","Pointing a firearm","0","0","0","0","0","0","0","0","0","0","0","0","0","0"
"2004","Chestermere, Alberta, Royal Canadian Mounted Police, municipal","48005","Pointing a firearm","0","0","0","0","0","0","0","0","0","0","0","0","0","0"
"2005","Chestermere, Alberta, Royal Canadian Mounted Police, municipal","48005","Pointing a firearm","0","0","0","0","0","0","0","0","0","0","0","0","0","0"
"2006","Chestermere, Alberta, Royal Canadian Mounted Police, municipal","48005","Pointing a firearm","0","0","0","0","0","0","0","0","0","0","0","0","0","0"
"2007","Chestermere, Alberta, Royal Canadian Mounted Police, municipal","48005","Pointing a firearm","0","0","0","0","0","0","0","0","0","0","0","0","0","0"
"2008","Chestermere, Alberta, Royal Canadian Mounted Police, municipal","48005","Pointing a firearm","0","0","0","0","0","0","0","0","0","0","0","0","0","0"
"2009","Chestermere, Alberta, Royal Canadian Mounted Police, municipal","48005","Pointing a firearm","1","0","1","0","7.44","0","0","0","237.91","1","0","0","0","3"
"2010","Chestermere, Alberta, Royal Canadian Mounted Police, municipal","48005","Pointing a firearm","0","0","0","-100","0","0","0","0","0","0","0","0","0","0"
"2011","Chestermere, Alberta, Royal Canadian Mounted Police, municipal","48005","Pointing a firearm","0","0","0","0","0","0","0","0","0","0","0","0","0","0"
"2012","Chestermere, Alberta, Royal Canadian Mounted Police, municipal","48005","Pointing a firearm","0","0","0","0","0","0","0","0","0","0","0","0","0","0"
"2013","Chestermere, Alberta, Royal Canadian Mounted Police, municipal","48005","Pointing a firearm","0","0","0","0","0","0","0","0","0","0","0","0","0","0"
"2014","Chestermere, Alberta, Royal Canadian Mounted Police, municipal","48005","Pointing a firearm","0","0","0","0","0","0","0","0","0","0","0","0","0","0"
"2015","Chestermere, Alberta, Royal Canadian Mounted Police, municipal","48005","Pointing a firearm","3","0","3","0","17.33","0","0","0","0","3","0","0","0","0"
"2016","Chestermere, Alberta, Royal Canadian Mounted Police, municipal","48005","Pointing a firearm","0","0","0","-100","0","0","0","0","0","0","0","0","0","0"
"1998","Chestermere, Alberta, Royal Canadian Mounted Police, municipal","48005","Total robbery","0","0","0","0","0","0","0","0","0","0","0","0","0","0"
"1999","Chestermere, Alberta, Royal Canadian Mounted Police, municipal","48005","Total robbery","0","0","0","0","0","0","0","0","0","0","0","0","0","0"
"2000","Chestermere, Alberta, Royal Canadian Mounted Police, municipal","48005","Total robbery","0","0","0","0","0","0","0","0","0","0","0","0","0","0"
"2001","Chestermere, Alberta, Royal Canadian Mounted Police, municipal","48005","Total robbery","0","0","0","0","0","0","0","0","0","0","0","0","0","0"
"2002","Chestermere, Alberta, Royal Canadian Mounted Police, municipal","48005","Total robbery","0","0","0","0","0","0","0","0","0","0","0","0","0","0"
"2003","Chestermere, Alberta, Royal Canadian Mounted Police, municipal","48005","Total robbery","0","0","0","0","0","0","0","0","0","0","0","0","0","0"
"2004","Chestermere, Alberta, Royal Canadian Mounted Police, municipal","48005","Total robbery","0","0","0","0","0","0","0","0","0","0","0","0","0","0"
"2005","Chestermere, Alberta, Royal Canadian Mounted Police, municipal","48005","Total robbery","0","0","0","0","0","0","0","0","0","0","0","0","0","0"
"2006","Chestermere, Alberta, Royal Canadian Mounted Police, municipal","48005","Total robbery","1","1","0","0","9.62","13.52","11.88","0","0","1","1","1","0","0"
"2007","Chestermere, Alberta, Royal Canadian Mounted Police, municipal","48005","Total robbery","3","0","0","174.34","26.4","0","0","0","0","0","0","0","0","0"
"2008","Chestermere, Alberta, Royal Canadian Mounted Police, municipal","48005","Total robbery","4","1","1","22.44","32.33","22.57","19.92","0","0","2","2","2","0","0"
"2009","Chestermere, Alberta, Royal Canadian Mounted Police, municipal","48005","Total robbery","0","0","0","-100","0","0","0","0","0","0","0","0","0","0"
"2010","Chestermere, Alberta, Royal Canadian Mounted Police, municipal","48005","Total robbery","1","1","0","0","6.94","9.66","8.54","0","0","1","1","1","0","0"
"2011","Chestermere, Alberta, Royal Canadian Mounted Police, municipal","48005","Total robbery","0","0","0","-100","0","0","0","0","0","0","0","0","0","0"
"2012","Chestermere, Alberta, Royal Canadian Mounted Police, municipal","48005","Total robbery","1","0","0","0","6.31","0","0","0","0","0","0","0","0","0"
"2013","Chestermere, Alberta, Royal Canadian Mounted Police, municipal","48005","Total robbery","0","0","0","-100","0","0","0","0","0","0","0","0","0","0"
"2014","Chestermere, Alberta, Royal Canadian Mounted Police, municipal","48005","Total robbery","1","0","0","0","5.9","0","0","0","0","0","0","0","0","0"
"2015","Chestermere, Alberta, Royal Canadian Mounted Police, municipal","48005","Total robbery","3","2","0","193.42","17.33","15.99","14.37","0","0","2","2","2","0","0"
"2016","Chestermere, Alberta, Royal Canadian Mounted Police, municipal","48005","Total robbery","4","3","0","30.08","22.54","0","28.09","276.82","0","3","0","4","4","0"
"1998","Chestermere, Alberta, Royal Canadian Mounted Police, municipal","48005","Robbery","0","0","0","0","0","0","0","0","0","0","0","0","0","0"
"1999","Chestermere, Alberta, Royal Canadian Mounted Police, municipal","48005","Robbery","0","0","0","0","0","0","0","0","0","0","0","0","0","0"
"2000","Chestermere, Alberta, Royal Canadian Mounted Police, municipal","48005","Robbery","0","0","0","0","0","0","0","0","0","0","0","0","0","0"
"2001","Chestermere, Alberta, Royal Canadian Mounted Police, municipal","48005","Robbery","0","0","0","0","0","0","0","0","0","0","0","0","0","0"
"2002","Chestermere, Alberta, Royal Canadian Mounted Police, municipal","48005","Robbery","0","0","0","0","0","0","0","0","0","0","0","0","0","0"
"2003","Chestermere, Alberta, Royal Canadian Mounted Police, municipal","48005","Robbery","0","0","0","0","0","0","0","0","0","0","0","0","0","0"
"2004","Chestermere, Alberta, Royal Canadian Mounted Police, municipal","48005","Robbery","0","0","0","0","0","0","0","0","0","0","0","0","0","0"
"2005","Chestermere, Alberta, Royal Canadian Mounted Police, municipal","48005","Robbery","0","0","0","0","0","0","0","0","0","0","0","0","0","0"
"2006","Chestermere, Alberta, Royal Canadian Mounted Police, municipal","48005","Robbery","1","1","0","0","9.62","13.52","11.88","0","0","1","1","1","0","0"
"2007","Chestermere, Alberta, Royal Canadian Mounted Police, municipal","48005","Robbery","3","0","0","174.34","26.4","0","0","0","0","0","0","0","0","0"
"2008","Chestermere, Alberta, Royal Canadian Mounted Police, municipal","48005","Robbery","4","1","1","22.44","32.33","22.57","19.92","0","0","2","2","2","0","0"
"2009","Chestermere, Alberta, Royal Canadian Mounted Police, municipal","48005","Robbery","0","0","0","-100","0","0","0","0","0","0","0","0","0","0"
"2010","Chestermere, Alberta, Royal Canadian Mounted Police, municipal","48005","Robbery","1","1","0","0","6.94","9.66","8.54","0","0","1","1","1","0","0"
"2011","Chestermere, Alberta, Royal Canadian Mounted Police, municipal","48005","Robbery","0","0","0","-100","0","0","0","0","0","0","0","0","0","0"
"2012","Chestermere, Alberta, Royal Canadian Mounted Police, municipal","48005","Robbery","1","0","0","0","6.31","0","0","0","0","0","0","0","0","0"
"2013","Chestermere, Alberta, Royal Canadian Mounted Police, municipal","48005","Robbery","0","0","0","-100","0","0","0","0","0","0","0","0","0","0"
"2014","Chestermere, Alberta, Royal Canadian Mounted Police, municipal","48005","Robbery","1","0","0","0","5.9","0","0","0","0","0","0","0","0","0"
"2015","Chestermere, Alberta, Royal Canadian Mounted Police, municipal","48005","Robbery","3","2","0","193.42","17.33","15.99","14.37","0","0","2","2","2","0","0"
"2016","Chestermere, Alberta, Royal Canadian Mounted Police, municipal","48005","Robbery","4","3","0","30.08","22.54","0","28.09","276.82","0","3","0","4","4","0"
"2005","Chestermere, Alberta, Royal Canadian Mounted Police, municipal","48005","Robbery to steal a firearm","0","0","0","0","0","0","0","0","0","0","0","0","0","0"
"2006","Chestermere, Alberta, Royal Canadian Mounted Police, municipal","48005","Robbery to steal a firearm","0","0","0","0","0","0","0","0","0","0","0","0","0","0"
"2007","Chestermere, Alberta, Royal Canadian Mounted Police, municipal","48005","Robbery to steal a firearm","0","0","0","0","0","0","0","0","0","0","0","0","0","0"
"2008","Chestermere, Alberta, Royal Canadian Mounted Police, municipal","48005","Robbery to steal a firearm","0","0","0","0","0","0","0","0","0","0","0","0","0","0"
"2009","Chestermere, Alberta, Royal Canadian Mounted Police, municipal","48005","Robbery to steal a firearm","0","0","0","0","0","0","0","0","0","0","0","0","0","0"
"2010","Chestermere, Alberta, Royal Canadian Mounted Police, municipal","48005","Robbery to steal a firearm","0","0","0","0","0","0","0","0","0","0","0","0","0","0"
"2011","Chestermere, Alberta, Royal Canadian Mounted Police, municipal","48005","Robbery to steal a firearm","0","0","0","0","0","0","0","0","0","0","0","0","0","0"
"2012","Chestermere, Alberta, Royal Canadian Mounted Police, municipal","48005","Robbery to steal a firearm","0","0","0","0","0","0","0","0","0","0","0","0","0","0"
"2013","Chestermere, Alberta, Royal Canadian Mounted Police, municipal","48005","Robbery to steal a firearm","0","0","0","0","0","0","0","0","0","0","0","0","0","0"
"2014","Chestermere, Alberta, Royal Canadian Mounted Police, municipal","48005","Robbery to steal a firearm","0","0","0","0","0","0","0","0","0","0","0","0","0","0"
"2015","Chestermere, Alberta, Royal Canadian Mounted Police, municipal","48005","Robbery to steal a firearm","0","0","0","0","0","0","0","0","0","0","0","0","0","0"
"2016","Chestermere, Alberta, Royal Canadian Mounted Police, municipal","48005","Robbery to steal a firearm","0","0","0","0","0","0","0","0","0","0","0","0","0","0"
"1998","Chestermere, Alberta, Royal Canadian Mounted Police, municipal","48005","Total forcible confinement or kidnapping","0","0","0","0","0","0","0","0","0","0","0","0","0","0"
"1999","Chestermere, Alberta, Royal Canadian Mounted Police, municipal","48005","Total forcible confinement or kidnapping","0","0","0","0","0","0","0","0","0","0","0","0","0","0"
"2000","Chestermere, Alberta, Royal Canadian Mounted Police, municipal","48005","Total forcible confinement or kidnapping","0","0","0","0","0","0","0","0","0","0","0","0","0","0"
"2001","Chestermere, Alberta, Royal Canadian Mounted Police, municipal","48005","Total forcible confinement or kidnapping","0","0","0","0","0","0","0","0","0","0","0","0","0","0"
"2002","Chestermere, Alberta, Royal Canadian Mounted Police, municipal","48005","Total forcible confinement or kidnapping","0","0","0","0","0","0","0","0","0","0","0","0","0","0"
"2003","Chestermere, Alberta, Royal Canadian Mounted Police, municipal","48005","Total forcible confinement or kidnapping","0","0","0","0","0","0","0","0","0","0","0","0","0","0"
"2004","Chestermere, Alberta, Royal Canadian Mounted Police, municipal","48005","Total forcible confinement or kidnapping","0","0","0","0","0","0","0","0","0","0","0","0","0","0"
"2005","Chestermere, Alberta, Royal Canadian Mounted Police, municipal","48005","Total forcible confinement or kidnapping","0","0","0","0","0","0","0","0","0","0","0","0","0","0"
"2006","Chestermere, Alberta, Royal Canadian Mounted Police, municipal","48005","Total forcible confinement or kidnapping","1","1","0","0","9.62","13.52","11.88","0","0","1","1","1","0","0"
"2007","Chestermere, Alberta, Royal Canadian Mounted Police, municipal","48005","Total forcible confinement or kidnapping","0","0","0","-100","0","0","0","0","0","0","0","0","0","0"
"2008","Chestermere, Alberta, Royal Canadian Mounted Police, municipal","48005","Total forcible confinement or kidnapping","4","2","1","0","32.33","33.85","29.88","0","0","3","3","3","0","0"
"2009","Chestermere, Alberta, Royal Canadian Mounted Police, municipal","48005","Total forcible confinement or kidnapping","2","1","0","-53.95","14.89","20.7","18.31","0","0","1","2","2","0","0"
"2010","Chestermere, Alberta, Royal Canadian Mounted Police, municipal","48005","Total forcible confinement or kidnapping","0","0","0","-100","0","0","0","0","0","0","0","0","0","0"
"2011","Chestermere, Alberta, Royal Canadian Mounted Police, municipal","48005","Total forcible confinement or kidnapping","1","1","0","0","6.5","0","0","0","0","1","0","0","0","0"
"2012","Chestermere, Alberta, Royal Canadian Mounted Police, municipal","48005","Total forcible confinement or kidnapping","0","0","0","-100","0","0","0","0","0","0","0","0","0","0"
"2013","Chestermere, Alberta, Royal Canadian Mounted Police, municipal","48005","Total forcible confinement or kidnapping","0","0","0","0","0","0","0","0","0","0","0","0","0","0"
"2014","Chestermere, Alberta, Royal Canadian Mounted Police, municipal","48005","Total forcible confinement or kidnapping","0","0","0","0","0","0","0","0","0","0","0","0","0","0"
"2015","Chestermere, Alberta, Royal Canadian Mounted Police, municipal","48005","Total forcible confinement or kidnapping","0","0","0","0","0","0","0","0","0","0","0","0","0","0"
"2016","Chestermere, Alberta, Royal Canadian Mounted Police, municipal","48005","Total forcible confinement or kidnapping","0","0","0","0","0","0","0","0","0","0","0","0","0","0"
"1998","Chestermere, Alberta, Royal Canadian Mounted Police, municipal","48005","Forcible confinement or kidnapping","0","0","0","0","0","0","0","0","0","0","0","0","0","0"
"1999","Chestermere, Alberta, Royal Canadian Mounted Police, municipal","48005","Forcible confinement or kidnapping","0","0","0","0","0","0","0","0","0","0","0","0","0","0"
"2000","Chestermere, Alberta, Royal Canadian Mounted Police, municipal","48005","Forcible confinement or kidnapping","0","0","0","0","0","0","0","0","0","0","0","0","0","0"
"2001","Chestermere, Alberta, Royal Canadian Mounted Police, municipal","48005","Forcible confinement or kidnapping","0","0","0","0","0","0","0","0","0","0","0","0","0","0"
"2002","Chestermere, Alberta, Royal Canadian Mounted Police, municipal","48005","Forcible confinement or kidnapping","0","0","0","0","0","0","0","0","0","0","0","0","0","0"
"2003","Chestermere, Alberta, Royal Canadian Mounted Police, municipal","48005","Forcible confinement or kidnapping","0","0","0","0","0","0","0","0","0","0","0","0","0","0"
"2004","Chestermere, Alberta, Royal Canadian Mounted Police, municipal","48005","Forcible confinement or kidnapping","0","0","0","0","0","0","0","0","0","0","0","0","0","0"
"2005","Chestermere, Alberta, Royal Canadian Mounted Police, municipal","48005","Forcible confinement or kidnapping","0","0","0","0","0","0","0","0","0","0","0","0","0","0"
"2006","Chestermere, Alberta, Royal Canadian Mounted Police, municipal","48005","Forcible confinement or kidnapping","1","1","0","0","9.62","13.52","11.88","0","0","1","1","1","0","0"
"2007","Chestermere, Alberta, Royal Canadian Mounted Police, municipal","48005","Forcible confinement or kidnapping","0","0","0","-100","0","0","0","0","0","0","0","0","0","0"
"2008","Chestermere, Alberta, Royal Canadian Mounted Police, municipal","48005","Forcible confinement or kidnapping","4","2","1","0","32.33","33.85","29.88","0","0","3","3","3","0","0"
"2009","Chestermere, Alberta, Royal Canadian Mounted Police, municipal","48005","Forcible confinement or kidnapping","2","1","0","-53.95","14.89","20.7","18.31","0","0","1","2","2","0","0"
"2010","Chestermere, Alberta, Royal Canadian Mounted Police, municipal","48005","Forcible confinement or kidnapping","0","0","0","-100","0","0","0","0","0","0","0","0","0","0"
"2011","Chestermere, Alberta, Royal Canadian Mounted Police, municipal","48005","Forcible confinement or kidnapping","0","0","0","0","0","0","0","0","0","0","0","0","0","0"
"2012","Chestermere, Alberta, Royal Canadian Mounted Police, municipal","48005","Forcible confinement or kidnapping","0","0","0","0","0","0","0","0","0","0","0","0","0","0"
"2013","Chestermere, Alberta, Royal Canadian Mounted Police, municipal","48005","Forcible confinement or kidnapping","0","0","0","0","0","0","0","0","0","0","0","0","0","0"
"2014","Chestermere, Alberta, Royal Canadian Mounted Police, municipal","48005","Forcible confinement or kidnapping","0","0","0","0","0","0","0","0","0","0","0","0","0","0"
"2015","Chestermere, Alberta, Royal Canadian Mounted Police, municipal","48005","Forcible confinement or kidnapping","0","0","0","0","0","0","0","0","0","0","0","0","0","0"
"2016","Chestermere, Alberta, Royal Canadian Mounted Police, municipal","48005","Forcible confinement or kidnapping","0","0","0","0","0","0","0","0","0","0","0","0","0","0"
"2005","Chestermere, Alberta, Royal Canadian Mounted Police, municipal","48005","Kidnapping","0","0","0","0","0","0","0","0","0","0","0","0","0","0"
"2006","Chestermere, Alberta, Royal Canadian Mounted Police, municipal","48005","Kidnapping","0","0","0","0","0","0","0","0","0","0","0","0","0","0"
"2007","Chestermere, Alberta, Royal Canadian Mounted Police, municipal","48005","Kidnapping","0","0","0","0","0","0","0","0","0","0","0","0","0","0"
"2008","Chestermere, Alberta, Royal Canadian Mounted Police, municipal","48005","Kidnapping","0","0","0","0","0","0","0","0","0","0","0","0","0","0"
"2009","Chestermere, Alberta, Royal Canadian Mounted Police, municipal","48005","Kidnapping","0","0","0","0","0","0","0","0","0","0","0","0","0","0"
"2010","Chestermere, Alberta, Royal Canadian Mounted Police, municipal","48005","Kidnapping","0","0","0","0","0","0","0","0","0","0","0","0","0","0"
"2011","Chestermere, Alberta, Royal Canadian Mounted Police, municipal","48005","Kidnapping","0","0","0","0","0","0","0","0","0","0","0","0","0","0"
"2012","Chestermere, Alberta, Royal Canadian Mounted Police, municipal","48005","Kidnapping","0","0","0","0","0","0","0","0","0","0","0","0","0","0"
"2013","Chestermere, Alberta, Royal Canadian Mounted Police, municipal","48005","Kidnapping","0","0","0","0","0","0","0","0","0","0","0","0","0","0"
"2014","Chestermere, Alberta, Royal Canadian Mounted Police, municipal","48005","Kidnapping","0","0","0","0","0","0","0","0","0","0","0","0","0","0"
"2015","Chestermere, Alberta, Royal Canadian Mounted Police, municipal","48005","Kidnapping","0","0","0","0","0","0","0","0","0","0","0","0","0","0"
"2016","Chestermere, Alberta, Royal Canadian Mounted Police, municipal","48005","Kidnapping","0","0","0","0","0","0","0","0","0","0","0","0","0","0"
"2005","Chestermere, Alberta, Royal Canadian Mounted Police, municipal","48005","Forcible confinement","0","0","0","0","0","0","0","0","0","0","0","0","0","0"
"2006","Chestermere, Alberta, Royal Canadian Mounted Police, municipal","48005","Forcible confinement","0","0","0","0","0","0","0","0","0","0","0","0","0","0"
"2007","Chestermere, Alberta, Royal Canadian Mounted Police, municipal","48005","Forcible confinement","0","0","0","0","0","0","0","0","0","0","0","0","0","0"
"2008","Chestermere, Alberta, Royal Canadian Mounted Police, municipal","48005","Forcible confinement","0","0","0","0","0","0","0","0","0","0","0","0","0","0"
"2009","Chestermere, Alberta, Royal Canadian Mounted Police, municipal","48005","Forcible confinement","0","0","0","0","0","0","0","0","0","0","0","0","0","0"
"2010","Chestermere, Alberta, Royal Canadian Mounted Police, municipal","48005","Forcible confinement","0","0","0","0","0","0","0","0","0","0","0","0","0","0"
"2011","Chestermere, Alberta, Royal Canadian Mounted Police, municipal","48005","Forcible confinement","1","1","0","0","6.5","0","0","0","0","1","0","0","0","0"
"2012","Chestermere, Alberta, Royal Canadian Mounted Police, municipal","48005","Forcible confinement","0","0","0","-100","0","0","0","0","0","0","0","0","0","0"
"2013","Chestermere, Alberta, Royal Canadian Mounted Police, municipal","48005","Forcible confinement","0","0","0","0","0","0","0","0","0","0","0","0","0","0"
"2014","Chestermere, Alberta, Royal Canadian Mounted Police, municipal","48005","Forcible confinement","0","0","0","0","0","0","0","0","0","0","0","0","0","0"
"2015","Chestermere, Alberta, Royal Canadian Mounted Police, municipal","48005","Forcible confinement","0","0","0","0","0","0","0","0","0","0","0","0","0","0"
"2016","Chestermere, Alberta, Royal Canadian Mounted Police, municipal","48005","Forcible confinement","0","0","0","0","0","0","0","0","0","0","0","0","0","0"
"1998","Chestermere, Alberta, Royal Canadian Mounted Police, municipal","48005","Total abduction","0","0","0","0","0","0","0","0","0","0","0","0","0","0"
"1999","Chestermere, Alberta, Royal Canadian Mounted Police, municipal","48005","Total abduction","0","0","0","0","0","0","0","0","0","0","0","0","0","0"
"2000","Chestermere, Alberta, Royal Canadian Mounted Police, municipal","48005","Total abduction","0","0","0","0","0","0","0","0","0","0","0","0","0","0"
"2001","Chestermere, Alberta, Royal Canadian Mounted Police, municipal","48005","Total abduction","0","0","0","0","0","0","0","0","0","0","0","0","0","0"
"2002","Chestermere, Alberta, Royal Canadian Mounted Police, municipal","48005","Total abduction","0","0","0","0","0","0","0","0","0","0","0","0","0","0"
"2003","Chestermere, Alberta, Royal Canadian Mounted Police, municipal","48005","Total abduction","0","0","0","0","0","0","0","0","0","0","0","0","0","0"
"2004","Chestermere, Alberta, Royal Canadian Mounted Police, municipal","48005","Total abduction","0","0","0","0","0","0","0","0","0","0","0","0","0","0"
"2005","Chestermere, Alberta, Royal Canadian Mounted Police, municipal","48005","Total abduction","0","0","0","0","0","0","0","0","0","0","0","0","0","0"
"2006","Chestermere, Alberta, Royal Canadian Mounted Police, municipal","48005","Total abduction","1","0","0","0","9.62","0","0","0","0","0","0","0","0","0"
"2007","Chestermere, Alberta, Royal Canadian Mounted Police, municipal","48005","Total abduction","1","0","0","-8.55","8.8","0","0","0","0","0","0","0","0","0"
"2008","Chestermere, Alberta, Royal Canadian Mounted Police, municipal","48005","Total abduction","0","0","0","-100","0","0","0","0","0","0","0","0","0","0"
"2009","Chestermere, Alberta, Royal Canadian Mounted Police, municipal","48005","Total abduction","0","0","0","0","0","0","0","0","0","0","0","0","0","0"
"2010","Chestermere, Alberta, Royal Canadian Mounted Police, municipal","48005","Total abduction","0","0","0","0","0","0","0","0","0","0","0","0","0","0"
"2011","Chestermere, Alberta, Royal Canadian Mounted Police, municipal","48005","Total abduction","0","0","0","0","0","0","0","0","0","0","0","0","0","0"
"2012","Chestermere, Alberta, Royal Canadian Mounted Police, municipal","48005","Total abduction","0","0","0","0","0","0","0","0","0","0","0","0","0","0"
"2013","Chestermere, Alberta, Royal Canadian Mounted Police, municipal","48005","Total abduction","0","0","0","0","0","0","0","0","0","0","0","0","0","0"
"2014","Chestermere, Alberta, Royal Canadian Mounted Police, municipal","48005","Total abduction","0","0","0","0","0","0","0","0","0","0","0","0","0","0"
"2015","Chestermere, Alberta, Royal Canadian Mounted Police, municipal","48005","Total abduction","0","0","0","0","0","0","0","0","0","0","0","0","0","0"
"2016","Chestermere, Alberta, Royal Canadian Mounted Police, municipal","48005","Total abduction","0","0","0","0","0","0","0","0","0","0","0","0","0","0"
"1998","Chestermere, Alberta, Royal Canadian Mounted Police, municipal","48005","Abduction under the age 14, not parent or guardian","0","0","0","0","0","0","0","0","0","0","0","0","0","0"
"1999","Chestermere, Alberta, Royal Canadian Mounted Police, municipal","48005","Abduction under the age 14, not parent or guardian","0","0","0","0","0","0","0","0","0","0","0","0","0","0"
"2000","Chestermere, Alberta, Royal Canadian Mounted Police, municipal","48005","Abduction under the age 14, not parent or guardian","0","0","0","0","0","0","0","0","0","0","0","0","0","0"
"2001","Chestermere, Alberta, Royal Canadian Mounted Police, municipal","48005","Abduction under the age 14, not parent or guardian","0","0","0","0","0","0","0","0","0","0","0","0","0","0"
"2002","Chestermere, Alberta, Royal Canadian Mounted Police, municipal","48005","Abduction under the age 14, not parent or guardian","0","0","0","0","0","0","0","0","0","0","0","0","0","0"
"2003","Chestermere, Alberta, Royal Canadian Mounted Police, municipal","48005","Abduction under the age 14, not parent or guardian","0","0","0","0","0","0","0","0","0","0","0","0","0","0"
"2004","Chestermere, Alberta, Royal Canadian Mounted Police, municipal","48005","Abduction under the age 14, not parent or guardian","0","0","0","0","0","0","0","0","0","0","0","0","0","0"
"2005","Chestermere, Alberta, Royal Canadian Mounted Police, municipal","48005","Abduction under the age 14, not parent or guardian","0","0","0","0","0","0","0","0","0","0","0","0","0","0"
"2006","Chestermere, Alberta, Royal Canadian Mounted Police, municipal","48005","Abduction under the age 14, not parent or guardian","1","0","0","0","9.62","0","0","0","0","0","0","0","0","0"
"2007","Chestermere, Alberta, Royal Canadian Mounted Police, municipal","48005","Abduction under the age 14, not parent or guardian","0","0","0","-100","0","0","0","0","0","0","0","0","0","0"
"2008","Chestermere, Alberta, Royal Canadian Mounted Police, municipal","48005","Abduction under the age 14, not parent or guardian","0","0","0","0","0","0","0","0","0","0","0","0","0","0"
"2009","Chestermere, Alberta, Royal Canadian Mounted Police, municipal","48005","Abduction under the age 14, not parent or guardian","0","0","0","0","0","0","0","0","0","0","0","0","0","0"
"2010","Chestermere, Alberta, Royal Canadian Mounted Police, municipal","48005","Abduction under the age 14, not parent or guardian","0","0","0","0","0","0","0","0","0","0","0","0","0","0"
"2011","Chestermere, Alberta, Royal Canadian Mounted Police, municipal","48005","Abduction under the age 14, not parent or guardian","0","0","0","0","0","0","0","0","0","0","0","0","0","0"
"2012","Chestermere, Alberta, Royal Canadian Mounted Police, municipal","48005","Abduction under the age 14, not parent or guardian","0","0","0","0","0","0","0","0","0","0","0","0","0","0"
"2013","Chestermere, Alberta, Royal Canadian Mounted Police, municipal","48005","Abduction under the age 14, not parent or guardian","0","0","0","0","0","0","0","0","0","0","0","0","0","0"
"2014","Chestermere, Alberta, Royal Canadian Mounted Police, municipal","48005","Abduction under the age 14, not parent or guardian","0","0","0","0","0","0","0","0","0","0","0","0","0","0"
"2015","Chestermere, Alberta, Royal Canadian Mounted Police, municipal","48005","Abduction under the age 14, not parent or guardian","0","0","0","0","0","0","0","0","0","0","0","0","0","0"
"2016","Chestermere, Alberta, Royal Canadian Mounted Police, municipal","48005","Abduction under the age 14, not parent or guardian","0","0","0","0","0","0","0","0","0","0","0","0","0","0"
"1998","Chestermere, Alberta, Royal Canadian Mounted Police, municipal","48005","Abduction under the age 16","0","0","0","0","0","0","0","0","0","0","0","0","0","0"
"1999","Chestermere, Alberta, Royal Canadian Mounted Police, municipal","48005","Abduction under the age 16","0","0","0","0","0","0","0","0","0","0","0","0","0","0"
"2000","Chestermere, Alberta, Royal Canadian Mounted Police, municipal","48005","Abduction under the age 16","0","0","0","0","0","0","0","0","0","0","0","0","0","0"
"2001","Chestermere, Alberta, Royal Canadian Mounted Police, municipal","48005","Abduction under the age 16","0","0","0","0","0","0","0","0","0","0","0","0","0","0"
"2002","Chestermere, Alberta, Royal Canadian Mounted Police, municipal","48005","Abduction under the age 16","0","0","0","0","0","0","0","0","0","0","0","0","0","0"
"2003","Chestermere, Alberta, Royal Canadian Mounted Police, municipal","48005","Abduction under the age 16","0","0","0","0","0","0","0","0","0","0","0","0","0","0"
"2004","Chestermere, Alberta, Royal Canadian Mounted Police, municipal","48005","Abduction under the age 16","0","0","0","0","0","0","0","0","0","0","0","0","0","0"
"2005","Chestermere, Alberta, Royal Canadian Mounted Police, municipal","48005","Abduction under the age 16","0","0","0","0","0","0","0","0","0","0","0","0","0","0"
"2006","Chestermere, Alberta, Royal Canadian Mounted Police, municipal","48005","Abduction under the age 16","0","0","0","0","0","0","0","0","0","0","0","0","0","0"
"2007","Chestermere, Alberta, Royal Canadian Mounted Police, municipal","48005","Abduction under the age 16","1","0","0","0","8.8","0","0","0","0","0","0","0","0","0"
"2008","Chestermere, Alberta, Royal Canadian Mounted Police, municipal","48005","Abduction under the age 16","0","0","0","-100","0","0","0","0","0","0","0","0","0","0"
"2009","Chestermere, Alberta, Royal Canadian Mounted Police, municipal","48005","Abduction under the age 16","0","0","0","0","0","0","0","0","0","0","0","0","0","0"
"2010","Chestermere, Alberta, Royal Canadian Mounted Police, municipal","48005","Abduction under the age 16","0","0","0","0","0","0","0","0","0","0","0","0","0","0"
"2011","Chestermere, Alberta, Royal Canadian Mounted Police, municipal","48005","Abduction under the age 16","0","0","0","0","0","0","0","0","0","0","0","0","0","0"
"2012","Chestermere, Alberta, Royal Canadian Mounted Police, municipal","48005","Abduction under the age 16","0","0","0","0","0","0","0","0","0","0","0","0","0","0"
"2013","Chestermere, Alberta, Royal Canadian Mounted Police, municipal","48005","Abduction under the age 16","0","0","0","0","0","0","0","0","0","0","0","0","0","0"
"2014","Chestermere, Alberta, Royal Canadian Mounted Police, municipal","48005","Abduction under the age 16","0","0","0","0","0","0","0","0","0","0","0","0","0","0"
"2015","Chestermere, Alberta, Royal Canadian Mounted Police, municipal","48005","Abduction under the age 16","0","0","0","0","0","0","0","0","0","0","0","0","0","0"
"2016","Chestermere, Alberta, Royal Canadian Mounted Police, municipal","48005","Abduction under the age 16","0","0","0","0","0","0","0","0","0","0","0","0","0","0"
"1998","Chestermere, Alberta, Royal Canadian Mounted Police, municipal","48005","Removal of children from Canada","0","0","0","0","0","0","0","0","0","0","0","0","0","0"
"1999","Chestermere, Alberta, Royal Canadian Mounted Police, municipal","48005","Removal of children from Canada","0","0","0","0","0","0","0","0","0","0","0","0","0","0"
"2000","Chestermere, Alberta, Royal Canadian Mounted Police, municipal","48005","Removal of children from Canada","0","0","0","0","0","0","0","0","0","0","0","0","0","0"
"2001","Chestermere, Alberta, Royal Canadian Mounted Police, municipal","48005","Removal of children from Canada","0","0","0","0","0","0","0","0","0","0","0","0","0","0"
"2002","Chestermere, Alberta, Royal Canadian Mounted Police, municipal","48005","Removal of children from Canada","0","0","0","0","0","0","0","0","0","0","0","0","0","0"
"2003","Chestermere, Alberta, Royal Canadian Mounted Police, municipal","48005","Removal of children from Canada","0","0","0","0","0","0","0","0","0","0","0","0","0","0"
"2004","Chestermere, Alberta, Royal Canadian Mounted Police, municipal","48005","Removal of children from Canada","0","0","0","0","0","0","0","0","0","0","0","0","0","0"
"2005","Chestermere, Alberta, Royal Canadian Mounted Police, municipal","48005","Removal of children from Canada","0","0","0","0","0","0","0","0","0","0","0","0","0","0"
"2006","Chestermere, Alberta, Royal Canadian Mounted Police, municipal","48005","Removal of children from Canada","0","0","0","0","0","0","0","0","0","0","0","0","0","0"
"2007","Chestermere, Alberta, Royal Canadian Mounted Police, municipal","48005","Removal of children from Canada","0","0","0","0","0","0","0","0","0","0","0","0","0","0"
"2008","Chestermere, Alberta, Royal Canadian Mounted Police, municipal","48005","Removal of children from Canada","0","0","0","0","0","0","0","0","0","0","0","0","0","0"
"2009","Chestermere, Alberta, Royal Canadian Mounted Police, municipal","48005","Removal of children from Canada","0","0","0","0","0","0","0","0","0","0","0","0","0","0"
"2010","Chestermere, Alberta, Royal Canadian Mounted Police, municipal","48005","Removal of children from Canada","0","0","0","0","0","0","0","0","0","0","0","0","0","0"
"2011","Chestermere, Alberta, Royal Canadian Mounted Police, municipal","48005","Removal of children from Canada","0","0","0","0","0","0","0","0","0","0","0","0","0","0"
"2012","Chestermere, Alberta, Royal Canadian Mounted Police, municipal","48005","Removal of children from Canada","0","0","0","0","0","0","0","0","0","0","0","0","0","0"
"2013","Chestermere, Alberta, Royal Canadian Mounted Police, municipal","48005","Removal of children from Canada","0","0","0","0","0","0","0","0","0","0","0","0","0","0"
"2014","Chestermere, Alberta, Royal Canadian Mounted Police, municipal","48005","Removal of children from Canada","0","0","0","0","0","0","0","0","0","0","0","0","0","0"
"2015","Chestermere, Alberta, Royal Canadian Mounted Police, municipal","48005","Removal of children from Canada","0","0","0","0","0","0","0","0","0","0","0","0","0","0"
"2016","Chestermere, Alberta, Royal Canadian Mounted Police, municipal","48005","Removal of children from Canada","0","0","0","0","0","0","0","0","0","0","0","0","0","0"
"1998","Chestermere, Alberta, Royal Canadian Mounted Police, municipal","48005","Abduction under the age 14 contravening a custody order","0","0","0","0","0","0","0","0","0","0","0","0","0","0"
"1999","Chestermere, Alberta, Royal Canadian Mounted Police, municipal","48005","Abduction under the age 14 contravening a custody order","0","0","0","0","0","0","0","0","0","0","0","0","0","0"
"2000","Chestermere, Alberta, Royal Canadian Mounted Police, municipal","48005","Abduction under the age 14 contravening a custody order","0","0","0","0","0","0","0","0","0","0","0","0","0","0"
"2001","Chestermere, Alberta, Royal Canadian Mounted Police, municipal","48005","Abduction under the age 14 contravening a custody order","0","0","0","0","0","0","0","0","0","0","0","0","0","0"
"2002","Chestermere, Alberta, Royal Canadian Mounted Police, municipal","48005","Abduction under the age 14 contravening a custody order","0","0","0","0","0","0","0","0","0","0","0","0","0","0"
"2003","Chestermere, Alberta, Royal Canadian Mounted Police, municipal","48005","Abduction under the age 14 contravening a custody order","0","0","0","0","0","0","0","0","0","0","0","0","0","0"
"2004","Chestermere, Alberta, Royal Canadian Mounted Police, municipal","48005","Abduction under the age 14 contravening a custody order","0","0","0","0","0","0","0","0","0","0","0","0","0","0"
"2005","Chestermere, Alberta, Royal Canadian Mounted Police, municipal","48005","Abduction under the age 14 contravening a custody order","0","0","0","0","0","0","0","0","0","0","0","0","0","0"
"2006","Chestermere, Alberta, Royal Canadian Mounted Police, municipal","48005","Abduction under the age 14 contravening a custody order","0","0","0","0","0","0","0","0","0","0","0","0","0","0"
"2007","Chestermere, Alberta, Royal Canadian Mounted Police, municipal","48005","Abduction under the age 14 contravening a custody order","0","0","0","0","0","0","0","0","0","0","0","0","0","0"
"2008","Chestermere, Alberta, Royal Canadian Mounted Police, municipal","48005","Abduction under the age 14 contravening a custody order","0","0","0","0","0","0","0","0","0","0","0","0","0","0"
"2009","Chestermere, Alberta, Royal Canadian Mounted Police, municipal","48005","Abduction under the age 14 contravening a custody order","0","0","0","0","0","0","0","0","0","0","0","0","0","0"
"2010","Chestermere, Alberta, Royal Canadian Mounted Police, municipal","48005","Abduction under the age 14 contravening a custody order","0","0","0","0","0","0","0","0","0","0","0","0","0","0"
"2011","Chestermere, Alberta, Royal Canadian Mounted Police, municipal","48005","Abduction under the age 14 contravening a custody order","0","0","0","0","0","0","0","0","0","0","0","0","0","0"
"2012","Chestermere, Alberta, Royal Canadian Mounted Police, municipal","48005","Abduction under the age 14 contravening a custody order","0","0","0","0","0","0","0","0","0","0","0","0","0","0"
"2013","Chestermere, Alberta, Royal Canadian Mounted Police, municipal","48005","Abduction under the age 14 contravening a custody order","0","0","0","0","0","0","0","0","0","0","0","0","0","0"
"2014","Chestermere, Alberta, Royal Canadian Mounted Police, municipal","48005","Abduction under the age 14 contravening a custody order","0","0","0","0","0","0","0","0","0","0","0","0","0","0"
"2015","Chestermere, Alberta, Royal Canadian Mounted Police, municipal","48005","Abduction under the age 14 contravening a custody order","0","0","0","0","0","0","0","0","0","0","0","0","0","0"
"2016","Chestermere, Alberta, Royal Canadian Mounted Police, municipal","48005","Abduction under the age 14 contravening a custody order","0","0","0","0","0","0","0","0","0","0","0","0","0","0"
"1998","Chestermere, Alberta, Royal Canadian Mounted Police, municipal","48005","Abduction under age 14, by parent or guardian","0","0","0","0","0","0","0","0","0","0","0","0","0","0"
"1999","Chestermere, Alberta, Royal Canadian Mounted Police, municipal","48005","Abduction under age 14, by parent or guardian","0","0","0","0","0","0","0","0","0","0","0","0","0","0"
"2000","Chestermere, Alberta, Royal Canadian Mounted Police, municipal","48005","Abduction under age 14, by parent or guardian","0","0","0","0","0","0","0","0","0","0","0","0","0","0"
"2001","Chestermere, Alberta, Royal Canadian Mounted Police, municipal","48005","Abduction under age 14, by parent or guardian","0","0","0","0","0","0","0","0","0","0","0","0","0","0"
"2002","Chestermere, Alberta, Royal Canadian Mounted Police, municipal","48005","Abduction under age 14, by parent or guardian","0","0","0","0","0","0","0","0","0","0","0","0","0","0"
"2003","Chestermere, Alberta, Royal Canadian Mounted Police, municipal","48005","Abduction under age 14, by parent or guardian","0","0","0","0","0","0","0","0","0","0","0","0","0","0"
"2004","Chestermere, Alberta, Royal Canadian Mounted Police, municipal","48005","Abduction under age 14, by parent or guardian","0","0","0","0","0","0","0","0","0","0","0","0","0","0"
"2005","Chestermere, Alberta, Royal Canadian Mounted Police, municipal","48005","Abduction under age 14, by parent or guardian","0","0","0","0","0","0","0","0","0","0","0","0","0","0"
"2006","Chestermere, Alberta, Royal Canadian Mounted Police, municipal","48005","Abduction under age 14, by parent or guardian","0","0","0","0","0","0","0","0","0","0","0","0","0","0"
"2007","Chestermere, Alberta, Royal Canadian Mounted Police, municipal","48005","Abduction under age 14, by parent or guardian","0","0","0","0","0","0","0","0","0","0","0","0","0","0"
"2008","Chestermere, Alberta, Royal Canadian Mounted Police, municipal","48005","Abduction under age 14, by parent or guardian","0","0","0","0","0","0","0","0","0","0","0","0","0","0"
"2009","Chestermere, Alberta, Royal Canadian Mounted Police, municipal","48005","Abduction under age 14, by parent or guardian","0","0","0","0","0","0","0","0","0","0","0","0","0","0"
"2010","Chestermere, Alberta, Royal Canadian Mounted Police, municipal","48005","Abduction under age 14, by parent or guardian","0","0","0","0","0","0","0","0","0","0","0","0","0","0"
"2011","Chestermere, Alberta, Royal Canadian Mounted Police, municipal","48005","Abduction under age 14, by parent or guardian","0","0","0","0","0","0","0","0","0","0","0","0","0","0"
"2012","Chestermere, Alberta, Royal Canadian Mounted Police, municipal","48005","Abduction under age 14, by parent or guardian","0","0","0","0","0","0","0","0","0","0","0","0","0","0"
"2013","Chestermere, Alberta, Royal Canadian Mounted Police, municipal","48005","Abduction under age 14, by parent or guardian","0","0","0","0","0","0","0","0","0","0","0","0","0","0"
"2014","Chestermere, Alberta, Royal Canadian Mounted Police, municipal","48005","Abduction under age 14, by parent or guardian","0","0","0","0","0","0","0","0","0","0","0","0","0","0"
"2015","Chestermere, Alberta, Royal Canadian Mounted Police, municipal","48005","Abduction under age 14, by parent or guardian","0","0","0","0","0","0","0","0","0","0","0","0","0","0"
"2016","Chestermere, Alberta, Royal Canadian Mounted Police, municipal","48005","Abduction under age 14, by parent or guardian","0","0","0","0","0","0","0","0","0","0","0","0","0","0"
"1998","Chestermere, Alberta, Royal Canadian Mounted Police, municipal","48005","Extortion","0","0","0","0","0","0","0","0","0","0","0","0","0","0"
"1999","Chestermere, Alberta, Royal Canadian Mounted Police, municipal","48005","Extortion","0","0","0","0","0","0","0","0","0","0","0","0","0","0"
"2000","Chestermere, Alberta, Royal Canadian Mounted Police, municipal","48005","Extortion","0","0","0","0","0","0","0","0","0","0","0","0","0","0"
"2001","Chestermere, Alberta, Royal Canadian Mounted Police, municipal","48005","Extortion","0","0","0","0","0","0","0","0","0","0","0","0","0","0"
"2002","Chestermere, Alberta, Royal Canadian Mounted Police, municipal","48005","Extortion","0","0","0","0","0","0","0","0","0","0","0","0","0","0"
"2003","Chestermere, Alberta, Royal Canadian Mounted Police, municipal","48005","Extortion","0","0","0","0","0","0","0","0","0","0","0","0","0","0"
"2004","Chestermere, Alberta, Royal Canadian Mounted Police, municipal","48005","Extortion","0","0","0","0","0","0","0","0","0","0","0","0","0","0"
"2005","Chestermere, Alberta, Royal Canadian Mounted Police, municipal","48005","Extortion","0","0","0","0","0","0","0","0","0","0","0","0","0","0"
"2006","Chestermere, Alberta, Royal Canadian Mounted Police, municipal","48005","Extortion","1","0","0","0","9.62","0","0","0","0","0","0","0","0","0"
"2007","Chestermere, Alberta, Royal Canadian Mounted Police, municipal","48005","Extortion","0","0","0","-100","0","0","0","0","0","0","0","0","0","0"
"2008","Chestermere, Alberta, Royal Canadian Mounted Police, municipal","48005","Extortion","3","2","1","0","24.25","22.57","19.92","0","254.67","3","2","2","0","3"
"2009","Chestermere, Alberta, Royal Canadian Mounted Police, municipal","48005","Extortion","0","0","0","-100","0","0","0","0","0","0","0","0","0","0"
"2010","Chestermere, Alberta, Royal Canadian Mounted Police, municipal","48005","Extortion","1","0","1","0","6.94","0","0","0","147.28","1","0","0","0","2"
"2011","Chestermere, Alberta, Royal Canadian Mounted Police, municipal","48005","Extortion","0","0","0","-100","0","0","0","0","0","0","0","0","0","0"
"2012","Chestermere, Alberta, Royal Canadian Mounted Police, municipal","48005","Extortion","0","0","0","0","0","0","0","0","0","0","0","0","0","0"
"2013","Chestermere, Alberta, Royal Canadian Mounted Police, municipal","48005","Extortion","0","0","0","0","0","0","0","0","0","0","0","0","0","0"
"2014","Chestermere, Alberta, Royal Canadian Mounted Police, municipal","48005","Extortion","0","0","0","0","0","0","0","0","0","0","0","0","0","0"
"2015","Chestermere, Alberta, Royal Canadian Mounted Police, municipal","48005","Extortion","0","0","0","0","0","0","0","0","0","0","0","0","0","0"
"2016","Chestermere, Alberta, Royal Canadian Mounted Police, municipal","48005","Extortion","1","0","0","0","5.63","0","0","0","0","0","0","0","0","0"
"1998","Chestermere, Alberta, Royal Canadian Mounted Police, municipal","48005","Criminal harassment","0","0","0","0","0","0","0","0","0","0","0","0","0","0"
"1999","Chestermere, Alberta, Royal Canadian Mounted Police, municipal","48005","Criminal harassment","0","0","0","0","0","0","0","0","0","0","0","0","0","0"
"2000","Chestermere, Alberta, Royal Canadian Mounted Police, municipal","48005","Criminal harassment","0","0","0","0","0","0","0","0","0","0","0","0","0","0"
"2001","Chestermere, Alberta, Royal Canadian Mounted Police, municipal","48005","Criminal harassment","0","0","0","0","0","0","0","0","0","0","0","0","0","0"
"2002","Chestermere, Alberta, Royal Canadian Mounted Police, municipal","48005","Criminal harassment","0","0","0","0","0","0","0","0","0","0","0","0","0","0"
"2003","Chestermere, Alberta, Royal Canadian Mounted Police, municipal","48005","Criminal harassment","0","0","0","0","0","0","0","0","0","0","0","0","0","0"
"2004","Chestermere, Alberta, Royal Canadian Mounted Police, municipal","48005","Criminal harassment","0","0","0","0","0","0","0","0","0","0","0","0","0","0"
"2005","Chestermere, Alberta, Royal Canadian Mounted Police, municipal","48005","Criminal harassment","3","1","1","0","34.63","15.99","14.14","0","0","2","1","1","0","0"
"2006","Chestermere, Alberta, Royal Canadian Mounted Police, municipal","48005","Criminal harassment","8","0","5","122.32","77","0","0","0","394.09","5","0","0","0","4"
"2007","Chestermere, Alberta, Royal Canadian Mounted Police, municipal","48005","Criminal harassment","4","0","4","-54.28","35.21","0","0","0","0","4","0","0","0","0"
"2008","Chestermere, Alberta, Royal Canadian Mounted Police, municipal","48005","Criminal harassment","6","3","4","37.74","48.49","45.13","39.84","0","169.78","7","4","4","0","2"
"2009","Chestermere, Alberta, Royal Canadian Mounted Police, municipal","48005","Criminal harassment","7","2","3","7.46","52.11","20.7","18.31","0","237.91","5","2","2","0","3"
"2010","Chestermere, Alberta, Royal Canadian Mounted Police, municipal","48005","Criminal harassment","6","2","4","-20.14","41.62","19.31","17.07","0","0","6","2","2","0","0"
"2011","Chestermere, Alberta, Royal Canadian Mounted Police, municipal","48005","Criminal harassment","10","1","5","56.17","64.99","9.06","8.05","0","72.46","6","1","1","0","1"
"2012","Chestermere, Alberta, Royal Canadian Mounted Police, municipal","48005","Criminal harassment","8","2","6","-22.33","50.48","8.78","15.65","72.05","288.18","8","1","2","1","4"
"2013","Chestermere, Alberta, Royal Canadian Mounted Police, municipal","48005","Criminal harassment","7","2","5","-15.45","42.69","16.92","15.13","0","215.21","7","2","2","0","3"
"2014","Chestermere, Alberta, Royal Canadian Mounted Police, municipal","48005","Criminal harassment","3","1","1","-58.5","17.71","8.17","7.33","0","0","2","1","1","0","0"
"2015","Chestermere, Alberta, Royal Canadian Mounted Police, municipal","48005","Criminal harassment","2","1","1","-34.8","11.55","8","7.18","0","0","2","1","1","0","0"
"2016","Chestermere, Alberta, Royal Canadian Mounted Police, municipal","48005","Criminal harassment","0","0","0","-100","0","0","0","0","0","0","0","0","0","0"
"1998","Chestermere, Alberta, Royal Canadian Mounted Police, municipal","48005","Uttering threats","0","0","0","0","0","0","0","0","0","0","0","0","0","0"
"1999","Chestermere, Alberta, Royal Canadian Mounted Police, municipal","48005","Uttering threats","0","0","0","0","0","0","0","0","0","0","0","0","0","0"
"2000","Chestermere, Alberta, Royal Canadian Mounted Police, municipal","48005","Uttering threats","0","0","0","0","0","0","0","0","0","0","0","0","0","0"
"2001","Chestermere, Alberta, Royal Canadian Mounted Police, municipal","48005","Uttering threats","0","0","0","0","0","0","0","0","0","0","0","0","0","0"
"2002","Chestermere, Alberta, Royal Canadian Mounted Police, municipal","48005","Uttering threats","0","0","0","0","0","0","0","0","0","0","0","0","0","0"
"2003","Chestermere, Alberta, Royal Canadian Mounted Police, municipal","48005","Uttering threats","0","0","0","0","0","0","0","0","0","0","0","0","0","0"
"2004","Chestermere, Alberta, Royal Canadian Mounted Police, municipal","48005","Uttering threats","0","0","0","0","0","0","0","0","0","0","0","0","0","0"
"2005","Chestermere, Alberta, Royal Canadian Mounted Police, municipal","48005","Uttering threats","13","4","6","0","150.08","47.98","70.7","244.2","366.3","10","3","5","2","3"
"2006","Chestermere, Alberta, Royal Canadian Mounted Police, municipal","48005","Uttering threats","27","7","10","73.15","259.87","81.09","71.31","0","492.61","17","6","6","0","5"
"2007","Chestermere, Alberta, Royal Canadian Mounted Police, municipal","48005","Uttering threats","27","0","21","-8.55","237.63","0","0","0","546.95","21","0","0","0","6"
"2008","Chestermere, Alberta, Royal Canadian Mounted Police, municipal","48005","Uttering threats","48","12","21","63.25","387.94","22.57","19.92","0","1188.46","33","2","2","0","14"
"2009","Chestermere, Alberta, Royal Canadian Mounted Police, municipal","48005","Uttering threats","14","4","10","-73.13","104.22","31.05","36.62","79.3","475.81","14","3","4","1","6"
"2010","Chestermere, Alberta, Royal Canadian Mounted Police, municipal","48005","Uttering threats","39","2","26","159.56","270.51","19.31","17.07","0","441.83","28","2","2","0","6"
"2011","Chestermere, Alberta, Royal Canadian Mounted Police, municipal","48005","Uttering threats","22","2","19","-47.14","142.99","0","8.05","72.46","507.25","21","0","1","1","7"
"2012","Chestermere, Alberta, Royal Canadian Mounted Police, municipal","48005","Uttering threats","37","6","27","63.29","233.48","26.34","23.48","0","504.32","33","3","3","0","7"
"2013","Chestermere, Alberta, Royal Canadian Mounted Police, municipal","48005","Uttering threats","21","10","6","-45.15","128.06","33.83","45.4","143.47","215.21","16","4","6","2","3"
"2014","Chestermere, Alberta, Royal Canadian Mounted Police, municipal","48005","Uttering threats","21","0","18","-3.17","124","0","0","0","357.4","18","0","0","0","5"
"2015","Chestermere, Alberta, Royal Canadian Mounted Police, municipal","48005","Uttering threats","14","5","6","-34.8","80.85","31.98","28.74","0","212.31","11","4","4","0","3"
"2016","Chestermere, Alberta, Royal Canadian Mounted Police, municipal","48005","Uttering threats","27","3","17","88.15","152.13","23.44","21.07","0","138.41","20","3","3","0","2"
"1998","Chestermere, Alberta, Royal Canadian Mounted Police, municipal","48005","Indecent/Harassing communications","0","0","0","0","0","0","0","0","0","0","0","0","0","0"
"1999","Chestermere, Alberta, Royal Canadian Mounted Police, municipal","48005","Indecent/Harassing communications","0","0","0","0","0","0","0","0","0","0","0","0","0","0"
"2000","Chestermere, Alberta, Royal Canadian Mounted Police, municipal","48005","Indecent/Harassing communications","0","0","0","0","0","0","0","0","0","0","0","0","0","0"
"2001","Chestermere, Alberta, Royal Canadian Mounted Police, municipal","48005","Indecent/Harassing communications","0","0","0","0","0","0","0","0","0","0","0","0","0","0"
"2002","Chestermere, Alberta, Royal Canadian Mounted Police, municipal","48005","Indecent/Harassing communications","0","0","0","0","0","0","0","0","0","0","0","0","0","0"
"2003","Chestermere, Alberta, Royal Canadian Mounted Police, municipal","48005","Indecent/Harassing communications","0","0","0","0","0","0","0","0","0","0","0","0","0","0"
"2004","Chestermere, Alberta, Royal Canadian Mounted Police, municipal","48005","Indecent/Harassing communications","0","0","0","0","0","0","0","0","0","0","0","0","0","0"
"2005","Chestermere, Alberta, Royal Canadian Mounted Police, municipal","48005","Indecent/Harassing communications","3","0","1","0","34.63","0","0","0","0","1","0","0","0","0"
"2006","Chestermere, Alberta, Royal Canadian Mounted Police, municipal","48005","Indecent/Harassing communications","10","1","3","177.9","96.25","13.52","11.88","0","98.52","4","1","1","0","1"
"2007","Chestermere, Alberta, Royal Canadian Mounted Police, municipal","48005","Indecent/Harassing communications","12","1","6","9.73","105.62","12.32","10.85","0","273.47","7","1","1","0","3"
"2008","Chestermere, Alberta, Royal Canadian Mounted Police, municipal","48005","Indecent/Harassing communications","11","0","5","-15.82","88.9","0","0","0","0","5","0","0","0","0"
"2009","Chestermere, Alberta, Royal Canadian Mounted Police, municipal","48005","Indecent/Harassing communications","10","1","6","-16.26","74.44","10.35","9.16","0","79.3","7","1","1","0","1"
"2010","Chestermere, Alberta, Royal Canadian Mounted Police, municipal","48005","Indecent/Harassing communications","20","1","9","86.35","138.73","9.66","8.54","0","0","10","1","1","0","0"
"2011","Chestermere, Alberta, Royal Canadian Mounted Police, municipal","48005","Indecent/Harassing communications","20","0","15","-6.3","129.99","0","0","0","434.78","15","0","0","0","6"
"2012","Chestermere, Alberta, Royal Canadian Mounted Police, municipal","48005","Indecent/Harassing communications","20","0","10","-2.91","126.21","0","0","0","144.09","10","0","0","0","2"
"2013","Chestermere, Alberta, Royal Canadian Mounted Police, municipal","48005","Indecent/Harassing communications","12","0","5","-42.02","73.18","0","0","0","215.21","5","0","0","0","3"
"2014","Chestermere, Alberta, Royal Canadian Mounted Police, municipal","48005","Indecent/Harassing communications","5","0","1","-59.65","29.52","0","0","0","0","1","0","0","0","0"
"2015","Chestermere, Alberta, Royal Canadian Mounted Police, municipal","48005","Indecent/Harassing communications","14","2","2","173.86","80.85","15.99","14.37","0","0","4","2","2","0","0"
"2016","Chestermere, Alberta, Royal Canadian Mounted Police, municipal","48005","Indecent/Harassing communications","24","0","3","67.25","135.23","0","0","0","0","3","0","0","0","0"
"2012","Chestermere, Alberta, Royal Canadian Mounted Police, municipal","48005","Total commodification of sexual activity violations","0","0","0","0","0","0","0","0","0","0","0","0","0","0"
"2013","Chestermere, Alberta, Royal Canadian Mounted Police, municipal","48005","Total commodification of sexual activity violations","0","0","0","0","0","0","0","0","0","0","0","0","0","0"
"2014","Chestermere, Alberta, Royal Canadian Mounted Police, municipal","48005","Total commodification of sexual activity violations","0","0","0","0","0","0","0","0","0","0","0","0","0","0"
"2015","Chestermere, Alberta, Royal Canadian Mounted Police, municipal","48005","Total commodification of sexual activity violations","0","0","0","0","0","0","0","0","0","0","0","0","0","0"
"2016","Chestermere, Alberta, Royal Canadian Mounted Police, municipal","48005","Total commodification of sexual activity violations","0","0","0","0","0","0","0","0","0","0","0","0","0","0"
"2012","Chestermere, Alberta, Royal Canadian Mounted Police, municipal","48005","Obtaining sexual services for consideration","0","0","0","0","0","0","0","0","0","0","0","0","0","0"
"2013","Chestermere, Alberta, Royal Canadian Mounted Police, municipal","48005","Obtaining sexual services for consideration","0","0","0","0","0","0","0","0","0","0","0","0","0","0"
"2014","Chestermere, Alberta, Royal Canadian Mounted Police, municipal","48005","Obtaining sexual services for consideration","0","0","0","0","0","0","0","0","0","0","0","0","0","0"
"2015","Chestermere, Alberta, Royal Canadian Mounted Police, municipal","48005","Obtaining sexual services for consideration","0","0","0","0","0","0","0","0","0","0","0","0","0","0"
"2016","Chestermere, Alberta, Royal Canadian Mounted Police, municipal","48005","Obtaining sexual services for consideration","0","0","0","0","0","0","0","0","0","0","0","0","0","0"
"2012","Chestermere, Alberta, Royal Canadian Mounted Police, municipal","48005","Obtaining sexual services for consideration from person under 18 years","0","0","0","0","0","0","0","0","0","0","0","0","0","0"
"2013","Chestermere, Alberta, Royal Canadian Mounted Police, municipal","48005","Obtaining sexual services for consideration from person under 18 years","0","0","0","0","0","0","0","0","0","0","0","0","0","0"
"2014","Chestermere, Alberta, Royal Canadian Mounted Police, municipal","48005","Obtaining sexual services for consideration from person under 18 years","0","0","0","0","0","0","0","0","0","0","0","0","0","0"
"2015","Chestermere, Alberta, Royal Canadian Mounted Police, municipal","48005","Obtaining sexual services for consideration from person under 18 years","0","0","0","0","0","0","0","0","0","0","0","0","0","0"
"2016","Chestermere, Alberta, Royal Canadian Mounted Police, municipal","48005","Obtaining sexual services for consideration from person under 18 years","0","0","0","0","0","0","0","0","0","0","0","0","0","0"
"2012","Chestermere, Alberta, Royal Canadian Mounted Police, municipal","48005","Receive material benefit from sexual services","0","0","0","0","0","0","0","0","0","0","0","0","0","0"
"2013","Chestermere, Alberta, Royal Canadian Mounted Police, municipal","48005","Receive material benefit from sexual services","0","0","0","0","0","0","0","0","0","0","0","0","0","0"
"2014","Chestermere, Alberta, Royal Canadian Mounted Police, municipal","48005","Receive material benefit from sexual services","0","0","0","0","0","0","0","0","0","0","0","0","0","0"
"2015","Chestermere, Alberta, Royal Canadian Mounted Police, municipal","48005","Receive material benefit from sexual services","0","0","0","0","0","0","0","0","0","0","0","0","0","0"
"2016","Chestermere, Alberta, Royal Canadian Mounted Police, municipal","48005","Receive material benefit from sexual services","0","0","0","0","0","0","0","0","0","0","0","0","0","0"
"2012","Chestermere, Alberta, Royal Canadian Mounted Police, municipal","48005","Receive material benefit from sexual services provided by a person under 18 years","0","0","0","0","0","0","0","0","0","0","0","0","0","0"
"2013","Chestermere, Alberta, Royal Canadian Mounted Police, municipal","48005","Receive material benefit from sexual services provided by a person under 18 years","0","0","0","0","0","0","0","0","0","0","0","0","0","0"
"2014","Chestermere, Alberta, Royal Canadian Mounted Police, municipal","48005","Receive material benefit from sexual services provided by a person under 18 years","0","0","0","0","0","0","0","0","0","0","0","0","0","0"
"2015","Chestermere, Alberta, Royal Canadian Mounted Police, municipal","48005","Receive material benefit from sexual services provided by a person under 18 years","0","0","0","0","0","0","0","0","0","0","0","0","0","0"
"2016","Chestermere, Alberta, Royal Canadian Mounted Police, municipal","48005","Receive material benefit from sexual services provided by a person under 18 years","0","0","0","0","0","0","0","0","0","0","0","0","0","0"
"2012","Chestermere, Alberta, Royal Canadian Mounted Police, municipal","48005","Procuring","0","0","0","0","0","0","0","0","0","0","0","0","0","0"
"2013","Chestermere, Alberta, Royal Canadian Mounted Police, municipal","48005","Procuring","0","0","0","0","0","0","0","0","0","0","0","0","0","0"
"2014","Chestermere, Alberta, Royal Canadian Mounted Police, municipal","48005","Procuring","0","0","0","0","0","0","0","0","0","0","0","0","0","0"
"2015","Chestermere, Alberta, Royal Canadian Mounted Police, municipal","48005","Procuring","0","0","0","0","0","0","0","0","0","0","0","0","0","0"
"2016","Chestermere, Alberta, Royal Canadian Mounted Police, municipal","48005","Procuring","0","0","0","0","0","0","0","0","0","0","0","0","0","0"
"2012","Chestermere, Alberta, Royal Canadian Mounted Police, municipal","48005","Procuring - person under 18 years","0","0","0","0","0","0","0","0","0","0","0","0","0","0"
"2013","Chestermere, Alberta, Royal Canadian Mounted Police, municipal","48005","Procuring - person under 18 years","0","0","0","0","0","0","0","0","0","0","0","0","0","0"
"2014","Chestermere, Alberta, Royal Canadian Mounted Police, municipal","48005","Procuring - person under 18 years","0","0","0","0","0","0","0","0","0","0","0","0","0","0"
"2015","Chestermere, Alberta, Royal Canadian Mounted Police, municipal","48005","Procuring - person under 18 years","0","0","0","0","0","0","0","0","0","0","0","0","0","0"
"2016","Chestermere, Alberta, Royal Canadian Mounted Police, municipal","48005","Procuring - person under 18 years","0","0","0","0","0","0","0","0","0","0","0","0","0","0"
"2012","Chestermere, Alberta, Royal Canadian Mounted Police, municipal","48005","Advertising sexual services","0","0","0","0","0","0","0","0","0","0","0","0","0","0"
"2013","Chestermere, Alberta, Royal Canadian Mounted Police, municipal","48005","Advertising sexual services","0","0","0","0","0","0","0","0","0","0","0","0","0","0"
"2014","Chestermere, Alberta, Royal Canadian Mounted Police, municipal","48005","Advertising sexual services","0","0","0","0","0","0","0","0","0","0","0","0","0","0"
"2015","Chestermere, Alberta, Royal Canadian Mounted Police, municipal","48005","Advertising sexual services","0","0","0","0","0","0","0","0","0","0","0","0","0","0"
"2016","Chestermere, Alberta, Royal Canadian Mounted Police, municipal","48005","Advertising sexual services","0","0","0","0","0","0","0","0","0","0","0","0","0","0"
"1998","Chestermere, Alberta, Royal Canadian Mounted Police, municipal","48005","Total other violent violations","0","0","0","0","0","0","0","0","0","0","0","0","0","0"
"1999","Chestermere, Alberta, Royal Canadian Mounted Police, municipal","48005","Total other violent violations","0","0","0","0","0","0","0","0","0","0","0","0","0","0"
"2000","Chestermere, Alberta, Royal Canadian Mounted Police, municipal","48005","Total other violent violations","0","0","0","0","0","0","0","0","0","0","0","0","0","0"
"2001","Chestermere, Alberta, Royal Canadian Mounted Police, municipal","48005","Total other violent violations","0","0","0","0","0","0","0","0","0","0","0","0","0","0"
"2002","Chestermere, Alberta, Royal Canadian Mounted Police, municipal","48005","Total other violent violations","0","0","0","0","0","0","0","0","0","0","0","0","0","0"
"2003","Chestermere, Alberta, Royal Canadian Mounted Police, municipal","48005","Total other violent violations","0","0","0","0","0","0","0","0","0","0","0","0","0","0"
"2004","Chestermere, Alberta, Royal Canadian Mounted Police, municipal","48005","Total other violent violations","0","0","0","0","0","0","0","0","0","0","0","0","0","0"
"2005","Chestermere, Alberta, Royal Canadian Mounted Police, municipal","48005","Total other violent violations","0","0","0","0","0","0","0","0","0","0","0","0","0","0"
"2006","Chestermere, Alberta, Royal Canadian Mounted Police, municipal","48005","Total other violent violations","1","0","1","0","9.62","0","0","0","0","1","0","0","0","0"
"2007","Chestermere, Alberta, Royal Canadian Mounted Police, municipal","48005","Total other violent violations","2","0","1","82.89","17.6","0","0","0","0","1","0","0","0","0"
"2008","Chestermere, Alberta, Royal Canadian Mounted Police, municipal","48005","Total other violent violations","2","0","2","-8.17","16.16","0","0","0","0","2","0","0","0","0"
"2009","Chestermere, Alberta, Royal Canadian Mounted Police, municipal","48005","Total other violent violations","0","0","0","-100","0","0","0","0","0","0","0","0","0","0"
"2010","Chestermere, Alberta, Royal Canadian Mounted Police, municipal","48005","Total other violent violations","0","0","0","0","0","0","0","0","0","0","0","0","0","0"
"2011","Chestermere, Alberta, Royal Canadian Mounted Police, municipal","48005","Total other violent violations","0","0","0","0","0","0","0","0","0","0","0","0","0","0"
"2012","Chestermere, Alberta, Royal Canadian Mounted Police, municipal","48005","Total other violent violations","2","0","2","0","12.62","0","0","0","0","2","0","0","0","0"
"2013","Chestermere, Alberta, Royal Canadian Mounted Police, municipal","48005","Total other violent violations","0","0","0","-100","0","0","0","0","0","0","0","0","0","0"
"2014","Chestermere, Alberta, Royal Canadian Mounted Police, municipal","48005","Total other violent violations","0","0","0","0","0","0","0","0","0","0","0","0","0","0"
"2015","Chestermere, Alberta, Royal Canadian Mounted Police, municipal","48005","Total other violent violations","2","2","0","0","11.55","0","7.18","70.77","0","2","0","1","1","0"
"2016","Chestermere, Alberta, Royal Canadian Mounted Police, municipal","48005","Total other violent violations","2","2","0","-2.44","11.27","7.81","7.02","0","0","2","1","1","0","0"
"1998","Chestermere, Alberta, Royal Canadian Mounted Police, municipal","48005","Conspire to commit murder","0","0","0","0","0","0","0","0","0","0","0","0","0","0"
"1999","Chestermere, Alberta, Royal Canadian Mounted Police, municipal","48005","Conspire to commit murder","0","0","0","0","0","0","0","0","0","0","0","0","0","0"
"2000","Chestermere, Alberta, Royal Canadian Mounted Police, municipal","48005","Conspire to commit murder","0","0","0","0","0","0","0","0","0","0","0","0","0","0"
"2001","Chestermere, Alberta, Royal Canadian Mounted Police, municipal","48005","Conspire to commit murder","0","0","0","0","0","0","0","0","0","0","0","0","0","0"
"2002","Chestermere, Alberta, Royal Canadian Mounted Police, municipal","48005","Conspire to commit murder","0","0","0","0","0","0","0","0","0","0","0","0","0","0"
"2003","Chestermere, Alberta, Royal Canadian Mounted Police, municipal","48005","Conspire to commit murder","0","0","0","0","0","0","0","0","0","0","0","0","0","0"
"2004","Chestermere, Alberta, Royal Canadian Mounted Police, municipal","48005","Conspire to commit murder","0","0","0","0","0","0","0","0","0","0","0","0","0","0"
"2005","Chestermere, Alberta, Royal Canadian Mounted Police, municipal","48005","Conspire to commit murder","0","0","0","0","0","0","0","0","0","0","0","0","0","0"
"2006","Chestermere, Alberta, Royal Canadian Mounted Police, municipal","48005","Conspire to commit murder","0","0","0","0","0","0","0","0","0","0","0","0","0","0"
"2007","Chestermere, Alberta, Royal Canadian Mounted Police, municipal","48005","Conspire to commit murder","0","0","0","0","0","0","0","0","0","0","0","0","0","0"
"2008","Chestermere, Alberta, Royal Canadian Mounted Police, municipal","48005","Conspire to commit murder","0","0","0","0","0","0","0","0","0","0","0","0","0","0"
"2009","Chestermere, Alberta, Royal Canadian Mounted Police, municipal","48005","Conspire to commit murder","0","0","0","0","0","0","0","0","0","0","0","0","0","0"
"2010","Chestermere, Alberta, Royal Canadian Mounted Police, municipal","48005","Conspire to commit murder","0","0","0","0","0","0","0","0","0","0","0","0","0","0"
"2011","Chestermere, Alberta, Royal Canadian Mounted Police, municipal","48005","Conspire to commit murder","0","0","0","0","0","0","0","0","0","0","0","0","0","0"
"2012","Chestermere, Alberta, Royal Canadian Mounted Police, municipal","48005","Conspire to commit murder","0","0","0","0","0","0","0","0","0","0","0","0","0","0"
"2013","Chestermere, Alberta, Royal Canadian Mounted Police, municipal","48005","Conspire to commit murder","0","0","0","0","0","0","0","0","0","0","0","0","0","0"
"2014","Chestermere, Alberta, Royal Canadian Mounted Police, municipal","48005","Conspire to commit murder","0","0","0","0","0","0","0","0","0","0","0","0","0","0"
"2015","Chestermere, Alberta, Royal Canadian Mounted Police, municipal","48005","Conspire to commit murder","0","0","0","0","0","0","0","0","0","0","0","0","0","0"
"2016","Chestermere, Alberta, Royal Canadian Mounted Police, municipal","48005","Conspire to commit murder","0","0","0","0","0","0","0","0","0","0","0","0","0","0"
"1998","Chestermere, Alberta, Royal Canadian Mounted Police, municipal","48005","Other sexual violations","0","0","0","0","0","0","0","0","0","0","0","0","0","0"
"1999","Chestermere, Alberta, Royal Canadian Mounted Police, municipal","48005","Other sexual violations","0","0","0","0","0","0","0","0","0","0","0","0","0","0"
"2000","Chestermere, Alberta, Royal Canadian Mounted Police, municipal","48005","Other sexual violations","0","0","0","0","0","0","0","0","0","0","0","0","0","0"
"2001","Chestermere, Alberta, Royal Canadian Mounted Police, municipal","48005","Other sexual violations","0","0","0","0","0","0","0","0","0","0","0","0","0","0"
"2002","Chestermere, Alberta, Royal Canadian Mounted Police, municipal","48005","Other sexual violations","0","0","0","0","0","0","0","0","0","0","0","0","0","0"
"2003","Chestermere, Alberta, Royal Canadian Mounted Police, municipal","48005","Other sexual violations","0","0","0","0","0","0","0","0","0","0","0","0","0","0"
"2004","Chestermere, Alberta, Royal Canadian Mounted Police, municipal","48005","Other sexual violations","0","0","0","0","0","0","0","0","0","0","0","0","0","0"
"2005","Chestermere, Alberta, Royal Canadian Mounted Police, municipal","48005","Other sexual violations","0","0","0","0","0","0","0","0","0","0","0","0","0","0"
"2006","Chestermere, Alberta, Royal Canadian Mounted Police, municipal","48005","Other sexual violations","1","0","1","0","9.62","0","0","0","0","1","0","0","0","0"
"2007","Chestermere, Alberta, Royal Canadian Mounted Police, municipal","48005","Other sexual violations","0","0","0","-100","0","0","0","0","0","0","0","0","0","0"
"2008","Chestermere, Alberta, Royal Canadian Mounted Police, municipal","48005","Other sexual violations","0","0","0","0","0","0","0","0","0","0","0","0","0","0"
"2009","Chestermere, Alberta, Royal Canadian Mounted Police, municipal","48005","Other sexual violations","0","0","0","0","0","0","0","0","0","0","0","0","0","0"
"2010","Chestermere, Alberta, Royal Canadian Mounted Police, municipal","48005","Other sexual violations","0","0","0","0","0","0","0","0","0","0","0","0","0","0"
"2011","Chestermere, Alberta, Royal Canadian Mounted Police, municipal","48005","Other sexual violations","0","0","0","0","0","0","0","0","0","0","0","0","0","0"
"2012","Chestermere, Alberta, Royal Canadian Mounted Police, municipal","48005","Other sexual violations","0","0","0","0","0","0","0","0","0","0","0","0","0","0"
"2013","Chestermere, Alberta, Royal Canadian Mounted Police, municipal","48005","Other sexual violations","0","0","0","0","0","0","0","0","0","0","0","0","0","0"
"2014","Chestermere, Alberta, Royal Canadian Mounted Police, municipal","48005","Other sexual violations","0","0","0","0","0","0","0","0","0","0","0","0","0","0"
"2015","Chestermere, Alberta, Royal Canadian Mounted Police, municipal","48005","Other sexual violations","0","0","0","0","0","0","0","0","0","0","0","0","0","0"
"2016","Chestermere, Alberta, Royal Canadian Mounted Police, municipal","48005","Other sexual violations","0","0","0","0","0","0","0","0","0","0","0","0","0","0"
"2005","Chestermere, Alberta, Royal Canadian Mounted Police, municipal","48005","Sexual Exploitation of a person with a disability","0","0","0","0","0","0","0","0","0","0","0","0","0","0"
"2006","Chestermere, Alberta, Royal Canadian Mounted Police, municipal","48005","Sexual Exploitation of a person with a disability","0","0","0","0","0","0","0","0","0","0","0","0","0","0"
"2007","Chestermere, Alberta, Royal Canadian Mounted Police, municipal","48005","Sexual Exploitation of a person with a disability","0","0","0","0","0","0","0","0","0","0","0","0","0","0"
"2008","Chestermere, Alberta, Royal Canadian Mounted Police, municipal","48005","Sexual Exploitation of a person with a disability","0","0","0","0","0","0","0","0","0","0","0","0","0","0"
"2009","Chestermere, Alberta, Royal Canadian Mounted Police, municipal","48005","Sexual Exploitation of a person with a disability","0","0","0","0","0","0","0","0","0","0","0","0","0","0"
"2010","Chestermere, Alberta, Royal Canadian Mounted Police, municipal","48005","Sexual Exploitation of a person with a disability","0","0","0","0","0","0","0","0","0","0","0","0","0","0"
"2011","Chestermere, Alberta, Royal Canadian Mounted Police, municipal","48005","Sexual Exploitation of a person with a disability","0","0","0","0","0","0","0","0","0","0","0","0","0","0"
"2012","Chestermere, Alberta, Royal Canadian Mounted Police, municipal","48005","Sexual Exploitation of a person with a disability","0","0","0","0","0","0","0","0","0","0","0","0","0","0"
"2013","Chestermere, Alberta, Royal Canadian Mounted Police, municipal","48005","Sexual Exploitation of a person with a disability","0","0","0","0","0","0","0","0","0","0","0","0","0","0"
"2014","Chestermere, Alberta, Royal Canadian Mounted Police, municipal","48005","Sexual Exploitation of a person with a disability","0","0","0","0","0","0","0","0","0","0","0","0","0","0"
"2015","Chestermere, Alberta, Royal Canadian Mounted Police, municipal","48005","Sexual Exploitation of a person with a disability","0","0","0","0","0","0","0","0","0","0","0","0","0","0"
"2016","Chestermere, Alberta, Royal Canadian Mounted Police, municipal","48005","Sexual Exploitation of a person with a disability","0","0","0","0","0","0","0","0","0","0","0","0","0","0"
"2005","Chestermere, Alberta, Royal Canadian Mounted Police, municipal","48005","Incest","0","0","0","0","0","0","0","0","0","0","0","0","0","0"
"2006","Chestermere, Alberta, Royal Canadian Mounted Police, municipal","48005","Incest","0","0","0","0","0","0","0","0","0","0","0","0","0","0"
"2007","Chestermere, Alberta, Royal Canadian Mounted Police, municipal","48005","Incest","0","0","0","0","0","0","0","0","0","0","0","0","0","0"
"2008","Chestermere, Alberta, Royal Canadian Mounted Police, municipal","48005","Incest","0","0","0","0","0","0","0","0","0","0","0","0","0","0"
"2009","Chestermere, Alberta, Royal Canadian Mounted Police, municipal","48005","Incest","0","0","0","0","0","0","0","0","0","0","0","0","0","0"
"2010","Chestermere, Alberta, Royal Canadian Mounted Police, municipal","48005","Incest","0","0","0","0","0","0","0","0","0","0","0","0","0","0"
"2011","Chestermere, Alberta, Royal Canadian Mounted Police, municipal","48005","Incest","0","0","0","0","0","0","0","0","0","0","0","0","0","0"
"2012","Chestermere, Alberta, Royal Canadian Mounted Police, municipal","48005","Incest","0","0","0","0","0","0","0","0","0","0","0","0","0","0"
"2013","Chestermere, Alberta, Royal Canadian Mounted Police, municipal","48005","Incest","0","0","0","0","0","0","0","0","0","0","0","0","0","0"
"2014","Chestermere, Alberta, Royal Canadian Mounted Police, municipal","48005","Incest","0","0","0","0","0","0","0","0","0","0","0","0","0","0"
"2015","Chestermere, Alberta, Royal Canadian Mounted Police, municipal","48005","Incest","0","0","0","0","0","0","0","0","0","0","0","0","0","0"
"2016","Chestermere, Alberta, Royal Canadian Mounted Police, municipal","48005","Incest","0","0","0","0","0","0","0","0","0","0","0","0","0","0"
"2005","Chestermere, Alberta, Royal Canadian Mounted Police, municipal","48005","Corrupting morals of a child","0","0","0","0","0","0","0","0","0","0","0","0","0","0"
"2006","Chestermere, Alberta, Royal Canadian Mounted Police, municipal","48005","Corrupting morals of a child","0","0","0","0","0","0","0","0","0","0","0","0","0","0"
"2007","Chestermere, Alberta, Royal Canadian Mounted Police, municipal","48005","Corrupting morals of a child","0","0","0","0","0","0","0","0","0","0","0","0","0","0"
"2008","Chestermere, Alberta, Royal Canadian Mounted Police, municipal","48005","Corrupting morals of a child","0","0","0","0","0","0","0","0","0","0","0","0","0","0"
"2009","Chestermere, Alberta, Royal Canadian Mounted Police, municipal","48005","Corrupting morals of a child","0","0","0","0","0","0","0","0","0","0","0","0","0","0"
"2010","Chestermere, Alberta, Royal Canadian Mounted Police, municipal","48005","Corrupting morals of a child","0","0","0","0","0","0","0","0","0","0","0","0","0","0"
"2011","Chestermere, Alberta, Royal Canadian Mounted Police, municipal","48005","Corrupting morals of a child","0","0","0","0","0","0","0","0","0","0","0","0","0","0"
"2012","Chestermere, Alberta, Royal Canadian Mounted Police, municipal","48005","Corrupting morals of a child","0","0","0","0","0","0","0","0","0","0","0","0","0","0"
"2013","Chestermere, Alberta, Royal Canadian Mounted Police, municipal","48005","Corrupting morals of a child","0","0","0","0","0","0","0","0","0","0","0","0","0","0"
"2014","Chestermere, Alberta, Royal Canadian Mounted Police, municipal","48005","Corrupting morals of a child","0","0","0","0","0","0","0","0","0","0","0","0","0","0"
"2015","Chestermere, Alberta, Royal Canadian Mounted Police, municipal","48005","Corrupting morals of a child","0","0","0","0","0","0","0","0","0","0","0","0","0","0"
"2016","Chestermere, Alberta, Royal Canadian Mounted Police, municipal","48005","Corrupting morals of a child","0","0","0","0","0","0","0","0","0","0","0","0","0","0"
"2005","Chestermere, Alberta, Royal Canadian Mounted Police, municipal","48005","Anal intercourse","0","0","0","0","0","0","0","0","0","0","0","0","0","0"
"2006","Chestermere, Alberta, Royal Canadian Mounted Police, municipal","48005","Anal intercourse","0","0","0","0","0","0","0","0","0","0","0","0","0","0"
"2007","Chestermere, Alberta, Royal Canadian Mounted Police, municipal","48005","Anal intercourse","0","0","0","0","0","0","0","0","0","0","0","0","0","0"
"2008","Chestermere, Alberta, Royal Canadian Mounted Police, municipal","48005","Anal intercourse","0","0","0","0","0","0","0","0","0","0","0","0","0","0"
"2009","Chestermere, Alberta, Royal Canadian Mounted Police, municipal","48005","Anal intercourse","0","0","0","0","0","0","0","0","0","0","0","0","0","0"
"2010","Chestermere, Alberta, Royal Canadian Mounted Police, municipal","48005","Anal intercourse","0","0","0","0","0","0","0","0","0","0","0","0","0","0"
"2011","Chestermere, Alberta, Royal Canadian Mounted Police, municipal","48005","Anal intercourse","0","0","0","0","0","0","0","0","0","0","0","0","0","0"
"2012","Chestermere, Alberta, Royal Canadian Mounted Police, municipal","48005","Anal intercourse","0","0","0","0","0","0","0","0","0","0","0","0","0","0"
"2013","Chestermere, Alberta, Royal Canadian Mounted Police, municipal","48005","Anal intercourse","0","0","0","0","0","0","0","0","0","0","0","0","0","0"
"2014","Chestermere, Alberta, Royal Canadian Mounted Police, municipal","48005","Anal intercourse","0","0","0","0","0","0","0","0","0","0","0","0","0","0"
"2015","Chestermere, Alberta, Royal Canadian Mounted Police, municipal","48005","Anal intercourse","0","0","0","0","0","0","0","0","0","0","0","0","0","0"
"2016","Chestermere, Alberta, Royal Canadian Mounted Police, municipal","48005","Anal intercourse","0","0","0","0","0","0","0","0","0","0","0","0","0","0"
"2005","Chestermere, Alberta, Royal Canadian Mounted Police, municipal","48005","Bestiality, commit or compel person","0","0","0","0","0","0","0","0","0","0","0","0","0","0"
"2006","Chestermere, Alberta, Royal Canadian Mounted Police, municipal","48005","Bestiality, commit or compel person","0","0","0","0","0","0","0","0","0","0","0","0","0","0"
"2007","Chestermere, Alberta, Royal Canadian Mounted Police, municipal","48005","Bestiality, commit or compel person","0","0","0","0","0","0","0","0","0","0","0","0","0","0"
"2008","Chestermere, Alberta, Royal Canadian Mounted Police, municipal","48005","Bestiality, commit or compel person","0","0","0","0","0","0","0","0","0","0","0","0","0","0"
"2009","Chestermere, Alberta, Royal Canadian Mounted Police, municipal","48005","Bestiality, commit or compel person","0","0","0","0","0","0","0","0","0","0","0","0","0","0"
"2010","Chestermere, Alberta, Royal Canadian Mounted Police, municipal","48005","Bestiality, commit or compel person","0","0","0","0","0","0","0","0","0","0","0","0","0","0"
"2011","Chestermere, Alberta, Royal Canadian Mounted Police, municipal","48005","Bestiality, commit or compel person","0","0","0","0","0","0","0","0","0","0","0","0","0","0"
"2012","Chestermere, Alberta, Royal Canadian Mounted Police, municipal","48005","Bestiality, commit or compel person","0","0","0","0","0","0","0","0","0","0","0","0","0","0"
"2013","Chestermere, Alberta, Royal Canadian Mounted Police, municipal","48005","Bestiality, commit or compel person","0","0","0","0","0","0","0","0","0","0","0","0","0","0"
"2014","Chestermere, Alberta, Royal Canadian Mounted Police, municipal","48005","Bestiality, commit or compel person","0","0","0","0","0","0","0","0","0","0","0","0","0","0"
"2015","Chestermere, Alberta, Royal Canadian Mounted Police, municipal","48005","Bestiality, commit or compel person","0","0","0","0","0","0","0","0","0","0","0","0","0","0"
"2016","Chestermere, Alberta, Royal Canadian Mounted Police, municipal","48005","Bestiality, commit or compel person","0","0","0","0","0","0","0","0","0","0","0","0","0","0"
"1998","Chestermere, Alberta, Royal Canadian Mounted Police, municipal","48005","Voyeurism","0","0","0","0","0","0","0","0","0","0","0","0","0","0"
"1999","Chestermere, Alberta, Royal Canadian Mounted Police, municipal","48005","Voyeurism","0","0","0","0","0","0","0","0","0","0","0","0","0","0"
"2000","Chestermere, Alberta, Royal Canadian Mounted Police, municipal","48005","Voyeurism","0","0","0","0","0","0","0","0","0","0","0","0","0","0"
"2001","Chestermere, Alberta, Royal Canadian Mounted Police, municipal","48005","Voyeurism","0","0","0","0","0","0","0","0","0","0","0","0","0","0"
"2002","Chestermere, Alberta, Royal Canadian Mounted Police, municipal","48005","Voyeurism","0","0","0","0","0","0","0","0","0","0","0","0","0","0"
"2003","Chestermere, Alberta, Royal Canadian Mounted Police, municipal","48005","Voyeurism","0","0","0","0","0","0","0","0","0","0","0","0","0","0"
"2004","Chestermere, Alberta, Royal Canadian Mounted Police, municipal","48005","Voyeurism","0","0","0","0","0","0","0","0","0","0","0","0","0","0"
"2005","Chestermere, Alberta, Royal Canadian Mounted Police, municipal","48005","Voyeurism","0","0","0","0","0","0","0","0","0","0","0","0","0","0"
"2006","Chestermere, Alberta, Royal Canadian Mounted Police, municipal","48005","Voyeurism","0","0","0","0","0","0","0","0","0","0","0","0","0","0"
"2007","Chestermere, Alberta, Royal Canadian Mounted Police, municipal","48005","Voyeurism","0","0","0","0","0","0","0","0","0","0","0","0","0","0"
"2008","Chestermere, Alberta, Royal Canadian Mounted Police, municipal","48005","Voyeurism","0","0","0","0","0","0","0","0","0","0","0","0","0","0"
"2009","Chestermere, Alberta, Royal Canadian Mounted Police, municipal","48005","Voyeurism","0","0","0","0","0","0","0","0","0","0","0","0","0","0"
"2010","Chestermere, Alberta, Royal Canadian Mounted Police, municipal","48005","Voyeurism","0","0","0","0","0","0","0","0","0","0","0","0","0","0"
"2011","Chestermere, Alberta, Royal Canadian Mounted Police, municipal","48005","Voyeurism","0","0","0","0","0","0","0","0","0","0","0","0","0","0"
"2012","Chestermere, Alberta, Royal Canadian Mounted Police, municipal","48005","Voyeurism","2","0","2","0","12.62","0","0","0","0","2","0","0","0","0"
"2013","Chestermere, Alberta, Royal Canadian Mounted Police, municipal","48005","Voyeurism","0","0","0","-100","0","0","0","0","0","0","0","0","0","0"
"2014","Chestermere, Alberta, Royal Canadian Mounted Police, municipal","48005","Voyeurism","0","0","0","0","0","0","0","0","0","0","0","0","0","0"
"2015","Chestermere, Alberta, Royal Canadian Mounted Police, municipal","48005","Voyeurism","0","0","0","0","0","0","0","0","0","0","0","0","0","0"
"2016","Chestermere, Alberta, Royal Canadian Mounted Police, municipal","48005","Voyeurism","0","0","0","0","0","0","0","0","0","0","0","0","0","0"
"2012","Chestermere, Alberta, Royal Canadian Mounted Police, municipal","48005","Nonconsensual distribution of intimate images","0","0","0","0","0","0","0","0","0","0","0","0","0","0"
"2013","Chestermere, Alberta, Royal Canadian Mounted Police, municipal","48005","Nonconsensual distribution of intimate images","0","0","0","0","0","0","0","0","0","0","0","0","0","0"
"2014","Chestermere, Alberta, Royal Canadian Mounted Police, municipal","48005","Nonconsensual distribution of intimate images","0","0","0","0","0","0","0","0","0","0","0","0","0","0"
"2015","Chestermere, Alberta, Royal Canadian Mounted Police, municipal","48005","Nonconsensual distribution of intimate images","0","0","0","0","0","0","0","0","0","0","0","0","0","0"
"2016","Chestermere, Alberta, Royal Canadian Mounted Police, municipal","48005","Nonconsensual distribution of intimate images","0","0","0","0","0","0","0","0","0","0","0","0","0","0"
"2005","Chestermere, Alberta, Royal Canadian Mounted Police, municipal","48005","Trap likely to or causing bodily harm","0","0","0","0","0","0","0","0","0","0","0","0","0","0"
"2006","Chestermere, Alberta, Royal Canadian Mounted Police, municipal","48005","Trap likely to or causing bodily harm","0","0","0","0","0","0","0","0","0","0","0","0","0","0"
"2007","Chestermere, Alberta, Royal Canadian Mounted Police, municipal","48005","Trap likely to or causing bodily harm","0","0","0","0","0","0","0","0","0","0","0","0","0","0"
"2008","Chestermere, Alberta, Royal Canadian Mounted Police, municipal","48005","Trap likely to or causing bodily harm","0","0","0","0","0","0","0","0","0","0","0","0","0","0"
"2009","Chestermere, Alberta, Royal Canadian Mounted Police, municipal","48005","Trap likely to or causing bodily harm","0","0","0","0","0","0","0","0","0","0","0","0","0","0"
"2010","Chestermere, Alberta, Royal Canadian Mounted Police, municipal","48005","Trap likely to or causing bodily harm","0","0","0","0","0","0","0","0","0","0","0","0","0","0"
"2011","Chestermere, Alberta, Royal Canadian Mounted Police, municipal","48005","Trap likely to or causing bodily harm","0","0","0","0","0","0","0","0","0","0","0","0","0","0"
"2012","Chestermere, Alberta, Royal Canadian Mounted Police, municipal","48005","Trap likely to or causing bodily harm","0","0","0","0","0","0","0","0","0","0","0","0","0","0"
"2013","Chestermere, Alberta, Royal Canadian Mounted Police, municipal","48005","Trap likely to or causing bodily harm","0","0","0","0","0","0","0","0","0","0","0","0","0","0"
"2014","Chestermere, Alberta, Royal Canadian Mounted Police, municipal","48005","Trap likely to or causing bodily harm","0","0","0","0","0","0","0","0","0","0","0","0","0","0"
"2015","Chestermere, Alberta, Royal Canadian Mounted Police, municipal","48005","Trap likely to or causing bodily harm","0","0","0","0","0","0","0","0","0","0","0","0","0","0"
"2016","Chestermere, Alberta, Royal Canadian Mounted Police, municipal","48005","Trap likely to or causing bodily harm","0","0","0","0","0","0","0","0","0","0","0","0","0","0"
"1998","Chestermere, Alberta, Royal Canadian Mounted Police, municipal","48005","Hostage-taking","0","0","0","0","0","0","0","0","0","0","0","0","0","0"
"1999","Chestermere, Alberta, Royal Canadian Mounted Police, municipal","48005","Hostage-taking","0","0","0","0","0","0","0","0","0","0","0","0","0","0"
"2000","Chestermere, Alberta, Royal Canadian Mounted Police, municipal","48005","Hostage-taking","0","0","0","0","0","0","0","0","0","0","0","0","0","0"
"2001","Chestermere, Alberta, Royal Canadian Mounted Police, municipal","48005","Hostage-taking","0","0","0","0","0","0","0","0","0","0","0","0","0","0"
"2002","Chestermere, Alberta, Royal Canadian Mounted Police, municipal","48005","Hostage-taking","0","0","0","0","0","0","0","0","0","0","0","0","0","0"
"2003","Chestermere, Alberta, Royal Canadian Mounted Police, municipal","48005","Hostage-taking","0","0","0","0","0","0","0","0","0","0","0","0","0","0"
"2004","Chestermere, Alberta, Royal Canadian Mounted Police, municipal","48005","Hostage-taking","0","0","0","0","0","0","0","0","0","0","0","0","0","0"
"2005","Chestermere, Alberta, Royal Canadian Mounted Police, municipal","48005","Hostage-taking","0","0","0","0","0","0","0","0","0","0","0","0","0","0"
"2006","Chestermere, Alberta, Royal Canadian Mounted Police, municipal","48005","Hostage-taking","0","0","0","0","0","0","0","0","0","0","0","0","0","0"
"2007","Chestermere, Alberta, Royal Canadian Mounted Police, municipal","48005","Hostage-taking","0","0","0","0","0","0","0","0","0","0","0","0","0","0"
"2008","Chestermere, Alberta, Royal Canadian Mounted Police, municipal","48005","Hostage-taking","0","0","0","0","0","0","0","0","0","0","0","0","0","0"
"2009","Chestermere, Alberta, Royal Canadian Mounted Police, municipal","48005","Hostage-taking","0","0","0","0","0","0","0","0","0","0","0","0","0","0"
"2010","Chestermere, Alberta, Royal Canadian Mounted Police, municipal","48005","Hostage-taking","0","0","0","0","0","0","0","0","0","0","0","0","0","0"
"2011","Chestermere, Alberta, Royal Canadian Mounted Police, municipal","48005","Hostage-taking","0","0","0","0","0","0","0","0","0","0","0","0","0","0"
"2012","Chestermere, Alberta, Royal Canadian Mounted Police, municipal","48005","Hostage-taking","0","0","0","0","0","0","0","0","0","0","0","0","0","0"
"2013","Chestermere, Alberta, Royal Canadian Mounted Police, municipal","48005","Hostage-taking","0","0","0","0","0","0","0","0","0","0","0","0","0","0"
"2014","Chestermere, Alberta, Royal Canadian Mounted Police, municipal","48005","Hostage-taking","0","0","0","0","0","0","0","0","0","0","0","0","0","0"
"2015","Chestermere, Alberta, Royal Canadian Mounted Police, municipal","48005","Hostage-taking","0","0","0","0","0","0","0","0","0","0","0","0","0","0"
"2016","Chestermere, Alberta, Royal Canadian Mounted Police, municipal","48005","Hostage-taking","0","0","0","0","0","0","0","0","0","0","0","0","0","0"
"2005","Chestermere, Alberta, Royal Canadian Mounted Police, municipal","48005","Trafficking in persons","0","0","0","0","0","0","0","0","0","0","0","0","0","0"
"2006","Chestermere, Alberta, Royal Canadian Mounted Police, municipal","48005","Trafficking in persons","0","0","0","0","0","0","0","0","0","0","0","0","0","0"
"2007","Chestermere, Alberta, Royal Canadian Mounted Police, municipal","48005","Trafficking in persons","0","0","0","0","0","0","0","0","0","0","0","0","0","0"
"2008","Chestermere, Alberta, Royal Canadian Mounted Police, municipal","48005","Trafficking in persons","0","0","0","0","0","0","0","0","0","0","0","0","0","0"
"2009","Chestermere, Alberta, Royal Canadian Mounted Police, municipal","48005","Trafficking in persons","0","0","0","0","0","0","0","0","0","0","0","0","0","0"
"2010","Chestermere, Alberta, Royal Canadian Mounted Police, municipal","48005","Trafficking in persons","0","0","0","0","0","0","0","0","0","0","0","0","0","0"
"2011","Chestermere, Alberta, Royal Canadian Mounted Police, municipal","48005","Trafficking in persons","0","0","0","0","0","0","0","0","0","0","0","0","0","0"
"2012","Chestermere, Alberta, Royal Canadian Mounted Police, municipal","48005","Trafficking in persons","0","0","0","0","0","0","0","0","0","0","0","0","0","0"
"2013","Chestermere, Alberta, Royal Canadian Mounted Police, municipal","48005","Trafficking in persons","0","0","0","0","0","0","0","0","0","0","0","0","0","0"
"2014","Chestermere, Alberta, Royal Canadian Mounted Police, municipal","48005","Trafficking in persons","0","0","0","0","0","0","0","0","0","0","0","0","0","0"
"2015","Chestermere, Alberta, Royal Canadian Mounted Police, municipal","48005","Trafficking in persons","0","0","0","0","0","0","0","0","0","0","0","0","0","0"
"2016","Chestermere, Alberta, Royal Canadian Mounted Police, municipal","48005","Trafficking in persons","0","0","0","0","0","0","0","0","0","0","0","0","0","0"
"1998","Chestermere, Alberta, Royal Canadian Mounted Police, municipal","48005","Intimidation of a justice system participant or a journalist","0","0","0","0","0","0","0","0","0","0","0","0","0","0"
"1999","Chestermere, Alberta, Royal Canadian Mounted Police, municipal","48005","Intimidation of a justice system participant or a journalist","0","0","0","0","0","0","0","0","0","0","0","0","0","0"
"2000","Chestermere, Alberta, Royal Canadian Mounted Police, municipal","48005","Intimidation of a justice system participant or a journalist","0","0","0","0","0","0","0","0","0","0","0","0","0","0"
"2001","Chestermere, Alberta, Royal Canadian Mounted Police, municipal","48005","Intimidation of a justice system participant or a journalist","0","0","0","0","0","0","0","0","0","0","0","0","0","0"
"2002","Chestermere, Alberta, Royal Canadian Mounted Police, municipal","48005","Intimidation of a justice system participant or a journalist","0","0","0","0","0","0","0","0","0","0","0","0","0","0"
"2003","Chestermere, Alberta, Royal Canadian Mounted Police, municipal","48005","Intimidation of a justice system participant or a journalist","0","0","0","0","0","0","0","0","0","0","0","0","0","0"
"2004","Chestermere, Alberta, Royal Canadian Mounted Police, municipal","48005","Intimidation of a justice system participant or a journalist","0","0","0","0","0","0","0","0","0","0","0","0","0","0"
"2005","Chestermere, Alberta, Royal Canadian Mounted Police, municipal","48005","Intimidation of a justice system participant or a journalist","0","0","0","0","0","0","0","0","0","0","0","0","0","0"
"2006","Chestermere, Alberta, Royal Canadian Mounted Police, municipal","48005","Intimidation of a justice system participant or a journalist","0","0","0","0","0","0","0","0","0","0","0","0","0","0"
"2007","Chestermere, Alberta, Royal Canadian Mounted Police, municipal","48005","Intimidation of a justice system participant or a journalist","0","0","0","0","0","0","0","0","0","0","0","0","0","0"
"2008","Chestermere, Alberta, Royal Canadian Mounted Police, municipal","48005","Intimidation of a justice system participant or a journalist","0","0","0","0","0","0","0","0","0","0","0","0","0","0"
"2009","Chestermere, Alberta, Royal Canadian Mounted Police, municipal","48005","Intimidation of a justice system participant or a journalist","0","0","0","0","0","0","0","0","0","0","0","0","0","0"
"2010","Chestermere, Alberta, Royal Canadian Mounted Police, municipal","48005","Intimidation of a justice system participant or a journalist","0","0","0","0","0","0","0","0","0","0","0","0","0","0"
"2011","Chestermere, Alberta, Royal Canadian Mounted Police, municipal","48005","Intimidation of a justice system participant or a journalist","0","0","0","0","0","0","0","0","0","0","0","0","0","0"
"2012","Chestermere, Alberta, Royal Canadian Mounted Police, municipal","48005","Intimidation of a justice system participant or a journalist","0","0","0","0","0","0","0","0","0","0","0","0","0","0"
"2013","Chestermere, Alberta, Royal Canadian Mounted Police, municipal","48005","Intimidation of a justice system participant or a journalist","0","0","0","0","0","0","0","0","0","0","0","0","0","0"
"2014","Chestermere, Alberta, Royal Canadian Mounted Police, municipal","48005","Intimidation of a justice system participant or a journalist","0","0","0","0","0","0","0","0","0","0","0","0","0","0"
"2015","Chestermere, Alberta, Royal Canadian Mounted Police, municipal","48005","Intimidation of a justice system participant or a journalist","0","0","0","0","0","0","0","0","0","0","0","0","0","0"
"2016","Chestermere, Alberta, Royal Canadian Mounted Police, municipal","48005","Intimidation of a justice system participant or a journalist","2","2","0","0","11.27","7.81","7.02","0","0","2","1","1","0","0"
"2005","Chestermere, Alberta, Royal Canadian Mounted Police, municipal","48005","Intimidation of a non-justice participant","0","0","0","0","0","0","0","0","0","0","0","0","0","0"
"2006","Chestermere, Alberta, Royal Canadian Mounted Police, municipal","48005","Intimidation of a non-justice participant","0","0","0","0","0","0","0","0","0","0","0","0","0","0"
"2007","Chestermere, Alberta, Royal Canadian Mounted Police, municipal","48005","Intimidation of a non-justice participant","0","0","0","0","0","0","0","0","0","0","0","0","0","0"
"2008","Chestermere, Alberta, Royal Canadian Mounted Police, municipal","48005","Intimidation of a non-justice participant","0","0","0","0","0","0","0","0","0","0","0","0","0","0"
"2009","Chestermere, Alberta, Royal Canadian Mounted Police, municipal","48005","Intimidation of a non-justice participant","0","0","0","0","0","0","0","0","0","0","0","0","0","0"
"2010","Chestermere, Alberta, Royal Canadian Mounted Police, municipal","48005","Intimidation of a non-justice participant","0","0","0","0","0","0","0","0","0","0","0","0","0","0"
"2011","Chestermere, Alberta, Royal Canadian Mounted Police, municipal","48005","Intimidation of a non-justice participant","0","0","0","0","0","0","0","0","0","0","0","0","0","0"
"2012","Chestermere, Alberta, Royal Canadian Mounted Police, municipal","48005","Intimidation of a non-justice participant","0","0","0","0","0","0","0","0","0","0","0","0","0","0"
"2013","Chestermere, Alberta, Royal Canadian Mounted Police, municipal","48005","Intimidation of a non-justice participant","0","0","0","0","0","0","0","0","0","0","0","0","0","0"
"2014","Chestermere, Alberta, Royal Canadian Mounted Police, municipal","48005","Intimidation of a non-justice participant","0","0","0","0","0","0","0","0","0","0","0","0","0","0"
"2015","Chestermere, Alberta, Royal Canadian Mounted Police, municipal","48005","Intimidation of a non-justice participant","0","0","0","0","0","0","0","0","0","0","0","0","0","0"
"2016","Chestermere, Alberta, Royal Canadian Mounted Police, municipal","48005","Intimidation of a non-justice participant","0","0","0","0","0","0","0","0","0","0","0","0","0","0"
"1998","Chestermere, Alberta, Royal Canadian Mounted Police, municipal","48005","Explosives causing death or bodily harm","0","0","0","0","0","0","0","0","0","0","0","0","0","0"
"1999","Chestermere, Alberta, Royal Canadian Mounted Police, municipal","48005","Explosives causing death or bodily harm","0","0","0","0","0","0","0","0","0","0","0","0","0","0"
"2000","Chestermere, Alberta, Royal Canadian Mounted Police, municipal","48005","Explosives causing death or bodily harm","0","0","0","0","0","0","0","0","0","0","0","0","0","0"
"2001","Chestermere, Alberta, Royal Canadian Mounted Police, municipal","48005","Explosives causing death or bodily harm","0","0","0","0","0","0","0","0","0","0","0","0","0","0"
"2002","Chestermere, Alberta, Royal Canadian Mounted Police, municipal","48005","Explosives causing death or bodily harm","0","0","0","0","0","0","0","0","0","0","0","0","0","0"
"2003","Chestermere, Alberta, Royal Canadian Mounted Police, municipal","48005","Explosives causing death or bodily harm","0","0","0","0","0","0","0","0","0","0","0","0","0","0"
"2004","Chestermere, Alberta, Royal Canadian Mounted Police, municipal","48005","Explosives causing death or bodily harm","0","0","0","0","0","0","0","0","0","0","0","0","0","0"
"2005","Chestermere, Alberta, Royal Canadian Mounted Police, municipal","48005","Explosives causing death or bodily harm","0","0","0","0","0","0","0","0","0","0","0","0","0","0"
"2006","Chestermere, Alberta, Royal Canadian Mounted Police, municipal","48005","Explosives causing death or bodily harm","0","0","0","0","0","0","0","0","0","0","0","0","0","0"
"2007","Chestermere, Alberta, Royal Canadian Mounted Police, municipal","48005","Explosives causing death or bodily harm","1","0","1","0","8.8","0","0","0","0","1","0","0","0","0"
"2008","Chestermere, Alberta, Royal Canadian Mounted Police, municipal","48005","Explosives causing death or bodily harm","0","0","0","-100","0","0","0","0","0","0","0","0","0","0"
"2009","Chestermere, Alberta, Royal Canadian Mounted Police, municipal","48005","Explosives causing death or bodily harm","0","0","0","0","0","0","0","0","0","0","0","0","0","0"
"2010","Chestermere, Alberta, Royal Canadian Mounted Police, municipal","48005","Explosives causing death or bodily harm","0","0","0","0","0","0","0","0","0","0","0","0","0","0"
"2011","Chestermere, Alberta, Royal Canadian Mounted Police, municipal","48005","Explosives causing death or bodily harm","0","0","0","0","0","0","0","0","0","0","0","0","0","0"
"2012","Chestermere, Alberta, Royal Canadian Mounted Police, municipal","48005","Explosives causing death or bodily harm","0","0","0","0","0","0","0","0","0","0","0","0","0","0"
"2013","Chestermere, Alberta, Royal Canadian Mounted Police, municipal","48005","Explosives causing death or bodily harm","0","0","0","0","0","0","0","0","0","0","0","0","0","0"
"2014","Chestermere, Alberta, Royal Canadian Mounted Police, municipal","48005","Explosives causing death or bodily harm","0","0","0","0","0","0","0","0","0","0","0","0","0","0"
"2015","Chestermere, Alberta, Royal Canadian Mounted Police, municipal","48005","Explosives causing death or bodily harm","0","0","0","0","0","0","0","0","0","0","0","0","0","0"
"2016","Chestermere, Alberta, Royal Canadian Mounted Police, municipal","48005","Explosives causing death or bodily harm","0","0","0","0","0","0","0","0","0","0","0","0","0","0"
"1998","Chestermere, Alberta, Royal Canadian Mounted Police, municipal","48005","Arson, disregard for human life","0","0","0","0","0","0","0","0","0","0","0","0","0","0"
"1999","Chestermere, Alberta, Royal Canadian Mounted Police, municipal","48005","Arson, disregard for human life","0","0","0","0","0","0","0","0","0","0","0","0","0","0"
"2000","Chestermere, Alberta, Royal Canadian Mounted Police, municipal","48005","Arson, disregard for human life","0","0","0","0","0","0","0","0","0","0","0","0","0","0"
"2001","Chestermere, Alberta, Royal Canadian Mounted Police, municipal","48005","Arson, disregard for human life","0","0","0","0","0","0","0","0","0","0","0","0","0","0"
"2002","Chestermere, Alberta, Royal Canadian Mounted Police, municipal","48005","Arson, disregard for human life","0","0","0","0","0","0","0","0","0","0","0","0","0","0"
"2003","Chestermere, Alberta, Royal Canadian Mounted Police, municipal","48005","Arson, disregard for human life","0","0","0","0","0","0","0","0","0","0","0","0","0","0"
"2004","Chestermere, Alberta, Royal Canadian Mounted Police, municipal","48005","Arson, disregard for human life","0","0","0","0","0","0","0","0","0","0","0","0","0","0"
"2005","Chestermere, Alberta, Royal Canadian Mounted Police, municipal","48005","Arson, disregard for human life","0","0","0","0","0","0","0","0","0","0","0","0","0","0"
"2006","Chestermere, Alberta, Royal Canadian Mounted Police, municipal","48005","Arson, disregard for human life","0","0","0","0","0","0","0","0","0","0","0","0","0","0"
"2007","Chestermere, Alberta, Royal Canadian Mounted Police, municipal","48005","Arson, disregard for human life","0","0","0","0","0","0","0","0","0","0","0","0","0","0"
"2008","Chestermere, Alberta, Royal Canadian Mounted Police, municipal","48005","Arson, disregard for human life","0","0","0","0","0","0","0","0","0","0","0","0","0","0"
"2009","Chestermere, Alberta, Royal Canadian Mounted Police, municipal","48005","Arson, disregard for human life","0","0","0","0","0","0","0","0","0","0","0","0","0","0"
"2010","Chestermere, Alberta, Royal Canadian Mounted Police, municipal","48005","Arson, disregard for human life","0","0","0","0","0","0","0","0","0","0","0","0","0","0"
"2011","Chestermere, Alberta, Royal Canadian Mounted Police, municipal","48005","Arson, disregard for human life","0","0","0","0","0","0","0","0","0","0","0","0","0","0"
"2012","Chestermere, Alberta, Royal Canadian Mounted Police, municipal","48005","Arson, disregard for human life","0","0","0","0","0","0","0","0","0","0","0","0","0","0"
"2013","Chestermere, Alberta, Royal Canadian Mounted Police, municipal","48005","Arson, disregard for human life","0","0","0","0","0","0","0","0","0","0","0","0","0","0"
"2014","Chestermere, Alberta, Royal Canadian Mounted Police, municipal","48005","Arson, disregard for human life","0","0","0","0","0","0","0","0","0","0","0","0","0","0"
"2015","Chestermere, Alberta, Royal Canadian Mounted Police, municipal","48005","Arson, disregard for human life","2","2","0","0","11.55","0","7.18","70.77","0","2","0","1","1","0"
"2016","Chestermere, Alberta, Royal Canadian Mounted Police, municipal","48005","Arson, disregard for human life","0","0","0","-100","0","0","0","0","0","0","0","0","0","0"
"2012","Chestermere, Alberta, Royal Canadian Mounted Police, municipal","48005","Failure to comply with mandatory safeguards in relation to medical assistance in dying","0","0","0","0","0","0","0","0","0","0","0","0","0","0"
"2013","Chestermere, Alberta, Royal Canadian Mounted Police, municipal","48005","Failure to comply with mandatory safeguards in relation to medical assistance in dying","0","0","0","0","0","0","0","0","0","0","0","0","0","0"
"2014","Chestermere, Alberta, Royal Canadian Mounted Police, municipal","48005","Failure to comply with mandatory safeguards in relation to medical assistance in dying","0","0","0","0","0","0","0","0","0","0","0","0","0","0"
"2015","Chestermere, Alberta, Royal Canadian Mounted Police, municipal","48005","Failure to comply with mandatory safeguards in relation to medical assistance in dying","0","0","0","0","0","0","0","0","0","0","0","0","0","0"
"2016","Chestermere, Alberta, Royal Canadian Mounted Police, municipal","48005","Failure to comply with mandatory safeguards in relation to medical assistance in dying","0","0","0","0","0","0","0","0","0","0","0","0","0","0"
"2012","Chestermere, Alberta, Royal Canadian Mounted Police, municipal","48005","Forging or destroying documents related to assistance requests with criminal intent","0","0","0","0","0","0","0","0","0","0","0","0","0","0"
"2013","Chestermere, Alberta, Royal Canadian Mounted Police, municipal","48005","Forging or destroying documents related to assistance requests with criminal intent","0","0","0","0","0","0","0","0","0","0","0","0","0","0"
"2014","Chestermere, Alberta, Royal Canadian Mounted Police, municipal","48005","Forging or destroying documents related to assistance requests with criminal intent","0","0","0","0","0","0","0","0","0","0","0","0","0","0"
"2015","Chestermere, Alberta, Royal Canadian Mounted Police, municipal","48005","Forging or destroying documents related to assistance requests with criminal intent","0","0","0","0","0","0","0","0","0","0","0","0","0","0"
"2016","Chestermere, Alberta, Royal Canadian Mounted Police, municipal","48005","Forging or destroying documents related to assistance requests with criminal intent","0","0","0","0","0","0","0","0","0","0","0","0","0","0"
"1998","Chestermere, Alberta, Royal Canadian Mounted Police, municipal","48005","Other violent violations","0","0","0","0","0","0","0","0","0","0","0","0","0","0"
"1999","Chestermere, Alberta, Royal Canadian Mounted Police, municipal","48005","Other violent violations","0","0","0","0","0","0","0","0","0","0","0","0","0","0"
"2000","Chestermere, Alberta, Royal Canadian Mounted Police, municipal","48005","Other violent violations","0","0","0","0","0","0","0","0","0","0","0","0","0","0"
"2001","Chestermere, Alberta, Royal Canadian Mounted Police, municipal","48005","Other violent violations","0","0","0","0","0","0","0","0","0","0","0","0","0","0"
"2002","Chestermere, Alberta, Royal Canadian Mounted Police, municipal","48005","Other violent violations","0","0","0","0","0","0","0","0","0","0","0","0","0","0"
"2003","Chestermere, Alberta, Royal Canadian Mounted Police, municipal","48005","Other violent violations","0","0","0","0","0","0","0","0","0","0","0","0","0","0"
"2004","Chestermere, Alberta, Royal Canadian Mounted Police, municipal","48005","Other violent violations","0","0","0","0","0","0","0","0","0","0","0","0","0","0"
"2005","Chestermere, Alberta, Royal Canadian Mounted Police, municipal","48005","Other violent violations","0","0","0","0","0","0","0","0","0","0","0","0","0","0"
"2006","Chestermere, Alberta, Royal Canadian Mounted Police, municipal","48005","Other violent violations","0","0","0","0","0","0","0","0","0","0","0","0","0","0"
"2007","Chestermere, Alberta, Royal Canadian Mounted Police, municipal","48005","Other violent violations","1","0","0","0","8.8","0","0","0","0","0","0","0","0","0"
"2008","Chestermere, Alberta, Royal Canadian Mounted Police, municipal","48005","Other violent violations","2","0","2","83.66","16.16","0","0","0","0","2","0","0","0","0"
"2009","Chestermere, Alberta, Royal Canadian Mounted Police, municipal","48005","Other violent violations","0","0","0","-100","0","0","0","0","0","0","0","0","0","0"
"2010","Chestermere, Alberta, Royal Canadian Mounted Police, municipal","48005","Other violent violations","0","0","0","0","0","0","0","0","0","0","0","0","0","0"
"2011","Chestermere, Alberta, Royal Canadian Mounted Police, municipal","48005","Other violent violations","0","0","0","0","0","0","0","0","0","0","0","0","0","0"
"2012","Chestermere, Alberta, Royal Canadian Mounted Police, municipal","48005","Other violent violations","0","0","0","0","0","0","0","0","0","0","0","0","0","0"
"2013","Chestermere, Alberta, Royal Canadian Mounted Police, municipal","48005","Other violent violations","0","0","0","0","0","0","0","0","0","0","0","0","0","0"
"2014","Chestermere, Alberta, Royal Canadian Mounted Police, municipal","48005","Other violent violations","0","0","0","0","0","0","0","0","0","0","0","0","0","0"
"2015","Chestermere, Alberta, Royal Canadian Mounted Police, municipal","48005","Other violent violations","0","0","0","0","0","0","0","0","0","0","0","0","0","0"
"2016","Chestermere, Alberta, Royal Canadian Mounted Police, municipal","48005","Other violent violations","0","0","0","0","0","0","0","0","0","0","0","0","0","0"
"1998","Chestermere, Alberta, Royal Canadian Mounted Police, municipal","48005","Total property crime violations","0","0","0","0","0","0","0","0","0","0","0","0","0","0"
"1999","Chestermere, Alberta, Royal Canadian Mounted Police, municipal","48005","Total property crime violations","0","0","0","0","0","0","0","0","0","0","0","0","0","0"
"2000","Chestermere, Alberta, Royal Canadian Mounted Police, municipal","48005","Total property crime violations","0","0","0","0","0","0","0","0","0","0","0","0","0","0"
"2001","Chestermere, Alberta, Royal Canadian Mounted Police, municipal","48005","Total property crime violations","0","0","0","0","0","0","0","0","0","0","0","0","0","0"
"2002","Chestermere, Alberta, Royal Canadian Mounted Police, municipal","48005","Total property crime violations","0","0","0","0","0","0","0","0","0","0","0","0","0","0"
"2003","Chestermere, Alberta, Royal Canadian Mounted Police, municipal","48005","Total property crime violations","0","0","0","0","0","0","0","0","0","0","0","0","0","0"
"2004","Chestermere, Alberta, Royal Canadian Mounted Police, municipal","48005","Total property crime violations","0","0","0","0","0","0","0","0","0","0","0","0","0","0"
"2005","Chestermere, Alberta, Royal Canadian Mounted Police, municipal","48005","Total property crime violations","115","12","18","0","1327.64","191.91","212.1","366.3","854.7","30","12","15","3","7"
"2006","Chestermere, Alberta, Royal Canadian Mounted Police, municipal","48005","Total property crime violations","407","25","36","195.05","3917.23","216.25","368.43","1477.83","1477.83","61","16","31","15","15"
"2007","Chestermere, Alberta, Royal Canadian Mounted Police, municipal","48005","Total property crime violations","506","23","99","13.69","4453.44","184.8","271.33","911.58","5195.99","122","15","25","10","57"
"2008","Chestermere, Alberta, Royal Canadian Mounted Police, municipal","48005","Total property crime violations","586","33","118","6.35","4736.12","225.66","229.06","254.67","3650.25","151","20","23","3","43"
"2009","Chestermere, Alberta, Royal Canadian Mounted Police, municipal","48005","Total property crime violations","555","15","76","-12.76","4131.62","134.56","155.65","317.21","3013.48","91","13","17","4","38"
"2010","Chestermere, Alberta, Royal Canadian Mounted Police, municipal","48005","Total property crime violations","493","16","68","-17.23","3419.57","115.86","153.65","441.83","2724.59","84","12","18","6","37"
"2011","Chestermere, Alberta, Royal Canadian Mounted Police, municipal","48005","Total property crime violations","442","18","63","-15.99","2872.74","108.71","193.25","869.57","2463.77","81","12","24","12","34"
"2012","Chestermere, Alberta, Royal Canadian Mounted Police, municipal","48005","Total property crime violations","435","16","64","-4.45","2745","114.13","125.21","216.14","2089.34","80","13","16","3","29"
"2013","Chestermere, Alberta, Royal Canadian Mounted Police, municipal","48005","Total property crime violations","447","18","58","-0.7","2725.78","118.41","121.06","143.47","1721.66","76","14","16","2","24"
"2014","Chestermere, Alberta, Royal Canadian Mounted Police, municipal","48005","Total property crime violations","514","19","75","11.35","3035.13","155.22","153.96","142.96","1286.63","94","19","21","2","18"
"2015","Chestermere, Alberta, Royal Canadian Mounted Police, municipal","48005","Total property crime violations","713","28","62","35.67","4117.82","231.87","237.07","283.09","990.8","90","29","33","4","14"
"2016","Chestermere, Alberta, Royal Canadian Mounted Police, municipal","48005","Total property crime violations","629","28","52","-13.93","3544.06","171.93","210.66","553.63","2214.53","80","22","30","8","32"
"1998","Chestermere, Alberta, Royal Canadian Mounted Police, municipal","48005","Total breaking and entering","0","0","0","0","0","0","0","0","0","0","0","0","0","0"
"1999","Chestermere, Alberta, Royal Canadian Mounted Police, municipal","48005","Total breaking and entering","0","0","0","0","0","0","0","0","0","0","0","0","0","0"
"2000","Chestermere, Alberta, Royal Canadian Mounted Police, municipal","48005","Total breaking and entering","0","0","0","0","0","0","0","0","0","0","0","0","0","0"
"2001","Chestermere, Alberta, Royal Canadian Mounted Police, municipal","48005","Total breaking and entering","0","0","0","0","0","0","0","0","0","0","0","0","0","0"
"2002","Chestermere, Alberta, Royal Canadian Mounted Police, municipal","48005","Total breaking and entering","0","0","0","0","0","0","0","0","0","0","0","0","0","0"
"2003","Chestermere, Alberta, Royal Canadian Mounted Police, municipal","48005","Total breaking and entering","0","0","0","0","0","0","0","0","0","0","0","0","0","0"
"2004","Chestermere, Alberta, Royal Canadian Mounted Police, municipal","48005","Total breaking and entering","0","0","0","0","0","0","0","0","0","0","0","0","0","0"
"2005","Chestermere, Alberta, Royal Canadian Mounted Police, municipal","48005","Total breaking and entering","13","3","1","0","150.08","47.98","56.56","122.1","0","4","3","4","1","0"
"2006","Chestermere, Alberta, Royal Canadian Mounted Police, municipal","48005","Total breaking and entering","72","3","1","361.73","692.97","0","59.42","492.61","0","4","0","5","5","0"
"2007","Chestermere, Alberta, Royal Canadian Mounted Police, municipal","48005","Total breaking and entering","91","3","6","15.58","800.92","12.32","21.71","91.16","638.1","9","1","2","1","7"
"2008","Chestermere, Alberta, Royal Canadian Mounted Police, municipal","48005","Total breaking and entering","59","0","7","-40.46","476.84","0","0","0","764.01","7","0","0","0","9"
"2009","Chestermere, Alberta, Royal Canadian Mounted Police, municipal","48005","Total breaking and entering","58","2","1","-9.45","431.77","20.7","18.31","0","0","3","2","2","0","0"
"2010","Chestermere, Alberta, Royal Canadian Mounted Police, municipal","48005","Total breaking and entering","50","0","6","-19.68","346.81","0","0","0","0","6","0","0","0","0"
"2011","Chestermere, Alberta, Royal Canadian Mounted Police, municipal","48005","Total breaking and entering","67","4","5","25.56","435.46","36.24","56.37","217.39","72.46","9","4","7","3","1"
"2012","Chestermere, Alberta, Royal Canadian Mounted Police, municipal","48005","Total breaking and entering","38","1","4","-44.93","239.79","8.78","7.83","0","72.05","5","1","1","0","1"
"2013","Chestermere, Alberta, Royal Canadian Mounted Police, municipal","48005","Total breaking and entering","36","4","3","-8.45","219.53","16.92","15.13","0","215.21","7","2","2","0","3"
"2014","Chestermere, Alberta, Royal Canadian Mounted Police, municipal","48005","Total breaking and entering","29","0","3","-21.99","171.24","0","0","0","357.4","3","0","0","0","5"
"2015","Chestermere, Alberta, Royal Canadian Mounted Police, municipal","48005","Total breaking and entering","62","3","1","109.1","358.07","31.98","28.74","0","0","4","4","4","0","0"
"2016","Chestermere, Alberta, Royal Canadian Mounted Police, municipal","48005","Total breaking and entering","54","5","2","-15.03","304.26","31.26","28.09","0","0","7","4","4","0","0"
"1998","Chestermere, Alberta, Royal Canadian Mounted Police, municipal","48005","Breaking and entering","0","0","0","0","0","0","0","0","0","0","0","0","0","0"
"1999","Chestermere, Alberta, Royal Canadian Mounted Police, municipal","48005","Breaking and entering","0","0","0","0","0","0","0","0","0","0","0","0","0","0"
"2000","Chestermere, Alberta, Royal Canadian Mounted Police, municipal","48005","Breaking and entering","0","0","0","0","0","0","0","0","0","0","0","0","0","0"
"2001","Chestermere, Alberta, Royal Canadian Mounted Police, municipal","48005","Breaking and entering","0","0","0","0","0","0","0","0","0","0","0","0","0","0"
"2002","Chestermere, Alberta, Royal Canadian Mounted Police, municipal","48005","Breaking and entering","0","0","0","0","0","0","0","0","0","0","0","0","0","0"
"2003","Chestermere, Alberta, Royal Canadian Mounted Police, municipal","48005","Breaking and entering","0","0","0","0","0","0","0","0","0","0","0","0","0","0"
"2004","Chestermere, Alberta, Royal Canadian Mounted Police, municipal","48005","Breaking and entering","0","0","0","0","0","0","0","0","0","0","0","0","0","0"
"2005","Chestermere, Alberta, Royal Canadian Mounted Police, municipal","48005","Breaking and entering","13","3","1","0","150.08","47.98","56.56","122.1","0","4","3","4","1","0"
"2006","Chestermere, Alberta, Royal Canadian Mounted Police, municipal","48005","Breaking and entering","72","3","1","361.73","692.97","0","59.42","492.61","0","4","0","5","5","0"
"2007","Chestermere, Alberta, Royal Canadian Mounted Police, municipal","48005","Breaking and entering","91","3","6","15.58","800.92","12.32","21.71","91.16","638.1","9","1","2","1","7"
"2008","Chestermere, Alberta, Royal Canadian Mounted Police, municipal","48005","Breaking and entering","59","0","7","-40.46","476.84","0","0","0","764.01","7","0","0","0","9"
"2009","Chestermere, Alberta, Royal Canadian Mounted Police, municipal","48005","Breaking and entering","58","2","1","-9.45","431.77","20.7","18.31","0","0","3","2","2","0","0"
"2010","Chestermere, Alberta, Royal Canadian Mounted Police, municipal","48005","Breaking and entering","50","0","6","-19.68","346.81","0","0","0","0","6","0","0","0","0"
"2011","Chestermere, Alberta, Royal Canadian Mounted Police, municipal","48005","Breaking and entering","67","4","5","25.56","435.46","36.24","56.37","217.39","72.46","9","4","7","3","1"
"2012","Chestermere, Alberta, Royal Canadian Mounted Police, municipal","48005","Breaking and entering","38","1","4","-44.93","239.79","8.78","7.83","0","72.05","5","1","1","0","1"
"2013","Chestermere, Alberta, Royal Canadian Mounted Police, municipal","48005","Breaking and entering","36","4","3","-8.45","219.53","16.92","15.13","0","215.21","7","2","2","0","3"
"2014","Chestermere, Alberta, Royal Canadian Mounted Police, municipal","48005","Breaking and entering","29","0","3","-21.99","171.24","0","0","0","357.4","3","0","0","0","5"
"2015","Chestermere, Alberta, Royal Canadian Mounted Police, municipal","48005","Breaking and entering","61","3","1","105.73","352.3","31.98","28.74","0","0","4","4","4","0","0"
"2016","Chestermere, Alberta, Royal Canadian Mounted Police, municipal","48005","Breaking and entering","54","5","2","-13.64","304.26","31.26","28.09","0","0","7","4","4","0","0"
"2005","Chestermere, Alberta, Royal Canadian Mounted Police, municipal","48005","Breaking and entering to steal a firearm","0","0","0","0","0","0","0","0","0","0","0","0","0","0"
"2006","Chestermere, Alberta, Royal Canadian Mounted Police, municipal","48005","Breaking and entering to steal a firearm","0","0","0","0","0","0","0","0","0","0","0","0","0","0"
"2007","Chestermere, Alberta, Royal Canadian Mounted Police, municipal","48005","Breaking and entering to steal a firearm","0","0","0","0","0","0","0","0","0","0","0","0","0","0"
"2008","Chestermere, Alberta, Royal Canadian Mounted Police, municipal","48005","Breaking and entering to steal a firearm","0","0","0","0","0","0","0","0","0","0","0","0","0","0"
"2009","Chestermere, Alberta, Royal Canadian Mounted Police, municipal","48005","Breaking and entering to steal a firearm","0","0","0","0","0","0","0","0","0","0","0","0","0","0"
"2010","Chestermere, Alberta, Royal Canadian Mounted Police, municipal","48005","Breaking and entering to steal a firearm","0","0","0","0","0","0","0","0","0","0","0","0","0","0"
"2011","Chestermere, Alberta, Royal Canadian Mounted Police, municipal","48005","Breaking and entering to steal a firearm","0","0","0","0","0","0","0","0","0","0","0","0","0","0"
"2012","Chestermere, Alberta, Royal Canadian Mounted Police, municipal","48005","Breaking and entering to steal a firearm","0","0","0","0","0","0","0","0","0","0","0","0","0","0"
"2013","Chestermere, Alberta, Royal Canadian Mounted Police, municipal","48005","Breaking and entering to steal a firearm","0","0","0","0","0","0","0","0","0","0","0","0","0","0"
"2014","Chestermere, Alberta, Royal Canadian Mounted Police, municipal","48005","Breaking and entering to steal a firearm","0","0","0","0","0","0","0","0","0","0","0","0","0","0"
"2015","Chestermere, Alberta, Royal Canadian Mounted Police, municipal","48005","Breaking and entering to steal a firearm","0","0","0","0","0","0","0","0","0","0","0","0","0","0"
"2016","Chestermere, Alberta, Royal Canadian Mounted Police, municipal","48005","Breaking and entering to steal a firearm","0","0","0","0","0","0","0","0","0","0","0","0","0","0"
"2005","Chestermere, Alberta, Royal Canadian Mounted Police, municipal","48005","Break and enter to steal a firearm from a motor vehicle","0","0","0","0","0","0","0","0","0","0","0","0","0","0"
"2006","Chestermere, Alberta, Royal Canadian Mounted Police, municipal","48005","Break and enter to steal a firearm from a motor vehicle","0","0","0","0","0","0","0","0","0","0","0","0","0","0"
"2007","Chestermere, Alberta, Royal Canadian Mounted Police, municipal","48005","Break and enter to steal a firearm from a motor vehicle","0","0","0","0","0","0","0","0","0","0","0","0","0","0"
"2008","Chestermere, Alberta, Royal Canadian Mounted Police, municipal","48005","Break and enter to steal a firearm from a motor vehicle","0","0","0","0","0","0","0","0","0","0","0","0","0","0"
"2009","Chestermere, Alberta, Royal Canadian Mounted Police, municipal","48005","Break and enter to steal a firearm from a motor vehicle","0","0","0","0","0","0","0","0","0","0","0","0","0","0"
"2010","Chestermere, Alberta, Royal Canadian Mounted Police, municipal","48005","Break and enter to steal a firearm from a motor vehicle","0","0","0","0","0","0","0","0","0","0","0","0","0","0"
"2011","Chestermere, Alberta, Royal Canadian Mounted Police, municipal","48005","Break and enter to steal a firearm from a motor vehicle","0","0","0","0","0","0","0","0","0","0","0","0","0","0"
"2012","Chestermere, Alberta, Royal Canadian Mounted Police, municipal","48005","Break and enter to steal a firearm from a motor vehicle","0","0","0","0","0","0","0","0","0","0","0","0","0","0"
"2013","Chestermere, Alberta, Royal Canadian Mounted Police, municipal","48005","Break and enter to steal a firearm from a motor vehicle","0","0","0","0","0","0","0","0","0","0","0","0","0","0"
"2014","Chestermere, Alberta, Royal Canadian Mounted Police, municipal","48005","Break and enter to steal a firearm from a motor vehicle","0","0","0","0","0","0","0","0","0","0","0","0","0","0"
"2015","Chestermere, Alberta, Royal Canadian Mounted Police, municipal","48005","Break and enter to steal a firearm from a motor vehicle","1","0","0","0","5.78","0","0","0","0","0","0","0","0","0"
"2016","Chestermere, Alberta, Royal Canadian Mounted Police, municipal","48005","Break and enter to steal a firearm from a motor vehicle","0","0","0","-100","0","0","0","0","0","0","0","0","0","0"
"1998","Chestermere, Alberta, Royal Canadian Mounted Police, municipal","48005","Total possession of stolen property","0","0","0","0","0","0","0","0","0","0","0","0","0","0"
"1999","Chestermere, Alberta, Royal Canadian Mounted Police, municipal","48005","Total possession of stolen property","0","0","0","0","0","0","0","0","0","0","0","0","0","0"
"2000","Chestermere, Alberta, Royal Canadian Mounted Police, municipal","48005","Total possession of stolen property","0","0","0","0","0","0","0","0","0","0","0","0","0","0"
"2001","Chestermere, Alberta, Royal Canadian Mounted Police, municipal","48005","Total possession of stolen property","0","0","0","0","0","0","0","0","0","0","0","0","0","0"
"2002","Chestermere, Alberta, Royal Canadian Mounted Police, municipal","48005","Total possession of stolen property","0","0","0","0","0","0","0","0","0","0","0","0","0","0"
"2003","Chestermere, Alberta, Royal Canadian Mounted Police, municipal","48005","Total possession of stolen property","0","0","0","0","0","0","0","0","0","0","0","0","0","0"
"2004","Chestermere, Alberta, Royal Canadian Mounted Police, municipal","48005","Total possession of stolen property","0","0","0","0","0","0","0","0","0","0","0","0","0","0"
"2005","Chestermere, Alberta, Royal Canadian Mounted Police, municipal","48005","Total possession of stolen property","2","1","0","0","23.09","15.99","14.14","0","0","1","1","1","0","0"
"2006","Chestermere, Alberta, Royal Canadian Mounted Police, municipal","48005","Total possession of stolen property","23","13","2","858.74","221.37","121.64","202.04","788.18","0","15","9","17","8","0"
"2007","Chestermere, Alberta, Royal Canadian Mounted Police, municipal","48005","Total possession of stolen property","22","3","6","-12.53","193.63","12.32","65.12","455.79","638.1","9","1","6","5","7"
"2008","Chestermere, Alberta, Royal Canadian Mounted Police, municipal","48005","Total possession of stolen property","36","10","8","50.27","290.96","124.11","129.47","169.78","0","18","11","13","2","0"
"2009","Chestermere, Alberta, Royal Canadian Mounted Police, municipal","48005","Total possession of stolen property","33","6","5","-15.57","245.66","62.11","82.4","237.91","237.91","11","6","9","3","3"
"2010","Chestermere, Alberta, Royal Canadian Mounted Police, municipal","48005","Total possession of stolen property","33","4","2","-6.83","228.9","28.97","51.22","220.91","0","6","3","6","3","0"
"2011","Chestermere, Alberta, Royal Canadian Mounted Police, municipal","48005","Total possession of stolen property","14","3","2","-60.25","90.99","27.18","24.16","0","217.39","5","3","3","0","3"
"2012","Chestermere, Alberta, Royal Canadian Mounted Police, municipal","48005","Total possession of stolen property","17","2","3","17.9","107.28","17.56","15.65","0","0","5","2","2","0","0"
"2013","Chestermere, Alberta, Royal Canadian Mounted Police, municipal","48005","Total possession of stolen property","15","1","2","-14.73","91.47","8.46","7.57","0","71.74","3","1","1","0","1"
"2014","Chestermere, Alberta, Royal Canadian Mounted Police, municipal","48005","Total possession of stolen property","15","5","1","-3.17","88.57","40.85","51.32","142.96","0","6","5","7","2","0"
"2015","Chestermere, Alberta, Royal Canadian Mounted Police, municipal","48005","Total possession of stolen property","21","2","2","36.93","121.28","8","7.18","0","70.77","4","1","1","0","1"
"2016","Chestermere, Alberta, Royal Canadian Mounted Police, municipal","48005","Total possession of stolen property","45","8","1","109.06","253.55","46.89","63.2","207.61","0","9","6","9","3","0"
"2005","Chestermere, Alberta, Royal Canadian Mounted Police, municipal","48005","Total trafficking in stolen property","0","0","0","0","0","0","0","0","0","0","0","0","0","0"
"2006","Chestermere, Alberta, Royal Canadian Mounted Police, municipal","48005","Total trafficking in stolen property","0","0","0","0","0","0","0","0","0","0","0","0","0","0"
"2007","Chestermere, Alberta, Royal Canadian Mounted Police, municipal","48005","Total trafficking in stolen property","0","0","0","0","0","0","0","0","0","0","0","0","0","0"
"2008","Chestermere, Alberta, Royal Canadian Mounted Police, municipal","48005","Total trafficking in stolen property","0","0","0","0","0","0","0","0","0","0","0","0","0","0"
"2009","Chestermere, Alberta, Royal Canadian Mounted Police, municipal","48005","Total trafficking in stolen property","0","0","0","0","0","0","0","0","0","0","0","0","0","0"
"2010","Chestermere, Alberta, Royal Canadian Mounted Police, municipal","48005","Total trafficking in stolen property","0","0","0","0","0","0","0","0","0","0","0","0","0","0"
"2011","Chestermere, Alberta, Royal Canadian Mounted Police, municipal","48005","Total trafficking in stolen property","0","0","0","0","0","0","0","0","0","0","0","0","0","0"
"2012","Chestermere, Alberta, Royal Canadian Mounted Police, municipal","48005","Total trafficking in stolen property","0","0","0","0","0","0","0","0","0","0","0","0","0","0"
"2013","Chestermere, Alberta, Royal Canadian Mounted Police, municipal","48005","Total trafficking in stolen property","0","0","0","0","0","0","0","0","0","0","0","0","0","0"
"2014","Chestermere, Alberta, Royal Canadian Mounted Police, municipal","48005","Total trafficking in stolen property","0","0","0","0","0","0","0","0","0","0","0","0","0","0"
"2015","Chestermere, Alberta, Royal Canadian Mounted Police, municipal","48005","Total trafficking in stolen property","1","0","0","0","5.78","0","0","0","0","0","0","0","0","0"
"2016","Chestermere, Alberta, Royal Canadian Mounted Police, municipal","48005","Total trafficking in stolen property","0","0","0","-100","0","0","0","0","0","0","0","0","0","0"
"1998","Chestermere, Alberta, Royal Canadian Mounted Police, municipal","48005","Total theft of motor vehicle","0","0","0","0","0","0","0","0","0","0","0","0","0","0"
"1999","Chestermere, Alberta, Royal Canadian Mounted Police, municipal","48005","Total theft of motor vehicle","0","0","0","0","0","0","0","0","0","0","0","0","0","0"
"2000","Chestermere, Alberta, Royal Canadian Mounted Police, municipal","48005","Total theft of motor vehicle","0","0","0","0","0","0","0","0","0","0","0","0","0","0"
"2001","Chestermere, Alberta, Royal Canadian Mounted Police, municipal","48005","Total theft of motor vehicle","0","0","0","0","0","0","0","0","0","0","0","0","0","0"
"2002","Chestermere, Alberta, Royal Canadian Mounted Police, municipal","48005","Total theft of motor vehicle","0","0","0","0","0","0","0","0","0","0","0","0","0","0"
"2003","Chestermere, Alberta, Royal Canadian Mounted Police, municipal","48005","Total theft of motor vehicle","0","0","0","0","0","0","0","0","0","0","0","0","0","0"
"2004","Chestermere, Alberta, Royal Canadian Mounted Police, municipal","48005","Total theft of motor vehicle","0","0","0","0","0","0","0","0","0","0","0","0","0","0"
"2005","Chestermere, Alberta, Royal Canadian Mounted Police, municipal","48005","Total theft of motor vehicle","7","1","1","0","80.81","15.99","14.14","0","0","2","1","1","0","0"
"2006","Chestermere, Alberta, Royal Canadian Mounted Police, municipal","48005","Total theft of motor vehicle","30","0","4","257.29","288.74","0","0","0","0","4","0","0","0","0"
"2007","Chestermere, Alberta, Royal Canadian Mounted Police, municipal","48005","Total theft of motor vehicle","36","0","12","9.73","316.85","0","0","0","820.42","12","0","0","0","9"
"2008","Chestermere, Alberta, Royal Canadian Mounted Police, municipal","48005","Total theft of motor vehicle","38","1","10","-3.07","307.12","11.28","9.96","0","254.67","11","1","1","0","3"
"2009","Chestermere, Alberta, Royal Canadian Mounted Police, municipal","48005","Total theft of motor vehicle","56","1","4","35.74","416.88","10.35","9.16","0","237.91","5","1","1","0","3"
"2010","Chestermere, Alberta, Royal Canadian Mounted Police, municipal","48005","Total theft of motor vehicle","38","0","6","-36.77","263.58","0","0","0","368.19","6","0","0","0","5"
"2011","Chestermere, Alberta, Royal Canadian Mounted Police, municipal","48005","Total theft of motor vehicle","14","2","2","-65.48","90.99","18.12","16.1","0","0","4","2","2","0","0"
"2012","Chestermere, Alberta, Royal Canadian Mounted Police, municipal","48005","Total theft of motor vehicle","39","0","6","170.47","246.1","0","0","0","72.05","6","0","0","0","1"
"2013","Chestermere, Alberta, Royal Canadian Mounted Police, municipal","48005","Total theft of motor vehicle","22","2","4","-45.49","134.15","8.46","15.13","71.74","0","6","1","2","1","0"
"2014","Chestermere, Alberta, Royal Canadian Mounted Police, municipal","48005","Total theft of motor vehicle","22","0","2","-3.17","129.91","0","0","0","0","2","0","0","0","0"
"2015","Chestermere, Alberta, Royal Canadian Mounted Police, municipal","48005","Total theft of motor vehicle","53","3","2","135.62","306.09","23.99","28.74","70.77","0","5","3","4","1","0"
"2016","Chestermere, Alberta, Royal Canadian Mounted Police, municipal","48005","Total theft of motor vehicle","72","1","7","32.53","405.68","0","21.07","207.61","69.2","8","0","3","3","1"
"1998","Chestermere, Alberta, Royal Canadian Mounted Police, municipal","48005","Total theft over $5,000 (non-motor vehicle)","0","0","0","0","0","0","0","0","0","0","0","0","0","0"
"1999","Chestermere, Alberta, Royal Canadian Mounted Police, municipal","48005","Total theft over $5,000 (non-motor vehicle)","0","0","0","0","0","0","0","0","0","0","0","0","0","0"
"2000","Chestermere, Alberta, Royal Canadian Mounted Police, municipal","48005","Total theft over $5,000 (non-motor vehicle)","0","0","0","0","0","0","0","0","0","0","0","0","0","0"
"2001","Chestermere, Alberta, Royal Canadian Mounted Police, municipal","48005","Total theft over $5,000 (non-motor vehicle)","0","0","0","0","0","0","0","0","0","0","0","0","0","0"
"2002","Chestermere, Alberta, Royal Canadian Mounted Police, municipal","48005","Total theft over $5,000 (non-motor vehicle)","0","0","0","0","0","0","0","0","0","0","0","0","0","0"
"2003","Chestermere, Alberta, Royal Canadian Mounted Police, municipal","48005","Total theft over $5,000 (non-motor vehicle)","0","0","0","0","0","0","0","0","0","0","0","0","0","0"
"2004","Chestermere, Alberta, Royal Canadian Mounted Police, municipal","48005","Total theft over $5,000 (non-motor vehicle)","0","0","0","0","0","0","0","0","0","0","0","0","0","0"
"2005","Chestermere, Alberta, Royal Canadian Mounted Police, municipal","48005","Total theft over $5,000 (non-motor vehicle)","2","2","0","0","23.09","31.98","28.28","0","0","2","2","2","0","0"
"2006","Chestermere, Alberta, Royal Canadian Mounted Police, municipal","48005","Total theft over $5,000 (non-motor vehicle)","4","0","0","66.74","38.5","0","0","0","0","0","0","0","0","0"
"2007","Chestermere, Alberta, Royal Canadian Mounted Police, municipal","48005","Total theft over $5,000 (non-motor vehicle)","10","0","1","128.61","88.01","0","0","0","0","1","0","0","0","0"
"2008","Chestermere, Alberta, Royal Canadian Mounted Police, municipal","48005","Total theft over $5,000 (non-motor vehicle)","12","0","0","10.19","96.99","0","0","0","0","0","0","0","0","0"
"2009","Chestermere, Alberta, Royal Canadian Mounted Police, municipal","48005","Total theft over $5,000 (non-motor vehicle)","11","1","1","-15.57","81.89","10.35","9.16","0","79.3","2","1","1","0","1"
"2010","Chestermere, Alberta, Royal Canadian Mounted Police, municipal","48005","Total theft over $5,000 (non-motor vehicle)","3","0","0","-74.59","20.81","0","0","0","0","0","0","0","0","0"
"2011","Chestermere, Alberta, Royal Canadian Mounted Police, municipal","48005","Total theft over $5,000 (non-motor vehicle)","8","0","0","149.87","52","0","0","0","0","0","0","0","0","0"
"2012","Chestermere, Alberta, Royal Canadian Mounted Police, municipal","48005","Total theft over $5,000 (non-motor vehicle)","12","0","1","45.64","75.72","0","0","0","72.05","1","0","0","0","1"
"2013","Chestermere, Alberta, Royal Canadian Mounted Police, municipal","48005","Total theft over $5,000 (non-motor vehicle)","10","1","2","-19.47","60.98","8.46","7.57","0","71.74","3","1","1","0","1"
"2014","Chestermere, Alberta, Royal Canadian Mounted Police, municipal","48005","Total theft over $5,000 (non-motor vehicle)","6","1","0","-41.9","35.43","8.17","7.33","0","0","1","1","1","0","0"
"2015","Chestermere, Alberta, Royal Canadian Mounted Police, municipal","48005","Total theft over $5,000 (non-motor vehicle)","9","0","0","46.71","51.98","0","0","0","0","0","0","0","0","0"
"2016","Chestermere, Alberta, Royal Canadian Mounted Police, municipal","48005","Total theft over $5,000 (non-motor vehicle)","8","0","1","-13.28","45.08","0","0","0","0","1","0","0","0","0"
"1998","Chestermere, Alberta, Royal Canadian Mounted Police, municipal","48005","Theft over $5,000","0","0","0","0","0","0","0","0","0","0","0","0","0","0"
"1999","Chestermere, Alberta, Royal Canadian Mounted Police, municipal","48005","Theft over $5,000","0","0","0","0","0","0","0","0","0","0","0","0","0","0"
"2000","Chestermere, Alberta, Royal Canadian Mounted Police, municipal","48005","Theft over $5,000","0","0","0","0","0","0","0","0","0","0","0","0","0","0"
"2001","Chestermere, Alberta, Royal Canadian Mounted Police, municipal","48005","Theft over $5,000","0","0","0","0","0","0","0","0","0","0","0","0","0","0"
"2002","Chestermere, Alberta, Royal Canadian Mounted Police, municipal","48005","Theft over $5,000","0","0","0","0","0","0","0","0","0","0","0","0","0","0"
"2003","Chestermere, Alberta, Royal Canadian Mounted Police, municipal","48005","Theft over $5,000","0","0","0","0","0","0","0","0","0","0","0","0","0","0"
"2004","Chestermere, Alberta, Royal Canadian Mounted Police, municipal","48005","Theft over $5,000","0","0","0","0","0","0","0","0","0","0","0","0","0","0"
"2005","Chestermere, Alberta, Royal Canadian Mounted Police, municipal","48005","Theft over $5,000","2","2","0","0","23.09","31.98","28.28","0","0","2","2","2","0","0"
"2006","Chestermere, Alberta, Royal Canadian Mounted Police, municipal","48005","Theft over $5,000","2","0","0","-16.63","19.25","0","0","0","0","0","0","0","0","0"
"2007","Chestermere, Alberta, Royal Canadian Mounted Police, municipal","48005","Theft over $5,000","8","0","1","265.78","70.41","0","0","0","0","1","0","0","0","0"
"2008","Chestermere, Alberta, Royal Canadian Mounted Police, municipal","48005","Theft over $5,000","6","0","0","-31.13","48.49","0","0","0","0","0","0","0","0","0"
"2009","Chestermere, Alberta, Royal Canadian Mounted Police, municipal","48005","Theft over $5,000","8","1","1","22.81","59.55","10.35","9.16","0","79.3","2","1","1","0","1"
"2010","Chestermere, Alberta, Royal Canadian Mounted Police, municipal","48005","Theft over $5,000","3","0","0","-65.06","20.81","0","0","0","0","0","0","0","0","0"
"2011","Chestermere, Alberta, Royal Canadian Mounted Police, municipal","48005","Theft over $5,000","5","0","0","56.17","32.5","0","0","0","0","0","0","0","0","0"
"2012","Chestermere, Alberta, Royal Canadian Mounted Police, municipal","48005","Theft over $5,000","11","0","1","113.6","69.41","0","0","0","72.05","1","0","0","0","1"
"2013","Chestermere, Alberta, Royal Canadian Mounted Police, municipal","48005","Theft over $5,000","7","1","1","-38.51","42.69","8.46","7.57","0","0","2","1","1","0","0"
"2014","Chestermere, Alberta, Royal Canadian Mounted Police, municipal","48005","Theft over $5,000","4","0","0","-44.67","23.62","0","0","0","0","0","0","0","0","0"
"2015","Chestermere, Alberta, Royal Canadian Mounted Police, municipal","48005","Theft over $5,000","5","0","0","22.26","28.88","0","0","0","0","0","0","0","0","0"
"2016","Chestermere, Alberta, Royal Canadian Mounted Police, municipal","48005","Theft over $5,000","8","0","1","56.1","45.08","0","0","0","0","1","0","0","0","0"
"1998","Chestermere, Alberta, Royal Canadian Mounted Police, municipal","48005","Theft over $5,000 from a motor vehicle","0","0","0","0","0","0","0","0","0","0","0","0","0","0"
"1999","Chestermere, Alberta, Royal Canadian Mounted Police, municipal","48005","Theft over $5,000 from a motor vehicle","0","0","0","0","0","0","0","0","0","0","0","0","0","0"
"2000","Chestermere, Alberta, Royal Canadian Mounted Police, municipal","48005","Theft over $5,000 from a motor vehicle","0","0","0","0","0","0","0","0","0","0","0","0","0","0"
"2001","Chestermere, Alberta, Royal Canadian Mounted Police, municipal","48005","Theft over $5,000 from a motor vehicle","0","0","0","0","0","0","0","0","0","0","0","0","0","0"
"2002","Chestermere, Alberta, Royal Canadian Mounted Police, municipal","48005","Theft over $5,000 from a motor vehicle","0","0","0","0","0","0","0","0","0","0","0","0","0","0"
"2003","Chestermere, Alberta, Royal Canadian Mounted Police, municipal","48005","Theft over $5,000 from a motor vehicle","0","0","0","0","0","0","0","0","0","0","0","0","0","0"
"2004","Chestermere, Alberta, Royal Canadian Mounted Police, municipal","48005","Theft over $5,000 from a motor vehicle","0","0","0","0","0","0","0","0","0","0","0","0","0","0"
"2005","Chestermere, Alberta, Royal Canadian Mounted Police, municipal","48005","Theft over $5,000 from a motor vehicle","0","0","0","0","0","0","0","0","0","0","0","0","0","0"
"2006","Chestermere, Alberta, Royal Canadian Mounted Police, municipal","48005","Theft over $5,000 from a motor vehicle","2","0","0","0","19.25","0","0","0","0","0","0","0","0","0"
"2007","Chestermere, Alberta, Royal Canadian Mounted Police, municipal","48005","Theft over $5,000 from a motor vehicle","2","0","0","-8.55","17.6","0","0","0","0","0","0","0","0","0"
"2008","Chestermere, Alberta, Royal Canadian Mounted Police, municipal","48005","Theft over $5,000 from a motor vehicle","6","0","0","175.49","48.49","0","0","0","0","0","0","0","0","0"
"2009","Chestermere, Alberta, Royal Canadian Mounted Police, municipal","48005","Theft over $5,000 from a motor vehicle","3","0","0","-53.95","22.33","0","0","0","0","0","0","0","0","0"
"2010","Chestermere, Alberta, Royal Canadian Mounted Police, municipal","48005","Theft over $5,000 from a motor vehicle","0","0","0","-100","0","0","0","0","0","0","0","0","0","0"
"2011","Chestermere, Alberta, Royal Canadian Mounted Police, municipal","48005","Theft over $5,000 from a motor vehicle","3","0","0","0","19.5","0","0","0","0","0","0","0","0","0"
"2012","Chestermere, Alberta, Royal Canadian Mounted Police, municipal","48005","Theft over $5,000 from a motor vehicle","1","0","0","-67.64","6.31","0","0","0","0","0","0","0","0","0"
"2013","Chestermere, Alberta, Royal Canadian Mounted Police, municipal","48005","Theft over $5,000 from a motor vehicle","2","0","0","93.27","12.2","0","0","0","0","0","0","0","0","0"
"2014","Chestermere, Alberta, Royal Canadian Mounted Police, municipal","48005","Theft over $5,000 from a motor vehicle","0","0","0","-100","0","0","0","0","0","0","0","0","0","0"
"2015","Chestermere, Alberta, Royal Canadian Mounted Police, municipal","48005","Theft over $5,000 from a motor vehicle","3","0","0","0","17.33","0","0","0","0","0","0","0","0","0"
"2016","Chestermere, Alberta, Royal Canadian Mounted Police, municipal","48005","Theft over $5,000 from a motor vehicle","0","0","0","-100","0","0","0","0","0","0","0","0","0","0"
"1998","Chestermere, Alberta, Royal Canadian Mounted Police, municipal","48005","Shoplifting over $5,000","0","0","0","0","0","0","0","0","0","0","0","0","0","0"
"1999","Chestermere, Alberta, Royal Canadian Mounted Police, municipal","48005","Shoplifting over $5,000","0","0","0","0","0","0","0","0","0","0","0","0","0","0"
"2000","Chestermere, Alberta, Royal Canadian Mounted Police, municipal","48005","Shoplifting over $5,000","0","0","0","0","0","0","0","0","0","0","0","0","0","0"
"2001","Chestermere, Alberta, Royal Canadian Mounted Police, municipal","48005","Shoplifting over $5,000","0","0","0","0","0","0","0","0","0","0","0","0","0","0"
"2002","Chestermere, Alberta, Royal Canadian Mounted Police, municipal","48005","Shoplifting over $5,000","0","0","0","0","0","0","0","0","0","0","0","0","0","0"
"2003","Chestermere, Alberta, Royal Canadian Mounted Police, municipal","48005","Shoplifting over $5,000","0","0","0","0","0","0","0","0","0","0","0","0","0","0"
"2004","Chestermere, Alberta, Royal Canadian Mounted Police, municipal","48005","Shoplifting over $5,000","0","0","0","0","0","0","0","0","0","0","0","0","0","0"
"2005","Chestermere, Alberta, Royal Canadian Mounted Police, municipal","48005","Shoplifting over $5,000","0","0","0","0","0","0","0","0","0","0","0","0","0","0"
"2006","Chestermere, Alberta, Royal Canadian Mounted Police, municipal","48005","Shoplifting over $5,000","0","0","0","0","0","0","0","0","0","0","0","0","0","0"
"2007","Chestermere, Alberta, Royal Canadian Mounted Police, municipal","48005","Shoplifting over $5,000","0","0","0","0","0","0","0","0","0","0","0","0","0","0"
"2008","Chestermere, Alberta, Royal Canadian Mounted Police, municipal","48005","Shoplifting over $5,000","0","0","0","0","0","0","0","0","0","0","0","0","0","0"
"2009","Chestermere, Alberta, Royal Canadian Mounted Police, municipal","48005","Shoplifting over $5,000","0","0","0","0","0","0","0","0","0","0","0","0","0","0"
"2010","Chestermere, Alberta, Royal Canadian Mounted Police, municipal","48005","Shoplifting over $5,000","0","0","0","0","0","0","0","0","0","0","0","0","0","0"
"2011","Chestermere, Alberta, Royal Canadian Mounted Police, municipal","48005","Shoplifting over $5,000","0","0","0","0","0","0","0","0","0","0","0","0","0","0"
"2012","Chestermere, Alberta, Royal Canadian Mounted Police, municipal","48005","Shoplifting over $5,000","0","0","0","0","0","0","0","0","0","0","0","0","0","0"
"2013","Chestermere, Alberta, Royal Canadian Mounted Police, municipal","48005","Shoplifting over $5,000","1","0","1","0","6.1","0","0","0","71.74","1","0","0","0","1"
"2014","Chestermere, Alberta, Royal Canadian Mounted Police, municipal","48005","Shoplifting over $5,000","2","1","0","93.67","11.81","8.17","7.33","0","0","1","1","1","0","0"
"2015","Chestermere, Alberta, Royal Canadian Mounted Police, municipal","48005","Shoplifting over $5,000","1","0","0","-51.1","5.78","0","0","0","0","0","0","0","0","0"
"2016","Chestermere, Alberta, Royal Canadian Mounted Police, municipal","48005","Shoplifting over $5,000","0","0","0","-100","0","0","0","0","0","0","0","0","0","0"
"1998","Chestermere, Alberta, Royal Canadian Mounted Police, municipal","48005","Total theft under $5,000 (non-motor vehicle)","0","0","0","0","0","0","0","0","0","0","0","0","0","0"
"1999","Chestermere, Alberta, Royal Canadian Mounted Police, municipal","48005","Total theft under $5,000 (non-motor vehicle)","0","0","0","0","0","0","0","0","0","0","0","0","0","0"
"2000","Chestermere, Alberta, Royal Canadian Mounted Police, municipal","48005","Total theft under $5,000 (non-motor vehicle)","0","0","0","0","0","0","0","0","0","0","0","0","0","0"
"2001","Chestermere, Alberta, Royal Canadian Mounted Police, municipal","48005","Total theft under $5,000 (non-motor vehicle)","0","0","0","0","0","0","0","0","0","0","0","0","0","0"
"2002","Chestermere, Alberta, Royal Canadian Mounted Police, municipal","48005","Total theft under $5,000 (non-motor vehicle)","0","0","0","0","0","0","0","0","0","0","0","0","0","0"
"2003","Chestermere, Alberta, Royal Canadian Mounted Police, municipal","48005","Total theft under $5,000 (non-motor vehicle)","0","0","0","0","0","0","0","0","0","0","0","0","0","0"
"2004","Chestermere, Alberta, Royal Canadian Mounted Police, municipal","48005","Total theft under $5,000 (non-motor vehicle)","0","0","0","0","0","0","0","0","0","0","0","0","0","0"
"2005","Chestermere, Alberta, Royal Canadian Mounted Police, municipal","48005","Total theft under $5,000 (non-motor vehicle)","45","4","6","0","519.51","63.97","70.7","122.1","0","10","4","5","1","0"
"2006","Chestermere, Alberta, Royal Canadian Mounted Police, municipal","48005","Total theft under $5,000 (non-motor vehicle)","136","2","12","151.96","1308.95","27.03","23.77","0","295.57","14","2","2","0","3"
"2007","Chestermere, Alberta, Royal Canadian Mounted Police, municipal","48005","Total theft under $5,000 (non-motor vehicle)","152","12","26","2.2","1337.79","147.84","151.94","182.32","1093.89","38","12","14","2","12"
"2008","Chestermere, Alberta, Royal Canadian Mounted Police, municipal","48005","Total theft under $5,000 (non-motor vehicle)","194","4","27","17.2","1567.93","11.28","19.92","84.89","254.67","31","1","2","1","3"
"2009","Chestermere, Alberta, Royal Canadian Mounted Police, municipal","48005","Total theft under $5,000 (non-motor vehicle)","199","1","32","-5.52","1481.43","10.35","9.16","0","555.11","33","1","1","0","7"
"2010","Chestermere, Alberta, Royal Canadian Mounted Police, municipal","48005","Total theft under $5,000 (non-motor vehicle)","170","4","15","-20.4","1179.16","38.62","34.14","0","810.01","19","4","4","0","11"
"2011","Chestermere, Alberta, Royal Canadian Mounted Police, municipal","48005","Total theft under $5,000 (non-motor vehicle)","144","1","15","-20.63","935.92","0","8.05","72.46","289.86","16","0","1","1","4"
"2012","Chestermere, Alberta, Royal Canadian Mounted Police, municipal","48005","Total theft under $5,000 (non-motor vehicle)","124","4","12","-16.39","782.48","17.56","31.3","144.09","648.41","16","2","4","2","9"
"2013","Chestermere, Alberta, Royal Canadian Mounted Police, municipal","48005","Total theft under $5,000 (non-motor vehicle)","175","7","19","36.38","1067.14","50.75","52.96","71.74","430.42","26","6","7","1","6"
"2014","Chestermere, Alberta, Royal Canadian Mounted Police, municipal","48005","Total theft under $5,000 (non-motor vehicle)","219","5","25","21.18","1293.18","40.85","36.66","0","214.44","30","5","5","0","3"
"2015","Chestermere, Alberta, Royal Canadian Mounted Police, municipal","48005","Total theft under $5,000 (non-motor vehicle)","317","6","23","41.57","1830.78","79.96","79.02","70.77","283.09","29","10","11","1","4"
"2016","Chestermere, Alberta, Royal Canadian Mounted Police, municipal","48005","Total theft under $5,000 (non-motor vehicle)","245","6","15","-24.6","1380.44","31.26","42.13","138.41","622.84","21","4","6","2","9"
"1998","Chestermere, Alberta, Royal Canadian Mounted Police, municipal","48005","Theft $5,000 or under","0","0","0","0","0","0","0","0","0","0","0","0","0","0"
"1999","Chestermere, Alberta, Royal Canadian Mounted Police, municipal","48005","Theft $5,000 or under","0","0","0","0","0","0","0","0","0","0","0","0","0","0"
"2000","Chestermere, Alberta, Royal Canadian Mounted Police, municipal","48005","Theft $5,000 or under","0","0","0","0","0","0","0","0","0","0","0","0","0","0"
"2001","Chestermere, Alberta, Royal Canadian Mounted Police, municipal","48005","Theft $5,000 or under","0","0","0","0","0","0","0","0","0","0","0","0","0","0"
"2002","Chestermere, Alberta, Royal Canadian Mounted Police, municipal","48005","Theft $5,000 or under","0","0","0","0","0","0","0","0","0","0","0","0","0","0"
"2003","Chestermere, Alberta, Royal Canadian Mounted Police, municipal","48005","Theft $5,000 or under","0","0","0","0","0","0","0","0","0","0","0","0","0","0"
"2004","Chestermere, Alberta, Royal Canadian Mounted Police, municipal","48005","Theft $5,000 or under","0","0","0","0","0","0","0","0","0","0","0","0","0","0"
"2005","Chestermere, Alberta, Royal Canadian Mounted Police, municipal","48005","Theft $5,000 or under","39","4","5","0","450.24","63.97","70.7","122.1","0","9","4","5","1","0"
"2006","Chestermere, Alberta, Royal Canadian Mounted Police, municipal","48005","Theft $5,000 or under","77","1","11","64.6","741.1","13.52","11.88","0","98.52","12","1","1","0","1"
"2007","Chestermere, Alberta, Royal Canadian Mounted Police, municipal","48005","Theft $5,000 or under","80","7","21","-4.99","704.1","98.56","86.82","0","729.26","28","8","8","0","8"
"2008","Chestermere, Alberta, Royal Canadian Mounted Police, municipal","48005","Theft $5,000 or under","74","1","18","-15.06","598.08","11.28","9.96","0","84.89","19","1","1","0","1"
"2009","Chestermere, Alberta, Royal Canadian Mounted Police, municipal","48005","Theft $5,000 or under","87","0","27","8.29","647.66","0","0","0","158.6","27","0","0","0","2"
"2010","Chestermere, Alberta, Royal Canadian Mounted Police, municipal","48005","Theft $5,000 or under","77","2","7","-17.54","534.09","19.31","17.07","0","147.28","9","2","2","0","2"
"2011","Chestermere, Alberta, Royal Canadian Mounted Police, municipal","48005","Theft $5,000 or under","58","1","12","-29.42","376.97","0","8.05","72.46","144.93","13","0","1","1","2"
"2012","Chestermere, Alberta, Royal Canadian Mounted Police, municipal","48005","Theft $5,000 or under","58","1","10","-2.91","366","0","7.83","72.05","432.28","11","0","1","1","6"
"2013","Chestermere, Alberta, Royal Canadian Mounted Police, municipal","48005","Theft $5,000 or under","76","2","17","26.62","463.44","8.46","15.13","71.74","215.21","19","1","2","1","3"
"2014","Chestermere, Alberta, Royal Canadian Mounted Police, municipal","48005","Theft $5,000 or under","115","2","18","46.53","679.07","16.34","14.66","0","71.48","20","2","2","0","1"
"2015","Chestermere, Alberta, Royal Canadian Mounted Police, municipal","48005","Theft $5,000 or under","162","3","16","37.78","935.6","31.98","28.74","0","283.09","19","4","4","0","4"
"2016","Chestermere, Alberta, Royal Canadian Mounted Police, municipal","48005","Theft $5,000 or under","76","2","7","-54.23","428.22","7.81","14.04","69.2","0","9","1","2","1","0"
"1998","Chestermere, Alberta, Royal Canadian Mounted Police, municipal","48005","Theft $5,000 or under from a motor vehicle","0","0","0","0","0","0","0","0","0","0","0","0","0","0"
"1999","Chestermere, Alberta, Royal Canadian Mounted Police, municipal","48005","Theft $5,000 or under from a motor vehicle","0","0","0","0","0","0","0","0","0","0","0","0","0","0"
"2000","Chestermere, Alberta, Royal Canadian Mounted Police, municipal","48005","Theft $5,000 or under from a motor vehicle","0","0","0","0","0","0","0","0","0","0","0","0","0","0"
"2001","Chestermere, Alberta, Royal Canadian Mounted Police, municipal","48005","Theft $5,000 or under from a motor vehicle","0","0","0","0","0","0","0","0","0","0","0","0","0","0"
"2002","Chestermere, Alberta, Royal Canadian Mounted Police, municipal","48005","Theft $5,000 or under from a motor vehicle","0","0","0","0","0","0","0","0","0","0","0","0","0","0"
"2003","Chestermere, Alberta, Royal Canadian Mounted Police, municipal","48005","Theft $5,000 or under from a motor vehicle","0","0","0","0","0","0","0","0","0","0","0","0","0","0"
"2004","Chestermere, Alberta, Royal Canadian Mounted Police, municipal","48005","Theft $5,000 or under from a motor vehicle","0","0","0","0","0","0","0","0","0","0","0","0","0","0"
"2005","Chestermere, Alberta, Royal Canadian Mounted Police, municipal","48005","Theft $5,000 or under from a motor vehicle","5","0","0","0","57.72","0","0","0","0","0","0","0","0","0"
"2006","Chestermere, Alberta, Royal Canadian Mounted Police, municipal","48005","Theft $5,000 or under from a motor vehicle","59","1","1","883.75","567.85","13.52","11.88","0","197.04","2","1","1","0","2"
"2007","Chestermere, Alberta, Royal Canadian Mounted Police, municipal","48005","Theft $5,000 or under from a motor vehicle","67","1","5","3.84","589.68","0","0","0","364.63","6","0","0","0","4"
"2008","Chestermere, Alberta, Royal Canadian Mounted Police, municipal","48005","Theft $5,000 or under from a motor vehicle","111","2","6","52.13","897.11","0","9.96","84.89","169.78","8","0","1","1","2"
"2009","Chestermere, Alberta, Royal Canadian Mounted Police, municipal","48005","Theft $5,000 or under from a motor vehicle","107","0","3","-11.21","796.55","0","0","0","79.3","3","0","0","0","1"
"2010","Chestermere, Alberta, Royal Canadian Mounted Police, municipal","48005","Theft $5,000 or under from a motor vehicle","77","0","0","-32.95","534.09","0","0","0","0","0","0","0","0","0"
"2011","Chestermere, Alberta, Royal Canadian Mounted Police, municipal","48005","Theft $5,000 or under from a motor vehicle","76","0","1","-7.51","493.96","0","0","0","0","1","0","0","0","0"
"2012","Chestermere, Alberta, Royal Canadian Mounted Police, municipal","48005","Theft $5,000 or under from a motor vehicle","60","1","0","-23.35","378.62","0","7.83","72.05","0","1","0","1","1","0"
"2013","Chestermere, Alberta, Royal Canadian Mounted Police, municipal","48005","Theft $5,000 or under from a motor vehicle","89","1","1","43.34","542.72","8.46","7.57","0","215.21","2","1","1","0","3"
"2014","Chestermere, Alberta, Royal Canadian Mounted Police, municipal","48005","Theft $5,000 or under from a motor vehicle","88","0","5","-4.25","519.63","0","0","0","0","5","0","0","0","0"
"2015","Chestermere, Alberta, Royal Canadian Mounted Police, municipal","48005","Theft $5,000 or under from a motor vehicle","140","2","6","55.6","808.55","39.98","43.1","70.77","0","8","5","6","1","0"
"2016","Chestermere, Alberta, Royal Canadian Mounted Police, municipal","48005","Theft $5,000 or under from a motor vehicle","146","1","6","1.74","822.63","0","7.02","69.2","622.84","7","0","1","1","9"
"1998","Chestermere, Alberta, Royal Canadian Mounted Police, municipal","48005","Shoplifting $5,000 or under","0","0","0","0","0","0","0","0","0","0","0","0","0","0"
"1999","Chestermere, Alberta, Royal Canadian Mounted Police, municipal","48005","Shoplifting $5,000 or under","0","0","0","0","0","0","0","0","0","0","0","0","0","0"
"2000","Chestermere, Alberta, Royal Canadian Mounted Police, municipal","48005","Shoplifting $5,000 or under","0","0","0","0","0","0","0","0","0","0","0","0","0","0"
"2001","Chestermere, Alberta, Royal Canadian Mounted Police, municipal","48005","Shoplifting $5,000 or under","0","0","0","0","0","0","0","0","0","0","0","0","0","0"
"2002","Chestermere, Alberta, Royal Canadian Mounted Police, municipal","48005","Shoplifting $5,000 or under","0","0","0","0","0","0","0","0","0","0","0","0","0","0"
"2003","Chestermere, Alberta, Royal Canadian Mounted Police, municipal","48005","Shoplifting $5,000 or under","0","0","0","0","0","0","0","0","0","0","0","0","0","0"
"2004","Chestermere, Alberta, Royal Canadian Mounted Police, municipal","48005","Shoplifting $5,000 or under","0","0","0","0","0","0","0","0","0","0","0","0","0","0"
"2005","Chestermere, Alberta, Royal Canadian Mounted Police, municipal","48005","Shoplifting $5,000 or under","1","0","1","0","11.54","0","0","0","0","1","0","0","0","0"
"2006","Chestermere, Alberta, Royal Canadian Mounted Police, municipal","48005","Shoplifting $5,000 or under","0","0","0","-100","0","0","0","0","0","0","0","0","0","0"
"2007","Chestermere, Alberta, Royal Canadian Mounted Police, municipal","48005","Shoplifting $5,000 or under","5","4","0","0","44.01","49.28","65.12","182.32","0","4","4","6","2","0"
"2008","Chestermere, Alberta, Royal Canadian Mounted Police, municipal","48005","Shoplifting $5,000 or under","9","1","3","65.29","72.74","0","0","0","0","4","0","0","0","0"
"2009","Chestermere, Alberta, Royal Canadian Mounted Police, municipal","48005","Shoplifting $5,000 or under","5","1","2","-48.83","37.22","10.35","9.16","0","317.21","3","1","1","0","4"
"2010","Chestermere, Alberta, Royal Canadian Mounted Police, municipal","48005","Shoplifting $5,000 or under","16","2","8","198.16","110.98","19.31","17.07","0","662.74","10","2","2","0","9"
"2011","Chestermere, Alberta, Royal Canadian Mounted Police, municipal","48005","Shoplifting $5,000 or under","10","0","2","-41.44","64.99","0","0","0","144.93","2","0","0","0","2"
"2012","Chestermere, Alberta, Royal Canadian Mounted Police, municipal","48005","Shoplifting $5,000 or under","6","2","2","-41.75","37.86","17.56","15.65","0","216.14","4","2","2","0","3"
"2013","Chestermere, Alberta, Royal Canadian Mounted Police, municipal","48005","Shoplifting $5,000 or under","10","4","1","61.06","60.98","33.83","30.26","0","0","5","4","4","0","0"
"2014","Chestermere, Alberta, Royal Canadian Mounted Police, municipal","48005","Shoplifting $5,000 or under","16","3","2","54.94","94.48","24.51","21.99","0","142.96","5","3","3","0","2"
"2015","Chestermere, Alberta, Royal Canadian Mounted Police, municipal","48005","Shoplifting $5,000 or under","15","1","1","-8.31","86.63","8","7.18","0","0","2","1","1","0","0"
"2016","Chestermere, Alberta, Royal Canadian Mounted Police, municipal","48005","Shoplifting $5,000 or under","23","3","2","49.59","129.59","23.44","21.07","0","0","5","3","3","0","0"
"1998","Chestermere, Alberta, Royal Canadian Mounted Police, municipal","48005","Fraud","0","0","0","0","0","0","0","0","0","0","0","0","0","0"
"1999","Chestermere, Alberta, Royal Canadian Mounted Police, municipal","48005","Fraud","0","0","0","0","0","0","0","0","0","0","0","0","0","0"
"2000","Chestermere, Alberta, Royal Canadian Mounted Police, municipal","48005","Fraud","0","0","0","0","0","0","0","0","0","0","0","0","0","0"
"2001","Chestermere, Alberta, Royal Canadian Mounted Police, municipal","48005","Fraud","0","0","0","0","0","0","0","0","0","0","0","0","0","0"
"2002","Chestermere, Alberta, Royal Canadian Mounted Police, municipal","48005","Fraud","0","0","0","0","0","0","0","0","0","0","0","0","0","0"
"2003","Chestermere, Alberta, Royal Canadian Mounted Police, municipal","48005","Fraud","0","0","0","0","0","0","0","0","0","0","0","0","0","0"
"2004","Chestermere, Alberta, Royal Canadian Mounted Police, municipal","48005","Fraud","0","0","0","0","0","0","0","0","0","0","0","0","0","0"
"2005","Chestermere, Alberta, Royal Canadian Mounted Police, municipal","48005","Fraud","5","0","0","0","57.72","0","0","0","0","0","0","0","0","0"
"2006","Chestermere, Alberta, Royal Canadian Mounted Police, municipal","48005","Fraud","25","5","4","316.84","240.62","54.06","47.54","0","0","9","4","4","0","0"
"2007","Chestermere, Alberta, Royal Canadian Mounted Police, municipal","48005","Fraud","41","1","14","49.97","360.85","12.32","10.85","0","0","15","1","1","0","0"
"2008","Chestermere, Alberta, Royal Canadian Mounted Police, municipal","48005","Fraud","60","15","19","34.38","484.93","45.13","39.84","0","84.89","34","4","4","0","1"
"2009","Chestermere, Alberta, Royal Canadian Mounted Police, municipal","48005","Fraud","41","4","9","-37.06","305.22","20.7","27.47","79.3","79.3","13","2","3","1","1"
"2010","Chestermere, Alberta, Royal Canadian Mounted Police, municipal","48005","Fraud","32","6","2","-27.28","221.96","38.62","51.22","147.28","73.64","8","4","6","2","1"
"2011","Chestermere, Alberta, Royal Canadian Mounted Police, municipal","48005","Fraud","23","1","3","-32.65","149.49","9.06","8.05","0","0","4","1","1","0","0"
"2012","Chestermere, Alberta, Royal Canadian Mounted Police, municipal","48005","Fraud","39","1","3","64.63","246.1","8.78","7.83","0","0","4","1","1","0","0"
"2013","Chestermere, Alberta, Royal Canadian Mounted Police, municipal","48005","Fraud","45","3","3","11.5","274.41","25.37","22.7","0","0","6","3","3","0","0"
"2014","Chestermere, Alberta, Royal Canadian Mounted Police, municipal","48005","Fraud","56","6","7","20.51","330.68","49.02","43.99","0","71.48","13","6","6","0","1"
"2015","Chestermere, Alberta, Royal Canadian Mounted Police, municipal","48005","Fraud","54","4","6","-5.69","311.87","31.98","28.74","0","0","10","4","4","0","0"
"2016","Chestermere, Alberta, Royal Canadian Mounted Police, municipal","48005","Fraud","73","4","2","31.89","411.31","31.26","28.09","0","0","6","4","4","0","0"
"2005","Chestermere, Alberta, Royal Canadian Mounted Police, municipal","48005","Identity theft","0","0","0","0","0","0","0","0","0","0","0","0","0","0"
"2006","Chestermere, Alberta, Royal Canadian Mounted Police, municipal","48005","Identity theft","0","0","0","0","0","0","0","0","0","0","0","0","0","0"
"2007","Chestermere, Alberta, Royal Canadian Mounted Police, municipal","48005","Identity theft","0","0","0","0","0","0","0","0","0","0","0","0","0","0"
"2008","Chestermere, Alberta, Royal Canadian Mounted Police, municipal","48005","Identity theft","0","0","0","0","0","0","0","0","0","0","0","0","0","0"
"2009","Chestermere, Alberta, Royal Canadian Mounted Police, municipal","48005","Identity theft","0","0","0","0","0","0","0","0","0","0","0","0","0","0"
"2010","Chestermere, Alberta, Royal Canadian Mounted Police, municipal","48005","Identity theft","0","0","0","0","0","0","0","0","0","0","0","0","0","0"
"2011","Chestermere, Alberta, Royal Canadian Mounted Police, municipal","48005","Identity theft","1","0","0","0","6.5","0","0","0","0","0","0","0","0","0"
"2012","Chestermere, Alberta, Royal Canadian Mounted Police, municipal","48005","Identity theft","2","0","0","94.18","12.62","0","0","0","0","0","0","0","0","0"
"2013","Chestermere, Alberta, Royal Canadian Mounted Police, municipal","48005","Identity theft","4","0","0","93.27","24.39","0","0","0","0","0","0","0","0","0"
"2014","Chestermere, Alberta, Royal Canadian Mounted Police, municipal","48005","Identity theft","1","0","0","-75.79","5.9","0","0","0","0","0","0","0","0","0"
"2015","Chestermere, Alberta, Royal Canadian Mounted Police, municipal","48005","Identity theft","3","0","0","193.42","17.33","0","0","0","0","0","0","0","0","0"
"2016","Chestermere, Alberta, Royal Canadian Mounted Police, municipal","48005","Identity theft","2","0","0","-34.96","11.27","0","0","0","0","0","0","0","0","0"
"2005","Chestermere, Alberta, Royal Canadian Mounted Police, municipal","48005","Identity fraud","0","0","0","0","0","0","0","0","0","0","0","0","0","0"
"2006","Chestermere, Alberta, Royal Canadian Mounted Police, municipal","48005","Identity fraud","0","0","0","0","0","0","0","0","0","0","0","0","0","0"
"2007","Chestermere, Alberta, Royal Canadian Mounted Police, municipal","48005","Identity fraud","0","0","0","0","0","0","0","0","0","0","0","0","0","0"
"2008","Chestermere, Alberta, Royal Canadian Mounted Police, municipal","48005","Identity fraud","0","0","0","0","0","0","0","0","0","0","0","0","0","0"
"2009","Chestermere, Alberta, Royal Canadian Mounted Police, municipal","48005","Identity fraud","0","0","0","0","0","0","0","0","0","0","0","0","0","0"
"2010","Chestermere, Alberta, Royal Canadian Mounted Police, municipal","48005","Identity fraud","2","0","0","0","13.87","0","0","0","0","0","0","0","0","0"
"2011","Chestermere, Alberta, Royal Canadian Mounted Police, municipal","48005","Identity fraud","0","0","0","-100","0","0","0","0","0","0","0","0","0","0"
"2012","Chestermere, Alberta, Royal Canadian Mounted Police, municipal","48005","Identity fraud","1","0","0","0","6.31","0","0","0","0","0","0","0","0","0"
"2013","Chestermere, Alberta, Royal Canadian Mounted Police, municipal","48005","Identity fraud","1","0","0","-3.37","6.1","0","0","0","0","0","0","0","0","0"
"2014","Chestermere, Alberta, Royal Canadian Mounted Police, municipal","48005","Identity fraud","2","0","0","93.67","11.81","0","0","0","0","0","0","0","0","0"
"2015","Chestermere, Alberta, Royal Canadian Mounted Police, municipal","48005","Identity fraud","5","0","0","144.51","28.88","0","0","0","0","0","0","0","0","0"
"2016","Chestermere, Alberta, Royal Canadian Mounted Police, municipal","48005","Identity fraud","3","0","0","-41.46","16.9","0","0","0","0","0","0","0","0","0"
"1998","Chestermere, Alberta, Royal Canadian Mounted Police, municipal","48005","Total mischief","0","0","0","0","0","0","0","0","0","0","0","0","0","0"
"1999","Chestermere, Alberta, Royal Canadian Mounted Police, municipal","48005","Total mischief","0","0","0","0","0","0","0","0","0","0","0","0","0","0"
"2000","Chestermere, Alberta, Royal Canadian Mounted Police, municipal","48005","Total mischief","0","0","0","0","0","0","0","0","0","0","0","0","0","0"
"2001","Chestermere, Alberta, Royal Canadian Mounted Police, municipal","48005","Total mischief","0","0","0","0","0","0","0","0","0","0","0","0","0","0"
"2002","Chestermere, Alberta, Royal Canadian Mounted Police, municipal","48005","Total mischief","0","0","0","0","0","0","0","0","0","0","0","0","0","0"
"2003","Chestermere, Alberta, Royal Canadian Mounted Police, municipal","48005","Total mischief","0","0","0","0","0","0","0","0","0","0","0","0","0","0"
"2004","Chestermere, Alberta, Royal Canadian Mounted Police, municipal","48005","Total mischief","0","0","0","0","0","0","0","0","0","0","0","0","0","0"
"2005","Chestermere, Alberta, Royal Canadian Mounted Police, municipal","48005","Total mischief","41","1","10","0","473.33","15.99","28.28","122.1","854.7","11","1","2","1","7"
"2006","Chestermere, Alberta, Royal Canadian Mounted Police, municipal","48005","Total mischief","113","2","12","129.77","1087.58","13.52","35.65","197.04","788.18","14","1","3","2","8"
"2007","Chestermere, Alberta, Royal Canadian Mounted Police, municipal","48005","Total mischief","151","4","34","22.2","1328.99","0","21.71","182.32","2005.47","38","0","2","2","22"
"2008","Chestermere, Alberta, Royal Canadian Mounted Police, municipal","48005","Total mischief","185","3","47","12.51","1495.19","33.85","29.88","0","2292.02","50","3","3","0","27"
"2009","Chestermere, Alberta, Royal Canadian Mounted Police, municipal","48005","Total mischief","155","0","24","-22.83","1153.87","0","0","0","1823.95","24","0","0","0","23"
"2010","Chestermere, Alberta, Royal Canadian Mounted Police, municipal","48005","Total mischief","159","2","35","-4.42","1102.86","9.66","17.07","73.64","1399.12","37","1","2","1","19"
"2011","Chestermere, Alberta, Royal Canadian Mounted Police, municipal","48005","Total mischief","169","7","34","-0.4","1098.4","18.12","80.52","579.71","1666.67","41","2","10","8","23"
"2012","Chestermere, Alberta, Royal Canadian Mounted Police, municipal","48005","Total mischief","161","8","35","-7.51","1015.97","61.45","62.6","72.05","1224.78","43","7","8","1","17"
"2013","Chestermere, Alberta, Royal Canadian Mounted Police, municipal","48005","Total mischief","136","0","25","-18.37","829.32","0","0","0","932.57","25","0","0","0","13"
"2014","Chestermere, Alberta, Royal Canadian Mounted Police, municipal","48005","Total mischief","161","2","37","14.64","950.69","16.34","14.66","0","643.32","39","2","2","0","9"
"2015","Chestermere, Alberta, Royal Canadian Mounted Police, municipal","48005","Total mischief","187","10","28","13.6","1079.99","55.97","64.66","141.54","636.94","38","7","9","2","9"
"2016","Chestermere, Alberta, Royal Canadian Mounted Police, municipal","48005","Total mischief","127","4","24","-33.74","715.57","31.26","28.09","0","1522.49","28","4","4","0","22"
"1998","Chestermere, Alberta, Royal Canadian Mounted Police, municipal","48005","Mischief","0","0","0","0","0","0","0","0","0","0","0","0","0","0"
"1999","Chestermere, Alberta, Royal Canadian Mounted Police, municipal","48005","Mischief","0","0","0","0","0","0","0","0","0","0","0","0","0","0"
"2000","Chestermere, Alberta, Royal Canadian Mounted Police, municipal","48005","Mischief","0","0","0","0","0","0","0","0","0","0","0","0","0","0"
"2001","Chestermere, Alberta, Royal Canadian Mounted Police, municipal","48005","Mischief","0","0","0","0","0","0","0","0","0","0","0","0","0","0"
"2002","Chestermere, Alberta, Royal Canadian Mounted Police, municipal","48005","Mischief","0","0","0","0","0","0","0","0","0","0","0","0","0","0"
"2003","Chestermere, Alberta, Royal Canadian Mounted Police, municipal","48005","Mischief","0","0","0","0","0","0","0","0","0","0","0","0","0","0"
"2004","Chestermere, Alberta, Royal Canadian Mounted Police, municipal","48005","Mischief","0","0","0","0","0","0","0","0","0","0","0","0","0","0"
"2005","Chestermere, Alberta, Royal Canadian Mounted Police, municipal","48005","Mischief","41","1","10","0","473.33","15.99","28.28","122.1","854.7","11","1","2","1","7"
"2006","Chestermere, Alberta, Royal Canadian Mounted Police, municipal","48005","Mischief","113","2","12","129.77","1087.58","13.52","35.65","197.04","788.18","14","1","3","2","8"
"2007","Chestermere, Alberta, Royal Canadian Mounted Police, municipal","48005","Mischief","151","4","34","22.2","1328.99","0","21.71","182.32","2005.47","38","0","2","2","22"
"2008","Chestermere, Alberta, Royal Canadian Mounted Police, municipal","48005","Mischief","185","3","47","12.51","1495.19","33.85","29.88","0","2292.02","50","3","3","0","27"
"2009","Chestermere, Alberta, Royal Canadian Mounted Police, municipal","48005","Mischief","155","0","24","-22.83","1153.87","0","0","0","1823.95","24","0","0","0","23"
"2010","Chestermere, Alberta, Royal Canadian Mounted Police, municipal","48005","Mischief","159","2","35","-4.42","1102.86","9.66","17.07","73.64","1399.12","37","1","2","1","19"
"2011","Chestermere, Alberta, Royal Canadian Mounted Police, municipal","48005","Mischief","169","7","34","-0.4","1098.4","18.12","80.52","579.71","1666.67","41","2","10","8","23"
"2012","Chestermere, Alberta, Royal Canadian Mounted Police, municipal","48005","Mischief","161","8","35","-7.51","1015.97","61.45","62.6","72.05","1224.78","43","7","8","1","17"
"2013","Chestermere, Alberta, Royal Canadian Mounted Police, municipal","48005","Mischief","136","0","25","-18.37","829.32","0","0","0","932.57","25","0","0","0","13"
"2014","Chestermere, Alberta, Royal Canadian Mounted Police, municipal","48005","Mischief","161","2","37","14.64","950.69","16.34","14.66","0","643.32","39","2","2","0","9"
"2015","Chestermere, Alberta, Royal Canadian Mounted Police, municipal","48005","Mischief","187","10","28","13.6","1079.99","55.97","64.66","141.54","636.94","38","7","9","2","9"
"2016","Chestermere, Alberta, Royal Canadian Mounted Police, municipal","48005","Mischief","127","4","24","-33.74","715.57","31.26","28.09","0","1522.49","28","4","4","0","22"
"2012","Chestermere, Alberta, Royal Canadian Mounted Police, municipal","48005","Mischief in relation to cultural property","0","0","0","0","0","0","0","0","0","0","0","0","0","0"
"2013","Chestermere, Alberta, Royal Canadian Mounted Police, municipal","48005","Mischief in relation to cultural property","0","0","0","0","0","0","0","0","0","0","0","0","0","0"
"2014","Chestermere, Alberta, Royal Canadian Mounted Police, municipal","48005","Mischief in relation to cultural property","0","0","0","0","0","0","0","0","0","0","0","0","0","0"
"2015","Chestermere, Alberta, Royal Canadian Mounted Police, municipal","48005","Mischief in relation to cultural property","0","0","0","0","0","0","0","0","0","0","0","0","0","0"
"2016","Chestermere, Alberta, Royal Canadian Mounted Police, municipal","48005","Mischief in relation to cultural property","0","0","0","0","0","0","0","0","0","0","0","0","0","0"
"2005","Chestermere, Alberta, Royal Canadian Mounted Police, municipal","48005","Mischief to religious property motivated by hate","0","0","0","0","0","0","0","0","0","0","0","0","0","0"
"2006","Chestermere, Alberta, Royal Canadian Mounted Police, municipal","48005","Mischief to religious property motivated by hate","0","0","0","0","0","0","0","0","0","0","0","0","0","0"
"2007","Chestermere, Alberta, Royal Canadian Mounted Police, municipal","48005","Mischief to religious property motivated by hate","0","0","0","0","0","0","0","0","0","0","0","0","0","0"
"2008","Chestermere, Alberta, Royal Canadian Mounted Police, municipal","48005","Mischief to religious property motivated by hate","0","0","0","0","0","0","0","0","0","0","0","0","0","0"
"2009","Chestermere, Alberta, Royal Canadian Mounted Police, municipal","48005","Mischief to religious property motivated by hate","0","0","0","0","0","0","0","0","0","0","0","0","0","0"
"2010","Chestermere, Alberta, Royal Canadian Mounted Police, municipal","48005","Mischief to religious property motivated by hate","0","0","0","0","0","0","0","0","0","0","0","0","0","0"
"2011","Chestermere, Alberta, Royal Canadian Mounted Police, municipal","48005","Mischief to religious property motivated by hate","0","0","0","0","0","0","0","0","0","0","0","0","0","0"
"2012","Chestermere, Alberta, Royal Canadian Mounted Police, municipal","48005","Mischief to religious property motivated by hate","0","0","0","0","0","0","0","0","0","0","0","0","0","0"
"2013","Chestermere, Alberta, Royal Canadian Mounted Police, municipal","48005","Mischief to religious property motivated by hate","0","0","0","0","0","0","0","0","0","0","0","0","0","0"
"2014","Chestermere, Alberta, Royal Canadian Mounted Police, municipal","48005","Mischief to religious property motivated by hate","0","0","0","0","0","0","0","0","0","0","0","0","0","0"
"2015","Chestermere, Alberta, Royal Canadian Mounted Police, municipal","48005","Mischief to religious property motivated by hate","0","0","0","0","0","0","0","0","0","0","0","0","0","0"
"2016","Chestermere, Alberta, Royal Canadian Mounted Police, municipal","48005","Mischief to religious property motivated by hate","0","0","0","0","0","0","0","0","0","0","0","0","0","0"
"2012","Chestermere, Alberta, Royal Canadian Mounted Police, municipal","48005","Mischief relating to war memorials","0","0","0","0","0","0","0","0","0","0","0","0","0","0"
"2013","Chestermere, Alberta, Royal Canadian Mounted Police, municipal","48005","Mischief relating to war memorials","0","0","0","0","0","0","0","0","0","0","0","0","0","0"
"2014","Chestermere, Alberta, Royal Canadian Mounted Police, municipal","48005","Mischief relating to war memorials","0","0","0","0","0","0","0","0","0","0","0","0","0","0"
"2015","Chestermere, Alberta, Royal Canadian Mounted Police, municipal","48005","Mischief relating to war memorials","0","0","0","0","0","0","0","0","0","0","0","0","0","0"
"2016","Chestermere, Alberta, Royal Canadian Mounted Police, municipal","48005","Mischief relating to war memorials","0","0","0","0","0","0","0","0","0","0","0","0","0","0"
"1998","Chestermere, Alberta, Royal Canadian Mounted Police, municipal","48005","Arson","0","0","0","0","0","0","0","0","0","0","0","0","0","0"
"1999","Chestermere, Alberta, Royal Canadian Mounted Police, municipal","48005","Arson","0","0","0","0","0","0","0","0","0","0","0","0","0","0"
"2000","Chestermere, Alberta, Royal Canadian Mounted Police, municipal","48005","Arson","0","0","0","0","0","0","0","0","0","0","0","0","0","0"
"2001","Chestermere, Alberta, Royal Canadian Mounted Police, municipal","48005","Arson","0","0","0","0","0","0","0","0","0","0","0","0","0","0"
"2002","Chestermere, Alberta, Royal Canadian Mounted Police, municipal","48005","Arson","0","0","0","0","0","0","0","0","0","0","0","0","0","0"
"2003","Chestermere, Alberta, Royal Canadian Mounted Police, municipal","48005","Arson","0","0","0","0","0","0","0","0","0","0","0","0","0","0"
"2004","Chestermere, Alberta, Royal Canadian Mounted Police, municipal","48005","Arson","0","0","0","0","0","0","0","0","0","0","0","0","0","0"
"2005","Chestermere, Alberta, Royal Canadian Mounted Police, municipal","48005","Arson","0","0","0","0","0","0","0","0","0","0","0","0","0","0"
"2006","Chestermere, Alberta, Royal Canadian Mounted Police, municipal","48005","Arson","4","0","1","0","38.5","0","0","0","394.09","1","0","0","0","4"
"2007","Chestermere, Alberta, Royal Canadian Mounted Police, municipal","48005","Arson","3","0","0","-31.42","26.4","0","0","0","0","0","0","0","0","0"
"2008","Chestermere, Alberta, Royal Canadian Mounted Police, municipal","48005","Arson","2","0","0","-38.78","16.16","0","0","0","0","0","0","0","0","0"
"2009","Chestermere, Alberta, Royal Canadian Mounted Police, municipal","48005","Arson","2","0","0","-7.89","14.89","0","0","0","0","0","0","0","0","0"
"2010","Chestermere, Alberta, Royal Canadian Mounted Police, municipal","48005","Arson","6","0","2","179.52","41.62","0","0","0","73.64","2","0","0","0","1"
"2011","Chestermere, Alberta, Royal Canadian Mounted Police, municipal","48005","Arson","2","0","2","-68.77","13","0","0","0","217.39","2","0","0","0","3"
"2012","Chestermere, Alberta, Royal Canadian Mounted Police, municipal","48005","Arson","2","0","0","-2.91","12.62","0","0","0","0","0","0","0","0","0"
"2013","Chestermere, Alberta, Royal Canadian Mounted Police, municipal","48005","Arson","3","0","0","44.95","18.29","0","0","0","0","0","0","0","0","0"
"2014","Chestermere, Alberta, Royal Canadian Mounted Police, municipal","48005","Arson","3","0","0","-3.17","17.71","0","0","0","0","0","0","0","0","0"
"2015","Chestermere, Alberta, Royal Canadian Mounted Police, municipal","48005","Arson","1","0","0","-67.4","5.78","0","0","0","0","0","0","0","0","0"
"2016","Chestermere, Alberta, Royal Canadian Mounted Police, municipal","48005","Arson","0","0","0","-100","0","0","0","0","0","0","0","0","0","0"
"2005","Chestermere, Alberta, Royal Canadian Mounted Police, municipal","48005","Altering, removing or destroying Vehicle Identification Number (VIN)","0","0","0","0","0","0","0","0","0","0","0","0","0","0"
"2006","Chestermere, Alberta, Royal Canadian Mounted Police, municipal","48005","Altering, removing or destroying Vehicle Identification Number (VIN)","0","0","0","0","0","0","0","0","0","0","0","0","0","0"
"2007","Chestermere, Alberta, Royal Canadian Mounted Police, municipal","48005","Altering, removing or destroying Vehicle Identification Number (VIN)","0","0","0","0","0","0","0","0","0","0","0","0","0","0"
"2008","Chestermere, Alberta, Royal Canadian Mounted Police, municipal","48005","Altering, removing or destroying Vehicle Identification Number (VIN)","0","0","0","0","0","0","0","0","0","0","0","0","0","0"
"2009","Chestermere, Alberta, Royal Canadian Mounted Police, municipal","48005","Altering, removing or destroying Vehicle Identification Number (VIN)","0","0","0","0","0","0","0","0","0","0","0","0","0","0"
"2010","Chestermere, Alberta, Royal Canadian Mounted Police, municipal","48005","Altering, removing or destroying Vehicle Identification Number (VIN)","0","0","0","0","0","0","0","0","0","0","0","0","0","0"
"2011","Chestermere, Alberta, Royal Canadian Mounted Police, municipal","48005","Altering, removing or destroying Vehicle Identification Number (VIN)","0","0","0","0","0","0","0","0","0","0","0","0","0","0"
"2012","Chestermere, Alberta, Royal Canadian Mounted Police, municipal","48005","Altering, removing or destroying Vehicle Identification Number (VIN)","0","0","0","0","0","0","0","0","0","0","0","0","0","0"
"2013","Chestermere, Alberta, Royal Canadian Mounted Police, municipal","48005","Altering, removing or destroying Vehicle Identification Number (VIN)","0","0","0","0","0","0","0","0","0","0","0","0","0","0"
"2014","Chestermere, Alberta, Royal Canadian Mounted Police, municipal","48005","Altering, removing or destroying Vehicle Identification Number (VIN)","0","0","0","0","0","0","0","0","0","0","0","0","0","0"
"2015","Chestermere, Alberta, Royal Canadian Mounted Police, municipal","48005","Altering, removing or destroying Vehicle Identification Number (VIN)","0","0","0","0","0","0","0","0","0","0","0","0","0","0"
"2016","Chestermere, Alberta, Royal Canadian Mounted Police, municipal","48005","Altering, removing or destroying Vehicle Identification Number (VIN)","0","0","0","0","0","0","0","0","0","0","0","0","0","0"
"1998","Chestermere, Alberta, Royal Canadian Mounted Police, municipal","48005","Total other Criminal Code violations","0","0","0","0","0","0","0","0","0","0","0","0","0","0"
"1999","Chestermere, Alberta, Royal Canadian Mounted Police, municipal","48005","Total other Criminal Code violations","0","0","0","0","0","0","0","0","0","0","0","0","0","0"
"2000","Chestermere, Alberta, Royal Canadian Mounted Police, municipal","48005","Total other Criminal Code violations","0","0","0","0","0","0","0","0","0","0","0","0","0","0"
"2001","Chestermere, Alberta, Royal Canadian Mounted Police, municipal","48005","Total other Criminal Code violations","0","0","0","0","0","0","0","0","0","0","0","0","0","0"
"2002","Chestermere, Alberta, Royal Canadian Mounted Police, municipal","48005","Total other Criminal Code violations","0","0","0","0","0","0","0","0","0","0","0","0","0","0"
"2003","Chestermere, Alberta, Royal Canadian Mounted Police, municipal","48005","Total other Criminal Code violations","0","0","0","0","0","0","0","0","0","0","0","0","0","0"
"2004","Chestermere, Alberta, Royal Canadian Mounted Police, municipal","48005","Total other Criminal Code violations","0","0","0","0","0","0","0","0","0","0","0","0","0","0"
"2005","Chestermere, Alberta, Royal Canadian Mounted Police, municipal","48005","Total other Criminal Code violations","47","17","21","0","542.6","207.9","240.38","488.4","244.2","38","13","17","4","2"
"2006","Chestermere, Alberta, Royal Canadian Mounted Police, municipal","48005","Total other Criminal Code violations","184","18","103","226.38","1770.93","135.15","178.27","492.61","1871.92","121","10","15","5","19"
"2007","Chestermere, Alberta, Royal Canadian Mounted Police, municipal","48005","Total other Criminal Code violations","252","31","160","25.24","2217.92","160.16","173.65","273.47","4557.89","191","13","16","3","50"
"2008","Chestermere, Alberta, Royal Canadian Mounted Police, municipal","48005","Total other Criminal Code violations","242","31","136","-11.82","1955.87","214.37","209.14","169.78","3904.92","167","19","21","2","46"
"2009","Chestermere, Alberta, Royal Canadian Mounted Police, municipal","48005","Total other Criminal Code violations","186","24","118","-29.21","1384.65","207.02","210.58","237.91","1982.55","142","20","23","3","25"
"2010","Chestermere, Alberta, Royal Canadian Mounted Police, municipal","48005","Total other Criminal Code violations","100","16","49","-49.91","693.63","106.21","119.5","220.91","1620.03","65","11","14","3","22"
"2011","Chestermere, Alberta, Royal Canadian Mounted Police, municipal","48005","Total other Criminal Code violations","87","28","36","-18.48","565.45","199.29","209.36","289.86","1014.49","64","22","26","4","14"
"2012","Chestermere, Alberta, Royal Canadian Mounted Police, municipal","48005","Total other Criminal Code violations","76","19","37","-15.18","479.59","131.68","140.86","216.14","1296.83","56","15","18","3","18"
"2013","Chestermere, Alberta, Royal Canadian Mounted Police, municipal","48005","Total other Criminal Code violations","84","17","40","6.81","512.23","109.96","98.36","0","573.89","57","13","13","0","8"
"2014","Chestermere, Alberta, Royal Canadian Mounted Police, municipal","48005","Total other Criminal Code violations","113","18","49","30.27","667.26","89.86","87.98","71.48","1143.67","67","11","12","1","16"
"2015","Chestermere, Alberta, Royal Canadian Mounted Police, municipal","48005","Total other Criminal Code violations","95","32","38","-17.77","548.66","263.85","237.07","0","212.31","70","33","33","0","3"
"2016","Chestermere, Alberta, Royal Canadian Mounted Police, municipal","48005","Total other Criminal Code violations","93","14","51","-4.49","524","109.41","105.33","69.2","415.22","65","14","15","1","6"
"1998","Chestermere, Alberta, Royal Canadian Mounted Police, municipal","48005","Counterfeiting","0","0","0","0","0","0","0","0","0","0","0","0","0","0"
"1999","Chestermere, Alberta, Royal Canadian Mounted Police, municipal","48005","Counterfeiting","0","0","0","0","0","0","0","0","0","0","0","0","0","0"
"2000","Chestermere, Alberta, Royal Canadian Mounted Police, municipal","48005","Counterfeiting","0","0","0","0","0","0","0","0","0","0","0","0","0","0"
"2001","Chestermere, Alberta, Royal Canadian Mounted Police, municipal","48005","Counterfeiting","0","0","0","0","0","0","0","0","0","0","0","0","0","0"
"2002","Chestermere, Alberta, Royal Canadian Mounted Police, municipal","48005","Counterfeiting","0","0","0","0","0","0","0","0","0","0","0","0","0","0"
"2003","Chestermere, Alberta, Royal Canadian Mounted Police, municipal","48005","Counterfeiting","0","0","0","0","0","0","0","0","0","0","0","0","0","0"
"2004","Chestermere, Alberta, Royal Canadian Mounted Police, municipal","48005","Counterfeiting","0","0","0","0","0","0","0","0","0","0","0","0","0","0"
"2005","Chestermere, Alberta, Royal Canadian Mounted Police, municipal","48005","Counterfeiting","0","0","0","0","0","0","0","0","0","0","0","0","0","0"
"2006","Chestermere, Alberta, Royal Canadian Mounted Police, municipal","48005","Counterfeiting","0","0","0","0","0","0","0","0","0","0","0","0","0","0"
"2007","Chestermere, Alberta, Royal Canadian Mounted Police, municipal","48005","Counterfeiting","0","0","0","0","0","0","0","0","0","0","0","0","0","0"
"2008","Chestermere, Alberta, Royal Canadian Mounted Police, municipal","48005","Counterfeiting","1","0","1","0","8.08","0","0","0","84.89","1","0","0","0","1"
"2009","Chestermere, Alberta, Royal Canadian Mounted Police, municipal","48005","Counterfeiting","0","0","0","-100","0","0","0","0","0","0","0","0","0","0"
"2010","Chestermere, Alberta, Royal Canadian Mounted Police, municipal","48005","Counterfeiting","0","0","0","0","0","0","0","0","0","0","0","0","0","0"
"2011","Chestermere, Alberta, Royal Canadian Mounted Police, municipal","48005","Counterfeiting","0","0","0","0","0","0","0","0","0","0","0","0","0","0"
"2012","Chestermere, Alberta, Royal Canadian Mounted Police, municipal","48005","Counterfeiting","0","0","0","0","0","0","0","0","0","0","0","0","0","0"
"2013","Chestermere, Alberta, Royal Canadian Mounted Police, municipal","48005","Counterfeiting","1","1","0","0","6.1","8.46","7.57","0","0","1","1","1","0","0"
"2014","Chestermere, Alberta, Royal Canadian Mounted Police, municipal","48005","Counterfeiting","0","0","0","-100","0","0","0","0","0","0","0","0","0","0"
"2015","Chestermere, Alberta, Royal Canadian Mounted Police, municipal","48005","Counterfeiting","0","0","0","0","0","0","0","0","0","0","0","0","0","0"
"2016","Chestermere, Alberta, Royal Canadian Mounted Police, municipal","48005","Counterfeiting","2","2","0","0","11.27","15.63","14.04","0","0","2","2","2","0","0"
"1998","Chestermere, Alberta, Royal Canadian Mounted Police, municipal","48005","Total weapons violations","0","0","0","0","0","0","0","0","0","0","0","0","0","0"
"1999","Chestermere, Alberta, Royal Canadian Mounted Police, municipal","48005","Total weapons violations","0","0","0","0","0","0","0","0","0","0","0","0","0","0"
"2000","Chestermere, Alberta, Royal Canadian Mounted Police, municipal","48005","Total weapons violations","0","0","0","0","0","0","0","0","0","0","0","0","0","0"
"2001","Chestermere, Alberta, Royal Canadian Mounted Police, municipal","48005","Total weapons violations","0","0","0","0","0","0","0","0","0","0","0","0","0","0"
"2002","Chestermere, Alberta, Royal Canadian Mounted Police, municipal","48005","Total weapons violations","0","0","0","0","0","0","0","0","0","0","0","0","0","0"
"2003","Chestermere, Alberta, Royal Canadian Mounted Police, municipal","48005","Total weapons violations","0","0","0","0","0","0","0","0","0","0","0","0","0","0"
"2004","Chestermere, Alberta, Royal Canadian Mounted Police, municipal","48005","Total weapons violations","0","0","0","0","0","0","0","0","0","0","0","0","0","0"
"2005","Chestermere, Alberta, Royal Canadian Mounted Police, municipal","48005","Total weapons violations","6","2","3","0","69.27","15.99","14.14","0","244.2","5","1","1","0","2"
"2006","Chestermere, Alberta, Royal Canadian Mounted Police, municipal","48005","Total weapons violations","12","5","7","66.74","115.5","27.03","35.65","98.52","197.04","12","2","3","1","2"
"2007","Chestermere, Alberta, Royal Canadian Mounted Police, municipal","48005","Total weapons violations","45","12","27","242.92","396.06","36.96","32.56","0","1549.68","39","3","3","0","17"
"2008","Chestermere, Alberta, Royal Canadian Mounted Police, municipal","48005","Total weapons violations","32","12","16","-34.7","258.63","22.57","19.92","0","339.56","28","2","2","0","4"
"2009","Chestermere, Alberta, Royal Canadian Mounted Police, municipal","48005","Total weapons violations","9","0","8","-74.09","67","0","0","0","79.3","8","0","0","0","1"
"2010","Chestermere, Alberta, Royal Canadian Mounted Police, municipal","48005","Total weapons violations","5","1","2","-48.24","34.68","9.66","8.54","0","73.64","3","1","1","0","1"
"2011","Chestermere, Alberta, Royal Canadian Mounted Police, municipal","48005","Total weapons violations","8","2","3","49.92","52","18.12","16.1","0","144.93","5","2","2","0","2"
"2012","Chestermere, Alberta, Royal Canadian Mounted Police, municipal","48005","Total weapons violations","5","2","2","-39.32","31.55","17.56","15.65","0","288.18","4","2","2","0","4"
"2013","Chestermere, Alberta, Royal Canadian Mounted Police, municipal","48005","Total weapons violations","1","0","1","-80.67","6.1","0","0","0","0","1","0","0","0","0"
"2014","Chestermere, Alberta, Royal Canadian Mounted Police, municipal","48005","Total weapons violations","4","0","1","287.34","23.62","0","0","0","71.48","1","0","0","0","1"
"2015","Chestermere, Alberta, Royal Canadian Mounted Police, municipal","48005","Total weapons violations","1","0","1","-75.55","5.78","0","0","0","0","1","0","0","0","0"
"2016","Chestermere, Alberta, Royal Canadian Mounted Police, municipal","48005","Total weapons violations","3","3","0","192.68","16.9","15.63","21.07","69.2","0","3","2","3","1","0"
"1998","Chestermere, Alberta, Royal Canadian Mounted Police, municipal","48005","Offensive weapons, explosives","0","0","0","0","0","0","0","0","0","0","0","0","0","0"
"1999","Chestermere, Alberta, Royal Canadian Mounted Police, municipal","48005","Offensive weapons, explosives","0","0","0","0","0","0","0","0","0","0","0","0","0","0"
"2000","Chestermere, Alberta, Royal Canadian Mounted Police, municipal","48005","Offensive weapons, explosives","0","0","0","0","0","0","0","0","0","0","0","0","0","0"
"2001","Chestermere, Alberta, Royal Canadian Mounted Police, municipal","48005","Offensive weapons, explosives","0","0","0","0","0","0","0","0","0","0","0","0","0","0"
"2002","Chestermere, Alberta, Royal Canadian Mounted Police, municipal","48005","Offensive weapons, explosives","0","0","0","0","0","0","0","0","0","0","0","0","0","0"
"2003","Chestermere, Alberta, Royal Canadian Mounted Police, municipal","48005","Offensive weapons, explosives","0","0","0","0","0","0","0","0","0","0","0","0","0","0"
"2004","Chestermere, Alberta, Royal Canadian Mounted Police, municipal","48005","Offensive weapons, explosives","0","0","0","0","0","0","0","0","0","0","0","0","0","0"
"2005","Chestermere, Alberta, Royal Canadian Mounted Police, municipal","48005","Offensive weapons, explosives","0","0","0","0","0","0","0","0","0","0","0","0","0","0"
"2006","Chestermere, Alberta, Royal Canadian Mounted Police, municipal","48005","Offensive weapons, explosives","0","0","0","0","0","0","0","0","0","0","0","0","0","0"
"2007","Chestermere, Alberta, Royal Canadian Mounted Police, municipal","48005","Offensive weapons, explosives","0","0","0","0","0","0","0","0","0","0","0","0","0","0"
"2008","Chestermere, Alberta, Royal Canadian Mounted Police, municipal","48005","Offensive weapons, explosives","0","0","0","0","0","0","0","0","0","0","0","0","0","0"
"2009","Chestermere, Alberta, Royal Canadian Mounted Police, municipal","48005","Offensive weapons, explosives","0","0","0","0","0","0","0","0","0","0","0","0","0","0"
"2010","Chestermere, Alberta, Royal Canadian Mounted Police, municipal","48005","Offensive weapons, explosives","0","0","0","0","0","0","0","0","0","0","0","0","0","0"
"2011","Chestermere, Alberta, Royal Canadian Mounted Police, municipal","48005","Offensive weapons, explosives","0","0","0","0","0","0","0","0","0","0","0","0","0","0"
"2012","Chestermere, Alberta, Royal Canadian Mounted Police, municipal","48005","Offensive weapons, explosives","0","0","0","0","0","0","0","0","0","0","0","0","0","0"
"2013","Chestermere, Alberta, Royal Canadian Mounted Police, municipal","48005","Offensive weapons, explosives","0","0","0","0","0","0","0","0","0","0","0","0","0","0"
"2014","Chestermere, Alberta, Royal Canadian Mounted Police, municipal","48005","Offensive weapons, explosives","2","0","0","0","11.81","0","0","0","0","0","0","0","0","0"
"2015","Chestermere, Alberta, Royal Canadian Mounted Police, municipal","48005","Offensive weapons, explosives","0","0","0","-100","0","0","0","0","0","0","0","0","0","0"
"2016","Chestermere, Alberta, Royal Canadian Mounted Police, municipal","48005","Offensive weapons, explosives","0","0","0","0","0","0","0","0","0","0","0","0","0","0"
"1998","Chestermere, Alberta, Royal Canadian Mounted Police, municipal","48005","Offensive weapons, prohibited","0","0","0","0","0","0","0","0","0","0","0","0","0","0"
"1999","Chestermere, Alberta, Royal Canadian Mounted Police, municipal","48005","Offensive weapons, prohibited","0","0","0","0","0","0","0","0","0","0","0","0","0","0"
"2000","Chestermere, Alberta, Royal Canadian Mounted Police, municipal","48005","Offensive weapons, prohibited","0","0","0","0","0","0","0","0","0","0","0","0","0","0"
"2001","Chestermere, Alberta, Royal Canadian Mounted Police, municipal","48005","Offensive weapons, prohibited","0","0","0","0","0","0","0","0","0","0","0","0","0","0"
"2002","Chestermere, Alberta, Royal Canadian Mounted Police, municipal","48005","Offensive weapons, prohibited","0","0","0","0","0","0","0","0","0","0","0","0","0","0"
"2003","Chestermere, Alberta, Royal Canadian Mounted Police, municipal","48005","Offensive weapons, prohibited","0","0","0","0","0","0","0","0","0","0","0","0","0","0"
"2004","Chestermere, Alberta, Royal Canadian Mounted Police, municipal","48005","Offensive weapons, prohibited","0","0","0","0","0","0","0","0","0","0","0","0","0","0"
"2005","Chestermere, Alberta, Royal Canadian Mounted Police, municipal","48005","Offensive weapons, prohibited","0","0","0","0","0","0","0","0","0","0","0","0","0","0"
"2006","Chestermere, Alberta, Royal Canadian Mounted Police, municipal","48005","Offensive weapons, prohibited","0","0","0","0","0","0","0","0","0","0","0","0","0","0"
"2007","Chestermere, Alberta, Royal Canadian Mounted Police, municipal","48005","Offensive weapons, prohibited","0","0","0","0","0","0","0","0","0","0","0","0","0","0"
"2008","Chestermere, Alberta, Royal Canadian Mounted Police, municipal","48005","Offensive weapons, prohibited","0","0","0","0","0","0","0","0","0","0","0","0","0","0"
"2009","Chestermere, Alberta, Royal Canadian Mounted Police, municipal","48005","Offensive weapons, prohibited","0","0","0","0","0","0","0","0","0","0","0","0","0","0"
"2010","Chestermere, Alberta, Royal Canadian Mounted Police, municipal","48005","Offensive weapons, prohibited","0","0","0","0","0","0","0","0","0","0","0","0","0","0"
"2011","Chestermere, Alberta, Royal Canadian Mounted Police, municipal","48005","Offensive weapons, prohibited","0","0","0","0","0","0","0","0","0","0","0","0","0","0"
"2012","Chestermere, Alberta, Royal Canadian Mounted Police, municipal","48005","Offensive weapons, prohibited","0","0","0","0","0","0","0","0","0","0","0","0","0","0"
"2013","Chestermere, Alberta, Royal Canadian Mounted Police, municipal","48005","Offensive weapons, prohibited","0","0","0","0","0","0","0","0","0","0","0","0","0","0"
"2014","Chestermere, Alberta, Royal Canadian Mounted Police, municipal","48005","Offensive weapons, prohibited","0","0","0","0","0","0","0","0","0","0","0","0","0","0"
"2015","Chestermere, Alberta, Royal Canadian Mounted Police, municipal","48005","Offensive weapons, prohibited","0","0","0","0","0","0","0","0","0","0","0","0","0","0"
"2016","Chestermere, Alberta, Royal Canadian Mounted Police, municipal","48005","Offensive weapons, prohibited","0","0","0","0","0","0","0","0","0","0","0","0","0","0"
"1998","Chestermere, Alberta, Royal Canadian Mounted Police, municipal","48005","Offensive weapons, restricted","0","0","0","0","0","0","0","0","0","0","0","0","0","0"
"1999","Chestermere, Alberta, Royal Canadian Mounted Police, municipal","48005","Offensive weapons, restricted","0","0","0","0","0","0","0","0","0","0","0","0","0","0"
"2000","Chestermere, Alberta, Royal Canadian Mounted Police, municipal","48005","Offensive weapons, restricted","0","0","0","0","0","0","0","0","0","0","0","0","0","0"
"2001","Chestermere, Alberta, Royal Canadian Mounted Police, municipal","48005","Offensive weapons, restricted","0","0","0","0","0","0","0","0","0","0","0","0","0","0"
"2002","Chestermere, Alberta, Royal Canadian Mounted Police, municipal","48005","Offensive weapons, restricted","0","0","0","0","0","0","0","0","0","0","0","0","0","0"
"2003","Chestermere, Alberta, Royal Canadian Mounted Police, municipal","48005","Offensive weapons, restricted","0","0","0","0","0","0","0","0","0","0","0","0","0","0"
"2004","Chestermere, Alberta, Royal Canadian Mounted Police, municipal","48005","Offensive weapons, restricted","0","0","0","0","0","0","0","0","0","0","0","0","0","0"
"2005","Chestermere, Alberta, Royal Canadian Mounted Police, municipal","48005","Offensive weapons, restricted","0","0","0","0","0","0","0","0","0","0","0","0","0","0"
"2006","Chestermere, Alberta, Royal Canadian Mounted Police, municipal","48005","Offensive weapons, restricted","0","0","0","0","0","0","0","0","0","0","0","0","0","0"
"2007","Chestermere, Alberta, Royal Canadian Mounted Police, municipal","48005","Offensive weapons, restricted","0","0","0","0","0","0","0","0","0","0","0","0","0","0"
"2008","Chestermere, Alberta, Royal Canadian Mounted Police, municipal","48005","Offensive weapons, restricted","0","0","0","0","0","0","0","0","0","0","0","0","0","0"
"2009","Chestermere, Alberta, Royal Canadian Mounted Police, municipal","48005","Offensive weapons, restricted","0","0","0","0","0","0","0","0","0","0","0","0","0","0"
"2010","Chestermere, Alberta, Royal Canadian Mounted Police, municipal","48005","Offensive weapons, restricted","0","0","0","0","0","0","0","0","0","0","0","0","0","0"
"2011","Chestermere, Alberta, Royal Canadian Mounted Police, municipal","48005","Offensive weapons, restricted","0","0","0","0","0","0","0","0","0","0","0","0","0","0"
"2012","Chestermere, Alberta, Royal Canadian Mounted Police, municipal","48005","Offensive weapons, restricted","0","0","0","0","0","0","0","0","0","0","0","0","0","0"
"2013","Chestermere, Alberta, Royal Canadian Mounted Police, municipal","48005","Offensive weapons, restricted","0","0","0","0","0","0","0","0","0","0","0","0","0","0"
"2014","Chestermere, Alberta, Royal Canadian Mounted Police, municipal","48005","Offensive weapons, restricted","0","0","0","0","0","0","0","0","0","0","0","0","0","0"
"2015","Chestermere, Alberta, Royal Canadian Mounted Police, municipal","48005","Offensive weapons, restricted","0","0","0","0","0","0","0","0","0","0","0","0","0","0"
"2016","Chestermere, Alberta, Royal Canadian Mounted Police, municipal","48005","Offensive weapons, restricted","0","0","0","0","0","0","0","0","0","0","0","0","0","0"
"1998","Chestermere, Alberta, Royal Canadian Mounted Police, municipal","48005","Firearm transfers or serial numbers","0","0","0","0","0","0","0","0","0","0","0","0","0","0"
"1999","Chestermere, Alberta, Royal Canadian Mounted Police, municipal","48005","Firearm transfers or serial numbers","0","0","0","0","0","0","0","0","0","0","0","0","0","0"
"2000","Chestermere, Alberta, Royal Canadian Mounted Police, municipal","48005","Firearm transfers or serial numbers","0","0","0","0","0","0","0","0","0","0","0","0","0","0"
"2001","Chestermere, Alberta, Royal Canadian Mounted Police, municipal","48005","Firearm transfers or serial numbers","0","0","0","0","0","0","0","0","0","0","0","0","0","0"
"2002","Chestermere, Alberta, Royal Canadian Mounted Police, municipal","48005","Firearm transfers or serial numbers","0","0","0","0","0","0","0","0","0","0","0","0","0","0"
"2003","Chestermere, Alberta, Royal Canadian Mounted Police, municipal","48005","Firearm transfers or serial numbers","0","0","0","0","0","0","0","0","0","0","0","0","0","0"
"2004","Chestermere, Alberta, Royal Canadian Mounted Police, municipal","48005","Firearm transfers or serial numbers","0","0","0","0","0","0","0","0","0","0","0","0","0","0"
"2005","Chestermere, Alberta, Royal Canadian Mounted Police, municipal","48005","Firearm transfers or serial numbers","0","0","0","0","0","0","0","0","0","0","0","0","0","0"
"2006","Chestermere, Alberta, Royal Canadian Mounted Police, municipal","48005","Firearm transfers or serial numbers","0","0","0","0","0","0","0","0","0","0","0","0","0","0"
"2007","Chestermere, Alberta, Royal Canadian Mounted Police, municipal","48005","Firearm transfers or serial numbers","0","0","0","0","0","0","0","0","0","0","0","0","0","0"
"2008","Chestermere, Alberta, Royal Canadian Mounted Police, municipal","48005","Firearm transfers or serial numbers","0","0","0","0","0","0","0","0","0","0","0","0","0","0"
"2009","Chestermere, Alberta, Royal Canadian Mounted Police, municipal","48005","Firearm transfers or serial numbers","0","0","0","0","0","0","0","0","0","0","0","0","0","0"
"2010","Chestermere, Alberta, Royal Canadian Mounted Police, municipal","48005","Firearm transfers or serial numbers","0","0","0","0","0","0","0","0","0","0","0","0","0","0"
"2011","Chestermere, Alberta, Royal Canadian Mounted Police, municipal","48005","Firearm transfers or serial numbers","0","0","0","0","0","0","0","0","0","0","0","0","0","0"
"2012","Chestermere, Alberta, Royal Canadian Mounted Police, municipal","48005","Firearm transfers or serial numbers","0","0","0","0","0","0","0","0","0","0","0","0","0","0"
"2013","Chestermere, Alberta, Royal Canadian Mounted Police, municipal","48005","Firearm transfers or serial numbers","0","0","0","0","0","0","0","0","0","0","0","0","0","0"
"2014","Chestermere, Alberta, Royal Canadian Mounted Police, municipal","48005","Firearm transfers or serial numbers","0","0","0","0","0","0","0","0","0","0","0","0","0","0"
"2015","Chestermere, Alberta, Royal Canadian Mounted Police, municipal","48005","Firearm transfers or serial numbers","0","0","0","0","0","0","0","0","0","0","0","0","0","0"
"2016","Chestermere, Alberta, Royal Canadian Mounted Police, municipal","48005","Firearm transfers or serial numbers","0","0","0","0","0","0","0","0","0","0","0","0","0","0"
"1998","Chestermere, Alberta, Royal Canadian Mounted Police, municipal","48005","Other offensive weapons","0","0","0","0","0","0","0","0","0","0","0","0","0","0"
"1999","Chestermere, Alberta, Royal Canadian Mounted Police, municipal","48005","Other offensive weapons","0","0","0","0","0","0","0","0","0","0","0","0","0","0"
"2000","Chestermere, Alberta, Royal Canadian Mounted Police, municipal","48005","Other offensive weapons","0","0","0","0","0","0","0","0","0","0","0","0","0","0"
"2001","Chestermere, Alberta, Royal Canadian Mounted Police, municipal","48005","Other offensive weapons","0","0","0","0","0","0","0","0","0","0","0","0","0","0"
"2002","Chestermere, Alberta, Royal Canadian Mounted Police, municipal","48005","Other offensive weapons","0","0","0","0","0","0","0","0","0","0","0","0","0","0"
"2003","Chestermere, Alberta, Royal Canadian Mounted Police, municipal","48005","Other offensive weapons","0","0","0","0","0","0","0","0","0","0","0","0","0","0"
"2004","Chestermere, Alberta, Royal Canadian Mounted Police, municipal","48005","Other offensive weapons","0","0","0","0","0","0","0","0","0","0","0","0","0","0"
"2005","Chestermere, Alberta, Royal Canadian Mounted Police, municipal","48005","Other offensive weapons","0","0","0","0","0","0","0","0","0","0","0","0","0","0"
"2006","Chestermere, Alberta, Royal Canadian Mounted Police, municipal","48005","Other offensive weapons","0","0","0","0","0","0","0","0","0","0","0","0","0","0"
"2007","Chestermere, Alberta, Royal Canadian Mounted Police, municipal","48005","Other offensive weapons","0","0","0","0","0","0","0","0","0","0","0","0","0","0"
"2008","Chestermere, Alberta, Royal Canadian Mounted Police, municipal","48005","Other offensive weapons","0","0","0","0","0","0","0","0","0","0","0","0","0","0"
"2009","Chestermere, Alberta, Royal Canadian Mounted Police, municipal","48005","Other offensive weapons","0","0","0","0","0","0","0","0","0","0","0","0","0","0"
"2010","Chestermere, Alberta, Royal Canadian Mounted Police, municipal","48005","Other offensive weapons","0","0","0","0","0","0","0","0","0","0","0","0","0","0"
"2011","Chestermere, Alberta, Royal Canadian Mounted Police, municipal","48005","Other offensive weapons","0","0","0","0","0","0","0","0","0","0","0","0","0","0"
"2012","Chestermere, Alberta, Royal Canadian Mounted Police, municipal","48005","Other offensive weapons","0","0","0","0","0","0","0","0","0","0","0","0","0","0"
"2013","Chestermere, Alberta, Royal Canadian Mounted Police, municipal","48005","Other offensive weapons","0","0","0","0","0","0","0","0","0","0","0","0","0","0"
"2014","Chestermere, Alberta, Royal Canadian Mounted Police, municipal","48005","Other offensive weapons","0","0","0","0","0","0","0","0","0","0","0","0","0","0"
"2015","Chestermere, Alberta, Royal Canadian Mounted Police, municipal","48005","Other offensive weapons","0","0","0","0","0","0","0","0","0","0","0","0","0","0"
"2016","Chestermere, Alberta, Royal Canadian Mounted Police, municipal","48005","Other offensive weapons","0","0","0","0","0","0","0","0","0","0","0","0","0","0"
"1998","Chestermere, Alberta, Royal Canadian Mounted Police, municipal","48005","Weapons trafficking","0","0","0","0","0","0","0","0","0","0","0","0","0","0"
"1999","Chestermere, Alberta, Royal Canadian Mounted Police, municipal","48005","Weapons trafficking","0","0","0","0","0","0","0","0","0","0","0","0","0","0"
"2000","Chestermere, Alberta, Royal Canadian Mounted Police, municipal","48005","Weapons trafficking","0","0","0","0","0","0","0","0","0","0","0","0","0","0"
"2001","Chestermere, Alberta, Royal Canadian Mounted Police, municipal","48005","Weapons trafficking","0","0","0","0","0","0","0","0","0","0","0","0","0","0"
"2002","Chestermere, Alberta, Royal Canadian Mounted Police, municipal","48005","Weapons trafficking","0","0","0","0","0","0","0","0","0","0","0","0","0","0"
"2003","Chestermere, Alberta, Royal Canadian Mounted Police, municipal","48005","Weapons trafficking","0","0","0","0","0","0","0","0","0","0","0","0","0","0"
"2004","Chestermere, Alberta, Royal Canadian Mounted Police, municipal","48005","Weapons trafficking","0","0","0","0","0","0","0","0","0","0","0","0","0","0"
"2005","Chestermere, Alberta, Royal Canadian Mounted Police, municipal","48005","Weapons trafficking","0","0","0","0","0","0","0","0","0","0","0","0","0","0"
"2006","Chestermere, Alberta, Royal Canadian Mounted Police, municipal","48005","Weapons trafficking","0","0","0","0","0","0","0","0","0","0","0","0","0","0"
"2007","Chestermere, Alberta, Royal Canadian Mounted Police, municipal","48005","Weapons trafficking","0","0","0","0","0","0","0","0","0","0","0","0","0","0"
"2008","Chestermere, Alberta, Royal Canadian Mounted Police, municipal","48005","Weapons trafficking","0","0","0","0","0","0","0","0","0","0","0","0","0","0"
"2009","Chestermere, Alberta, Royal Canadian Mounted Police, municipal","48005","Weapons trafficking","0","0","0","0","0","0","0","0","0","0","0","0","0","0"
"2010","Chestermere, Alberta, Royal Canadian Mounted Police, municipal","48005","Weapons trafficking","0","0","0","0","0","0","0","0","0","0","0","0","0","0"
"2011","Chestermere, Alberta, Royal Canadian Mounted Police, municipal","48005","Weapons trafficking","0","0","0","0","0","0","0","0","0","0","0","0","0","0"
"2012","Chestermere, Alberta, Royal Canadian Mounted Police, municipal","48005","Weapons trafficking","0","0","0","0","0","0","0","0","0","0","0","0","0","0"
"2013","Chestermere, Alberta, Royal Canadian Mounted Police, municipal","48005","Weapons trafficking","0","0","0","0","0","0","0","0","0","0","0","0","0","0"
"2014","Chestermere, Alberta, Royal Canadian Mounted Police, municipal","48005","Weapons trafficking","0","0","0","0","0","0","0","0","0","0","0","0","0","0"
"2015","Chestermere, Alberta, Royal Canadian Mounted Police, municipal","48005","Weapons trafficking","0","0","0","0","0","0","0","0","0","0","0","0","0","0"
"2016","Chestermere, Alberta, Royal Canadian Mounted Police, municipal","48005","Weapons trafficking","0","0","0","0","0","0","0","0","0","0","0","0","0","0"
"1998","Chestermere, Alberta, Royal Canadian Mounted Police, municipal","48005","Weapons possession contrary to order","0","0","0","0","0","0","0","0","0","0","0","0","0","0"
"1999","Chestermere, Alberta, Royal Canadian Mounted Police, municipal","48005","Weapons possession contrary to order","0","0","0","0","0","0","0","0","0","0","0","0","0","0"
"2000","Chestermere, Alberta, Royal Canadian Mounted Police, municipal","48005","Weapons possession contrary to order","0","0","0","0","0","0","0","0","0","0","0","0","0","0"
"2001","Chestermere, Alberta, Royal Canadian Mounted Police, municipal","48005","Weapons possession contrary to order","0","0","0","0","0","0","0","0","0","0","0","0","0","0"
"2002","Chestermere, Alberta, Royal Canadian Mounted Police, municipal","48005","Weapons possession contrary to order","0","0","0","0","0","0","0","0","0","0","0","0","0","0"
"2003","Chestermere, Alberta, Royal Canadian Mounted Police, municipal","48005","Weapons possession contrary to order","0","0","0","0","0","0","0","0","0","0","0","0","0","0"
"2004","Chestermere, Alberta, Royal Canadian Mounted Police, municipal","48005","Weapons possession contrary to order","0","0","0","0","0","0","0","0","0","0","0","0","0","0"
"2005","Chestermere, Alberta, Royal Canadian Mounted Police, municipal","48005","Weapons possession contrary to order","0","0","0","0","0","0","0","0","0","0","0","0","0","0"
"2006","Chestermere, Alberta, Royal Canadian Mounted Police, municipal","48005","Weapons possession contrary to order","0","0","0","0","0","0","0","0","0","0","0","0","0","0"
"2007","Chestermere, Alberta, Royal Canadian Mounted Police, municipal","48005","Weapons possession contrary to order","1","1","0","0","8.8","12.32","10.85","0","0","1","1","1","0","0"
"2008","Chestermere, Alberta, Royal Canadian Mounted Police, municipal","48005","Weapons possession contrary to order","1","1","0","-8.17","8.08","11.28","9.96","0","0","1","1","1","0","0"
"2009","Chestermere, Alberta, Royal Canadian Mounted Police, municipal","48005","Weapons possession contrary to order","0","0","0","-100","0","0","0","0","0","0","0","0","0","0"
"2010","Chestermere, Alberta, Royal Canadian Mounted Police, municipal","48005","Weapons possession contrary to order","0","0","0","0","0","0","0","0","0","0","0","0","0","0"
"2011","Chestermere, Alberta, Royal Canadian Mounted Police, municipal","48005","Weapons possession contrary to order","0","0","0","0","0","0","0","0","0","0","0","0","0","0"
"2012","Chestermere, Alberta, Royal Canadian Mounted Police, municipal","48005","Weapons possession contrary to order","0","0","0","0","0","0","0","0","0","0","0","0","0","0"
"2013","Chestermere, Alberta, Royal Canadian Mounted Police, municipal","48005","Weapons possession contrary to order","0","0","0","0","0","0","0","0","0","0","0","0","0","0"
"2014","Chestermere, Alberta, Royal Canadian Mounted Police, municipal","48005","Weapons possession contrary to order","0","0","0","0","0","0","0","0","0","0","0","0","0","0"
"2015","Chestermere, Alberta, Royal Canadian Mounted Police, municipal","48005","Weapons possession contrary to order","0","0","0","0","0","0","0","0","0","0","0","0","0","0"
"2016","Chestermere, Alberta, Royal Canadian Mounted Police, municipal","48005","Weapons possession contrary to order","0","0","0","0","0","0","0","0","0","0","0","0","0","0"
"1998","Chestermere, Alberta, Royal Canadian Mounted Police, municipal","48005","Possession of weapons","0","0","0","0","0","0","0","0","0","0","0","0","0","0"
"1999","Chestermere, Alberta, Royal Canadian Mounted Police, municipal","48005","Possession of weapons","0","0","0","0","0","0","0","0","0","0","0","0","0","0"
"2000","Chestermere, Alberta, Royal Canadian Mounted Police, municipal","48005","Possession of weapons","0","0","0","0","0","0","0","0","0","0","0","0","0","0"
"2001","Chestermere, Alberta, Royal Canadian Mounted Police, municipal","48005","Possession of weapons","0","0","0","0","0","0","0","0","0","0","0","0","0","0"
"2002","Chestermere, Alberta, Royal Canadian Mounted Police, municipal","48005","Possession of weapons","0","0","0","0","0","0","0","0","0","0","0","0","0","0"
"2003","Chestermere, Alberta, Royal Canadian Mounted Police, municipal","48005","Possession of weapons","0","0","0","0","0","0","0","0","0","0","0","0","0","0"
"2004","Chestermere, Alberta, Royal Canadian Mounted Police, municipal","48005","Possession of weapons","0","0","0","0","0","0","0","0","0","0","0","0","0","0"
"2005","Chestermere, Alberta, Royal Canadian Mounted Police, municipal","48005","Possession of weapons","4","1","3","0","46.18","15.99","14.14","0","244.2","4","1","1","0","2"
"2006","Chestermere, Alberta, Royal Canadian Mounted Police, municipal","48005","Possession of weapons","11","5","6","129.26","105.87","27.03","35.65","98.52","98.52","11","2","3","1","1"
"2007","Chestermere, Alberta, Royal Canadian Mounted Police, municipal","48005","Possession of weapons","43","11","27","257.47","378.45","24.64","21.71","0","1549.68","38","2","2","0","17"
"2008","Chestermere, Alberta, Royal Canadian Mounted Police, municipal","48005","Possession of weapons","28","11","15","-40.2","226.3","11.28","9.96","0","339.56","26","1","1","0","4"
"2009","Chestermere, Alberta, Royal Canadian Mounted Police, municipal","48005","Possession of weapons","9","0","8","-70.39","67","0","0","0","79.3","8","0","0","0","1"
"2010","Chestermere, Alberta, Royal Canadian Mounted Police, municipal","48005","Possession of weapons","5","1","2","-48.24","34.68","9.66","8.54","0","73.64","3","1","1","0","1"
"2011","Chestermere, Alberta, Royal Canadian Mounted Police, municipal","48005","Possession of weapons","8","2","3","49.92","52","18.12","16.1","0","144.93","5","2","2","0","2"
"2012","Chestermere, Alberta, Royal Canadian Mounted Police, municipal","48005","Possession of weapons","4","1","2","-51.45","25.24","8.78","7.83","0","288.18","3","1","1","0","4"
"2013","Chestermere, Alberta, Royal Canadian Mounted Police, municipal","48005","Possession of weapons","1","0","1","-75.84","6.1","0","0","0","0","1","0","0","0","0"
"2014","Chestermere, Alberta, Royal Canadian Mounted Police, municipal","48005","Possession of weapons","2","0","1","93.67","11.81","0","0","0","71.48","1","0","0","0","1"
"2015","Chestermere, Alberta, Royal Canadian Mounted Police, municipal","48005","Possession of weapons","1","0","1","-51.1","5.78","0","0","0","0","1","0","0","0","0"
"2016","Chestermere, Alberta, Royal Canadian Mounted Police, municipal","48005","Possession of weapons","3","3","0","192.68","16.9","15.63","21.07","69.2","0","3","2","3","1","0"
"1998","Chestermere, Alberta, Royal Canadian Mounted Police, municipal","48005","Unauthorized importing or exporting of weapons","0","0","0","0","0","0","0","0","0","0","0","0","0","0"
"1999","Chestermere, Alberta, Royal Canadian Mounted Police, municipal","48005","Unauthorized importing or exporting of weapons","0","0","0","0","0","0","0","0","0","0","0","0","0","0"
"2000","Chestermere, Alberta, Royal Canadian Mounted Police, municipal","48005","Unauthorized importing or exporting of weapons","0","0","0","0","0","0","0","0","0","0","0","0","0","0"
"2001","Chestermere, Alberta, Royal Canadian Mounted Police, municipal","48005","Unauthorized importing or exporting of weapons","0","0","0","0","0","0","0","0","0","0","0","0","0","0"
"2002","Chestermere, Alberta, Royal Canadian Mounted Police, municipal","48005","Unauthorized importing or exporting of weapons","0","0","0","0","0","0","0","0","0","0","0","0","0","0"
"2003","Chestermere, Alberta, Royal Canadian Mounted Police, municipal","48005","Unauthorized importing or exporting of weapons","0","0","0","0","0","0","0","0","0","0","0","0","0","0"
"2004","Chestermere, Alberta, Royal Canadian Mounted Police, municipal","48005","Unauthorized importing or exporting of weapons","0","0","0","0","0","0","0","0","0","0","0","0","0","0"
"2005","Chestermere, Alberta, Royal Canadian Mounted Police, municipal","48005","Unauthorized importing or exporting of weapons","0","0","0","0","0","0","0","0","0","0","0","0","0","0"
"2006","Chestermere, Alberta, Royal Canadian Mounted Police, municipal","48005","Unauthorized importing or exporting of weapons","0","0","0","0","0","0","0","0","0","0","0","0","0","0"
"2007","Chestermere, Alberta, Royal Canadian Mounted Police, municipal","48005","Unauthorized importing or exporting of weapons","0","0","0","0","0","0","0","0","0","0","0","0","0","0"
"2008","Chestermere, Alberta, Royal Canadian Mounted Police, municipal","48005","Unauthorized importing or exporting of weapons","1","0","0","0","8.08","0","0","0","0","0","0","0","0","0"
"2009","Chestermere, Alberta, Royal Canadian Mounted Police, municipal","48005","Unauthorized importing or exporting of weapons","0","0","0","-100","0","0","0","0","0","0","0","0","0","0"
"2010","Chestermere, Alberta, Royal Canadian Mounted Police, municipal","48005","Unauthorized importing or exporting of weapons","0","0","0","0","0","0","0","0","0","0","0","0","0","0"
"2011","Chestermere, Alberta, Royal Canadian Mounted Police, municipal","48005","Unauthorized importing or exporting of weapons","0","0","0","0","0","0","0","0","0","0","0","0","0","0"
"2012","Chestermere, Alberta, Royal Canadian Mounted Police, municipal","48005","Unauthorized importing or exporting of weapons","0","0","0","0","0","0","0","0","0","0","0","0","0","0"
"2013","Chestermere, Alberta, Royal Canadian Mounted Police, municipal","48005","Unauthorized importing or exporting of weapons","0","0","0","0","0","0","0","0","0","0","0","0","0","0"
"2014","Chestermere, Alberta, Royal Canadian Mounted Police, municipal","48005","Unauthorized importing or exporting of weapons","0","0","0","0","0","0","0","0","0","0","0","0","0","0"
"2015","Chestermere, Alberta, Royal Canadian Mounted Police, municipal","48005","Unauthorized importing or exporting of weapons","0","0","0","0","0","0","0","0","0","0","0","0","0","0"
"2016","Chestermere, Alberta, Royal Canadian Mounted Police, municipal","48005","Unauthorized importing or exporting of weapons","0","0","0","0","0","0","0","0","0","0","0","0","0","0"
"1998","Chestermere, Alberta, Royal Canadian Mounted Police, municipal","48005","Firearms documentation or administration","0","0","0","0","0","0","0","0","0","0","0","0","0","0"
"1999","Chestermere, Alberta, Royal Canadian Mounted Police, municipal","48005","Firearms documentation or administration","0","0","0","0","0","0","0","0","0","0","0","0","0","0"
"2000","Chestermere, Alberta, Royal Canadian Mounted Police, municipal","48005","Firearms documentation or administration","0","0","0","0","0","0","0","0","0","0","0","0","0","0"
"2001","Chestermere, Alberta, Royal Canadian Mounted Police, municipal","48005","Firearms documentation or administration","0","0","0","0","0","0","0","0","0","0","0","0","0","0"
"2002","Chestermere, Alberta, Royal Canadian Mounted Police, municipal","48005","Firearms documentation or administration","0","0","0","0","0","0","0","0","0","0","0","0","0","0"
"2003","Chestermere, Alberta, Royal Canadian Mounted Police, municipal","48005","Firearms documentation or administration","0","0","0","0","0","0","0","0","0","0","0","0","0","0"
"2004","Chestermere, Alberta, Royal Canadian Mounted Police, municipal","48005","Firearms documentation or administration","0","0","0","0","0","0","0","0","0","0","0","0","0","0"
"2005","Chestermere, Alberta, Royal Canadian Mounted Police, municipal","48005","Firearms documentation or administration","1","0","0","0","11.54","0","0","0","0","0","0","0","0","0"
"2006","Chestermere, Alberta, Royal Canadian Mounted Police, municipal","48005","Firearms documentation or administration","0","0","0","-100","0","0","0","0","0","0","0","0","0","0"
"2007","Chestermere, Alberta, Royal Canadian Mounted Police, municipal","48005","Firearms documentation or administration","0","0","0","0","0","0","0","0","0","0","0","0","0","0"
"2008","Chestermere, Alberta, Royal Canadian Mounted Police, municipal","48005","Firearms documentation or administration","0","0","0","0","0","0","0","0","0","0","0","0","0","0"
"2009","Chestermere, Alberta, Royal Canadian Mounted Police, municipal","48005","Firearms documentation or administration","0","0","0","0","0","0","0","0","0","0","0","0","0","0"
"2010","Chestermere, Alberta, Royal Canadian Mounted Police, municipal","48005","Firearms documentation or administration","0","0","0","0","0","0","0","0","0","0","0","0","0","0"
"2011","Chestermere, Alberta, Royal Canadian Mounted Police, municipal","48005","Firearms documentation or administration","0","0","0","0","0","0","0","0","0","0","0","0","0","0"
"2012","Chestermere, Alberta, Royal Canadian Mounted Police, municipal","48005","Firearms documentation or administration","0","0","0","0","0","0","0","0","0","0","0","0","0","0"
"2013","Chestermere, Alberta, Royal Canadian Mounted Police, municipal","48005","Firearms documentation or administration","0","0","0","0","0","0","0","0","0","0","0","0","0","0"
"2014","Chestermere, Alberta, Royal Canadian Mounted Police, municipal","48005","Firearms documentation or administration","0","0","0","0","0","0","0","0","0","0","0","0","0","0"
"2015","Chestermere, Alberta, Royal Canadian Mounted Police, municipal","48005","Firearms documentation or administration","0","0","0","0","0","0","0","0","0","0","0","0","0","0"
"2016","Chestermere, Alberta, Royal Canadian Mounted Police, municipal","48005","Firearms documentation or administration","0","0","0","0","0","0","0","0","0","0","0","0","0","0"
"1998","Chestermere, Alberta, Royal Canadian Mounted Police, municipal","48005","Unsafe storage of firearms","0","0","0","0","0","0","0","0","0","0","0","0","0","0"
"1999","Chestermere, Alberta, Royal Canadian Mounted Police, municipal","48005","Unsafe storage of firearms","0","0","0","0","0","0","0","0","0","0","0","0","0","0"
"2000","Chestermere, Alberta, Royal Canadian Mounted Police, municipal","48005","Unsafe storage of firearms","0","0","0","0","0","0","0","0","0","0","0","0","0","0"
"2001","Chestermere, Alberta, Royal Canadian Mounted Police, municipal","48005","Unsafe storage of firearms","0","0","0","0","0","0","0","0","0","0","0","0","0","0"
"2002","Chestermere, Alberta, Royal Canadian Mounted Police, municipal","48005","Unsafe storage of firearms","0","0","0","0","0","0","0","0","0","0","0","0","0","0"
"2003","Chestermere, Alberta, Royal Canadian Mounted Police, municipal","48005","Unsafe storage of firearms","0","0","0","0","0","0","0","0","0","0","0","0","0","0"
"2004","Chestermere, Alberta, Royal Canadian Mounted Police, municipal","48005","Unsafe storage of firearms","0","0","0","0","0","0","0","0","0","0","0","0","0","0"
"2005","Chestermere, Alberta, Royal Canadian Mounted Police, municipal","48005","Unsafe storage of firearms","1","1","0","0","11.54","0","0","0","0","1","0","0","0","0"
"2006","Chestermere, Alberta, Royal Canadian Mounted Police, municipal","48005","Unsafe storage of firearms","1","0","1","-16.63","9.62","0","0","0","98.52","1","0","0","0","1"
"2007","Chestermere, Alberta, Royal Canadian Mounted Police, municipal","48005","Unsafe storage of firearms","1","0","0","-8.55","8.8","0","0","0","0","0","0","0","0","0"
"2008","Chestermere, Alberta, Royal Canadian Mounted Police, municipal","48005","Unsafe storage of firearms","2","0","1","83.66","16.16","0","0","0","0","1","0","0","0","0"
"2009","Chestermere, Alberta, Royal Canadian Mounted Police, municipal","48005","Unsafe storage of firearms","0","0","0","-100","0","0","0","0","0","0","0","0","0","0"
"2010","Chestermere, Alberta, Royal Canadian Mounted Police, municipal","48005","Unsafe storage of firearms","0","0","0","0","0","0","0","0","0","0","0","0","0","0"
"2011","Chestermere, Alberta, Royal Canadian Mounted Police, municipal","48005","Unsafe storage of firearms","0","0","0","0","0","0","0","0","0","0","0","0","0","0"
"2012","Chestermere, Alberta, Royal Canadian Mounted Police, municipal","48005","Unsafe storage of firearms","1","1","0","0","6.31","8.78","7.83","0","0","1","1","1","0","0"
"2013","Chestermere, Alberta, Royal Canadian Mounted Police, municipal","48005","Unsafe storage of firearms","0","0","0","-100","0","0","0","0","0","0","0","0","0","0"
"2014","Chestermere, Alberta, Royal Canadian Mounted Police, municipal","48005","Unsafe storage of firearms","0","0","0","0","0","0","0","0","0","0","0","0","0","0"
"2015","Chestermere, Alberta, Royal Canadian Mounted Police, municipal","48005","Unsafe storage of firearms","0","0","0","0","0","0","0","0","0","0","0","0","0","0"
"2016","Chestermere, Alberta, Royal Canadian Mounted Police, municipal","48005","Unsafe storage of firearms","0","0","0","0","0","0","0","0","0","0","0","0","0","0"
"1998","Chestermere, Alberta, Royal Canadian Mounted Police, municipal","48005","Child pornography","0","0","0","0","0","0","0","0","0","0","0","0","0","0"
"1999","Chestermere, Alberta, Royal Canadian Mounted Police, municipal","48005","Child pornography","0","0","0","0","0","0","0","0","0","0","0","0","0","0"
"2000","Chestermere, Alberta, Royal Canadian Mounted Police, municipal","48005","Child pornography","0","0","0","0","0","0","0","0","0","0","0","0","0","0"
"2001","Chestermere, Alberta, Royal Canadian Mounted Police, municipal","48005","Child pornography","0","0","0","0","0","0","0","0","0","0","0","0","0","0"
"2002","Chestermere, Alberta, Royal Canadian Mounted Police, municipal","48005","Child pornography","0","0","0","0","0","0","0","0","0","0","0","0","0","0"
"2003","Chestermere, Alberta, Royal Canadian Mounted Police, municipal","48005","Child pornography","0","0","0","0","0","0","0","0","0","0","0","0","0","0"
"2004","Chestermere, Alberta, Royal Canadian Mounted Police, municipal","48005","Child pornography","0","0","0","0","0","0","0","0","0","0","0","0","0","0"
"2005","Chestermere, Alberta, Royal Canadian Mounted Police, municipal","48005","Child pornography","0","0","0","0","0","0","0","0","0","0","0","0","0","0"
"2006","Chestermere, Alberta, Royal Canadian Mounted Police, municipal","48005","Child pornography","0","0","0","0","0","0","0","0","0","0","0","0","0","0"
"2007","Chestermere, Alberta, Royal Canadian Mounted Police, municipal","48005","Child pornography","0","0","0","0","0","0","0","0","0","0","0","0","0","0"
"2008","Chestermere, Alberta, Royal Canadian Mounted Police, municipal","48005","Child pornography","1","0","0","0","8.08","0","0","0","0","0","0","0","0","0"
"2009","Chestermere, Alberta, Royal Canadian Mounted Police, municipal","48005","Child pornography","1","0","1","-7.89","7.44","0","0","0","237.91","1","0","0","0","3"
"2010","Chestermere, Alberta, Royal Canadian Mounted Police, municipal","48005","Child pornography","1","0","1","-6.83","6.94","0","0","0","73.64","1","0","0","0","1"
"2011","Chestermere, Alberta, Royal Canadian Mounted Police, municipal","48005","Child pornography","0","0","0","-100","0","0","0","0","0","0","0","0","0","0"
"2012","Chestermere, Alberta, Royal Canadian Mounted Police, municipal","48005","Child pornography","2","0","0","0","12.62","0","0","0","0","0","0","0","0","0"
"2013","Chestermere, Alberta, Royal Canadian Mounted Police, municipal","48005","Child pornography","1","0","0","-51.68","6.1","0","0","0","0","0","0","0","0","0"
"2014","Chestermere, Alberta, Royal Canadian Mounted Police, municipal","48005","Child pornography","0","0","0","-100","0","0","0","0","0","0","0","0","0","0"
"2015","Chestermere, Alberta, Royal Canadian Mounted Police, municipal","48005","Child pornography","3","1","0","0","17.33","0","0","0","0","1","0","0","0","0"
"2016","Chestermere, Alberta, Royal Canadian Mounted Police, municipal","48005","Child pornography","0","0","1","-100","0","0","0","0","69.2","1","0","0","0","1"
"2012","Chestermere, Alberta, Royal Canadian Mounted Police, municipal","48005","Making, or distribution of child pornography","0","0","0","0","0","0","0","0","0","0","0","0","0","0"
"2013","Chestermere, Alberta, Royal Canadian Mounted Police, municipal","48005","Making, or distribution of child pornography","0","0","0","0","0","0","0","0","0","0","0","0","0","0"
"2014","Chestermere, Alberta, Royal Canadian Mounted Police, municipal","48005","Making, or distribution of child pornography","0","0","0","0","0","0","0","0","0","0","0","0","0","0"
"2015","Chestermere, Alberta, Royal Canadian Mounted Police, municipal","48005","Making, or distribution of child pornography","0","0","0","0","0","0","0","0","0","0","0","0","0","0"
"2016","Chestermere, Alberta, Royal Canadian Mounted Police, municipal","48005","Making, or distribution of child pornography","0","0","0","0","0","0","0","0","0","0","0","0","0","0"
"1998","Chestermere, Alberta, Royal Canadian Mounted Police, municipal","48005","Total prostitution","0","0","0","0","0","0","0","0","0","0","0","0","0","0"
"1999","Chestermere, Alberta, Royal Canadian Mounted Police, municipal","48005","Total prostitution","0","0","0","0","0","0","0","0","0","0","0","0","0","0"
"2000","Chestermere, Alberta, Royal Canadian Mounted Police, municipal","48005","Total prostitution","0","0","0","0","0","0","0","0","0","0","0","0","0","0"
"2001","Chestermere, Alberta, Royal Canadian Mounted Police, municipal","48005","Total prostitution","0","0","0","0","0","0","0","0","0","0","0","0","0","0"
"2002","Chestermere, Alberta, Royal Canadian Mounted Police, municipal","48005","Total prostitution","0","0","0","0","0","0","0","0","0","0","0","0","0","0"
"2003","Chestermere, Alberta, Royal Canadian Mounted Police, municipal","48005","Total prostitution","0","0","0","0","0","0","0","0","0","0","0","0","0","0"
"2004","Chestermere, Alberta, Royal Canadian Mounted Police, municipal","48005","Total prostitution","0","0","0","0","0","0","0","0","0","0","0","0","0","0"
"2005","Chestermere, Alberta, Royal Canadian Mounted Police, municipal","48005","Total prostitution","0","0","0","0","0","0","0","0","0","0","0","0","0","0"
"2006","Chestermere, Alberta, Royal Canadian Mounted Police, municipal","48005","Total prostitution","0","0","0","0","0","0","0","0","0","0","0","0","0","0"
"2007","Chestermere, Alberta, Royal Canadian Mounted Police, municipal","48005","Total prostitution","0","0","0","0","0","0","0","0","0","0","0","0","0","0"
"2008","Chestermere, Alberta, Royal Canadian Mounted Police, municipal","48005","Total prostitution","1","0","0","0","8.08","0","0","0","0","0","0","0","0","0"
"2009","Chestermere, Alberta, Royal Canadian Mounted Police, municipal","48005","Total prostitution","0","0","0","-100","0","0","0","0","0","0","0","0","0","0"
"2010","Chestermere, Alberta, Royal Canadian Mounted Police, municipal","48005","Total prostitution","0","0","0","0","0","0","0","0","0","0","0","0","0","0"
"2011","Chestermere, Alberta, Royal Canadian Mounted Police, municipal","48005","Total prostitution","0","0","0","0","0","0","0","0","0","0","0","0","0","0"
"2012","Chestermere, Alberta, Royal Canadian Mounted Police, municipal","48005","Total prostitution","0","0","0","0","0","0","0","0","0","0","0","0","0","0"
"2013","Chestermere, Alberta, Royal Canadian Mounted Police, municipal","48005","Total prostitution","0","0","0","0","0","0","0","0","0","0","0","0","0","0"
"2014","Chestermere, Alberta, Royal Canadian Mounted Police, municipal","48005","Total prostitution","0","0","0","0","0","0","0","0","0","0","0","0","0","0"
"2015","Chestermere, Alberta, Royal Canadian Mounted Police, municipal","48005","Total prostitution","0","0","0","0","0","0","0","0","0","0","0","0","0","0"
"2016","Chestermere, Alberta, Royal Canadian Mounted Police, municipal","48005","Total prostitution","0","0","0","0","0","0","0","0","0","0","0","0","0","0"
"1998","Chestermere, Alberta, Royal Canadian Mounted Police, municipal","48005","Bawdy house","0","0","0","0","0","0","0","0","0","0","0","0","0","0"
"1999","Chestermere, Alberta, Royal Canadian Mounted Police, municipal","48005","Bawdy house","0","0","0","0","0","0","0","0","0","0","0","0","0","0"
"2000","Chestermere, Alberta, Royal Canadian Mounted Police, municipal","48005","Bawdy house","0","0","0","0","0","0","0","0","0","0","0","0","0","0"
"2001","Chestermere, Alberta, Royal Canadian Mounted Police, municipal","48005","Bawdy house","0","0","0","0","0","0","0","0","0","0","0","0","0","0"
"2002","Chestermere, Alberta, Royal Canadian Mounted Police, municipal","48005","Bawdy house","0","0","0","0","0","0","0","0","0","0","0","0","0","0"
"2003","Chestermere, Alberta, Royal Canadian Mounted Police, municipal","48005","Bawdy house","0","0","0","0","0","0","0","0","0","0","0","0","0","0"
"2004","Chestermere, Alberta, Royal Canadian Mounted Police, municipal","48005","Bawdy house","0","0","0","0","0","0","0","0","0","0","0","0","0","0"
"2005","Chestermere, Alberta, Royal Canadian Mounted Police, municipal","48005","Bawdy house","0","0","0","0","0","0","0","0","0","0","0","0","0","0"
"2006","Chestermere, Alberta, Royal Canadian Mounted Police, municipal","48005","Bawdy house","0","0","0","0","0","0","0","0","0","0","0","0","0","0"
"2007","Chestermere, Alberta, Royal Canadian Mounted Police, municipal","48005","Bawdy house","0","0","0","0","0","0","0","0","0","0","0","0","0","0"
"2008","Chestermere, Alberta, Royal Canadian Mounted Police, municipal","48005","Bawdy house","0","0","0","0","0","0","0","0","0","0","0","0","0","0"
"2009","Chestermere, Alberta, Royal Canadian Mounted Police, municipal","48005","Bawdy house","0","0","0","0","0","0","0","0","0","0","0","0","0","0"
"2010","Chestermere, Alberta, Royal Canadian Mounted Police, municipal","48005","Bawdy house","0","0","0","0","0","0","0","0","0","0","0","0","0","0"
"2011","Chestermere, Alberta, Royal Canadian Mounted Police, municipal","48005","Bawdy house","0","0","0","0","0","0","0","0","0","0","0","0","0","0"
"2012","Chestermere, Alberta, Royal Canadian Mounted Police, municipal","48005","Bawdy house","0","0","0","0","0","0","0","0","0","0","0","0","0","0"
"2013","Chestermere, Alberta, Royal Canadian Mounted Police, municipal","48005","Bawdy house","0","0","0","0","0","0","0","0","0","0","0","0","0","0"
"2014","Chestermere, Alberta, Royal Canadian Mounted Police, municipal","48005","Bawdy house","0","0","0","0","0","0","0","0","0","0","0","0","0","0"
"2015","Chestermere, Alberta, Royal Canadian Mounted Police, municipal","48005","Bawdy house","0","0","0","0","0","0","0","0","0","0","0","0","0","0"
"2016","Chestermere, Alberta, Royal Canadian Mounted Police, municipal","48005","Bawdy house","0","0","0","0","0","0","0","0","0","0","0","0","0","0"
"1998","Chestermere, Alberta, Royal Canadian Mounted Police, municipal","48005","Living off the avails of prostitution of a person under age 18","0","0","0","0","0","0","0","0","0","0","0","0","0","0"
"1999","Chestermere, Alberta, Royal Canadian Mounted Police, municipal","48005","Living off the avails of prostitution of a person under age 18","0","0","0","0","0","0","0","0","0","0","0","0","0","0"
"2000","Chestermere, Alberta, Royal Canadian Mounted Police, municipal","48005","Living off the avails of prostitution of a person under age 18","0","0","0","0","0","0","0","0","0","0","0","0","0","0"
"2001","Chestermere, Alberta, Royal Canadian Mounted Police, municipal","48005","Living off the avails of prostitution of a person under age 18","0","0","0","0","0","0","0","0","0","0","0","0","0","0"
"2002","Chestermere, Alberta, Royal Canadian Mounted Police, municipal","48005","Living off the avails of prostitution of a person under age 18","0","0","0","0","0","0","0","0","0","0","0","0","0","0"
"2003","Chestermere, Alberta, Royal Canadian Mounted Police, municipal","48005","Living off the avails of prostitution of a person under age 18","0","0","0","0","0","0","0","0","0","0","0","0","0","0"
"2004","Chestermere, Alberta, Royal Canadian Mounted Police, municipal","48005","Living off the avails of prostitution of a person under age 18","0","0","0","0","0","0","0","0","0","0","0","0","0","0"
"2005","Chestermere, Alberta, Royal Canadian Mounted Police, municipal","48005","Living off the avails of prostitution of a person under age 18","0","0","0","0","0","0","0","0","0","0","0","0","0","0"
"2006","Chestermere, Alberta, Royal Canadian Mounted Police, municipal","48005","Living off the avails of prostitution of a person under age 18","0","0","0","0","0","0","0","0","0","0","0","0","0","0"
"2007","Chestermere, Alberta, Royal Canadian Mounted Police, municipal","48005","Living off the avails of prostitution of a person under age 18","0","0","0","0","0","0","0","0","0","0","0","0","0","0"
"2008","Chestermere, Alberta, Royal Canadian Mounted Police, municipal","48005","Living off the avails of prostitution of a person under age 18","0","0","0","0","0","0","0","0","0","0","0","0","0","0"
"2009","Chestermere, Alberta, Royal Canadian Mounted Police, municipal","48005","Living off the avails of prostitution of a person under age 18","0","0","0","0","0","0","0","0","0","0","0","0","0","0"
"2010","Chestermere, Alberta, Royal Canadian Mounted Police, municipal","48005","Living off the avails of prostitution of a person under age 18","0","0","0","0","0","0","0","0","0","0","0","0","0","0"
"2011","Chestermere, Alberta, Royal Canadian Mounted Police, municipal","48005","Living off the avails of prostitution of a person under age 18","0","0","0","0","0","0","0","0","0","0","0","0","0","0"
"2012","Chestermere, Alberta, Royal Canadian Mounted Police, municipal","48005","Living off the avails of prostitution of a person under age 18","0","0","0","0","0","0","0","0","0","0","0","0","0","0"
"2013","Chestermere, Alberta, Royal Canadian Mounted Police, municipal","48005","Living off the avails of prostitution of a person under age 18","0","0","0","0","0","0","0","0","0","0","0","0","0","0"
"2014","Chestermere, Alberta, Royal Canadian Mounted Police, municipal","48005","Living off the avails of prostitution of a person under age 18","0","0","0","0","0","0","0","0","0","0","0","0","0","0"
"2015","Chestermere, Alberta, Royal Canadian Mounted Police, municipal","48005","Living off the avails of prostitution of a person under age 18","0","0","0","0","0","0","0","0","0","0","0","0","0","0"
"2016","Chestermere, Alberta, Royal Canadian Mounted Police, municipal","48005","Living off the avails of prostitution of a person under age 18","0","0","0","0","0","0","0","0","0","0","0","0","0","0"
"1998","Chestermere, Alberta, Royal Canadian Mounted Police, municipal","48005","Procuring","0","0","0","0","0","0","0","0","0","0","0","0","0","0"
"1999","Chestermere, Alberta, Royal Canadian Mounted Police, municipal","48005","Procuring","0","0","0","0","0","0","0","0","0","0","0","0","0","0"
"2000","Chestermere, Alberta, Royal Canadian Mounted Police, municipal","48005","Procuring","0","0","0","0","0","0","0","0","0","0","0","0","0","0"
"2001","Chestermere, Alberta, Royal Canadian Mounted Police, municipal","48005","Procuring","0","0","0","0","0","0","0","0","0","0","0","0","0","0"
"2002","Chestermere, Alberta, Royal Canadian Mounted Police, municipal","48005","Procuring","0","0","0","0","0","0","0","0","0","0","0","0","0","0"
"2003","Chestermere, Alberta, Royal Canadian Mounted Police, municipal","48005","Procuring","0","0","0","0","0","0","0","0","0","0","0","0","0","0"
"2004","Chestermere, Alberta, Royal Canadian Mounted Police, municipal","48005","Procuring","0","0","0","0","0","0","0","0","0","0","0","0","0","0"
"2005","Chestermere, Alberta, Royal Canadian Mounted Police, municipal","48005","Procuring","0","0","0","0","0","0","0","0","0","0","0","0","0","0"
"2006","Chestermere, Alberta, Royal Canadian Mounted Police, municipal","48005","Procuring","0","0","0","0","0","0","0","0","0","0","0","0","0","0"
"2007","Chestermere, Alberta, Royal Canadian Mounted Police, municipal","48005","Procuring","0","0","0","0","0","0","0","0","0","0","0","0","0","0"
"2008","Chestermere, Alberta, Royal Canadian Mounted Police, municipal","48005","Procuring","1","0","0","0","8.08","0","0","0","0","0","0","0","0","0"
"2009","Chestermere, Alberta, Royal Canadian Mounted Police, municipal","48005","Procuring","0","0","0","-100","0","0","0","0","0","0","0","0","0","0"
"2010","Chestermere, Alberta, Royal Canadian Mounted Police, municipal","48005","Procuring","0","0","0","0","0","0","0","0","0","0","0","0","0","0"
"2011","Chestermere, Alberta, Royal Canadian Mounted Police, municipal","48005","Procuring","0","0","0","0","0","0","0","0","0","0","0","0","0","0"
"1998","Chestermere, Alberta, Royal Canadian Mounted Police, municipal","48005","Obtains or communicates with a person under age 18 for purpose of sex","0","0","0","0","0","0","0","0","0","0","0","0","0","0"
"1999","Chestermere, Alberta, Royal Canadian Mounted Police, municipal","48005","Obtains or communicates with a person under age 18 for purpose of sex","0","0","0","0","0","0","0","0","0","0","0","0","0","0"
"2000","Chestermere, Alberta, Royal Canadian Mounted Police, municipal","48005","Obtains or communicates with a person under age 18 for purpose of sex","0","0","0","0","0","0","0","0","0","0","0","0","0","0"
"2001","Chestermere, Alberta, Royal Canadian Mounted Police, municipal","48005","Obtains or communicates with a person under age 18 for purpose of sex","0","0","0","0","0","0","0","0","0","0","0","0","0","0"
"2002","Chestermere, Alberta, Royal Canadian Mounted Police, municipal","48005","Obtains or communicates with a person under age 18 for purpose of sex","0","0","0","0","0","0","0","0","0","0","0","0","0","0"
"2003","Chestermere, Alberta, Royal Canadian Mounted Police, municipal","48005","Obtains or communicates with a person under age 18 for purpose of sex","0","0","0","0","0","0","0","0","0","0","0","0","0","0"
"2004","Chestermere, Alberta, Royal Canadian Mounted Police, municipal","48005","Obtains or communicates with a person under age 18 for purpose of sex","0","0","0","0","0","0","0","0","0","0","0","0","0","0"
"2005","Chestermere, Alberta, Royal Canadian Mounted Police, municipal","48005","Obtains or communicates with a person under age 18 for purpose of sex","0","0","0","0","0","0","0","0","0","0","0","0","0","0"
"2006","Chestermere, Alberta, Royal Canadian Mounted Police, municipal","48005","Obtains or communicates with a person under age 18 for purpose of sex","0","0","0","0","0","0","0","0","0","0","0","0","0","0"
"2007","Chestermere, Alberta, Royal Canadian Mounted Police, municipal","48005","Obtains or communicates with a person under age 18 for purpose of sex","0","0","0","0","0","0","0","0","0","0","0","0","0","0"
"2008","Chestermere, Alberta, Royal Canadian Mounted Police, municipal","48005","Obtains or communicates with a person under age 18 for purpose of sex","0","0","0","0","0","0","0","0","0","0","0","0","0","0"
"2009","Chestermere, Alberta, Royal Canadian Mounted Police, municipal","48005","Obtains or communicates with a person under age 18 for purpose of sex","0","0","0","0","0","0","0","0","0","0","0","0","0","0"
"2010","Chestermere, Alberta, Royal Canadian Mounted Police, municipal","48005","Obtains or communicates with a person under age 18 for purpose of sex","0","0","0","0","0","0","0","0","0","0","0","0","0","0"
"2011","Chestermere, Alberta, Royal Canadian Mounted Police, municipal","48005","Obtains or communicates with a person under age 18 for purpose of sex","0","0","0","0","0","0","0","0","0","0","0","0","0","0"
"2012","Chestermere, Alberta, Royal Canadian Mounted Police, municipal","48005","Obtains or communicates with a person under age 18 for purpose of sex","0","0","0","0","0","0","0","0","0","0","0","0","0","0"
"2013","Chestermere, Alberta, Royal Canadian Mounted Police, municipal","48005","Obtains or communicates with a person under age 18 for purpose of sex","0","0","0","0","0","0","0","0","0","0","0","0","0","0"
"2014","Chestermere, Alberta, Royal Canadian Mounted Police, municipal","48005","Obtains or communicates with a person under age 18 for purpose of sex","0","0","0","0","0","0","0","0","0","0","0","0","0","0"
"2015","Chestermere, Alberta, Royal Canadian Mounted Police, municipal","48005","Obtains or communicates with a person under age 18 for purpose of sex","0","0","0","0","0","0","0","0","0","0","0","0","0","0"
"2016","Chestermere, Alberta, Royal Canadian Mounted Police, municipal","48005","Obtains or communicates with a person under age 18 for purpose of sex","0","0","0","0","0","0","0","0","0","0","0","0","0","0"
"1998","Chestermere, Alberta, Royal Canadian Mounted Police, municipal","48005","Other prostitution","0","0","0","0","0","0","0","0","0","0","0","0","0","0"
"1999","Chestermere, Alberta, Royal Canadian Mounted Police, municipal","48005","Other prostitution","0","0","0","0","0","0","0","0","0","0","0","0","0","0"
"2000","Chestermere, Alberta, Royal Canadian Mounted Police, municipal","48005","Other prostitution","0","0","0","0","0","0","0","0","0","0","0","0","0","0"
"2001","Chestermere, Alberta, Royal Canadian Mounted Police, municipal","48005","Other prostitution","0","0","0","0","0","0","0","0","0","0","0","0","0","0"
"2002","Chestermere, Alberta, Royal Canadian Mounted Police, municipal","48005","Other prostitution","0","0","0","0","0","0","0","0","0","0","0","0","0","0"
"2003","Chestermere, Alberta, Royal Canadian Mounted Police, municipal","48005","Other prostitution","0","0","0","0","0","0","0","0","0","0","0","0","0","0"
"2004","Chestermere, Alberta, Royal Canadian Mounted Police, municipal","48005","Other prostitution","0","0","0","0","0","0","0","0","0","0","0","0","0","0"
"2005","Chestermere, Alberta, Royal Canadian Mounted Police, municipal","48005","Other prostitution","0","0","0","0","0","0","0","0","0","0","0","0","0","0"
"2006","Chestermere, Alberta, Royal Canadian Mounted Police, municipal","48005","Other prostitution","0","0","0","0","0","0","0","0","0","0","0","0","0","0"
"2007","Chestermere, Alberta, Royal Canadian Mounted Police, municipal","48005","Other prostitution","0","0","0","0","0","0","0","0","0","0","0","0","0","0"
"2008","Chestermere, Alberta, Royal Canadian Mounted Police, municipal","48005","Other prostitution","0","0","0","0","0","0","0","0","0","0","0","0","0","0"
"2009","Chestermere, Alberta, Royal Canadian Mounted Police, municipal","48005","Other prostitution","0","0","0","0","0","0","0","0","0","0","0","0","0","0"
"2010","Chestermere, Alberta, Royal Canadian Mounted Police, municipal","48005","Other prostitution","0","0","0","0","0","0","0","0","0","0","0","0","0","0"
"2011","Chestermere, Alberta, Royal Canadian Mounted Police, municipal","48005","Other prostitution","0","0","0","0","0","0","0","0","0","0","0","0","0","0"
"2012","Chestermere, Alberta, Royal Canadian Mounted Police, municipal","48005","Other prostitution","0","0","0","0","0","0","0","0","0","0","0","0","0","0"
"2013","Chestermere, Alberta, Royal Canadian Mounted Police, municipal","48005","Other prostitution","0","0","0","0","0","0","0","0","0","0","0","0","0","0"
"2014","Chestermere, Alberta, Royal Canadian Mounted Police, municipal","48005","Other prostitution","0","0","0","0","0","0","0","0","0","0","0","0","0","0"
"2015","Chestermere, Alberta, Royal Canadian Mounted Police, municipal","48005","Other prostitution","0","0","0","0","0","0","0","0","0","0","0","0","0","0"
"2016","Chestermere, Alberta, Royal Canadian Mounted Police, municipal","48005","Other prostitution","0","0","0","0","0","0","0","0","0","0","0","0","0","0"
"2012","Chestermere, Alberta, Royal Canadian Mounted Police, municipal","48005","Communicating to provide sexual services for consideration","0","0","0","0","0","0","0","0","0","0","0","0","0","0"
"2013","Chestermere, Alberta, Royal Canadian Mounted Police, municipal","48005","Communicating to provide sexual services for consideration","0","0","0","0","0","0","0","0","0","0","0","0","0","0"
"2014","Chestermere, Alberta, Royal Canadian Mounted Police, municipal","48005","Communicating to provide sexual services for consideration","0","0","0","0","0","0","0","0","0","0","0","0","0","0"
"2015","Chestermere, Alberta, Royal Canadian Mounted Police, municipal","48005","Communicating to provide sexual services for consideration","0","0","0","0","0","0","0","0","0","0","0","0","0","0"
"2016","Chestermere, Alberta, Royal Canadian Mounted Police, municipal","48005","Communicating to provide sexual services for consideration","0","0","0","0","0","0","0","0","0","0","0","0","0","0"
"2012","Chestermere, Alberta, Royal Canadian Mounted Police, municipal","48005","Stopping or impeding traffic for the purpose of offering, providing or obtaining sexual services for consideration","0","0","0","0","0","0","0","0","0","0","0","0","0","0"
"2013","Chestermere, Alberta, Royal Canadian Mounted Police, municipal","48005","Stopping or impeding traffic for the purpose of offering, providing or obtaining sexual services for consideration","0","0","0","0","0","0","0","0","0","0","0","0","0","0"
"2014","Chestermere, Alberta, Royal Canadian Mounted Police, municipal","48005","Stopping or impeding traffic for the purpose of offering, providing or obtaining sexual services for consideration","0","0","0","0","0","0","0","0","0","0","0","0","0","0"
"2015","Chestermere, Alberta, Royal Canadian Mounted Police, municipal","48005","Stopping or impeding traffic for the purpose of offering, providing or obtaining sexual services for consideration","0","0","0","0","0","0","0","0","0","0","0","0","0","0"
"2016","Chestermere, Alberta, Royal Canadian Mounted Police, municipal","48005","Stopping or impeding traffic for the purpose of offering, providing or obtaining sexual services for consideration","0","0","0","0","0","0","0","0","0","0","0","0","0","0"
"1998","Chestermere, Alberta, Royal Canadian Mounted Police, municipal","48005","Disturb the peace","0","0","0","0","0","0","0","0","0","0","0","0","0","0"
"1999","Chestermere, Alberta, Royal Canadian Mounted Police, municipal","48005","Disturb the peace","0","0","0","0","0","0","0","0","0","0","0","0","0","0"
"2000","Chestermere, Alberta, Royal Canadian Mounted Police, municipal","48005","Disturb the peace","0","0","0","0","0","0","0","0","0","0","0","0","0","0"
"2001","Chestermere, Alberta, Royal Canadian Mounted Police, municipal","48005","Disturb the peace","0","0","0","0","0","0","0","0","0","0","0","0","0","0"
"2002","Chestermere, Alberta, Royal Canadian Mounted Police, municipal","48005","Disturb the peace","0","0","0","0","0","0","0","0","0","0","0","0","0","0"
"2003","Chestermere, Alberta, Royal Canadian Mounted Police, municipal","48005","Disturb the peace","0","0","0","0","0","0","0","0","0","0","0","0","0","0"
"2004","Chestermere, Alberta, Royal Canadian Mounted Police, municipal","48005","Disturb the peace","0","0","0","0","0","0","0","0","0","0","0","0","0","0"
"2005","Chestermere, Alberta, Royal Canadian Mounted Police, municipal","48005","Disturb the peace","22","1","16","0","253.98","63.97","56.56","0","0","17","4","4","0","0"
"2006","Chestermere, Alberta, Royal Canadian Mounted Police, municipal","48005","Disturb the peace","129","3","74","388.84","1241.58","40.55","47.54","98.52","1280.79","77","3","4","1","13"
"2007","Chestermere, Alberta, Royal Canadian Mounted Police, municipal","48005","Disturb the peace","153","1","111","8.46","1346.59","12.32","10.85","0","2461.26","112","1","1","0","27"
"2008","Chestermere, Alberta, Royal Canadian Mounted Police, municipal","48005","Disturb the peace","146","0","95","-12.37","1179.99","0","0","0","2716.47","95","0","0","0","32"
"2009","Chestermere, Alberta, Royal Canadian Mounted Police, municipal","48005","Disturb the peace","122","0","87","-23.03","908.21","0","0","0","1110.23","87","0","0","0","14"
"2010","Chestermere, Alberta, Royal Canadian Mounted Police, municipal","48005","Disturb the peace","56","0","35","-57.23","388.43","0","0","0","1325.48","35","0","0","0","18"
"2011","Chestermere, Alberta, Royal Canadian Mounted Police, municipal","48005","Disturb the peace","42","0","26","-29.72","272.98","0","0","0","434.78","26","0","0","0","6"
"2012","Chestermere, Alberta, Royal Canadian Mounted Police, municipal","48005","Disturb the peace","38","0","27","-12.16","239.79","0","0","0","936.6","27","0","0","0","13"
"2013","Chestermere, Alberta, Royal Canadian Mounted Police, municipal","48005","Disturb the peace","56","1","34","42.41","341.48","8.46","7.57","0","573.89","35","1","1","0","8"
"2014","Chestermere, Alberta, Royal Canadian Mounted Police, municipal","48005","Disturb the peace","82","1","42","41.79","484.2","0","7.33","71.48","857.76","43","0","1","1","12"
"2015","Chestermere, Alberta, Royal Canadian Mounted Police, municipal","48005","Disturb the peace","48","2","30","-42.75","277.22","15.99","14.37","0","141.54","32","2","2","0","2"
"2016","Chestermere, Alberta, Royal Canadian Mounted Police, municipal","48005","Disturb the peace","65","1","39","32.11","366.24","7.81","7.02","0","207.61","40","1","1","0","3"
"1998","Chestermere, Alberta, Royal Canadian Mounted Police, municipal","48005","Total administration of justice violations","0","0","0","0","0","0","0","0","0","0","0","0","0","0"
"1999","Chestermere, Alberta, Royal Canadian Mounted Police, municipal","48005","Total administration of justice violations","0","0","0","0","0","0","0","0","0","0","0","0","0","0"
"2000","Chestermere, Alberta, Royal Canadian Mounted Police, municipal","48005","Total administration of justice violations","0","0","0","0","0","0","0","0","0","0","0","0","0","0"
"2001","Chestermere, Alberta, Royal Canadian Mounted Police, municipal","48005","Total administration of justice violations","0","0","0","0","0","0","0","0","0","0","0","0","0","0"
"2002","Chestermere, Alberta, Royal Canadian Mounted Police, municipal","48005","Total administration of justice violations","0","0","0","0","0","0","0","0","0","0","0","0","0","0"
"2003","Chestermere, Alberta, Royal Canadian Mounted Police, municipal","48005","Total administration of justice violations","0","0","0","0","0","0","0","0","0","0","0","0","0","0"
"2004","Chestermere, Alberta, Royal Canadian Mounted Police, municipal","48005","Total administration of justice violations","0","0","0","0","0","0","0","0","0","0","0","0","0","0"
"2005","Chestermere, Alberta, Royal Canadian Mounted Police, municipal","48005","Total administration of justice violations","15","12","1","0","173.17","95.95","113.12","244.2","0","13","6","8","2","0"
"2006","Chestermere, Alberta, Royal Canadian Mounted Police, municipal","48005","Total administration of justice violations","30","8","16","66.74","288.74","54.06","83.19","295.57","295.57","24","4","7","3","3"
"2007","Chestermere, Alberta, Royal Canadian Mounted Police, municipal","48005","Total administration of justice violations","26","16","8","-20.75","228.83","98.56","119.38","273.47","0","24","8","11","3","0"
"2008","Chestermere, Alberta, Royal Canadian Mounted Police, municipal","48005","Total administration of justice violations","26","13","12","-8.17","210.13","135.39","129.47","84.89","254.67","25","12","13","1","3"
"2009","Chestermere, Alberta, Royal Canadian Mounted Police, municipal","48005","Total administration of justice violations","33","21","11","16.91","245.66","175.97","183.12","237.91","237.91","32","17","20","3","3"
"2010","Chestermere, Alberta, Royal Canadian Mounted Police, municipal","48005","Total administration of justice violations","19","13","4","-46.35","131.79","86.9","93.9","147.28","0","17","9","11","2","0"
"2011","Chestermere, Alberta, Royal Canadian Mounted Police, municipal","48005","Total administration of justice violations","28","22","4","38.09","181.98","154","161.04","217.39","362.32","26","17","20","3","5"
"2012","Chestermere, Alberta, Royal Canadian Mounted Police, municipal","48005","Total administration of justice violations","17","13","4","-41.05","107.28","70.23","86.08","216.14","0","17","8","11","3","0"
"2013","Chestermere, Alberta, Royal Canadian Mounted Police, municipal","48005","Total administration of justice violations","18","14","3","2.32","109.76","84.58","75.66","0","0","17","10","10","0","0"
"2014","Chestermere, Alberta, Royal Canadian Mounted Police, municipal","48005","Total administration of justice violations","18","15","3","-3.17","106.29","73.52","65.98","0","214.44","18","9","9","0","3"
"2015","Chestermere, Alberta, Royal Canadian Mounted Police, municipal","48005","Total administration of justice violations","34","26","7","84.74","196.36","223.87","201.15","0","70.77","33","28","28","0","1"
"2016","Chestermere, Alberta, Royal Canadian Mounted Police, municipal","48005","Total administration of justice violations","14","8","6","-59.83","78.88","70.33","63.2","0","0","14","9","9","0","0"
"1998","Chestermere, Alberta, Royal Canadian Mounted Police, municipal","48005","Fail to comply with order","0","0","0","0","0","0","0","0","0","0","0","0","0","0"
"1999","Chestermere, Alberta, Royal Canadian Mounted Police, municipal","48005","Fail to comply with order","0","0","0","0","0","0","0","0","0","0","0","0","0","0"
"2000","Chestermere, Alberta, Royal Canadian Mounted Police, municipal","48005","Fail to comply with order","0","0","0","0","0","0","0","0","0","0","0","0","0","0"
"2001","Chestermere, Alberta, Royal Canadian Mounted Police, municipal","48005","Fail to comply with order","0","0","0","0","0","0","0","0","0","0","0","0","0","0"
"2002","Chestermere, Alberta, Royal Canadian Mounted Police, municipal","48005","Fail to comply with order","0","0","0","0","0","0","0","0","0","0","0","0","0","0"
"2003","Chestermere, Alberta, Royal Canadian Mounted Police, municipal","48005","Fail to comply with order","0","0","0","0","0","0","0","0","0","0","0","0","0","0"
"2004","Chestermere, Alberta, Royal Canadian Mounted Police, municipal","48005","Fail to comply with order","0","0","0","0","0","0","0","0","0","0","0","0","0","0"
"2005","Chestermere, Alberta, Royal Canadian Mounted Police, municipal","48005","Fail to comply with order","7","7","0","0","80.81","47.98","56.56","122.1","0","7","3","4","1","0"
"2006","Chestermere, Alberta, Royal Canadian Mounted Police, municipal","48005","Fail to comply with order","8","5","3","-4.72","77","54.06","71.31","197.04","197.04","8","4","6","2","2"
"2007","Chestermere, Alberta, Royal Canadian Mounted Police, municipal","48005","Fail to comply with order","18","11","6","105.75","158.42","73.92","86.82","182.32","0","17","6","8","2","0"
"2008","Chestermere, Alberta, Royal Canadian Mounted Police, municipal","48005","Fail to comply with order","17","8","9","-13.27","137.4","90.26","89.63","84.89","169.78","17","8","9","1","2"
"2009","Chestermere, Alberta, Royal Canadian Mounted Police, municipal","48005","Fail to comply with order","21","14","7","13.78","156.33","113.86","128.18","237.91","158.6","21","11","14","3","2"
"2010","Chestermere, Alberta, Royal Canadian Mounted Police, municipal","48005","Fail to comply with order","14","11","2","-37.88","97.11","77.24","76.82","73.64","0","13","8","9","1","0"
"2011","Chestermere, Alberta, Royal Canadian Mounted Police, municipal","48005","Fail to comply with order","20","18","1","33.86","129.99","117.76","128.83","217.39","144.93","19","13","16","3","2"
"2012","Chestermere, Alberta, Royal Canadian Mounted Police, municipal","48005","Fail to comply with order","14","11","4","-32.04","88.34","52.67","70.43","216.14","0","15","6","9","3","0"
"2013","Chestermere, Alberta, Royal Canadian Mounted Police, municipal","48005","Fail to comply with order","11","9","2","-24.07","67.08","59.21","52.96","0","0","11","7","7","0","0"
"2014","Chestermere, Alberta, Royal Canadian Mounted Police, municipal","48005","Fail to comply with order","8","7","1","-29.57","47.24","49.02","43.99","0","71.48","8","6","6","0","1"
"2015","Chestermere, Alberta, Royal Canadian Mounted Police, municipal","48005","Fail to comply with order","30","23","6","266.77","173.26","199.89","179.6","0","70.77","29","25","25","0","1"
"2016","Chestermere, Alberta, Royal Canadian Mounted Police, municipal","48005","Fail to comply with order","9","6","3","-70.73","50.71","54.7","49.15","0","0","9","7","7","0","0"
"1998","Chestermere, Alberta, Royal Canadian Mounted Police, municipal","48005","Escape or helps to escape from lawful custody","0","0","0","0","0","0","0","0","0","0","0","0","0","0"
"1999","Chestermere, Alberta, Royal Canadian Mounted Police, municipal","48005","Escape or helps to escape from lawful custody","0","0","0","0","0","0","0","0","0","0","0","0","0","0"
"2000","Chestermere, Alberta, Royal Canadian Mounted Police, municipal","48005","Escape or helps to escape from lawful custody","0","0","0","0","0","0","0","0","0","0","0","0","0","0"
"2001","Chestermere, Alberta, Royal Canadian Mounted Police, municipal","48005","Escape or helps to escape from lawful custody","0","0","0","0","0","0","0","0","0","0","0","0","0","0"
"2002","Chestermere, Alberta, Royal Canadian Mounted Police, municipal","48005","Escape or helps to escape from lawful custody","0","0","0","0","0","0","0","0","0","0","0","0","0","0"
"2003","Chestermere, Alberta, Royal Canadian Mounted Police, municipal","48005","Escape or helps to escape from lawful custody","0","0","0","0","0","0","0","0","0","0","0","0","0","0"
"2004","Chestermere, Alberta, Royal Canadian Mounted Police, municipal","48005","Escape or helps to escape from lawful custody","0","0","0","0","0","0","0","0","0","0","0","0","0","0"
"2005","Chestermere, Alberta, Royal Canadian Mounted Police, municipal","48005","Escape or helps to escape from lawful custody","0","0","0","0","0","0","0","0","0","0","0","0","0","0"
"2006","Chestermere, Alberta, Royal Canadian Mounted Police, municipal","48005","Escape or helps to escape from lawful custody","0","0","0","0","0","0","0","0","0","0","0","0","0","0"
"2007","Chestermere, Alberta, Royal Canadian Mounted Police, municipal","48005","Escape or helps to escape from lawful custody","1","1","0","0","8.8","0","0","0","0","1","0","0","0","0"
"2008","Chestermere, Alberta, Royal Canadian Mounted Police, municipal","48005","Escape or helps to escape from lawful custody","0","0","0","-100","0","0","0","0","0","0","0","0","0","0"
"2009","Chestermere, Alberta, Royal Canadian Mounted Police, municipal","48005","Escape or helps to escape from lawful custody","0","0","0","0","0","0","0","0","0","0","0","0","0","0"
"2010","Chestermere, Alberta, Royal Canadian Mounted Police, municipal","48005","Escape or helps to escape from lawful custody","0","0","0","0","0","0","0","0","0","0","0","0","0","0"
"2011","Chestermere, Alberta, Royal Canadian Mounted Police, municipal","48005","Escape or helps to escape from lawful custody","0","0","0","0","0","0","0","0","0","0","0","0","0","0"
"2012","Chestermere, Alberta, Royal Canadian Mounted Police, municipal","48005","Escape or helps to escape from lawful custody","0","0","0","0","0","0","0","0","0","0","0","0","0","0"
"2013","Chestermere, Alberta, Royal Canadian Mounted Police, municipal","48005","Escape or helps to escape from lawful custody","0","0","0","0","0","0","0","0","0","0","0","0","0","0"
"2014","Chestermere, Alberta, Royal Canadian Mounted Police, municipal","48005","Escape or helps to escape from lawful custody","0","0","0","0","0","0","0","0","0","0","0","0","0","0"
"2015","Chestermere, Alberta, Royal Canadian Mounted Police, municipal","48005","Escape or helps to escape from lawful custody","0","0","0","0","0","0","0","0","0","0","0","0","0","0"
"2016","Chestermere, Alberta, Royal Canadian Mounted Police, municipal","48005","Escape or helps to escape from lawful custody","0","0","0","0","0","0","0","0","0","0","0","0","0","0"
"1998","Chestermere, Alberta, Royal Canadian Mounted Police, municipal","48005","Prisoner unlawfully at large","0","0","0","0","0","0","0","0","0","0","0","0","0","0"
"1999","Chestermere, Alberta, Royal Canadian Mounted Police, municipal","48005","Prisoner unlawfully at large","0","0","0","0","0","0","0","0","0","0","0","0","0","0"
"2000","Chestermere, Alberta, Royal Canadian Mounted Police, municipal","48005","Prisoner unlawfully at large","0","0","0","0","0","0","0","0","0","0","0","0","0","0"
"2001","Chestermere, Alberta, Royal Canadian Mounted Police, municipal","48005","Prisoner unlawfully at large","0","0","0","0","0","0","0","0","0","0","0","0","0","0"
"2002","Chestermere, Alberta, Royal Canadian Mounted Police, municipal","48005","Prisoner unlawfully at large","0","0","0","0","0","0","0","0","0","0","0","0","0","0"
"2003","Chestermere, Alberta, Royal Canadian Mounted Police, municipal","48005","Prisoner unlawfully at large","0","0","0","0","0","0","0","0","0","0","0","0","0","0"
"2004","Chestermere, Alberta, Royal Canadian Mounted Police, municipal","48005","Prisoner unlawfully at large","0","0","0","0","0","0","0","0","0","0","0","0","0","0"
"2005","Chestermere, Alberta, Royal Canadian Mounted Police, municipal","48005","Prisoner unlawfully at large","0","0","0","0","0","0","0","0","0","0","0","0","0","0"
"2006","Chestermere, Alberta, Royal Canadian Mounted Police, municipal","48005","Prisoner unlawfully at large","0","0","0","0","0","0","0","0","0","0","0","0","0","0"
"2007","Chestermere, Alberta, Royal Canadian Mounted Police, municipal","48005","Prisoner unlawfully at large","0","0","0","0","0","0","0","0","0","0","0","0","0","0"
"2008","Chestermere, Alberta, Royal Canadian Mounted Police, municipal","48005","Prisoner unlawfully at large","0","0","0","0","0","0","0","0","0","0","0","0","0","0"
"2009","Chestermere, Alberta, Royal Canadian Mounted Police, municipal","48005","Prisoner unlawfully at large","0","0","0","0","0","0","0","0","0","0","0","0","0","0"
"2010","Chestermere, Alberta, Royal Canadian Mounted Police, municipal","48005","Prisoner unlawfully at large","0","0","0","0","0","0","0","0","0","0","0","0","0","0"
"2011","Chestermere, Alberta, Royal Canadian Mounted Police, municipal","48005","Prisoner unlawfully at large","0","0","0","0","0","0","0","0","0","0","0","0","0","0"
"2012","Chestermere, Alberta, Royal Canadian Mounted Police, municipal","48005","Prisoner unlawfully at large","0","0","0","0","0","0","0","0","0","0","0","0","0","0"
"2013","Chestermere, Alberta, Royal Canadian Mounted Police, municipal","48005","Prisoner unlawfully at large","0","0","0","0","0","0","0","0","0","0","0","0","0","0"
"2014","Chestermere, Alberta, Royal Canadian Mounted Police, municipal","48005","Prisoner unlawfully at large","0","0","0","0","0","0","0","0","0","0","0","0","0","0"
"2015","Chestermere, Alberta, Royal Canadian Mounted Police, municipal","48005","Prisoner unlawfully at large","0","0","0","0","0","0","0","0","0","0","0","0","0","0"
"2016","Chestermere, Alberta, Royal Canadian Mounted Police, municipal","48005","Prisoner unlawfully at large","0","0","0","0","0","0","0","0","0","0","0","0","0","0"
"1998","Chestermere, Alberta, Royal Canadian Mounted Police, municipal","48005","Fail to appear","0","0","0","0","0","0","0","0","0","0","0","0","0","0"
"1999","Chestermere, Alberta, Royal Canadian Mounted Police, municipal","48005","Fail to appear","0","0","0","0","0","0","0","0","0","0","0","0","0","0"
"2000","Chestermere, Alberta, Royal Canadian Mounted Police, municipal","48005","Fail to appear","0","0","0","0","0","0","0","0","0","0","0","0","0","0"
"2001","Chestermere, Alberta, Royal Canadian Mounted Police, municipal","48005","Fail to appear","0","0","0","0","0","0","0","0","0","0","0","0","0","0"
"2002","Chestermere, Alberta, Royal Canadian Mounted Police, municipal","48005","Fail to appear","0","0","0","0","0","0","0","0","0","0","0","0","0","0"
"2003","Chestermere, Alberta, Royal Canadian Mounted Police, municipal","48005","Fail to appear","0","0","0","0","0","0","0","0","0","0","0","0","0","0"
"2004","Chestermere, Alberta, Royal Canadian Mounted Police, municipal","48005","Fail to appear","0","0","0","0","0","0","0","0","0","0","0","0","0","0"
"2005","Chestermere, Alberta, Royal Canadian Mounted Police, municipal","48005","Fail to appear","2","2","0","0","23.09","15.99","14.14","0","0","2","1","1","0","0"
"2006","Chestermere, Alberta, Royal Canadian Mounted Police, municipal","48005","Fail to appear","3","2","1","25.05","28.87","0","0","0","0","3","0","0","0","0"
"2007","Chestermere, Alberta, Royal Canadian Mounted Police, municipal","48005","Fail to appear","2","2","0","-39.04","17.6","12.32","21.71","91.16","0","2","1","2","1","0"
"2008","Chestermere, Alberta, Royal Canadian Mounted Police, municipal","48005","Fail to appear","2","2","0","-8.17","16.16","22.57","19.92","0","0","2","2","2","0","0"
"2009","Chestermere, Alberta, Royal Canadian Mounted Police, municipal","48005","Fail to appear","2","2","0","-7.89","14.89","10.35","9.16","0","0","2","1","1","0","0"
"2010","Chestermere, Alberta, Royal Canadian Mounted Police, municipal","48005","Fail to appear","0","0","0","-100","0","0","0","0","0","0","0","0","0","0"
"2011","Chestermere, Alberta, Royal Canadian Mounted Police, municipal","48005","Fail to appear","1","1","0","0","6.5","9.06","8.05","0","0","1","1","1","0","0"
"2012","Chestermere, Alberta, Royal Canadian Mounted Police, municipal","48005","Fail to appear","0","0","0","-100","0","0","0","0","0","0","0","0","0","0"
"2013","Chestermere, Alberta, Royal Canadian Mounted Police, municipal","48005","Fail to appear","3","3","0","0","18.29","8.46","7.57","0","0","3","1","1","0","0"
"2014","Chestermere, Alberta, Royal Canadian Mounted Police, municipal","48005","Fail to appear","6","6","0","93.67","35.43","8.17","7.33","0","0","6","1","1","0","0"
"2015","Chestermere, Alberta, Royal Canadian Mounted Police, municipal","48005","Fail to appear","0","0","0","-100","0","0","0","0","0","0","0","0","0","0"
"2016","Chestermere, Alberta, Royal Canadian Mounted Police, municipal","48005","Fail to appear","0","0","0","0","0","0","0","0","0","0","0","0","0","0"
"1998","Chestermere, Alberta, Royal Canadian Mounted Police, municipal","48005","Breach of probation","0","0","0","0","0","0","0","0","0","0","0","0","0","0"
"1999","Chestermere, Alberta, Royal Canadian Mounted Police, municipal","48005","Breach of probation","0","0","0","0","0","0","0","0","0","0","0","0","0","0"
"2000","Chestermere, Alberta, Royal Canadian Mounted Police, municipal","48005","Breach of probation","0","0","0","0","0","0","0","0","0","0","0","0","0","0"
"2001","Chestermere, Alberta, Royal Canadian Mounted Police, municipal","48005","Breach of probation","0","0","0","0","0","0","0","0","0","0","0","0","0","0"
"2002","Chestermere, Alberta, Royal Canadian Mounted Police, municipal","48005","Breach of probation","0","0","0","0","0","0","0","0","0","0","0","0","0","0"
"2003","Chestermere, Alberta, Royal Canadian Mounted Police, municipal","48005","Breach of probation","0","0","0","0","0","0","0","0","0","0","0","0","0","0"
"2004","Chestermere, Alberta, Royal Canadian Mounted Police, municipal","48005","Breach of probation","0","0","0","0","0","0","0","0","0","0","0","0","0","0"
"2005","Chestermere, Alberta, Royal Canadian Mounted Police, municipal","48005","Breach of probation","5","3","1","0","57.72","31.98","42.42","122.1","0","4","2","3","1","0"
"2006","Chestermere, Alberta, Royal Canadian Mounted Police, municipal","48005","Breach of probation","16","0","11","166.78","153.99","0","0","0","0","11","0","0","0","0"
"2007","Chestermere, Alberta, Royal Canadian Mounted Police, municipal","48005","Breach of probation","2","2","0","-88.57","17.6","12.32","10.85","0","0","2","1","1","0","0"
"2008","Chestermere, Alberta, Royal Canadian Mounted Police, municipal","48005","Breach of probation","2","1","1","-8.17","16.16","11.28","9.96","0","0","2","1","1","0","0"
"2009","Chestermere, Alberta, Royal Canadian Mounted Police, municipal","48005","Breach of probation","7","5","2","222.38","52.11","51.75","45.78","0","0","7","5","5","0","0"
"2010","Chestermere, Alberta, Royal Canadian Mounted Police, municipal","48005","Breach of probation","1","1","0","-86.69","6.94","9.66","8.54","0","0","1","1","1","0","0"
"2011","Chestermere, Alberta, Royal Canadian Mounted Police, municipal","48005","Breach of probation","2","2","0","87.4","13","18.12","16.1","0","0","2","2","2","0","0"
"2012","Chestermere, Alberta, Royal Canadian Mounted Police, municipal","48005","Breach of probation","1","1","0","-51.45","6.31","8.78","7.83","0","0","1","1","1","0","0"
"2013","Chestermere, Alberta, Royal Canadian Mounted Police, municipal","48005","Breach of probation","3","2","1","189.9","18.29","16.92","15.13","0","0","3","2","2","0","0"
"2014","Chestermere, Alberta, Royal Canadian Mounted Police, municipal","48005","Breach of probation","2","1","1","-35.44","11.81","8.17","7.33","0","71.48","2","1","1","0","1"
"2015","Chestermere, Alberta, Royal Canadian Mounted Police, municipal","48005","Breach of probation","3","3","0","46.71","17.33","23.99","21.55","0","0","3","3","3","0","0"
"2016","Chestermere, Alberta, Royal Canadian Mounted Police, municipal","48005","Breach of probation","2","1","1","-34.96","11.27","7.81","7.02","0","0","2","1","1","0","0"
"1998","Chestermere, Alberta, Royal Canadian Mounted Police, municipal","48005","Other violations against the administration of law and justice (Part IV Criminal Code)","0","0","0","0","0","0","0","0","0","0","0","0","0","0"
"1999","Chestermere, Alberta, Royal Canadian Mounted Police, municipal","48005","Other violations against the administration of law and justice (Part IV Criminal Code)","0","0","0","0","0","0","0","0","0","0","0","0","0","0"
"2000","Chestermere, Alberta, Royal Canadian Mounted Police, municipal","48005","Other violations against the administration of law and justice (Part IV Criminal Code)","0","0","0","0","0","0","0","0","0","0","0","0","0","0"
"2001","Chestermere, Alberta, Royal Canadian Mounted Police, municipal","48005","Other violations against the administration of law and justice (Part IV Criminal Code)","0","0","0","0","0","0","0","0","0","0","0","0","0","0"
"2002","Chestermere, Alberta, Royal Canadian Mounted Police, municipal","48005","Other violations against the administration of law and justice (Part IV Criminal Code)","0","0","0","0","0","0","0","0","0","0","0","0","0","0"
"2003","Chestermere, Alberta, Royal Canadian Mounted Police, municipal","48005","Other violations against the administration of law and justice (Part IV Criminal Code)","0","0","0","0","0","0","0","0","0","0","0","0","0","0"
"2004","Chestermere, Alberta, Royal Canadian Mounted Police, municipal","48005","Other violations against the administration of law and justice (Part IV Criminal Code)","0","0","0","0","0","0","0","0","0","0","0","0","0","0"
"2005","Chestermere, Alberta, Royal Canadian Mounted Police, municipal","48005","Other violations against the administration of law and justice (Part IV Criminal Code)","1","0","0","0","11.54","0","0","0","0","0","0","0","0","0"
"2006","Chestermere, Alberta, Royal Canadian Mounted Police, municipal","48005","Other violations against the administration of law and justice (Part IV Criminal Code)","3","1","1","150.11","28.87","0","11.88","98.52","98.52","2","0","1","1","1"
"2007","Chestermere, Alberta, Royal Canadian Mounted Police, municipal","48005","Other violations against the administration of law and justice (Part IV Criminal Code)","3","0","2","-8.55","26.4","0","0","0","0","2","0","0","0","0"
"2008","Chestermere, Alberta, Royal Canadian Mounted Police, municipal","48005","Other violations against the administration of law and justice (Part IV Criminal Code)","5","2","2","53.05","40.41","11.28","9.96","0","84.89","4","1","1","0","1"
"2009","Chestermere, Alberta, Royal Canadian Mounted Police, municipal","48005","Other violations against the administration of law and justice (Part IV Criminal Code)","3","0","2","-44.73","22.33","0","0","0","79.3","2","0","0","0","1"
"2010","Chestermere, Alberta, Royal Canadian Mounted Police, municipal","48005","Other violations against the administration of law and justice (Part IV Criminal Code)","4","1","2","24.23","27.75","0","8.54","73.64","0","3","0","1","1","0"
"2011","Chestermere, Alberta, Royal Canadian Mounted Police, municipal","48005","Other violations against the administration of law and justice (Part IV Criminal Code)","5","1","3","17.13","32.5","9.06","8.05","0","217.39","4","1","1","0","3"
"2012","Chestermere, Alberta, Royal Canadian Mounted Police, municipal","48005","Other violations against the administration of law and justice (Part IV Criminal Code)","2","1","0","-61.16","12.62","8.78","7.83","0","0","1","1","1","0","0"
"2013","Chestermere, Alberta, Royal Canadian Mounted Police, municipal","48005","Other violations against the administration of law and justice (Part IV Criminal Code)","1","0","0","-51.68","6.1","0","0","0","0","0","0","0","0","0"
"2014","Chestermere, Alberta, Royal Canadian Mounted Police, municipal","48005","Other violations against the administration of law and justice (Part IV Criminal Code)","2","1","1","93.67","11.81","8.17","7.33","0","71.48","2","1","1","0","1"
"2015","Chestermere, Alberta, Royal Canadian Mounted Police, municipal","48005","Other violations against the administration of law and justice (Part IV Criminal Code)","1","0","1","-51.1","5.78","0","0","0","0","1","0","0","0","0"
"2016","Chestermere, Alberta, Royal Canadian Mounted Police, municipal","48005","Other violations against the administration of law and justice (Part IV Criminal Code)","3","1","2","192.68","16.9","7.81","7.02","0","0","3","1","1","0","0"
"1998","Chestermere, Alberta, Royal Canadian Mounted Police, municipal","48005","Total other violations","0","0","0","0","0","0","0","0","0","0","0","0","0","0"
"1999","Chestermere, Alberta, Royal Canadian Mounted Police, municipal","48005","Total other violations","0","0","0","0","0","0","0","0","0","0","0","0","0","0"
"2000","Chestermere, Alberta, Royal Canadian Mounted Police, municipal","48005","Total other violations","0","0","0","0","0","0","0","0","0","0","0","0","0","0"
"2001","Chestermere, Alberta, Royal Canadian Mounted Police, municipal","48005","Total other violations","0","0","0","0","0","0","0","0","0","0","0","0","0","0"
"2002","Chestermere, Alberta, Royal Canadian Mounted Police, municipal","48005","Total other violations","0","0","0","0","0","0","0","0","0","0","0","0","0","0"
"2003","Chestermere, Alberta, Royal Canadian Mounted Police, municipal","48005","Total other violations","0","0","0","0","0","0","0","0","0","0","0","0","0","0"
"2004","Chestermere, Alberta, Royal Canadian Mounted Police, municipal","48005","Total other violations","0","0","0","0","0","0","0","0","0","0","0","0","0","0"
"2005","Chestermere, Alberta, Royal Canadian Mounted Police, municipal","48005","Total other violations","4","2","1","0","46.18","31.98","56.56","244.2","0","3","2","4","2","0"
"2006","Chestermere, Alberta, Royal Canadian Mounted Police, municipal","48005","Total other violations","13","2","6","170.95","125.12","13.52","11.88","0","98.52","8","1","1","0","1"
"2007","Chestermere, Alberta, Royal Canadian Mounted Police, municipal","48005","Total other violations","28","2","14","96.96","246.44","12.32","10.85","0","546.95","16","1","1","0","6"
"2008","Chestermere, Alberta, Royal Canadian Mounted Police, municipal","48005","Total other violations","35","6","12","14.79","282.87","56.41","59.76","84.89","509.34","18","5","6","1","6"
"2009","Chestermere, Alberta, Royal Canadian Mounted Police, municipal","48005","Total other violations","21","3","11","-44.73","156.33","31.05","27.47","0","317.21","14","3","3","0","4"
"2010","Chestermere, Alberta, Royal Canadian Mounted Police, municipal","48005","Total other violations","19","2","7","-15.7","131.79","9.66","17.07","73.64","147.28","9","1","2","1","2"
"2011","Chestermere, Alberta, Royal Canadian Mounted Police, municipal","48005","Total other violations","9","4","3","-55.61","58.49","27.18","32.21","72.46","72.46","7","3","4","1","1"
"2012","Chestermere, Alberta, Royal Canadian Mounted Police, municipal","48005","Total other violations","14","4","4","51.03","88.34","43.89","39.13","0","72.05","8","5","5","0","1"
"2013","Chestermere, Alberta, Royal Canadian Mounted Police, municipal","48005","Total other violations","7","1","2","-51.68","42.69","8.46","7.57","0","0","3","1","1","0","0"
"2014","Chestermere, Alberta, Royal Canadian Mounted Police, municipal","48005","Total other violations","9","2","3","24.5","53.14","16.34","14.66","0","0","5","2","2","0","0"
"2015","Chestermere, Alberta, Royal Canadian Mounted Police, municipal","48005","Total other violations","9","3","0","-2.19","51.98","23.99","21.55","0","0","3","3","3","0","0"
"2016","Chestermere, Alberta, Royal Canadian Mounted Police, municipal","48005","Total other violations","9","0","5","-2.44","50.71","0","0","0","138.41","5","0","0","0","2"
"1998","Chestermere, Alberta, Royal Canadian Mounted Police, municipal","48005","Betting house","0","0","0","0","0","0","0","0","0","0","0","0","0","0"
"1999","Chestermere, Alberta, Royal Canadian Mounted Police, municipal","48005","Betting house","0","0","0","0","0","0","0","0","0","0","0","0","0","0"
"2000","Chestermere, Alberta, Royal Canadian Mounted Police, municipal","48005","Betting house","0","0","0","0","0","0","0","0","0","0","0","0","0","0"
"2001","Chestermere, Alberta, Royal Canadian Mounted Police, municipal","48005","Betting house","0","0","0","0","0","0","0","0","0","0","0","0","0","0"
"2002","Chestermere, Alberta, Royal Canadian Mounted Police, municipal","48005","Betting house","0","0","0","0","0","0","0","0","0","0","0","0","0","0"
"2003","Chestermere, Alberta, Royal Canadian Mounted Police, municipal","48005","Betting house","0","0","0","0","0","0","0","0","0","0","0","0","0","0"
"2004","Chestermere, Alberta, Royal Canadian Mounted Police, municipal","48005","Betting house","0","0","0","0","0","0","0","0","0","0","0","0","0","0"
"2005","Chestermere, Alberta, Royal Canadian Mounted Police, municipal","48005","Betting house","0","0","0","0","0","0","0","0","0","0","0","0","0","0"
"2006","Chestermere, Alberta, Royal Canadian Mounted Police, municipal","48005","Betting house","0","0","0","0","0","0","0","0","0","0","0","0","0","0"
"2007","Chestermere, Alberta, Royal Canadian Mounted Police, municipal","48005","Betting house","0","0","0","0","0","0","0","0","0","0","0","0","0","0"
"2008","Chestermere, Alberta, Royal Canadian Mounted Police, municipal","48005","Betting house","0","0","0","0","0","0","0","0","0","0","0","0","0","0"
"2009","Chestermere, Alberta, Royal Canadian Mounted Police, municipal","48005","Betting house","0","0","0","0","0","0","0","0","0","0","0","0","0","0"
"2010","Chestermere, Alberta, Royal Canadian Mounted Police, municipal","48005","Betting house","0","0","0","0","0","0","0","0","0","0","0","0","0","0"
"2011","Chestermere, Alberta, Royal Canadian Mounted Police, municipal","48005","Betting house","0","0","0","0","0","0","0","0","0","0","0","0","0","0"
"2012","Chestermere, Alberta, Royal Canadian Mounted Police, municipal","48005","Betting house","0","0","0","0","0","0","0","0","0","0","0","0","0","0"
"2013","Chestermere, Alberta, Royal Canadian Mounted Police, municipal","48005","Betting house","0","0","0","0","0","0","0","0","0","0","0","0","0","0"
"2014","Chestermere, Alberta, Royal Canadian Mounted Police, municipal","48005","Betting house","0","0","0","0","0","0","0","0","0","0","0","0","0","0"
"2015","Chestermere, Alberta, Royal Canadian Mounted Police, municipal","48005","Betting house","0","0","0","0","0","0","0","0","0","0","0","0","0","0"
"2016","Chestermere, Alberta, Royal Canadian Mounted Police, municipal","48005","Betting house","0","0","0","0","0","0","0","0","0","0","0","0","0","0"
"1998","Chestermere, Alberta, Royal Canadian Mounted Police, municipal","48005","Gaming house","0","0","0","0","0","0","0","0","0","0","0","0","0","0"
"1999","Chestermere, Alberta, Royal Canadian Mounted Police, municipal","48005","Gaming house","0","0","0","0","0","0","0","0","0","0","0","0","0","0"
"2000","Chestermere, Alberta, Royal Canadian Mounted Police, municipal","48005","Gaming house","0","0","0","0","0","0","0","0","0","0","0","0","0","0"
"2001","Chestermere, Alberta, Royal Canadian Mounted Police, municipal","48005","Gaming house","0","0","0","0","0","0","0","0","0","0","0","0","0","0"
"2002","Chestermere, Alberta, Royal Canadian Mounted Police, municipal","48005","Gaming house","0","0","0","0","0","0","0","0","0","0","0","0","0","0"
"2003","Chestermere, Alberta, Royal Canadian Mounted Police, municipal","48005","Gaming house","0","0","0","0","0","0","0","0","0","0","0","0","0","0"
"2004","Chestermere, Alberta, Royal Canadian Mounted Police, municipal","48005","Gaming house","0","0","0","0","0","0","0","0","0","0","0","0","0","0"
"2005","Chestermere, Alberta, Royal Canadian Mounted Police, municipal","48005","Gaming house","0","0","0","0","0","0","0","0","0","0","0","0","0","0"
"2006","Chestermere, Alberta, Royal Canadian Mounted Police, municipal","48005","Gaming house","0","0","0","0","0","0","0","0","0","0","0","0","0","0"
"2007","Chestermere, Alberta, Royal Canadian Mounted Police, municipal","48005","Gaming house","0","0","0","0","0","0","0","0","0","0","0","0","0","0"
"2008","Chestermere, Alberta, Royal Canadian Mounted Police, municipal","48005","Gaming house","0","0","0","0","0","0","0","0","0","0","0","0","0","0"
"2009","Chestermere, Alberta, Royal Canadian Mounted Police, municipal","48005","Gaming house","0","0","0","0","0","0","0","0","0","0","0","0","0","0"
"2010","Chestermere, Alberta, Royal Canadian Mounted Police, municipal","48005","Gaming house","1","0","0","0","6.94","0","0","0","0","0","0","0","0","0"
"2011","Chestermere, Alberta, Royal Canadian Mounted Police, municipal","48005","Gaming house","0","0","0","-100","0","0","0","0","0","0","0","0","0","0"
"2012","Chestermere, Alberta, Royal Canadian Mounted Police, municipal","48005","Gaming house","0","0","0","0","0","0","0","0","0","0","0","0","0","0"
"2013","Chestermere, Alberta, Royal Canadian Mounted Police, municipal","48005","Gaming house","0","0","0","0","0","0","0","0","0","0","0","0","0","0"
"2014","Chestermere, Alberta, Royal Canadian Mounted Police, municipal","48005","Gaming house","0","0","0","0","0","0","0","0","0","0","0","0","0","0"
"2015","Chestermere, Alberta, Royal Canadian Mounted Police, municipal","48005","Gaming house","0","0","0","0","0","0","0","0","0","0","0","0","0","0"
"2016","Chestermere, Alberta, Royal Canadian Mounted Police, municipal","48005","Gaming house","0","0","0","0","0","0","0","0","0","0","0","0","0","0"
"1998","Chestermere, Alberta, Royal Canadian Mounted Police, municipal","48005","Other violations related to gaming and betting","0","0","0","0","0","0","0","0","0","0","0","0","0","0"
"1999","Chestermere, Alberta, Royal Canadian Mounted Police, municipal","48005","Other violations related to gaming and betting","0","0","0","0","0","0","0","0","0","0","0","0","0","0"
"2000","Chestermere, Alberta, Royal Canadian Mounted Police, municipal","48005","Other violations related to gaming and betting","0","0","0","0","0","0","0","0","0","0","0","0","0","0"
"2001","Chestermere, Alberta, Royal Canadian Mounted Police, municipal","48005","Other violations related to gaming and betting","0","0","0","0","0","0","0","0","0","0","0","0","0","0"
"2002","Chestermere, Alberta, Royal Canadian Mounted Police, municipal","48005","Other violations related to gaming and betting","0","0","0","0","0","0","0","0","0","0","0","0","0","0"
"2003","Chestermere, Alberta, Royal Canadian Mounted Police, municipal","48005","Other violations related to gaming and betting","0","0","0","0","0","0","0","0","0","0","0","0","0","0"
"2004","Chestermere, Alberta, Royal Canadian Mounted Police, municipal","48005","Other violations related to gaming and betting","0","0","0","0","0","0","0","0","0","0","0","0","0","0"
"2005","Chestermere, Alberta, Royal Canadian Mounted Police, municipal","48005","Other violations related to gaming and betting","0","0","0","0","0","0","0","0","0","0","0","0","0","0"
"2006","Chestermere, Alberta, Royal Canadian Mounted Police, municipal","48005","Other violations related to gaming and betting","0","0","0","0","0","0","0","0","0","0","0","0","0","0"
"2007","Chestermere, Alberta, Royal Canadian Mounted Police, municipal","48005","Other violations related to gaming and betting","0","0","0","0","0","0","0","0","0","0","0","0","0","0"
"2008","Chestermere, Alberta, Royal Canadian Mounted Police, municipal","48005","Other violations related to gaming and betting","0","0","0","0","0","0","0","0","0","0","0","0","0","0"
"2009","Chestermere, Alberta, Royal Canadian Mounted Police, municipal","48005","Other violations related to gaming and betting","0","0","0","0","0","0","0","0","0","0","0","0","0","0"
"2010","Chestermere, Alberta, Royal Canadian Mounted Police, municipal","48005","Other violations related to gaming and betting","0","0","0","0","0","0","0","0","0","0","0","0","0","0"
"2011","Chestermere, Alberta, Royal Canadian Mounted Police, municipal","48005","Other violations related to gaming and betting","0","0","0","0","0","0","0","0","0","0","0","0","0","0"
"2012","Chestermere, Alberta, Royal Canadian Mounted Police, municipal","48005","Other violations related to gaming and betting","0","0","0","0","0","0","0","0","0","0","0","0","0","0"
"2013","Chestermere, Alberta, Royal Canadian Mounted Police, municipal","48005","Other violations related to gaming and betting","0","0","0","0","0","0","0","0","0","0","0","0","0","0"
"2014","Chestermere, Alberta, Royal Canadian Mounted Police, municipal","48005","Other violations related to gaming and betting","0","0","0","0","0","0","0","0","0","0","0","0","0","0"
"2015","Chestermere, Alberta, Royal Canadian Mounted Police, municipal","48005","Other violations related to gaming and betting","0","0","0","0","0","0","0","0","0","0","0","0","0","0"
"2016","Chestermere, Alberta, Royal Canadian Mounted Police, municipal","48005","Other violations related to gaming and betting","0","0","0","0","0","0","0","0","0","0","0","0","0","0"
"2012","Chestermere, Alberta, Royal Canadian Mounted Police, municipal","48005","Common Bawdy House","0","0","0","0","0","0","0","0","0","0","0","0","0","0"
"2013","Chestermere, Alberta, Royal Canadian Mounted Police, municipal","48005","Common Bawdy House","0","0","0","0","0","0","0","0","0","0","0","0","0","0"
"2014","Chestermere, Alberta, Royal Canadian Mounted Police, municipal","48005","Common Bawdy House","0","0","0","0","0","0","0","0","0","0","0","0","0","0"
"2015","Chestermere, Alberta, Royal Canadian Mounted Police, municipal","48005","Common Bawdy House","0","0","0","0","0","0","0","0","0","0","0","0","0","0"
"2016","Chestermere, Alberta, Royal Canadian Mounted Police, municipal","48005","Common Bawdy House","0","0","0","0","0","0","0","0","0","0","0","0","0","0"
"1998","Chestermere, Alberta, Royal Canadian Mounted Police, municipal","48005","Indecent acts","0","0","0","0","0","0","0","0","0","0","0","0","0","0"
"1999","Chestermere, Alberta, Royal Canadian Mounted Police, municipal","48005","Indecent acts","0","0","0","0","0","0","0","0","0","0","0","0","0","0"
"2000","Chestermere, Alberta, Royal Canadian Mounted Police, municipal","48005","Indecent acts","0","0","0","0","0","0","0","0","0","0","0","0","0","0"
"2001","Chestermere, Alberta, Royal Canadian Mounted Police, municipal","48005","Indecent acts","0","0","0","0","0","0","0","0","0","0","0","0","0","0"
"2002","Chestermere, Alberta, Royal Canadian Mounted Police, municipal","48005","Indecent acts","0","0","0","0","0","0","0","0","0","0","0","0","0","0"
"2003","Chestermere, Alberta, Royal Canadian Mounted Police, municipal","48005","Indecent acts","0","0","0","0","0","0","0","0","0","0","0","0","0","0"
"2004","Chestermere, Alberta, Royal Canadian Mounted Police, municipal","48005","Indecent acts","0","0","0","0","0","0","0","0","0","0","0","0","0","0"
"2005","Chestermere, Alberta, Royal Canadian Mounted Police, municipal","48005","Indecent acts","0","0","0","0","0","0","0","0","0","0","0","0","0","0"
"2006","Chestermere, Alberta, Royal Canadian Mounted Police, municipal","48005","Indecent acts","4","1","1","0","38.5","0","0","0","0","2","0","0","0","0"
"2007","Chestermere, Alberta, Royal Canadian Mounted Police, municipal","48005","Indecent acts","3","0","0","-31.42","26.4","0","0","0","0","0","0","0","0","0"
"2008","Chestermere, Alberta, Royal Canadian Mounted Police, municipal","48005","Indecent acts","1","0","0","-69.39","8.08","0","0","0","0","0","0","0","0","0"
"2009","Chestermere, Alberta, Royal Canadian Mounted Police, municipal","48005","Indecent acts","0","0","0","-100","0","0","0","0","0","0","0","0","0","0"
"2010","Chestermere, Alberta, Royal Canadian Mounted Police, municipal","48005","Indecent acts","3","1","1","0","20.81","9.66","8.54","0","0","2","1","1","0","0"
"2011","Chestermere, Alberta, Royal Canadian Mounted Police, municipal","48005","Indecent acts","0","0","0","-100","0","0","0","0","0","0","0","0","0","0"
"2012","Chestermere, Alberta, Royal Canadian Mounted Police, municipal","48005","Indecent acts","1","0","1","0","6.31","0","0","0","0","1","0","0","0","0"
"2013","Chestermere, Alberta, Royal Canadian Mounted Police, municipal","48005","Indecent acts","1","0","0","-3.37","6.1","0","0","0","0","0","0","0","0","0"
"2014","Chestermere, Alberta, Royal Canadian Mounted Police, municipal","48005","Indecent acts","2","0","0","93.67","11.81","0","0","0","0","0","0","0","0","0"
"2015","Chestermere, Alberta, Royal Canadian Mounted Police, municipal","48005","Indecent acts","2","0","0","-2.19","11.55","0","0","0","0","0","0","0","0","0"
"2016","Chestermere, Alberta, Royal Canadian Mounted Police, municipal","48005","Indecent acts","1","0","1","-51.22","5.63","0","0","0","0","1","0","0","0","0"
"1998","Chestermere, Alberta, Royal Canadian Mounted Police, municipal","48005","Corrupting morals","0","0","0","0","0","0","0","0","0","0","0","0","0","0"
"1999","Chestermere, Alberta, Royal Canadian Mounted Police, municipal","48005","Corrupting morals","0","0","0","0","0","0","0","0","0","0","0","0","0","0"
"2000","Chestermere, Alberta, Royal Canadian Mounted Police, municipal","48005","Corrupting morals","0","0","0","0","0","0","0","0","0","0","0","0","0","0"
"2001","Chestermere, Alberta, Royal Canadian Mounted Police, municipal","48005","Corrupting morals","0","0","0","0","0","0","0","0","0","0","0","0","0","0"
"2002","Chestermere, Alberta, Royal Canadian Mounted Police, municipal","48005","Corrupting morals","0","0","0","0","0","0","0","0","0","0","0","0","0","0"
"2003","Chestermere, Alberta, Royal Canadian Mounted Police, municipal","48005","Corrupting morals","0","0","0","0","0","0","0","0","0","0","0","0","0","0"
"2004","Chestermere, Alberta, Royal Canadian Mounted Police, municipal","48005","Corrupting morals","0","0","0","0","0","0","0","0","0","0","0","0","0","0"
"2005","Chestermere, Alberta, Royal Canadian Mounted Police, municipal","48005","Corrupting morals","0","0","0","0","0","0","0","0","0","0","0","0","0","0"
"2006","Chestermere, Alberta, Royal Canadian Mounted Police, municipal","48005","Corrupting morals","0","0","0","0","0","0","0","0","0","0","0","0","0","0"
"2007","Chestermere, Alberta, Royal Canadian Mounted Police, municipal","48005","Corrupting morals","0","0","0","0","0","0","0","0","0","0","0","0","0","0"
"2008","Chestermere, Alberta, Royal Canadian Mounted Police, municipal","48005","Corrupting morals","0","0","0","0","0","0","0","0","0","0","0","0","0","0"
"2009","Chestermere, Alberta, Royal Canadian Mounted Police, municipal","48005","Corrupting morals","0","0","0","0","0","0","0","0","0","0","0","0","0","0"
"2010","Chestermere, Alberta, Royal Canadian Mounted Police, municipal","48005","Corrupting morals","0","0","0","0","0","0","0","0","0","0","0","0","0","0"
"2011","Chestermere, Alberta, Royal Canadian Mounted Police, municipal","48005","Corrupting morals","0","0","0","0","0","0","0","0","0","0","0","0","0","0"
"2012","Chestermere, Alberta, Royal Canadian Mounted Police, municipal","48005","Corrupting morals","0","0","0","0","0","0","0","0","0","0","0","0","0","0"
"2013","Chestermere, Alberta, Royal Canadian Mounted Police, municipal","48005","Corrupting morals","0","0","0","0","0","0","0","0","0","0","0","0","0","0"
"2014","Chestermere, Alberta, Royal Canadian Mounted Police, municipal","48005","Corrupting morals","0","0","0","0","0","0","0","0","0","0","0","0","0","0"
"2015","Chestermere, Alberta, Royal Canadian Mounted Police, municipal","48005","Corrupting morals","0","0","0","0","0","0","0","0","0","0","0","0","0","0"
"2016","Chestermere, Alberta, Royal Canadian Mounted Police, municipal","48005","Corrupting morals","0","0","0","0","0","0","0","0","0","0","0","0","0","0"
"1998","Chestermere, Alberta, Royal Canadian Mounted Police, municipal","48005","Obstruct public or peace officer","0","0","0","0","0","0","0","0","0","0","0","0","0","0"
"1999","Chestermere, Alberta, Royal Canadian Mounted Police, municipal","48005","Obstruct public or peace officer","0","0","0","0","0","0","0","0","0","0","0","0","0","0"
"2000","Chestermere, Alberta, Royal Canadian Mounted Police, municipal","48005","Obstruct public or peace officer","0","0","0","0","0","0","0","0","0","0","0","0","0","0"
"2001","Chestermere, Alberta, Royal Canadian Mounted Police, municipal","48005","Obstruct public or peace officer","0","0","0","0","0","0","0","0","0","0","0","0","0","0"
"2002","Chestermere, Alberta, Royal Canadian Mounted Police, municipal","48005","Obstruct public or peace officer","0","0","0","0","0","0","0","0","0","0","0","0","0","0"
"2003","Chestermere, Alberta, Royal Canadian Mounted Police, municipal","48005","Obstruct public or peace officer","0","0","0","0","0","0","0","0","0","0","0","0","0","0"
"2004","Chestermere, Alberta, Royal Canadian Mounted Police, municipal","48005","Obstruct public or peace officer","0","0","0","0","0","0","0","0","0","0","0","0","0","0"
"2005","Chestermere, Alberta, Royal Canadian Mounted Police, municipal","48005","Obstruct public or peace officer","1","1","0","0","11.54","15.99","14.14","0","0","1","1","1","0","0"
"2006","Chestermere, Alberta, Royal Canadian Mounted Police, municipal","48005","Obstruct public or peace officer","4","1","3","233.47","38.5","13.52","11.88","0","0","4","1","1","0","0"
"2007","Chestermere, Alberta, Royal Canadian Mounted Police, municipal","48005","Obstruct public or peace officer","8","2","7","82.89","70.41","12.32","10.85","0","0","9","1","1","0","0"
"2008","Chestermere, Alberta, Royal Canadian Mounted Police, municipal","48005","Obstruct public or peace officer","14","4","7","60.7","113.15","45.13","39.84","0","0","11","4","4","0","0"
"2009","Chestermere, Alberta, Royal Canadian Mounted Police, municipal","48005","Obstruct public or peace officer","10","2","7","-34.21","74.44","20.7","18.31","0","79.3","9","2","2","0","1"
"2010","Chestermere, Alberta, Royal Canadian Mounted Police, municipal","48005","Obstruct public or peace officer","3","1","2","-72.05","20.81","0","8.54","73.64","0","3","0","1","1","0"
"2011","Chestermere, Alberta, Royal Canadian Mounted Police, municipal","48005","Obstruct public or peace officer","4","3","1","24.94","26","18.12","24.16","72.46","0","4","2","3","1","0"
"2012","Chestermere, Alberta, Royal Canadian Mounted Police, municipal","48005","Obstruct public or peace officer","4","4","0","-2.91","25.24","43.89","39.13","0","0","4","5","5","0","0"
"2013","Chestermere, Alberta, Royal Canadian Mounted Police, municipal","48005","Obstruct public or peace officer","1","1","0","-75.84","6.1","8.46","7.57","0","0","1","1","1","0","0"
"2014","Chestermere, Alberta, Royal Canadian Mounted Police, municipal","48005","Obstruct public or peace officer","1","1","0","-3.17","5.9","8.17","7.33","0","0","1","1","1","0","0"
"2015","Chestermere, Alberta, Royal Canadian Mounted Police, municipal","48005","Obstruct public or peace officer","3","3","0","193.42","17.33","23.99","21.55","0","0","3","3","3","0","0"
"2016","Chestermere, Alberta, Royal Canadian Mounted Police, municipal","48005","Obstruct public or peace officer","0","0","0","-100","0","0","0","0","0","0","0","0","0","0"
"1998","Chestermere, Alberta, Royal Canadian Mounted Police, municipal","48005","Trespass at night","0","0","0","0","0","0","0","0","0","0","0","0","0","0"
"1999","Chestermere, Alberta, Royal Canadian Mounted Police, municipal","48005","Trespass at night","0","0","0","0","0","0","0","0","0","0","0","0","0","0"
"2000","Chestermere, Alberta, Royal Canadian Mounted Police, municipal","48005","Trespass at night","0","0","0","0","0","0","0","0","0","0","0","0","0","0"
"2001","Chestermere, Alberta, Royal Canadian Mounted Police, municipal","48005","Trespass at night","0","0","0","0","0","0","0","0","0","0","0","0","0","0"
"2002","Chestermere, Alberta, Royal Canadian Mounted Police, municipal","48005","Trespass at night","0","0","0","0","0","0","0","0","0","0","0","0","0","0"
"2003","Chestermere, Alberta, Royal Canadian Mounted Police, municipal","48005","Trespass at night","0","0","0","0","0","0","0","0","0","0","0","0","0","0"
"2004","Chestermere, Alberta, Royal Canadian Mounted Police, municipal","48005","Trespass at night","0","0","0","0","0","0","0","0","0","0","0","0","0","0"
"2005","Chestermere, Alberta, Royal Canadian Mounted Police, municipal","48005","Trespass at night","1","1","0","0","11.54","15.99","14.14","0","0","1","1","1","0","0"
"2006","Chestermere, Alberta, Royal Canadian Mounted Police, municipal","48005","Trespass at night","1","0","1","-16.63","9.62","0","0","0","98.52","1","0","0","0","1"
"2007","Chestermere, Alberta, Royal Canadian Mounted Police, municipal","48005","Trespass at night","7","0","4","540.12","61.61","0","0","0","455.79","4","0","0","0","5"
"2008","Chestermere, Alberta, Royal Canadian Mounted Police, municipal","48005","Trespass at night","6","1","2","-21.29","48.49","0","9.96","84.89","339.56","3","0","1","1","4"
"2009","Chestermere, Alberta, Royal Canadian Mounted Police, municipal","48005","Trespass at night","6","1","1","-7.89","44.67","10.35","9.16","0","158.6","2","1","1","0","2"
"2010","Chestermere, Alberta, Royal Canadian Mounted Police, municipal","48005","Trespass at night","6","0","1","-6.83","41.62","0","0","0","0","1","0","0","0","0"
"2011","Chestermere, Alberta, Royal Canadian Mounted Police, municipal","48005","Trespass at night","2","0","0","-68.77","13","0","0","0","0","0","0","0","0","0"
"2012","Chestermere, Alberta, Royal Canadian Mounted Police, municipal","48005","Trespass at night","3","0","0","45.64","18.93","0","0","0","0","0","0","0","0","0"
"2013","Chestermere, Alberta, Royal Canadian Mounted Police, municipal","48005","Trespass at night","0","0","0","-100","0","0","0","0","0","0","0","0","0","0"
"2014","Chestermere, Alberta, Royal Canadian Mounted Police, municipal","48005","Trespass at night","1","0","0","0","5.9","0","0","0","0","0","0","0","0","0"
"2015","Chestermere, Alberta, Royal Canadian Mounted Police, municipal","48005","Trespass at night","1","0","0","-2.19","5.78","0","0","0","0","0","0","0","0","0"
"2016","Chestermere, Alberta, Royal Canadian Mounted Police, municipal","48005","Trespass at night","2","0","0","95.12","11.27","0","0","0","0","0","0","0","0","0"
"2005","Chestermere, Alberta, Royal Canadian Mounted Police, municipal","48005","Utter threats to property or animal","0","0","0","0","0","0","0","0","0","0","0","0","0","0"
"2006","Chestermere, Alberta, Royal Canadian Mounted Police, municipal","48005","Utter threats to property or animal","0","0","0","0","0","0","0","0","0","0","0","0","0","0"
"2007","Chestermere, Alberta, Royal Canadian Mounted Police, municipal","48005","Utter threats to property or animal","0","0","0","0","0","0","0","0","0","0","0","0","0","0"
"2008","Chestermere, Alberta, Royal Canadian Mounted Police, municipal","48005","Utter threats to property or animal","0","0","0","0","0","0","0","0","0","0","0","0","0","0"
"2009","Chestermere, Alberta, Royal Canadian Mounted Police, municipal","48005","Utter threats to property or animal","0","0","0","0","0","0","0","0","0","0","0","0","0","0"
"2010","Chestermere, Alberta, Royal Canadian Mounted Police, municipal","48005","Utter threats to property or animal","2","0","2","0","13.87","0","0","0","73.64","2","0","0","0","1"
"2011","Chestermere, Alberta, Royal Canadian Mounted Police, municipal","48005","Utter threats to property or animal","1","0","1","-53.15","6.5","0","0","0","72.46","1","0","0","0","1"
"2012","Chestermere, Alberta, Royal Canadian Mounted Police, municipal","48005","Utter threats to property or animal","3","0","2","191.27","18.93","0","0","0","72.05","2","0","0","0","1"
"2013","Chestermere, Alberta, Royal Canadian Mounted Police, municipal","48005","Utter threats to property or animal","3","0","2","-3.37","18.29","0","0","0","0","2","0","0","0","0"
"2014","Chestermere, Alberta, Royal Canadian Mounted Police, municipal","48005","Utter threats to property or animal","2","0","2","-35.44","11.81","0","0","0","0","2","0","0","0","0"
"2015","Chestermere, Alberta, Royal Canadian Mounted Police, municipal","48005","Utter threats to property or animal","0","0","0","-100","0","0","0","0","0","0","0","0","0","0"
"2016","Chestermere, Alberta, Royal Canadian Mounted Police, municipal","48005","Utter threats to property or animal","1","0","1","0","5.63","0","0","0","0","1","0","0","0","0"
"2005","Chestermere, Alberta, Royal Canadian Mounted Police, municipal","48005","Advocating genocide","0","0","0","0","0","0","0","0","0","0","0","0","0","0"
"2006","Chestermere, Alberta, Royal Canadian Mounted Police, municipal","48005","Advocating genocide","0","0","0","0","0","0","0","0","0","0","0","0","0","0"
"2007","Chestermere, Alberta, Royal Canadian Mounted Police, municipal","48005","Advocating genocide","0","0","0","0","0","0","0","0","0","0","0","0","0","0"
"2008","Chestermere, Alberta, Royal Canadian Mounted Police, municipal","48005","Advocating genocide","0","0","0","0","0","0","0","0","0","0","0","0","0","0"
"2009","Chestermere, Alberta, Royal Canadian Mounted Police, municipal","48005","Advocating genocide","0","0","0","0","0","0","0","0","0","0","0","0","0","0"
"2010","Chestermere, Alberta, Royal Canadian Mounted Police, municipal","48005","Advocating genocide","0","0","0","0","0","0","0","0","0","0","0","0","0","0"
"2011","Chestermere, Alberta, Royal Canadian Mounted Police, municipal","48005","Advocating genocide","0","0","0","0","0","0","0","0","0","0","0","0","0","0"
"2012","Chestermere, Alberta, Royal Canadian Mounted Police, municipal","48005","Advocating genocide","0","0","0","0","0","0","0","0","0","0","0","0","0","0"
"2013","Chestermere, Alberta, Royal Canadian Mounted Police, municipal","48005","Advocating genocide","0","0","0","0","0","0","0","0","0","0","0","0","0","0"
"2014","Chestermere, Alberta, Royal Canadian Mounted Police, municipal","48005","Advocating genocide","0","0","0","0","0","0","0","0","0","0","0","0","0","0"
"2015","Chestermere, Alberta, Royal Canadian Mounted Police, municipal","48005","Advocating genocide","0","0","0","0","0","0","0","0","0","0","0","0","0","0"
"2016","Chestermere, Alberta, Royal Canadian Mounted Police, municipal","48005","Advocating genocide","0","0","0","0","0","0","0","0","0","0","0","0","0","0"
"2005","Chestermere, Alberta, Royal Canadian Mounted Police, municipal","48005","Public incitement of hatred","0","0","0","0","0","0","0","0","0","0","0","0","0","0"
"2006","Chestermere, Alberta, Royal Canadian Mounted Police, municipal","48005","Public incitement of hatred","0","0","0","0","0","0","0","0","0","0","0","0","0","0"
"2007","Chestermere, Alberta, Royal Canadian Mounted Police, municipal","48005","Public incitement of hatred","0","0","0","0","0","0","0","0","0","0","0","0","0","0"
"2008","Chestermere, Alberta, Royal Canadian Mounted Police, municipal","48005","Public incitement of hatred","0","0","0","0","0","0","0","0","0","0","0","0","0","0"
"2009","Chestermere, Alberta, Royal Canadian Mounted Police, municipal","48005","Public incitement of hatred","0","0","0","0","0","0","0","0","0","0","0","0","0","0"
"2010","Chestermere, Alberta, Royal Canadian Mounted Police, municipal","48005","Public incitement of hatred","0","0","0","0","0","0","0","0","0","0","0","0","0","0"
"2011","Chestermere, Alberta, Royal Canadian Mounted Police, municipal","48005","Public incitement of hatred","0","0","0","0","0","0","0","0","0","0","0","0","0","0"
"2012","Chestermere, Alberta, Royal Canadian Mounted Police, municipal","48005","Public incitement of hatred","0","0","0","0","0","0","0","0","0","0","0","0","0","0"
"2013","Chestermere, Alberta, Royal Canadian Mounted Police, municipal","48005","Public incitement of hatred","0","0","0","0","0","0","0","0","0","0","0","0","0","0"
"2014","Chestermere, Alberta, Royal Canadian Mounted Police, municipal","48005","Public incitement of hatred","0","0","0","0","0","0","0","0","0","0","0","0","0","0"
"2015","Chestermere, Alberta, Royal Canadian Mounted Police, municipal","48005","Public incitement of hatred","0","0","0","0","0","0","0","0","0","0","0","0","0","0"
"2016","Chestermere, Alberta, Royal Canadian Mounted Police, municipal","48005","Public incitement of hatred","0","0","0","0","0","0","0","0","0","0","0","0","0","0"
"2005","Chestermere, Alberta, Royal Canadian Mounted Police, municipal","48005","Unauthorized recording of a movie","0","0","0","0","0","0","0","0","0","0","0","0","0","0"
"2006","Chestermere, Alberta, Royal Canadian Mounted Police, municipal","48005","Unauthorized recording of a movie","0","0","0","0","0","0","0","0","0","0","0","0","0","0"
"2007","Chestermere, Alberta, Royal Canadian Mounted Police, municipal","48005","Unauthorized recording of a movie","0","0","0","0","0","0","0","0","0","0","0","0","0","0"
"2008","Chestermere, Alberta, Royal Canadian Mounted Police, municipal","48005","Unauthorized recording of a movie","0","0","0","0","0","0","0","0","0","0","0","0","0","0"
"2009","Chestermere, Alberta, Royal Canadian Mounted Police, municipal","48005","Unauthorized recording of a movie","0","0","0","0","0","0","0","0","0","0","0","0","0","0"
"2010","Chestermere, Alberta, Royal Canadian Mounted Police, municipal","48005","Unauthorized recording of a movie","0","0","0","0","0","0","0","0","0","0","0","0","0","0"
"2011","Chestermere, Alberta, Royal Canadian Mounted Police, municipal","48005","Unauthorized recording of a movie","0","0","0","0","0","0","0","0","0","0","0","0","0","0"
"2012","Chestermere, Alberta, Royal Canadian Mounted Police, municipal","48005","Unauthorized recording of a movie","0","0","0","0","0","0","0","0","0","0","0","0","0","0"
"2013","Chestermere, Alberta, Royal Canadian Mounted Police, municipal","48005","Unauthorized recording of a movie","0","0","0","0","0","0","0","0","0","0","0","0","0","0"
"2014","Chestermere, Alberta, Royal Canadian Mounted Police, municipal","48005","Unauthorized recording of a movie","0","0","0","0","0","0","0","0","0","0","0","0","0","0"
"2015","Chestermere, Alberta, Royal Canadian Mounted Police, municipal","48005","Unauthorized recording of a movie","0","0","0","0","0","0","0","0","0","0","0","0","0","0"
"2016","Chestermere, Alberta, Royal Canadian Mounted Police, municipal","48005","Unauthorized recording of a movie","0","0","0","0","0","0","0","0","0","0","0","0","0","0"
"1998","Chestermere, Alberta, Royal Canadian Mounted Police, municipal","48005","Offences against public order (Part II Criminal Code)","0","0","0","0","0","0","0","0","0","0","0","0","0","0"
"1999","Chestermere, Alberta, Royal Canadian Mounted Police, municipal","48005","Offences against public order (Part II Criminal Code)","0","0","0","0","0","0","0","0","0","0","0","0","0","0"
"2000","Chestermere, Alberta, Royal Canadian Mounted Police, municipal","48005","Offences against public order (Part II Criminal Code)","0","0","0","0","0","0","0","0","0","0","0","0","0","0"
"2001","Chestermere, Alberta, Royal Canadian Mounted Police, municipal","48005","Offences against public order (Part II Criminal Code)","0","0","0","0","0","0","0","0","0","0","0","0","0","0"
"2002","Chestermere, Alberta, Royal Canadian Mounted Police, municipal","48005","Offences against public order (Part II Criminal Code)","0","0","0","0","0","0","0","0","0","0","0","0","0","0"
"2003","Chestermere, Alberta, Royal Canadian Mounted Police, municipal","48005","Offences against public order (Part II Criminal Code)","0","0","0","0","0","0","0","0","0","0","0","0","0","0"
"2004","Chestermere, Alberta, Royal Canadian Mounted Police, municipal","48005","Offences against public order (Part II Criminal Code)","0","0","0","0","0","0","0","0","0","0","0","0","0","0"
"2005","Chestermere, Alberta, Royal Canadian Mounted Police, municipal","48005","Offences against public order (Part II Criminal Code)","0","0","0","0","0","0","0","0","0","0","0","0","0","0"
"2006","Chestermere, Alberta, Royal Canadian Mounted Police, municipal","48005","Offences against public order (Part II Criminal Code)","0","0","0","0","0","0","0","0","0","0","0","0","0","0"
"2007","Chestermere, Alberta, Royal Canadian Mounted Police, municipal","48005","Offences against public order (Part II Criminal Code)","3","0","1","0","26.4","0","0","0","91.16","1","0","0","0","1"
"2008","Chestermere, Alberta, Royal Canadian Mounted Police, municipal","48005","Offences against public order (Part II Criminal Code)","1","0","0","-69.39","8.08","0","0","0","0","0","0","0","0","0"
"2009","Chestermere, Alberta, Royal Canadian Mounted Police, municipal","48005","Offences against public order (Part II Criminal Code)","1","0","0","-7.89","7.44","0","0","0","0","0","0","0","0","0"
"2010","Chestermere, Alberta, Royal Canadian Mounted Police, municipal","48005","Offences against public order (Part II Criminal Code)","0","0","0","-100","0","0","0","0","0","0","0","0","0","0"
"2011","Chestermere, Alberta, Royal Canadian Mounted Police, municipal","48005","Offences against public order (Part II Criminal Code)","0","0","0","0","0","0","0","0","0","0","0","0","0","0"
"2012","Chestermere, Alberta, Royal Canadian Mounted Police, municipal","48005","Offences against public order (Part II Criminal Code)","0","0","0","0","0","0","0","0","0","0","0","0","0","0"
"2013","Chestermere, Alberta, Royal Canadian Mounted Police, municipal","48005","Offences against public order (Part II Criminal Code)","0","0","0","0","0","0","0","0","0","0","0","0","0","0"
"2014","Chestermere, Alberta, Royal Canadian Mounted Police, municipal","48005","Offences against public order (Part II Criminal Code)","0","0","0","0","0","0","0","0","0","0","0","0","0","0"
"2015","Chestermere, Alberta, Royal Canadian Mounted Police, municipal","48005","Offences against public order (Part II Criminal Code)","0","0","0","0","0","0","0","0","0","0","0","0","0","0"
"2016","Chestermere, Alberta, Royal Canadian Mounted Police, municipal","48005","Offences against public order (Part II Criminal Code)","0","0","0","0","0","0","0","0","0","0","0","0","0","0"
"2002","Chestermere, Alberta, Royal Canadian Mounted Police, municipal","48005","Property or service for terrorist activity","0","0","0","0","0","0","0","0","0","0","0","0","0","0"
"2003","Chestermere, Alberta, Royal Canadian Mounted Police, municipal","48005","Property or service for terrorist activity","0","0","0","0","0","0","0","0","0","0","0","0","0","0"
"2004","Chestermere, Alberta, Royal Canadian Mounted Police, municipal","48005","Property or service for terrorist activity","0","0","0","0","0","0","0","0","0","0","0","0","0","0"
"2005","Chestermere, Alberta, Royal Canadian Mounted Police, municipal","48005","Property or service for terrorist activity","0","0","0","0","0","0","0","0","0","0","0","0","0","0"
"2006","Chestermere, Alberta, Royal Canadian Mounted Police, municipal","48005","Property or service for terrorist activity","0","0","0","0","0","0","0","0","0","0","0","0","0","0"
"2007","Chestermere, Alberta, Royal Canadian Mounted Police, municipal","48005","Property or service for terrorist activity","0","0","0","0","0","0","0","0","0","0","0","0","0","0"
"2008","Chestermere, Alberta, Royal Canadian Mounted Police, municipal","48005","Property or service for terrorist activity","0","0","0","0","0","0","0","0","0","0","0","0","0","0"
"2009","Chestermere, Alberta, Royal Canadian Mounted Police, municipal","48005","Property or service for terrorist activity","0","0","0","0","0","0","0","0","0","0","0","0","0","0"
"2010","Chestermere, Alberta, Royal Canadian Mounted Police, municipal","48005","Property or service for terrorist activity","0","0","0","0","0","0","0","0","0","0","0","0","0","0"
"2011","Chestermere, Alberta, Royal Canadian Mounted Police, municipal","48005","Property or service for terrorist activity","0","0","0","0","0","0","0","0","0","0","0","0","0","0"
"2012","Chestermere, Alberta, Royal Canadian Mounted Police, municipal","48005","Property or service for terrorist activity","0","0","0","0","0","0","0","0","0","0","0","0","0","0"
"2013","Chestermere, Alberta, Royal Canadian Mounted Police, municipal","48005","Property or service for terrorist activity","0","0","0","0","0","0","0","0","0","0","0","0","0","0"
"2014","Chestermere, Alberta, Royal Canadian Mounted Police, municipal","48005","Property or service for terrorist activity","0","0","0","0","0","0","0","0","0","0","0","0","0","0"
"2015","Chestermere, Alberta, Royal Canadian Mounted Police, municipal","48005","Property or service for terrorist activity","0","0","0","0","0","0","0","0","0","0","0","0","0","0"
"2016","Chestermere, Alberta, Royal Canadian Mounted Police, municipal","48005","Property or service for terrorist activity","0","0","0","0","0","0","0","0","0","0","0","0","0","0"
"2002","Chestermere, Alberta, Royal Canadian Mounted Police, municipal","48005","Freezing of property, disclosure or audit","0","0","0","0","0","0","0","0","0","0","0","0","0","0"
"2003","Chestermere, Alberta, Royal Canadian Mounted Police, municipal","48005","Freezing of property, disclosure or audit","0","0","0","0","0","0","0","0","0","0","0","0","0","0"
"2004","Chestermere, Alberta, Royal Canadian Mounted Police, municipal","48005","Freezing of property, disclosure or audit","0","0","0","0","0","0","0","0","0","0","0","0","0","0"
"2005","Chestermere, Alberta, Royal Canadian Mounted Police, municipal","48005","Freezing of property, disclosure or audit","0","0","0","0","0","0","0","0","0","0","0","0","0","0"
"2006","Chestermere, Alberta, Royal Canadian Mounted Police, municipal","48005","Freezing of property, disclosure or audit","0","0","0","0","0","0","0","0","0","0","0","0","0","0"
"2007","Chestermere, Alberta, Royal Canadian Mounted Police, municipal","48005","Freezing of property, disclosure or audit","0","0","0","0","0","0","0","0","0","0","0","0","0","0"
"2008","Chestermere, Alberta, Royal Canadian Mounted Police, municipal","48005","Freezing of property, disclosure or audit","0","0","0","0","0","0","0","0","0","0","0","0","0","0"
"2009","Chestermere, Alberta, Royal Canadian Mounted Police, municipal","48005","Freezing of property, disclosure or audit","0","0","0","0","0","0","0","0","0","0","0","0","0","0"
"2010","Chestermere, Alberta, Royal Canadian Mounted Police, municipal","48005","Freezing of property, disclosure or audit","0","0","0","0","0","0","0","0","0","0","0","0","0","0"
"2011","Chestermere, Alberta, Royal Canadian Mounted Police, municipal","48005","Freezing of property, disclosure or audit","0","0","0","0","0","0","0","0","0","0","0","0","0","0"
"2012","Chestermere, Alberta, Royal Canadian Mounted Police, municipal","48005","Freezing of property, disclosure or audit","0","0","0","0","0","0","0","0","0","0","0","0","0","0"
"2013","Chestermere, Alberta, Royal Canadian Mounted Police, municipal","48005","Freezing of property, disclosure or audit","0","0","0","0","0","0","0","0","0","0","0","0","0","0"
"2014","Chestermere, Alberta, Royal Canadian Mounted Police, municipal","48005","Freezing of property, disclosure or audit","0","0","0","0","0","0","0","0","0","0","0","0","0","0"
"2015","Chestermere, Alberta, Royal Canadian Mounted Police, municipal","48005","Freezing of property, disclosure or audit","0","0","0","0","0","0","0","0","0","0","0","0","0","0"
"2016","Chestermere, Alberta, Royal Canadian Mounted Police, municipal","48005","Freezing of property, disclosure or audit","0","0","0","0","0","0","0","0","0","0","0","0","0","0"
"2002","Chestermere, Alberta, Royal Canadian Mounted Police, municipal","48005","Participate in activity of terrorist group","0","0","0","0","0","0","0","0","0","0","0","0","0","0"
"2003","Chestermere, Alberta, Royal Canadian Mounted Police, municipal","48005","Participate in activity of terrorist group","0","0","0","0","0","0","0","0","0","0","0","0","0","0"
"2004","Chestermere, Alberta, Royal Canadian Mounted Police, municipal","48005","Participate in activity of terrorist group","0","0","0","0","0","0","0","0","0","0","0","0","0","0"
"2005","Chestermere, Alberta, Royal Canadian Mounted Police, municipal","48005","Participate in activity of terrorist group","0","0","0","0","0","0","0","0","0","0","0","0","0","0"
"2006","Chestermere, Alberta, Royal Canadian Mounted Police, municipal","48005","Participate in activity of terrorist group","0","0","0","0","0","0","0","0","0","0","0","0","0","0"
"2007","Chestermere, Alberta, Royal Canadian Mounted Police, municipal","48005","Participate in activity of terrorist group","0","0","0","0","0","0","0","0","0","0","0","0","0","0"
"2008","Chestermere, Alberta, Royal Canadian Mounted Police, municipal","48005","Participate in activity of terrorist group","0","0","0","0","0","0","0","0","0","0","0","0","0","0"
"2009","Chestermere, Alberta, Royal Canadian Mounted Police, municipal","48005","Participate in activity of terrorist group","0","0","0","0","0","0","0","0","0","0","0","0","0","0"
"2010","Chestermere, Alberta, Royal Canadian Mounted Police, municipal","48005","Participate in activity of terrorist group","0","0","0","0","0","0","0","0","0","0","0","0","0","0"
"2011","Chestermere, Alberta, Royal Canadian Mounted Police, municipal","48005","Participate in activity of terrorist group","0","0","0","0","0","0","0","0","0","0","0","0","0","0"
"2012","Chestermere, Alberta, Royal Canadian Mounted Police, municipal","48005","Participate in activity of terrorist group","0","0","0","0","0","0","0","0","0","0","0","0","0","0"
"2013","Chestermere, Alberta, Royal Canadian Mounted Police, municipal","48005","Participate in activity of terrorist group","0","0","0","0","0","0","0","0","0","0","0","0","0","0"
"2014","Chestermere, Alberta, Royal Canadian Mounted Police, municipal","48005","Participate in activity of terrorist group","0","0","0","0","0","0","0","0","0","0","0","0","0","0"
"2015","Chestermere, Alberta, Royal Canadian Mounted Police, municipal","48005","Participate in activity of terrorist group","0","0","0","0","0","0","0","0","0","0","0","0","0","0"
"2016","Chestermere, Alberta, Royal Canadian Mounted Police, municipal","48005","Participate in activity of terrorist group","0","0","0","0","0","0","0","0","0","0","0","0","0","0"
"2002","Chestermere, Alberta, Royal Canadian Mounted Police, municipal","48005","Facilitate terrorist activity","0","0","0","0","0","0","0","0","0","0","0","0","0","0"
"2003","Chestermere, Alberta, Royal Canadian Mounted Police, municipal","48005","Facilitate terrorist activity","0","0","0","0","0","0","0","0","0","0","0","0","0","0"
"2004","Chestermere, Alberta, Royal Canadian Mounted Police, municipal","48005","Facilitate terrorist activity","0","0","0","0","0","0","0","0","0","0","0","0","0","0"
"2005","Chestermere, Alberta, Royal Canadian Mounted Police, municipal","48005","Facilitate terrorist activity","0","0","0","0","0","0","0","0","0","0","0","0","0","0"
"2006","Chestermere, Alberta, Royal Canadian Mounted Police, municipal","48005","Facilitate terrorist activity","0","0","0","0","0","0","0","0","0","0","0","0","0","0"
"2007","Chestermere, Alberta, Royal Canadian Mounted Police, municipal","48005","Facilitate terrorist activity","0","0","0","0","0","0","0","0","0","0","0","0","0","0"
"2008","Chestermere, Alberta, Royal Canadian Mounted Police, municipal","48005","Facilitate terrorist activity","0","0","0","0","0","0","0","0","0","0","0","0","0","0"
"2009","Chestermere, Alberta, Royal Canadian Mounted Police, municipal","48005","Facilitate terrorist activity","0","0","0","0","0","0","0","0","0","0","0","0","0","0"
"2010","Chestermere, Alberta, Royal Canadian Mounted Police, municipal","48005","Facilitate terrorist activity","0","0","0","0","0","0","0","0","0","0","0","0","0","0"
"2011","Chestermere, Alberta, Royal Canadian Mounted Police, municipal","48005","Facilitate terrorist activity","0","0","0","0","0","0","0","0","0","0","0","0","0","0"
"2012","Chestermere, Alberta, Royal Canadian Mounted Police, municipal","48005","Facilitate terrorist activity","0","0","0","0","0","0","0","0","0","0","0","0","0","0"
"2013","Chestermere, Alberta, Royal Canadian Mounted Police, municipal","48005","Facilitate terrorist activity","0","0","0","0","0","0","0","0","0","0","0","0","0","0"
"2014","Chestermere, Alberta, Royal Canadian Mounted Police, municipal","48005","Facilitate terrorist activity","0","0","0","0","0","0","0","0","0","0","0","0","0","0"
"2015","Chestermere, Alberta, Royal Canadian Mounted Police, municipal","48005","Facilitate terrorist activity","0","0","0","0","0","0","0","0","0","0","0","0","0","0"
"2016","Chestermere, Alberta, Royal Canadian Mounted Police, municipal","48005","Facilitate terrorist activity","0","0","0","0","0","0","0","0","0","0","0","0","0","0"
"2002","Chestermere, Alberta, Royal Canadian Mounted Police, municipal","48005","Commission or instructing to carry out terrorist activity","0","0","0","0","0","0","0","0","0","0","0","0","0","0"
"2003","Chestermere, Alberta, Royal Canadian Mounted Police, municipal","48005","Commission or instructing to carry out terrorist activity","0","0","0","0","0","0","0","0","0","0","0","0","0","0"
"2004","Chestermere, Alberta, Royal Canadian Mounted Police, municipal","48005","Commission or instructing to carry out terrorist activity","0","0","0","0","0","0","0","0","0","0","0","0","0","0"
"2005","Chestermere, Alberta, Royal Canadian Mounted Police, municipal","48005","Commission or instructing to carry out terrorist activity","0","0","0","0","0","0","0","0","0","0","0","0","0","0"
"2006","Chestermere, Alberta, Royal Canadian Mounted Police, municipal","48005","Commission or instructing to carry out terrorist activity","0","0","0","0","0","0","0","0","0","0","0","0","0","0"
"2007","Chestermere, Alberta, Royal Canadian Mounted Police, municipal","48005","Commission or instructing to carry out terrorist activity","0","0","0","0","0","0","0","0","0","0","0","0","0","0"
"2008","Chestermere, Alberta, Royal Canadian Mounted Police, municipal","48005","Commission or instructing to carry out terrorist activity","0","0","0","0","0","0","0","0","0","0","0","0","0","0"
"2009","Chestermere, Alberta, Royal Canadian Mounted Police, municipal","48005","Commission or instructing to carry out terrorist activity","0","0","0","0","0","0","0","0","0","0","0","0","0","0"
"2010","Chestermere, Alberta, Royal Canadian Mounted Police, municipal","48005","Commission or instructing to carry out terrorist activity","0","0","0","0","0","0","0","0","0","0","0","0","0","0"
"2011","Chestermere, Alberta, Royal Canadian Mounted Police, municipal","48005","Commission or instructing to carry out terrorist activity","0","0","0","0","0","0","0","0","0","0","0","0","0","0"
"2012","Chestermere, Alberta, Royal Canadian Mounted Police, municipal","48005","Commission or instructing to carry out terrorist activity","0","0","0","0","0","0","0","0","0","0","0","0","0","0"
"2013","Chestermere, Alberta, Royal Canadian Mounted Police, municipal","48005","Commission or instructing to carry out terrorist activity","0","0","0","0","0","0","0","0","0","0","0","0","0","0"
"2014","Chestermere, Alberta, Royal Canadian Mounted Police, municipal","48005","Commission or instructing to carry out terrorist activity","0","0","0","0","0","0","0","0","0","0","0","0","0","0"
"2015","Chestermere, Alberta, Royal Canadian Mounted Police, municipal","48005","Commission or instructing to carry out terrorist activity","0","0","0","0","0","0","0","0","0","0","0","0","0","0"
"2016","Chestermere, Alberta, Royal Canadian Mounted Police, municipal","48005","Commission or instructing to carry out terrorist activity","0","0","0","0","0","0","0","0","0","0","0","0","0","0"
"2002","Chestermere, Alberta, Royal Canadian Mounted Police, municipal","48005","Harbour or conceal terrorist","0","0","0","0","0","0","0","0","0","0","0","0","0","0"
"2003","Chestermere, Alberta, Royal Canadian Mounted Police, municipal","48005","Harbour or conceal terrorist","0","0","0","0","0","0","0","0","0","0","0","0","0","0"
"2004","Chestermere, Alberta, Royal Canadian Mounted Police, municipal","48005","Harbour or conceal terrorist","0","0","0","0","0","0","0","0","0","0","0","0","0","0"
"2005","Chestermere, Alberta, Royal Canadian Mounted Police, municipal","48005","Harbour or conceal terrorist","0","0","0","0","0","0","0","0","0","0","0","0","0","0"
"2006","Chestermere, Alberta, Royal Canadian Mounted Police, municipal","48005","Harbour or conceal terrorist","0","0","0","0","0","0","0","0","0","0","0","0","0","0"
"2007","Chestermere, Alberta, Royal Canadian Mounted Police, municipal","48005","Harbour or conceal terrorist","0","0","0","0","0","0","0","0","0","0","0","0","0","0"
"2008","Chestermere, Alberta, Royal Canadian Mounted Police, municipal","48005","Harbour or conceal terrorist","0","0","0","0","0","0","0","0","0","0","0","0","0","0"
"2009","Chestermere, Alberta, Royal Canadian Mounted Police, municipal","48005","Harbour or conceal terrorist","0","0","0","0","0","0","0","0","0","0","0","0","0","0"
"2010","Chestermere, Alberta, Royal Canadian Mounted Police, municipal","48005","Harbour or conceal terrorist","0","0","0","0","0","0","0","0","0","0","0","0","0","0"
"2011","Chestermere, Alberta, Royal Canadian Mounted Police, municipal","48005","Harbour or conceal terrorist","0","0","0","0","0","0","0","0","0","0","0","0","0","0"
"2012","Chestermere, Alberta, Royal Canadian Mounted Police, municipal","48005","Harbour or conceal terrorist","0","0","0","0","0","0","0","0","0","0","0","0","0","0"
"2013","Chestermere, Alberta, Royal Canadian Mounted Police, municipal","48005","Harbour or conceal terrorist","0","0","0","0","0","0","0","0","0","0","0","0","0","0"
"2014","Chestermere, Alberta, Royal Canadian Mounted Police, municipal","48005","Harbour or conceal terrorist","0","0","0","0","0","0","0","0","0","0","0","0","0","0"
"2015","Chestermere, Alberta, Royal Canadian Mounted Police, municipal","48005","Harbour or conceal terrorist","0","0","0","0","0","0","0","0","0","0","0","0","0","0"
"2016","Chestermere, Alberta, Royal Canadian Mounted Police, municipal","48005","Harbour or conceal terrorist","0","0","0","0","0","0","0","0","0","0","0","0","0","0"
"2005","Chestermere, Alberta, Royal Canadian Mounted Police, municipal","48005","Hoax terrorism","0","0","0","0","0","0","0","0","0","0","0","0","0","0"
"2006","Chestermere, Alberta, Royal Canadian Mounted Police, municipal","48005","Hoax terrorism","0","0","0","0","0","0","0","0","0","0","0","0","0","0"
"2007","Chestermere, Alberta, Royal Canadian Mounted Police, municipal","48005","Hoax terrorism","0","0","0","0","0","0","0","0","0","0","0","0","0","0"
"2008","Chestermere, Alberta, Royal Canadian Mounted Police, municipal","48005","Hoax terrorism","0","0","0","0","0","0","0","0","0","0","0","0","0","0"
"2009","Chestermere, Alberta, Royal Canadian Mounted Police, municipal","48005","Hoax terrorism","0","0","0","0","0","0","0","0","0","0","0","0","0","0"
"2010","Chestermere, Alberta, Royal Canadian Mounted Police, municipal","48005","Hoax terrorism","0","0","0","0","0","0","0","0","0","0","0","0","0","0"
"2011","Chestermere, Alberta, Royal Canadian Mounted Police, municipal","48005","Hoax terrorism","0","0","0","0","0","0","0","0","0","0","0","0","0","0"
"2012","Chestermere, Alberta, Royal Canadian Mounted Police, municipal","48005","Hoax terrorism","0","0","0","0","0","0","0","0","0","0","0","0","0","0"
"2013","Chestermere, Alberta, Royal Canadian Mounted Police, municipal","48005","Hoax terrorism","0","0","0","0","0","0","0","0","0","0","0","0","0","0"
"2014","Chestermere, Alberta, Royal Canadian Mounted Police, municipal","48005","Hoax terrorism","0","0","0","0","0","0","0","0","0","0","0","0","0","0"
"2015","Chestermere, Alberta, Royal Canadian Mounted Police, municipal","48005","Hoax terrorism","0","0","0","0","0","0","0","0","0","0","0","0","0","0"
"2016","Chestermere, Alberta, Royal Canadian Mounted Police, municipal","48005","Hoax terrorism","0","0","0","0","0","0","0","0","0","0","0","0","0","0"
"2012","Chestermere, Alberta, Royal Canadian Mounted Police, municipal","48005","Advocating/Promoting terrorism offence","0","0","0","0","0","0","0","0","0","0","0","0","0","0"
"2013","Chestermere, Alberta, Royal Canadian Mounted Police, municipal","48005","Advocating/Promoting terrorism offence","0","0","0","0","0","0","0","0","0","0","0","0","0","0"
"2014","Chestermere, Alberta, Royal Canadian Mounted Police, municipal","48005","Advocating/Promoting terrorism offence","0","0","0","0","0","0","0","0","0","0","0","0","0","0"
"2015","Chestermere, Alberta, Royal Canadian Mounted Police, municipal","48005","Advocating/Promoting terrorism offence","0","0","0","0","0","0","0","0","0","0","0","0","0","0"
"2016","Chestermere, Alberta, Royal Canadian Mounted Police, municipal","48005","Advocating/Promoting terrorism offence","0","0","0","0","0","0","0","0","0","0","0","0","0","0"
"1998","Chestermere, Alberta, Royal Canadian Mounted Police, municipal","48005","Firearms and other offensive weapons (Part III Criminal Code)","0","0","0","0","0","0","0","0","0","0","0","0","0","0"
"1999","Chestermere, Alberta, Royal Canadian Mounted Police, municipal","48005","Firearms and other offensive weapons (Part III Criminal Code)","0","0","0","0","0","0","0","0","0","0","0","0","0","0"
"2000","Chestermere, Alberta, Royal Canadian Mounted Police, municipal","48005","Firearms and other offensive weapons (Part III Criminal Code)","0","0","0","0","0","0","0","0","0","0","0","0","0","0"
"2001","Chestermere, Alberta, Royal Canadian Mounted Police, municipal","48005","Firearms and other offensive weapons (Part III Criminal Code)","0","0","0","0","0","0","0","0","0","0","0","0","0","0"
"2002","Chestermere, Alberta, Royal Canadian Mounted Police, municipal","48005","Firearms and other offensive weapons (Part III Criminal Code)","0","0","0","0","0","0","0","0","0","0","0","0","0","0"
"2003","Chestermere, Alberta, Royal Canadian Mounted Police, municipal","48005","Firearms and other offensive weapons (Part III Criminal Code)","0","0","0","0","0","0","0","0","0","0","0","0","0","0"
"2004","Chestermere, Alberta, Royal Canadian Mounted Police, municipal","48005","Firearms and other offensive weapons (Part III Criminal Code)","0","0","0","0","0","0","0","0","0","0","0","0","0","0"
"2005","Chestermere, Alberta, Royal Canadian Mounted Police, municipal","48005","Firearms and other offensive weapons (Part III Criminal Code)","2","0","1","0","23.09","0","28.28","244.2","0","1","0","2","2","0"
"2006","Chestermere, Alberta, Royal Canadian Mounted Police, municipal","48005","Firearms and other offensive weapons (Part III Criminal Code)","0","0","0","-100","0","0","0","0","0","0","0","0","0","0"
"2007","Chestermere, Alberta, Royal Canadian Mounted Police, municipal","48005","Firearms and other offensive weapons (Part III Criminal Code)","3","0","0","0","26.4","0","0","0","0","0","0","0","0","0"
"2008","Chestermere, Alberta, Royal Canadian Mounted Police, municipal","48005","Firearms and other offensive weapons (Part III Criminal Code)","8","0","1","144.88","64.66","0","0","0","169.78","1","0","0","0","2"
"2009","Chestermere, Alberta, Royal Canadian Mounted Police, municipal","48005","Firearms and other offensive weapons (Part III Criminal Code)","1","0","0","-88.49","7.44","0","0","0","0","0","0","0","0","0"
"2010","Chestermere, Alberta, Royal Canadian Mounted Police, municipal","48005","Firearms and other offensive weapons (Part III Criminal Code)","2","0","0","86.35","13.87","0","0","0","0","0","0","0","0","0"
"2011","Chestermere, Alberta, Royal Canadian Mounted Police, municipal","48005","Firearms and other offensive weapons (Part III Criminal Code)","0","0","0","-100","0","0","0","0","0","0","0","0","0","0"
"2012","Chestermere, Alberta, Royal Canadian Mounted Police, municipal","48005","Firearms and other offensive weapons (Part III Criminal Code)","0","0","0","0","0","0","0","0","0","0","0","0","0","0"
"2013","Chestermere, Alberta, Royal Canadian Mounted Police, municipal","48005","Firearms and other offensive weapons (Part III Criminal Code)","0","0","0","0","0","0","0","0","0","0","0","0","0","0"
"2014","Chestermere, Alberta, Royal Canadian Mounted Police, municipal","48005","Firearms and other offensive weapons (Part III Criminal Code)","0","0","0","0","0","0","0","0","0","0","0","0","0","0"
"2015","Chestermere, Alberta, Royal Canadian Mounted Police, municipal","48005","Firearms and other offensive weapons (Part III Criminal Code)","1","0","0","0","5.78","0","0","0","0","0","0","0","0","0"
"2016","Chestermere, Alberta, Royal Canadian Mounted Police, municipal","48005","Firearms and other offensive weapons (Part III Criminal Code)","1","0","0","-2.44","5.63","0","0","0","0","0","0","0","0","0"
"2012","Chestermere, Alberta, Royal Canadian Mounted Police, municipal","48005","Leaving Canada to participate in activity of terrorist group","0","0","0","0","0","0","0","0","0","0","0","0","0","0"
"2013","Chestermere, Alberta, Royal Canadian Mounted Police, municipal","48005","Leaving Canada to participate in activity of terrorist group","0","0","0","0","0","0","0","0","0","0","0","0","0","0"
"2014","Chestermere, Alberta, Royal Canadian Mounted Police, municipal","48005","Leaving Canada to participate in activity of terrorist group","0","0","0","0","0","0","0","0","0","0","0","0","0","0"
"2015","Chestermere, Alberta, Royal Canadian Mounted Police, municipal","48005","Leaving Canada to participate in activity of terrorist group","0","0","0","0","0","0","0","0","0","0","0","0","0","0"
"2016","Chestermere, Alberta, Royal Canadian Mounted Police, municipal","48005","Leaving Canada to participate in activity of terrorist group","0","0","0","0","0","0","0","0","0","0","0","0","0","0"
"2012","Chestermere, Alberta, Royal Canadian Mounted Police, municipal","48005","Leaving Canada to facilitate terrorist activity","0","0","0","0","0","0","0","0","0","0","0","0","0","0"
"2013","Chestermere, Alberta, Royal Canadian Mounted Police, municipal","48005","Leaving Canada to facilitate terrorist activity","0","0","0","0","0","0","0","0","0","0","0","0","0","0"
"2014","Chestermere, Alberta, Royal Canadian Mounted Police, municipal","48005","Leaving Canada to facilitate terrorist activity","0","0","0","0","0","0","0","0","0","0","0","0","0","0"
"2015","Chestermere, Alberta, Royal Canadian Mounted Police, municipal","48005","Leaving Canada to facilitate terrorist activity","0","0","0","0","0","0","0","0","0","0","0","0","0","0"
"2016","Chestermere, Alberta, Royal Canadian Mounted Police, municipal","48005","Leaving Canada to facilitate terrorist activity","0","0","0","0","0","0","0","0","0","0","0","0","0","0"
"2012","Chestermere, Alberta, Royal Canadian Mounted Police, municipal","48005","Leaving Canada to commit offence for terrorist group","0","0","0","0","0","0","0","0","0","0","0","0","0","0"
"2013","Chestermere, Alberta, Royal Canadian Mounted Police, municipal","48005","Leaving Canada to commit offence for terrorist group","0","0","0","0","0","0","0","0","0","0","0","0","0","0"
"2014","Chestermere, Alberta, Royal Canadian Mounted Police, municipal","48005","Leaving Canada to commit offence for terrorist group","0","0","0","0","0","0","0","0","0","0","0","0","0","0"
"2015","Chestermere, Alberta, Royal Canadian Mounted Police, municipal","48005","Leaving Canada to commit offence for terrorist group","0","0","0","0","0","0","0","0","0","0","0","0","0","0"
"2016","Chestermere, Alberta, Royal Canadian Mounted Police, municipal","48005","Leaving Canada to commit offence for terrorist group","0","0","0","0","0","0","0","0","0","0","0","0","0","0"
"2012","Chestermere, Alberta, Royal Canadian Mounted Police, municipal","48005","Leaving Canada to commit offence that is terrorist activity","0","0","0","0","0","0","0","0","0","0","0","0","0","0"
"2013","Chestermere, Alberta, Royal Canadian Mounted Police, municipal","48005","Leaving Canada to commit offence that is terrorist activity","0","0","0","0","0","0","0","0","0","0","0","0","0","0"
"2014","Chestermere, Alberta, Royal Canadian Mounted Police, municipal","48005","Leaving Canada to commit offence that is terrorist activity","0","0","0","0","0","0","0","0","0","0","0","0","0","0"
"2015","Chestermere, Alberta, Royal Canadian Mounted Police, municipal","48005","Leaving Canada to commit offence that is terrorist activity","0","0","0","0","0","0","0","0","0","0","0","0","0","0"
"2016","Chestermere, Alberta, Royal Canadian Mounted Police, municipal","48005","Leaving Canada to commit offence that is terrorist activity","0","0","0","0","0","0","0","0","0","0","0","0","0","0"
"2012","Chestermere, Alberta, Royal Canadian Mounted Police, municipal","48005","Concealing person who carried out terrorist activity that is a terrorism offence for which that person is liable to imprisonment for life","0","0","0","0","0","0","0","0","0","0","0","0","0","0"
"2013","Chestermere, Alberta, Royal Canadian Mounted Police, municipal","48005","Concealing person who carried out terrorist activity that is a terrorism offence for which that person is liable to imprisonment for life","0","0","0","0","0","0","0","0","0","0","0","0","0","0"
"2014","Chestermere, Alberta, Royal Canadian Mounted Police, municipal","48005","Concealing person who carried out terrorist activity that is a terrorism offence for which that person is liable to imprisonment for life","0","0","0","0","0","0","0","0","0","0","0","0","0","0"
"2015","Chestermere, Alberta, Royal Canadian Mounted Police, municipal","48005","Concealing person who carried out terrorist activity that is a terrorism offence for which that person is liable to imprisonment for life","0","0","0","0","0","0","0","0","0","0","0","0","0","0"
"2016","Chestermere, Alberta, Royal Canadian Mounted Police, municipal","48005","Concealing person who carried out terrorist activity that is a terrorism offence for which that person is liable to imprisonment for life","0","0","0","0","0","0","0","0","0","0","0","0","0","0"
"2012","Chestermere, Alberta, Royal Canadian Mounted Police, municipal","48005","Concealing person who carried out terrorist activity that is a terrorism offence for which that person is liable to any punishment other than life","0","0","0","0","0","0","0","0","0","0","0","0","0","0"
"2013","Chestermere, Alberta, Royal Canadian Mounted Police, municipal","48005","Concealing person who carried out terrorist activity that is a terrorism offence for which that person is liable to any punishment other than life","0","0","0","0","0","0","0","0","0","0","0","0","0","0"
"2014","Chestermere, Alberta, Royal Canadian Mounted Police, municipal","48005","Concealing person who carried out terrorist activity that is a terrorism offence for which that person is liable to any punishment other than life","0","0","0","0","0","0","0","0","0","0","0","0","0","0"
"2015","Chestermere, Alberta, Royal Canadian Mounted Police, municipal","48005","Concealing person who carried out terrorist activity that is a terrorism offence for which that person is liable to any punishment other than life","0","0","0","0","0","0","0","0","0","0","0","0","0","0"
"2016","Chestermere, Alberta, Royal Canadian Mounted Police, municipal","48005","Concealing person who carried out terrorist activity that is a terrorism offence for which that person is liable to any punishment other than life","0","0","0","0","0","0","0","0","0","0","0","0","0","0"
"2012","Chestermere, Alberta, Royal Canadian Mounted Police, municipal","48005","Concealing person who is likely to carry out terrorist activity","0","0","0","0","0","0","0","0","0","0","0","0","0","0"
"2013","Chestermere, Alberta, Royal Canadian Mounted Police, municipal","48005","Concealing person who is likely to carry out terrorist activity","0","0","0","0","0","0","0","0","0","0","0","0","0","0"
"2014","Chestermere, Alberta, Royal Canadian Mounted Police, municipal","48005","Concealing person who is likely to carry out terrorist activity","0","0","0","0","0","0","0","0","0","0","0","0","0","0"
"2015","Chestermere, Alberta, Royal Canadian Mounted Police, municipal","48005","Concealing person who is likely to carry out terrorist activity","0","0","0","0","0","0","0","0","0","0","0","0","0","0"
"2016","Chestermere, Alberta, Royal Canadian Mounted Police, municipal","48005","Concealing person who is likely to carry out terrorist activity","0","0","0","0","0","0","0","0","0","0","0","0","0","0"
"1998","Chestermere, Alberta, Royal Canadian Mounted Police, municipal","48005","Sexual offences, public morals and disorderly conduct (Part V Criminal Code)","0","0","0","0","0","0","0","0","0","0","0","0","0","0"
"1999","Chestermere, Alberta, Royal Canadian Mounted Police, municipal","48005","Sexual offences, public morals and disorderly conduct (Part V Criminal Code)","0","0","0","0","0","0","0","0","0","0","0","0","0","0"
"2000","Chestermere, Alberta, Royal Canadian Mounted Police, municipal","48005","Sexual offences, public morals and disorderly conduct (Part V Criminal Code)","0","0","0","0","0","0","0","0","0","0","0","0","0","0"
"2001","Chestermere, Alberta, Royal Canadian Mounted Police, municipal","48005","Sexual offences, public morals and disorderly conduct (Part V Criminal Code)","0","0","0","0","0","0","0","0","0","0","0","0","0","0"
"2002","Chestermere, Alberta, Royal Canadian Mounted Police, municipal","48005","Sexual offences, public morals and disorderly conduct (Part V Criminal Code)","0","0","0","0","0","0","0","0","0","0","0","0","0","0"
"2003","Chestermere, Alberta, Royal Canadian Mounted Police, municipal","48005","Sexual offences, public morals and disorderly conduct (Part V Criminal Code)","0","0","0","0","0","0","0","0","0","0","0","0","0","0"
"2004","Chestermere, Alberta, Royal Canadian Mounted Police, municipal","48005","Sexual offences, public morals and disorderly conduct (Part V Criminal Code)","0","0","0","0","0","0","0","0","0","0","0","0","0","0"
"2005","Chestermere, Alberta, Royal Canadian Mounted Police, municipal","48005","Sexual offences, public morals and disorderly conduct (Part V Criminal Code)","0","0","0","0","0","0","0","0","0","0","0","0","0","0"
"2006","Chestermere, Alberta, Royal Canadian Mounted Police, municipal","48005","Sexual offences, public morals and disorderly conduct (Part V Criminal Code)","0","0","0","0","0","0","0","0","0","0","0","0","0","0"
"2007","Chestermere, Alberta, Royal Canadian Mounted Police, municipal","48005","Sexual offences, public morals and disorderly conduct (Part V Criminal Code)","0","0","0","0","0","0","0","0","0","0","0","0","0","0"
"2008","Chestermere, Alberta, Royal Canadian Mounted Police, municipal","48005","Sexual offences, public morals and disorderly conduct (Part V Criminal Code)","0","0","0","0","0","0","0","0","0","0","0","0","0","0"
"2009","Chestermere, Alberta, Royal Canadian Mounted Police, municipal","48005","Sexual offences, public morals and disorderly conduct (Part V Criminal Code)","0","0","0","0","0","0","0","0","0","0","0","0","0","0"
"2010","Chestermere, Alberta, Royal Canadian Mounted Police, municipal","48005","Sexual offences, public morals and disorderly conduct (Part V Criminal Code)","0","0","0","0","0","0","0","0","0","0","0","0","0","0"
"2011","Chestermere, Alberta, Royal Canadian Mounted Police, municipal","48005","Sexual offences, public morals and disorderly conduct (Part V Criminal Code)","0","0","0","0","0","0","0","0","0","0","0","0","0","0"
"2012","Chestermere, Alberta, Royal Canadian Mounted Police, municipal","48005","Sexual offences, public morals and disorderly conduct (Part V Criminal Code)","0","0","0","0","0","0","0","0","0","0","0","0","0","0"
"2013","Chestermere, Alberta, Royal Canadian Mounted Police, municipal","48005","Sexual offences, public morals and disorderly conduct (Part V Criminal Code)","0","0","0","0","0","0","0","0","0","0","0","0","0","0"
"2014","Chestermere, Alberta, Royal Canadian Mounted Police, municipal","48005","Sexual offences, public morals and disorderly conduct (Part V Criminal Code)","0","0","0","0","0","0","0","0","0","0","0","0","0","0"
"2015","Chestermere, Alberta, Royal Canadian Mounted Police, municipal","48005","Sexual offences, public morals and disorderly conduct (Part V Criminal Code)","0","0","0","0","0","0","0","0","0","0","0","0","0","0"
"2016","Chestermere, Alberta, Royal Canadian Mounted Police, municipal","48005","Sexual offences, public morals and disorderly conduct (Part V Criminal Code)","0","0","0","0","0","0","0","0","0","0","0","0","0","0"
"1998","Chestermere, Alberta, Royal Canadian Mounted Police, municipal","48005","Invasion of privacy (Part VI Criminal Code)","0","0","0","0","0","0","0","0","0","0","0","0","0","0"
"1999","Chestermere, Alberta, Royal Canadian Mounted Police, municipal","48005","Invasion of privacy (Part VI Criminal Code)","0","0","0","0","0","0","0","0","0","0","0","0","0","0"
"2000","Chestermere, Alberta, Royal Canadian Mounted Police, municipal","48005","Invasion of privacy (Part VI Criminal Code)","0","0","0","0","0","0","0","0","0","0","0","0","0","0"
"2001","Chestermere, Alberta, Royal Canadian Mounted Police, municipal","48005","Invasion of privacy (Part VI Criminal Code)","0","0","0","0","0","0","0","0","0","0","0","0","0","0"
"2002","Chestermere, Alberta, Royal Canadian Mounted Police, municipal","48005","Invasion of privacy (Part VI Criminal Code)","0","0","0","0","0","0","0","0","0","0","0","0","0","0"
"2003","Chestermere, Alberta, Royal Canadian Mounted Police, municipal","48005","Invasion of privacy (Part VI Criminal Code)","0","0","0","0","0","0","0","0","0","0","0","0","0","0"
"2004","Chestermere, Alberta, Royal Canadian Mounted Police, municipal","48005","Invasion of privacy (Part VI Criminal Code)","0","0","0","0","0","0","0","0","0","0","0","0","0","0"
"2005","Chestermere, Alberta, Royal Canadian Mounted Police, municipal","48005","Invasion of privacy (Part VI Criminal Code)","0","0","0","0","0","0","0","0","0","0","0","0","0","0"
"2006","Chestermere, Alberta, Royal Canadian Mounted Police, municipal","48005","Invasion of privacy (Part VI Criminal Code)","0","0","0","0","0","0","0","0","0","0","0","0","0","0"
"2007","Chestermere, Alberta, Royal Canadian Mounted Police, municipal","48005","Invasion of privacy (Part VI Criminal Code)","0","0","0","0","0","0","0","0","0","0","0","0","0","0"
"2008","Chestermere, Alberta, Royal Canadian Mounted Police, municipal","48005","Invasion of privacy (Part VI Criminal Code)","0","0","0","0","0","0","0","0","0","0","0","0","0","0"
"2009","Chestermere, Alberta, Royal Canadian Mounted Police, municipal","48005","Invasion of privacy (Part VI Criminal Code)","0","0","0","0","0","0","0","0","0","0","0","0","0","0"
"2010","Chestermere, Alberta, Royal Canadian Mounted Police, municipal","48005","Invasion of privacy (Part VI Criminal Code)","0","0","0","0","0","0","0","0","0","0","0","0","0","0"
"2011","Chestermere, Alberta, Royal Canadian Mounted Police, municipal","48005","Invasion of privacy (Part VI Criminal Code)","0","0","0","0","0","0","0","0","0","0","0","0","0","0"
"2012","Chestermere, Alberta, Royal Canadian Mounted Police, municipal","48005","Invasion of privacy (Part VI Criminal Code)","0","0","0","0","0","0","0","0","0","0","0","0","0","0"
"2013","Chestermere, Alberta, Royal Canadian Mounted Police, municipal","48005","Invasion of privacy (Part VI Criminal Code)","0","0","0","0","0","0","0","0","0","0","0","0","0","0"
"2014","Chestermere, Alberta, Royal Canadian Mounted Police, municipal","48005","Invasion of privacy (Part VI Criminal Code)","0","0","0","0","0","0","0","0","0","0","0","0","0","0"
"2015","Chestermere, Alberta, Royal Canadian Mounted Police, municipal","48005","Invasion of privacy (Part VI Criminal Code)","0","0","0","0","0","0","0","0","0","0","0","0","0","0"
"2016","Chestermere, Alberta, Royal Canadian Mounted Police, municipal","48005","Invasion of privacy (Part VI Criminal Code)","0","0","0","0","0","0","0","0","0","0","0","0","0","0"
"1998","Chestermere, Alberta, Royal Canadian Mounted Police, municipal","48005","Disorderly houses, gaming and betting","0","0","0","0","0","0","0","0","0","0","0","0","0","0"
"1999","Chestermere, Alberta, Royal Canadian Mounted Police, municipal","48005","Disorderly houses, gaming and betting","0","0","0","0","0","0","0","0","0","0","0","0","0","0"
"2000","Chestermere, Alberta, Royal Canadian Mounted Police, municipal","48005","Disorderly houses, gaming and betting","0","0","0","0","0","0","0","0","0","0","0","0","0","0"
"2001","Chestermere, Alberta, Royal Canadian Mounted Police, municipal","48005","Disorderly houses, gaming and betting","0","0","0","0","0","0","0","0","0","0","0","0","0","0"
"2002","Chestermere, Alberta, Royal Canadian Mounted Police, municipal","48005","Disorderly houses, gaming and betting","0","0","0","0","0","0","0","0","0","0","0","0","0","0"
"2003","Chestermere, Alberta, Royal Canadian Mounted Police, municipal","48005","Disorderly houses, gaming and betting","0","0","0","0","0","0","0","0","0","0","0","0","0","0"
"2004","Chestermere, Alberta, Royal Canadian Mounted Police, municipal","48005","Disorderly houses, gaming and betting","0","0","0","0","0","0","0","0","0","0","0","0","0","0"
"2005","Chestermere, Alberta, Royal Canadian Mounted Police, municipal","48005","Disorderly houses, gaming and betting","0","0","0","0","0","0","0","0","0","0","0","0","0","0"
"2006","Chestermere, Alberta, Royal Canadian Mounted Police, municipal","48005","Disorderly houses, gaming and betting","0","0","0","0","0","0","0","0","0","0","0","0","0","0"
"2007","Chestermere, Alberta, Royal Canadian Mounted Police, municipal","48005","Disorderly houses, gaming and betting","0","0","0","0","0","0","0","0","0","0","0","0","0","0"
"2008","Chestermere, Alberta, Royal Canadian Mounted Police, municipal","48005","Disorderly houses, gaming and betting","0","0","0","0","0","0","0","0","0","0","0","0","0","0"
"2009","Chestermere, Alberta, Royal Canadian Mounted Police, municipal","48005","Disorderly houses, gaming and betting","0","0","0","0","0","0","0","0","0","0","0","0","0","0"
"2010","Chestermere, Alberta, Royal Canadian Mounted Police, municipal","48005","Disorderly houses, gaming and betting","0","0","0","0","0","0","0","0","0","0","0","0","0","0"
"2011","Chestermere, Alberta, Royal Canadian Mounted Police, municipal","48005","Disorderly houses, gaming and betting","0","0","0","0","0","0","0","0","0","0","0","0","0","0"
"2012","Chestermere, Alberta, Royal Canadian Mounted Police, municipal","48005","Disorderly houses, gaming and betting","0","0","0","0","0","0","0","0","0","0","0","0","0","0"
"2013","Chestermere, Alberta, Royal Canadian Mounted Police, municipal","48005","Disorderly houses, gaming and betting","0","0","0","0","0","0","0","0","0","0","0","0","0","0"
"2014","Chestermere, Alberta, Royal Canadian Mounted Police, municipal","48005","Disorderly houses, gaming and betting","0","0","0","0","0","0","0","0","0","0","0","0","0","0"
"2015","Chestermere, Alberta, Royal Canadian Mounted Police, municipal","48005","Disorderly houses, gaming and betting","0","0","0","0","0","0","0","0","0","0","0","0","0","0"
"2016","Chestermere, Alberta, Royal Canadian Mounted Police, municipal","48005","Disorderly houses, gaming and betting","0","0","0","0","0","0","0","0","0","0","0","0","0","0"
"1998","Chestermere, Alberta, Royal Canadian Mounted Police, municipal","48005","Offences against the person and reputation (Part VIII Criminal Code)","0","0","0","0","0","0","0","0","0","0","0","0","0","0"
"1999","Chestermere, Alberta, Royal Canadian Mounted Police, municipal","48005","Offences against the person and reputation (Part VIII Criminal Code)","0","0","0","0","0","0","0","0","0","0","0","0","0","0"
"2000","Chestermere, Alberta, Royal Canadian Mounted Police, municipal","48005","Offences against the person and reputation (Part VIII Criminal Code)","0","0","0","0","0","0","0","0","0","0","0","0","0","0"
"2001","Chestermere, Alberta, Royal Canadian Mounted Police, municipal","48005","Offences against the person and reputation (Part VIII Criminal Code)","0","0","0","0","0","0","0","0","0","0","0","0","0","0"
"2002","Chestermere, Alberta, Royal Canadian Mounted Police, municipal","48005","Offences against the person and reputation (Part VIII Criminal Code)","0","0","0","0","0","0","0","0","0","0","0","0","0","0"
"2003","Chestermere, Alberta, Royal Canadian Mounted Police, municipal","48005","Offences against the person and reputation (Part VIII Criminal Code)","0","0","0","0","0","0","0","0","0","0","0","0","0","0"
"2004","Chestermere, Alberta, Royal Canadian Mounted Police, municipal","48005","Offences against the person and reputation (Part VIII Criminal Code)","0","0","0","0","0","0","0","0","0","0","0","0","0","0"
"2005","Chestermere, Alberta, Royal Canadian Mounted Police, municipal","48005","Offences against the person and reputation (Part VIII Criminal Code)","0","0","0","0","0","0","0","0","0","0","0","0","0","0"
"2006","Chestermere, Alberta, Royal Canadian Mounted Police, municipal","48005","Offences against the person and reputation (Part VIII Criminal Code)","1","0","1","0","9.62","0","0","0","0","1","0","0","0","0"
"2007","Chestermere, Alberta, Royal Canadian Mounted Police, municipal","48005","Offences against the person and reputation (Part VIII Criminal Code)","0","0","0","-100","0","0","0","0","0","0","0","0","0","0"
"2008","Chestermere, Alberta, Royal Canadian Mounted Police, municipal","48005","Offences against the person and reputation (Part VIII Criminal Code)","1","1","0","0","8.08","11.28","9.96","0","0","1","1","1","0","0"
"2009","Chestermere, Alberta, Royal Canadian Mounted Police, municipal","48005","Offences against the person and reputation (Part VIII Criminal Code)","2","0","2","84.22","14.89","0","0","0","79.3","2","0","0","0","1"
"2010","Chestermere, Alberta, Royal Canadian Mounted Police, municipal","48005","Offences against the person and reputation (Part VIII Criminal Code)","0","0","0","-100","0","0","0","0","0","0","0","0","0","0"
"2011","Chestermere, Alberta, Royal Canadian Mounted Police, municipal","48005","Offences against the person and reputation (Part VIII Criminal Code)","0","0","0","0","0","0","0","0","0","0","0","0","0","0"
"2012","Chestermere, Alberta, Royal Canadian Mounted Police, municipal","48005","Offences against the person and reputation (Part VIII Criminal Code)","0","0","0","0","0","0","0","0","0","0","0","0","0","0"
"2013","Chestermere, Alberta, Royal Canadian Mounted Police, municipal","48005","Offences against the person and reputation (Part VIII Criminal Code)","1","0","0","0","6.1","0","0","0","0","0","0","0","0","0"
"2014","Chestermere, Alberta, Royal Canadian Mounted Police, municipal","48005","Offences against the person and reputation (Part VIII Criminal Code)","0","0","0","-100","0","0","0","0","0","0","0","0","0","0"
"2015","Chestermere, Alberta, Royal Canadian Mounted Police, municipal","48005","Offences against the person and reputation (Part VIII Criminal Code)","0","0","0","0","0","0","0","0","0","0","0","0","0","0"
"2016","Chestermere, Alberta, Royal Canadian Mounted Police, municipal","48005","Offences against the person and reputation (Part VIII Criminal Code)","0","0","0","0","0","0","0","0","0","0","0","0","0","0"
"2012","Chestermere, Alberta, Royal Canadian Mounted Police, municipal","48005","Failure to comply with the regulations/obligations for medical assistance in dying","0","0","0","0","0","0","0","0","0","0","0","0","0","0"
"2013","Chestermere, Alberta, Royal Canadian Mounted Police, municipal","48005","Failure to comply with the regulations/obligations for medical assistance in dying","0","0","0","0","0","0","0","0","0","0","0","0","0","0"
"2014","Chestermere, Alberta, Royal Canadian Mounted Police, municipal","48005","Failure to comply with the regulations/obligations for medical assistance in dying","0","0","0","0","0","0","0","0","0","0","0","0","0","0"
"2015","Chestermere, Alberta, Royal Canadian Mounted Police, municipal","48005","Failure to comply with the regulations/obligations for medical assistance in dying","0","0","0","0","0","0","0","0","0","0","0","0","0","0"
"2016","Chestermere, Alberta, Royal Canadian Mounted Police, municipal","48005","Failure to comply with the regulations/obligations for medical assistance in dying","0","0","0","0","0","0","0","0","0","0","0","0","0","0"
"1998","Chestermere, Alberta, Royal Canadian Mounted Police, municipal","48005","Offences against rights of property (Part IX Criminal Code)","0","0","0","0","0","0","0","0","0","0","0","0","0","0"
"1999","Chestermere, Alberta, Royal Canadian Mounted Police, municipal","48005","Offences against rights of property (Part IX Criminal Code)","0","0","0","0","0","0","0","0","0","0","0","0","0","0"
"2000","Chestermere, Alberta, Royal Canadian Mounted Police, municipal","48005","Offences against rights of property (Part IX Criminal Code)","0","0","0","0","0","0","0","0","0","0","0","0","0","0"
"2001","Chestermere, Alberta, Royal Canadian Mounted Police, municipal","48005","Offences against rights of property (Part IX Criminal Code)","0","0","0","0","0","0","0","0","0","0","0","0","0","0"
"2002","Chestermere, Alberta, Royal Canadian Mounted Police, municipal","48005","Offences against rights of property (Part IX Criminal Code)","0","0","0","0","0","0","0","0","0","0","0","0","0","0"
"2003","Chestermere, Alberta, Royal Canadian Mounted Police, municipal","48005","Offences against rights of property (Part IX Criminal Code)","0","0","0","0","0","0","0","0","0","0","0","0","0","0"
"2004","Chestermere, Alberta, Royal Canadian Mounted Police, municipal","48005","Offences against rights of property (Part IX Criminal Code)","0","0","0","0","0","0","0","0","0","0","0","0","0","0"
"2005","Chestermere, Alberta, Royal Canadian Mounted Police, municipal","48005","Offences against rights of property (Part IX Criminal Code)","0","0","0","0","0","0","0","0","0","0","0","0","0","0"
"2006","Chestermere, Alberta, Royal Canadian Mounted Police, municipal","48005","Offences against rights of property (Part IX Criminal Code)","1","0","0","0","9.62","0","0","0","0","0","0","0","0","0"
"2007","Chestermere, Alberta, Royal Canadian Mounted Police, municipal","48005","Offences against rights of property (Part IX Criminal Code)","0","0","0","-100","0","0","0","0","0","0","0","0","0","0"
"2008","Chestermere, Alberta, Royal Canadian Mounted Police, municipal","48005","Offences against rights of property (Part IX Criminal Code)","1","0","0","0","8.08","0","0","0","0","0","0","0","0","0"
"2009","Chestermere, Alberta, Royal Canadian Mounted Police, municipal","48005","Offences against rights of property (Part IX Criminal Code)","0","0","0","-100","0","0","0","0","0","0","0","0","0","0"
"2010","Chestermere, Alberta, Royal Canadian Mounted Police, municipal","48005","Offences against rights of property (Part IX Criminal Code)","0","0","0","0","0","0","0","0","0","0","0","0","0","0"
"2011","Chestermere, Alberta, Royal Canadian Mounted Police, municipal","48005","Offences against rights of property (Part IX Criminal Code)","0","0","0","0","0","0","0","0","0","0","0","0","0","0"
"2012","Chestermere, Alberta, Royal Canadian Mounted Police, municipal","48005","Offences against rights of property (Part IX Criminal Code)","0","0","0","0","0","0","0","0","0","0","0","0","0","0"
"2013","Chestermere, Alberta, Royal Canadian Mounted Police, municipal","48005","Offences against rights of property (Part IX Criminal Code)","0","0","0","0","0","0","0","0","0","0","0","0","0","0"
"2014","Chestermere, Alberta, Royal Canadian Mounted Police, municipal","48005","Offences against rights of property (Part IX Criminal Code)","0","0","0","0","0","0","0","0","0","0","0","0","0","0"
"2015","Chestermere, Alberta, Royal Canadian Mounted Police, municipal","48005","Offences against rights of property (Part IX Criminal Code)","0","0","0","0","0","0","0","0","0","0","0","0","0","0"
"2016","Chestermere, Alberta, Royal Canadian Mounted Police, municipal","48005","Offences against rights of property (Part IX Criminal Code)","0","0","0","0","0","0","0","0","0","0","0","0","0","0"
"1998","Chestermere, Alberta, Royal Canadian Mounted Police, municipal","48005","Fraudulent transactions relating to contracts and trade (Part X Criminal Code)","0","0","0","0","0","0","0","0","0","0","0","0","0","0"
"1999","Chestermere, Alberta, Royal Canadian Mounted Police, municipal","48005","Fraudulent transactions relating to contracts and trade (Part X Criminal Code)","0","0","0","0","0","0","0","0","0","0","0","0","0","0"
"2000","Chestermere, Alberta, Royal Canadian Mounted Police, municipal","48005","Fraudulent transactions relating to contracts and trade (Part X Criminal Code)","0","0","0","0","0","0","0","0","0","0","0","0","0","0"
"2001","Chestermere, Alberta, Royal Canadian Mounted Police, municipal","48005","Fraudulent transactions relating to contracts and trade (Part X Criminal Code)","0","0","0","0","0","0","0","0","0","0","0","0","0","0"
"2002","Chestermere, Alberta, Royal Canadian Mounted Police, municipal","48005","Fraudulent transactions relating to contracts and trade (Part X Criminal Code)","0","0","0","0","0","0","0","0","0","0","0","0","0","0"
"2003","Chestermere, Alberta, Royal Canadian Mounted Police, municipal","48005","Fraudulent transactions relating to contracts and trade (Part X Criminal Code)","0","0","0","0","0","0","0","0","0","0","0","0","0","0"
"2004","Chestermere, Alberta, Royal Canadian Mounted Police, municipal","48005","Fraudulent transactions relating to contracts and trade (Part X Criminal Code)","0","0","0","0","0","0","0","0","0","0","0","0","0","0"
"2005","Chestermere, Alberta, Royal Canadian Mounted Police, municipal","48005","Fraudulent transactions relating to contracts and trade (Part X Criminal Code)","0","0","0","0","0","0","0","0","0","0","0","0","0","0"
"2006","Chestermere, Alberta, Royal Canadian Mounted Police, municipal","48005","Fraudulent transactions relating to contracts and trade (Part X Criminal Code)","0","0","0","0","0","0","0","0","0","0","0","0","0","0"
"2007","Chestermere, Alberta, Royal Canadian Mounted Police, municipal","48005","Fraudulent transactions relating to contracts and trade (Part X Criminal Code)","0","0","0","0","0","0","0","0","0","0","0","0","0","0"
"2008","Chestermere, Alberta, Royal Canadian Mounted Police, municipal","48005","Fraudulent transactions relating to contracts and trade (Part X Criminal Code)","0","0","0","0","0","0","0","0","0","0","0","0","0","0"
"2009","Chestermere, Alberta, Royal Canadian Mounted Police, municipal","48005","Fraudulent transactions relating to contracts and trade (Part X Criminal Code)","0","0","0","0","0","0","0","0","0","0","0","0","0","0"
"2010","Chestermere, Alberta, Royal Canadian Mounted Police, municipal","48005","Fraudulent transactions relating to contracts and trade (Part X Criminal Code)","0","0","0","0","0","0","0","0","0","0","0","0","0","0"
"2011","Chestermere, Alberta, Royal Canadian Mounted Police, municipal","48005","Fraudulent transactions relating to contracts and trade (Part X Criminal Code)","0","0","0","0","0","0","0","0","0","0","0","0","0","0"
"2012","Chestermere, Alberta, Royal Canadian Mounted Police, municipal","48005","Fraudulent transactions relating to contracts and trade (Part X Criminal Code)","0","0","0","0","0","0","0","0","0","0","0","0","0","0"
"2013","Chestermere, Alberta, Royal Canadian Mounted Police, municipal","48005","Fraudulent transactions relating to contracts and trade (Part X Criminal Code)","0","0","0","0","0","0","0","0","0","0","0","0","0","0"
"2014","Chestermere, Alberta, Royal Canadian Mounted Police, municipal","48005","Fraudulent transactions relating to contracts and trade (Part X Criminal Code)","0","0","0","0","0","0","0","0","0","0","0","0","0","0"
"2015","Chestermere, Alberta, Royal Canadian Mounted Police, municipal","48005","Fraudulent transactions relating to contracts and trade (Part X Criminal Code)","0","0","0","0","0","0","0","0","0","0","0","0","0","0"
"2016","Chestermere, Alberta, Royal Canadian Mounted Police, municipal","48005","Fraudulent transactions relating to contracts and trade (Part X Criminal Code)","0","0","0","0","0","0","0","0","0","0","0","0","0","0"
"1998","Chestermere, Alberta, Royal Canadian Mounted Police, municipal","48005","Willful and forbidden acts in respect of certain property (Part XI Criminal Code)","0","0","0","0","0","0","0","0","0","0","0","0","0","0"
"1999","Chestermere, Alberta, Royal Canadian Mounted Police, municipal","48005","Willful and forbidden acts in respect of certain property (Part XI Criminal Code)","0","0","0","0","0","0","0","0","0","0","0","0","0","0"
"2000","Chestermere, Alberta, Royal Canadian Mounted Police, municipal","48005","Willful and forbidden acts in respect of certain property (Part XI Criminal Code)","0","0","0","0","0","0","0","0","0","0","0","0","0","0"
"2001","Chestermere, Alberta, Royal Canadian Mounted Police, municipal","48005","Willful and forbidden acts in respect of certain property (Part XI Criminal Code)","0","0","0","0","0","0","0","0","0","0","0","0","0","0"
"2002","Chestermere, Alberta, Royal Canadian Mounted Police, municipal","48005","Willful and forbidden acts in respect of certain property (Part XI Criminal Code)","0","0","0","0","0","0","0","0","0","0","0","0","0","0"
"2003","Chestermere, Alberta, Royal Canadian Mounted Police, municipal","48005","Willful and forbidden acts in respect of certain property (Part XI Criminal Code)","0","0","0","0","0","0","0","0","0","0","0","0","0","0"
"2004","Chestermere, Alberta, Royal Canadian Mounted Police, municipal","48005","Willful and forbidden acts in respect of certain property (Part XI Criminal Code)","0","0","0","0","0","0","0","0","0","0","0","0","0","0"
"2005","Chestermere, Alberta, Royal Canadian Mounted Police, municipal","48005","Willful and forbidden acts in respect of certain property (Part XI Criminal Code)","0","0","0","0","0","0","0","0","0","0","0","0","0","0"
"2006","Chestermere, Alberta, Royal Canadian Mounted Police, municipal","48005","Willful and forbidden acts in respect of certain property (Part XI Criminal Code)","1","0","0","0","9.62","0","0","0","0","0","0","0","0","0"
"2007","Chestermere, Alberta, Royal Canadian Mounted Police, municipal","48005","Willful and forbidden acts in respect of certain property (Part XI Criminal Code)","4","0","2","265.78","35.21","0","0","0","0","2","0","0","0","0"
"2008","Chestermere, Alberta, Royal Canadian Mounted Police, municipal","48005","Willful and forbidden acts in respect of certain property (Part XI Criminal Code)","3","0","2","-31.13","24.25","0","0","0","0","2","0","0","0","0"
"2009","Chestermere, Alberta, Royal Canadian Mounted Police, municipal","48005","Willful and forbidden acts in respect of certain property (Part XI Criminal Code)","1","0","1","-69.3","7.44","0","0","0","0","1","0","0","0","0"
"2010","Chestermere, Alberta, Royal Canadian Mounted Police, municipal","48005","Willful and forbidden acts in respect of certain property (Part XI Criminal Code)","2","0","1","86.35","13.87","0","0","0","73.64","1","0","0","0","1"
"2011","Chestermere, Alberta, Royal Canadian Mounted Police, municipal","48005","Willful and forbidden acts in respect of certain property (Part XI Criminal Code)","1","1","0","-53.15","6.5","9.06","8.05","0","0","1","1","1","0","0"
"2012","Chestermere, Alberta, Royal Canadian Mounted Police, municipal","48005","Willful and forbidden acts in respect of certain property (Part XI Criminal Code)","3","0","1","191.27","18.93","0","0","0","0","1","0","0","0","0"
"2013","Chestermere, Alberta, Royal Canadian Mounted Police, municipal","48005","Willful and forbidden acts in respect of certain property (Part XI Criminal Code)","0","0","0","-100","0","0","0","0","0","0","0","0","0","0"
"2014","Chestermere, Alberta, Royal Canadian Mounted Police, municipal","48005","Willful and forbidden acts in respect of certain property (Part XI Criminal Code)","3","0","1","0","17.71","0","0","0","0","1","0","0","0","0"
"2015","Chestermere, Alberta, Royal Canadian Mounted Police, municipal","48005","Willful and forbidden acts in respect of certain property (Part XI Criminal Code)","2","0","0","-34.8","11.55","0","0","0","0","0","0","0","0","0"
"2016","Chestermere, Alberta, Royal Canadian Mounted Police, municipal","48005","Willful and forbidden acts in respect of certain property (Part XI Criminal Code)","3","0","2","46.34","16.9","0","0","0","138.41","2","0","0","0","2"
"1998","Chestermere, Alberta, Royal Canadian Mounted Police, municipal","48005","Offences relating to currency (Part XII Criminal Code)","0","0","0","0","0","0","0","0","0","0","0","0","0","0"
"1999","Chestermere, Alberta, Royal Canadian Mounted Police, municipal","48005","Offences relating to currency (Part XII Criminal Code)","0","0","0","0","0","0","0","0","0","0","0","0","0","0"
"2000","Chestermere, Alberta, Royal Canadian Mounted Police, municipal","48005","Offences relating to currency (Part XII Criminal Code)","0","0","0","0","0","0","0","0","0","0","0","0","0","0"
"2001","Chestermere, Alberta, Royal Canadian Mounted Police, municipal","48005","Offences relating to currency (Part XII Criminal Code)","0","0","0","0","0","0","0","0","0","0","0","0","0","0"
"2002","Chestermere, Alberta, Royal Canadian Mounted Police, municipal","48005","Offences relating to currency (Part XII Criminal Code)","0","0","0","0","0","0","0","0","0","0","0","0","0","0"
"2003","Chestermere, Alberta, Royal Canadian Mounted Police, municipal","48005","Offences relating to currency (Part XII Criminal Code)","0","0","0","0","0","0","0","0","0","0","0","0","0","0"
"2004","Chestermere, Alberta, Royal Canadian Mounted Police, municipal","48005","Offences relating to currency (Part XII Criminal Code)","0","0","0","0","0","0","0","0","0","0","0","0","0","0"
"2005","Chestermere, Alberta, Royal Canadian Mounted Police, municipal","48005","Offences relating to currency (Part XII Criminal Code)","0","0","0","0","0","0","0","0","0","0","0","0","0","0"
"2006","Chestermere, Alberta, Royal Canadian Mounted Police, municipal","48005","Offences relating to currency (Part XII Criminal Code)","0","0","0","0","0","0","0","0","0","0","0","0","0","0"
"2007","Chestermere, Alberta, Royal Canadian Mounted Police, municipal","48005","Offences relating to currency (Part XII Criminal Code)","0","0","0","0","0","0","0","0","0","0","0","0","0","0"
"2008","Chestermere, Alberta, Royal Canadian Mounted Police, municipal","48005","Offences relating to currency (Part XII Criminal Code)","0","0","0","0","0","0","0","0","0","0","0","0","0","0"
"2009","Chestermere, Alberta, Royal Canadian Mounted Police, municipal","48005","Offences relating to currency (Part XII Criminal Code)","0","0","0","0","0","0","0","0","0","0","0","0","0","0"
"2010","Chestermere, Alberta, Royal Canadian Mounted Police, municipal","48005","Offences relating to currency (Part XII Criminal Code)","0","0","0","0","0","0","0","0","0","0","0","0","0","0"
"2011","Chestermere, Alberta, Royal Canadian Mounted Police, municipal","48005","Offences relating to currency (Part XII Criminal Code)","0","0","0","0","0","0","0","0","0","0","0","0","0","0"
"2012","Chestermere, Alberta, Royal Canadian Mounted Police, municipal","48005","Offences relating to currency (Part XII Criminal Code)","0","0","0","0","0","0","0","0","0","0","0","0","0","0"
"2013","Chestermere, Alberta, Royal Canadian Mounted Police, municipal","48005","Offences relating to currency (Part XII Criminal Code)","0","0","0","0","0","0","0","0","0","0","0","0","0","0"
"2014","Chestermere, Alberta, Royal Canadian Mounted Police, municipal","48005","Offences relating to currency (Part XII Criminal Code)","0","0","0","0","0","0","0","0","0","0","0","0","0","0"
"2015","Chestermere, Alberta, Royal Canadian Mounted Police, municipal","48005","Offences relating to currency (Part XII Criminal Code)","0","0","0","0","0","0","0","0","0","0","0","0","0","0"
"2016","Chestermere, Alberta, Royal Canadian Mounted Police, municipal","48005","Offences relating to currency (Part XII Criminal Code)","0","0","0","0","0","0","0","0","0","0","0","0","0","0"
"1998","Chestermere, Alberta, Royal Canadian Mounted Police, municipal","48005","Proceeds of crime (Part XII.2 Criminal Code)","0","0","0","0","0","0","0","0","0","0","0","0","0","0"
"1999","Chestermere, Alberta, Royal Canadian Mounted Police, municipal","48005","Proceeds of crime (Part XII.2 Criminal Code)","0","0","0","0","0","0","0","0","0","0","0","0","0","0"
"2000","Chestermere, Alberta, Royal Canadian Mounted Police, municipal","48005","Proceeds of crime (Part XII.2 Criminal Code)","0","0","0","0","0","0","0","0","0","0","0","0","0","0"
"2001","Chestermere, Alberta, Royal Canadian Mounted Police, municipal","48005","Proceeds of crime (Part XII.2 Criminal Code)","0","0","0","0","0","0","0","0","0","0","0","0","0","0"
"2002","Chestermere, Alberta, Royal Canadian Mounted Police, municipal","48005","Proceeds of crime (Part XII.2 Criminal Code)","0","0","0","0","0","0","0","0","0","0","0","0","0","0"
"2003","Chestermere, Alberta, Royal Canadian Mounted Police, municipal","48005","Proceeds of crime (Part XII.2 Criminal Code)","0","0","0","0","0","0","0","0","0","0","0","0","0","0"
"2004","Chestermere, Alberta, Royal Canadian Mounted Police, municipal","48005","Proceeds of crime (Part XII.2 Criminal Code)","0","0","0","0","0","0","0","0","0","0","0","0","0","0"
"2005","Chestermere, Alberta, Royal Canadian Mounted Police, municipal","48005","Proceeds of crime (Part XII.2 Criminal Code)","0","0","0","0","0","0","0","0","0","0","0","0","0","0"
"2006","Chestermere, Alberta, Royal Canadian Mounted Police, municipal","48005","Proceeds of crime (Part XII.2 Criminal Code)","0","0","0","0","0","0","0","0","0","0","0","0","0","0"
"2007","Chestermere, Alberta, Royal Canadian Mounted Police, municipal","48005","Proceeds of crime (Part XII.2 Criminal Code)","0","0","0","0","0","0","0","0","0","0","0","0","0","0"
"2008","Chestermere, Alberta, Royal Canadian Mounted Police, municipal","48005","Proceeds of crime (Part XII.2 Criminal Code)","0","0","0","0","0","0","0","0","0","0","0","0","0","0"
"2009","Chestermere, Alberta, Royal Canadian Mounted Police, municipal","48005","Proceeds of crime (Part XII.2 Criminal Code)","0","0","0","0","0","0","0","0","0","0","0","0","0","0"
"2010","Chestermere, Alberta, Royal Canadian Mounted Police, municipal","48005","Proceeds of crime (Part XII.2 Criminal Code)","0","0","0","0","0","0","0","0","0","0","0","0","0","0"
"2011","Chestermere, Alberta, Royal Canadian Mounted Police, municipal","48005","Proceeds of crime (Part XII.2 Criminal Code)","0","0","0","0","0","0","0","0","0","0","0","0","0","0"
"2012","Chestermere, Alberta, Royal Canadian Mounted Police, municipal","48005","Proceeds of crime (Part XII.2 Criminal Code)","0","0","0","0","0","0","0","0","0","0","0","0","0","0"
"2013","Chestermere, Alberta, Royal Canadian Mounted Police, municipal","48005","Proceeds of crime (Part XII.2 Criminal Code)","0","0","0","0","0","0","0","0","0","0","0","0","0","0"
"2014","Chestermere, Alberta, Royal Canadian Mounted Police, municipal","48005","Proceeds of crime (Part XII.2 Criminal Code)","0","0","0","0","0","0","0","0","0","0","0","0","0","0"
"2015","Chestermere, Alberta, Royal Canadian Mounted Police, municipal","48005","Proceeds of crime (Part XII.2 Criminal Code)","0","0","0","0","0","0","0","0","0","0","0","0","0","0"
"2016","Chestermere, Alberta, Royal Canadian Mounted Police, municipal","48005","Proceeds of crime (Part XII.2 Criminal Code)","0","0","0","0","0","0","0","0","0","0","0","0","0","0"
"1998","Chestermere, Alberta, Royal Canadian Mounted Police, municipal","48005","Attempts, conspiracies, accessories (Part XIII Criminal Code)","0","0","0","0","0","0","0","0","0","0","0","0","0","0"
"1999","Chestermere, Alberta, Royal Canadian Mounted Police, municipal","48005","Attempts, conspiracies, accessories (Part XIII Criminal Code)","0","0","0","0","0","0","0","0","0","0","0","0","0","0"
"2000","Chestermere, Alberta, Royal Canadian Mounted Police, municipal","48005","Attempts, conspiracies, accessories (Part XIII Criminal Code)","0","0","0","0","0","0","0","0","0","0","0","0","0","0"
"2001","Chestermere, Alberta, Royal Canadian Mounted Police, municipal","48005","Attempts, conspiracies, accessories (Part XIII Criminal Code)","0","0","0","0","0","0","0","0","0","0","0","0","0","0"
"2002","Chestermere, Alberta, Royal Canadian Mounted Police, municipal","48005","Attempts, conspiracies, accessories (Part XIII Criminal Code)","0","0","0","0","0","0","0","0","0","0","0","0","0","0"
"2003","Chestermere, Alberta, Royal Canadian Mounted Police, municipal","48005","Attempts, conspiracies, accessories (Part XIII Criminal Code)","0","0","0","0","0","0","0","0","0","0","0","0","0","0"
"2004","Chestermere, Alberta, Royal Canadian Mounted Police, municipal","48005","Attempts, conspiracies, accessories (Part XIII Criminal Code)","0","0","0","0","0","0","0","0","0","0","0","0","0","0"
"2005","Chestermere, Alberta, Royal Canadian Mounted Police, municipal","48005","Attempts, conspiracies, accessories (Part XIII Criminal Code)","0","0","0","0","0","0","0","0","0","0","0","0","0","0"
"2006","Chestermere, Alberta, Royal Canadian Mounted Police, municipal","48005","Attempts, conspiracies, accessories (Part XIII Criminal Code)","0","0","0","0","0","0","0","0","0","0","0","0","0","0"
"2007","Chestermere, Alberta, Royal Canadian Mounted Police, municipal","48005","Attempts, conspiracies, accessories (Part XIII Criminal Code)","0","0","0","0","0","0","0","0","0","0","0","0","0","0"
"2008","Chestermere, Alberta, Royal Canadian Mounted Police, municipal","48005","Attempts, conspiracies, accessories (Part XIII Criminal Code)","0","0","0","0","0","0","0","0","0","0","0","0","0","0"
"2009","Chestermere, Alberta, Royal Canadian Mounted Police, municipal","48005","Attempts, conspiracies, accessories (Part XIII Criminal Code)","0","0","0","0","0","0","0","0","0","0","0","0","0","0"
"2010","Chestermere, Alberta, Royal Canadian Mounted Police, municipal","48005","Attempts, conspiracies, accessories (Part XIII Criminal Code)","0","0","0","0","0","0","0","0","0","0","0","0","0","0"
"2011","Chestermere, Alberta, Royal Canadian Mounted Police, municipal","48005","Attempts, conspiracies, accessories (Part XIII Criminal Code)","0","0","0","0","0","0","0","0","0","0","0","0","0","0"
"2012","Chestermere, Alberta, Royal Canadian Mounted Police, municipal","48005","Attempts, conspiracies, accessories (Part XIII Criminal Code)","0","0","0","0","0","0","0","0","0","0","0","0","0","0"
"2013","Chestermere, Alberta, Royal Canadian Mounted Police, municipal","48005","Attempts, conspiracies, accessories (Part XIII Criminal Code)","0","0","0","0","0","0","0","0","0","0","0","0","0","0"
"2014","Chestermere, Alberta, Royal Canadian Mounted Police, municipal","48005","Attempts, conspiracies, accessories (Part XIII Criminal Code)","0","0","0","0","0","0","0","0","0","0","0","0","0","0"
"2015","Chestermere, Alberta, Royal Canadian Mounted Police, municipal","48005","Attempts, conspiracies, accessories (Part XIII Criminal Code)","0","0","0","0","0","0","0","0","0","0","0","0","0","0"
"2016","Chestermere, Alberta, Royal Canadian Mounted Police, municipal","48005","Attempts, conspiracies, accessories (Part XIII Criminal Code)","0","0","0","0","0","0","0","0","0","0","0","0","0","0"
"2002","Chestermere, Alberta, Royal Canadian Mounted Police, municipal","48005","Instruct offence for criminal organization","0","0","0","0","0","0","0","0","0","0","0","0","0","0"
"2003","Chestermere, Alberta, Royal Canadian Mounted Police, municipal","48005","Instruct offence for criminal organization","0","0","0","0","0","0","0","0","0","0","0","0","0","0"
"2004","Chestermere, Alberta, Royal Canadian Mounted Police, municipal","48005","Instruct offence for criminal organization","0","0","0","0","0","0","0","0","0","0","0","0","0","0"
"2005","Chestermere, Alberta, Royal Canadian Mounted Police, municipal","48005","Instruct offence for criminal organization","0","0","0","0","0","0","0","0","0","0","0","0","0","0"
"2006","Chestermere, Alberta, Royal Canadian Mounted Police, municipal","48005","Instruct offence for criminal organization","0","0","0","0","0","0","0","0","0","0","0","0","0","0"
"2007","Chestermere, Alberta, Royal Canadian Mounted Police, municipal","48005","Instruct offence for criminal organization","0","0","0","0","0","0","0","0","0","0","0","0","0","0"
"2008","Chestermere, Alberta, Royal Canadian Mounted Police, municipal","48005","Instruct offence for criminal organization","0","0","0","0","0","0","0","0","0","0","0","0","0","0"
"2009","Chestermere, Alberta, Royal Canadian Mounted Police, municipal","48005","Instruct offence for criminal organization","0","0","0","0","0","0","0","0","0","0","0","0","0","0"
"2010","Chestermere, Alberta, Royal Canadian Mounted Police, municipal","48005","Instruct offence for criminal organization","0","0","0","0","0","0","0","0","0","0","0","0","0","0"
"2011","Chestermere, Alberta, Royal Canadian Mounted Police, municipal","48005","Instruct offence for criminal organization","0","0","0","0","0","0","0","0","0","0","0","0","0","0"
"2012","Chestermere, Alberta, Royal Canadian Mounted Police, municipal","48005","Instruct offence for criminal organization","0","0","0","0","0","0","0","0","0","0","0","0","0","0"
"2013","Chestermere, Alberta, Royal Canadian Mounted Police, municipal","48005","Instruct offence for criminal organization","0","0","0","0","0","0","0","0","0","0","0","0","0","0"
"2014","Chestermere, Alberta, Royal Canadian Mounted Police, municipal","48005","Instruct offence for criminal organization","0","0","0","0","0","0","0","0","0","0","0","0","0","0"
"2015","Chestermere, Alberta, Royal Canadian Mounted Police, municipal","48005","Instruct offence for criminal organization","0","0","0","0","0","0","0","0","0","0","0","0","0","0"
"2016","Chestermere, Alberta, Royal Canadian Mounted Police, municipal","48005","Instruct offence for criminal organization","0","0","0","0","0","0","0","0","0","0","0","0","0","0"
"2002","Chestermere, Alberta, Royal Canadian Mounted Police, municipal","48005","Commit offence for criminal organization","0","0","0","0","0","0","0","0","0","0","0","0","0","0"
"2003","Chestermere, Alberta, Royal Canadian Mounted Police, municipal","48005","Commit offence for criminal organization","0","0","0","0","0","0","0","0","0","0","0","0","0","0"
"2004","Chestermere, Alberta, Royal Canadian Mounted Police, municipal","48005","Commit offence for criminal organization","0","0","0","0","0","0","0","0","0","0","0","0","0","0"
"2005","Chestermere, Alberta, Royal Canadian Mounted Police, municipal","48005","Commit offence for criminal organization","0","0","0","0","0","0","0","0","0","0","0","0","0","0"
"2006","Chestermere, Alberta, Royal Canadian Mounted Police, municipal","48005","Commit offence for criminal organization","0","0","0","0","0","0","0","0","0","0","0","0","0","0"
"2007","Chestermere, Alberta, Royal Canadian Mounted Police, municipal","48005","Commit offence for criminal organization","0","0","0","0","0","0","0","0","0","0","0","0","0","0"
"2008","Chestermere, Alberta, Royal Canadian Mounted Police, municipal","48005","Commit offence for criminal organization","0","0","0","0","0","0","0","0","0","0","0","0","0","0"
"2009","Chestermere, Alberta, Royal Canadian Mounted Police, municipal","48005","Commit offence for criminal organization","0","0","0","0","0","0","0","0","0","0","0","0","0","0"
"2010","Chestermere, Alberta, Royal Canadian Mounted Police, municipal","48005","Commit offence for criminal organization","0","0","0","0","0","0","0","0","0","0","0","0","0","0"
"2011","Chestermere, Alberta, Royal Canadian Mounted Police, municipal","48005","Commit offence for criminal organization","0","0","0","0","0","0","0","0","0","0","0","0","0","0"
"2012","Chestermere, Alberta, Royal Canadian Mounted Police, municipal","48005","Commit offence for criminal organization","0","0","0","0","0","0","0","0","0","0","0","0","0","0"
"2013","Chestermere, Alberta, Royal Canadian Mounted Police, municipal","48005","Commit offence for criminal organization","0","0","0","0","0","0","0","0","0","0","0","0","0","0"
"2014","Chestermere, Alberta, Royal Canadian Mounted Police, municipal","48005","Commit offence for criminal organization","0","0","0","0","0","0","0","0","0","0","0","0","0","0"
"2015","Chestermere, Alberta, Royal Canadian Mounted Police, municipal","48005","Commit offence for criminal organization","0","0","0","0","0","0","0","0","0","0","0","0","0","0"
"2016","Chestermere, Alberta, Royal Canadian Mounted Police, municipal","48005","Commit offence for criminal organization","0","0","0","0","0","0","0","0","0","0","0","0","0","0"
"2002","Chestermere, Alberta, Royal Canadian Mounted Police, municipal","48005","Participate in activities of criminal organization","0","0","0","0","0","0","0","0","0","0","0","0","0","0"
"2003","Chestermere, Alberta, Royal Canadian Mounted Police, municipal","48005","Participate in activities of criminal organization","0","0","0","0","0","0","0","0","0","0","0","0","0","0"
"2004","Chestermere, Alberta, Royal Canadian Mounted Police, municipal","48005","Participate in activities of criminal organization","0","0","0","0","0","0","0","0","0","0","0","0","0","0"
"2005","Chestermere, Alberta, Royal Canadian Mounted Police, municipal","48005","Participate in activities of criminal organization","0","0","0","0","0","0","0","0","0","0","0","0","0","0"
"2006","Chestermere, Alberta, Royal Canadian Mounted Police, municipal","48005","Participate in activities of criminal organization","0","0","0","0","0","0","0","0","0","0","0","0","0","0"
"2007","Chestermere, Alberta, Royal Canadian Mounted Police, municipal","48005","Participate in activities of criminal organization","0","0","0","0","0","0","0","0","0","0","0","0","0","0"
"2008","Chestermere, Alberta, Royal Canadian Mounted Police, municipal","48005","Participate in activities of criminal organization","0","0","0","0","0","0","0","0","0","0","0","0","0","0"
"2009","Chestermere, Alberta, Royal Canadian Mounted Police, municipal","48005","Participate in activities of criminal organization","0","0","0","0","0","0","0","0","0","0","0","0","0","0"
"2010","Chestermere, Alberta, Royal Canadian Mounted Police, municipal","48005","Participate in activities of criminal organization","0","0","0","0","0","0","0","0","0","0","0","0","0","0"
"2011","Chestermere, Alberta, Royal Canadian Mounted Police, municipal","48005","Participate in activities of criminal organization","0","0","0","0","0","0","0","0","0","0","0","0","0","0"
"2012","Chestermere, Alberta, Royal Canadian Mounted Police, municipal","48005","Participate in activities of criminal organization","0","0","0","0","0","0","0","0","0","0","0","0","0","0"
"2013","Chestermere, Alberta, Royal Canadian Mounted Police, municipal","48005","Participate in activities of criminal organization","0","0","0","0","0","0","0","0","0","0","0","0","0","0"
"2014","Chestermere, Alberta, Royal Canadian Mounted Police, municipal","48005","Participate in activities of criminal organization","0","0","0","0","0","0","0","0","0","0","0","0","0","0"
"2015","Chestermere, Alberta, Royal Canadian Mounted Police, municipal","48005","Participate in activities of criminal organization","0","0","0","0","0","0","0","0","0","0","0","0","0","0"
"2016","Chestermere, Alberta, Royal Canadian Mounted Police, municipal","48005","Participate in activities of criminal organization","0","0","0","0","0","0","0","0","0","0","0","0","0","0"
"2012","Chestermere, Alberta, Royal Canadian Mounted Police, municipal","48005","Recruitment of members by a criminal organization","0","0","0","0","0","0","0","0","0","0","0","0","0","0"
"2013","Chestermere, Alberta, Royal Canadian Mounted Police, municipal","48005","Recruitment of members by a criminal organization","0","0","0","0","0","0","0","0","0","0","0","0","0","0"
"2014","Chestermere, Alberta, Royal Canadian Mounted Police, municipal","48005","Recruitment of members by a criminal organization","0","0","0","0","0","0","0","0","0","0","0","0","0","0"
"2015","Chestermere, Alberta, Royal Canadian Mounted Police, municipal","48005","Recruitment of members by a criminal organization","0","0","0","0","0","0","0","0","0","0","0","0","0","0"
"2016","Chestermere, Alberta, Royal Canadian Mounted Police, municipal","48005","Recruitment of members by a criminal organization","0","0","0","0","0","0","0","0","0","0","0","0","0","0"
"1998","Chestermere, Alberta, Royal Canadian Mounted Police, municipal","48005","All other Criminal Code (includes Part XII.1 Criminal Code)","0","0","0","0","0","0","0","0","0","0","0","0","0","0"
"1999","Chestermere, Alberta, Royal Canadian Mounted Police, municipal","48005","All other Criminal Code (includes Part XII.1 Criminal Code)","0","0","0","0","0","0","0","0","0","0","0","0","0","0"
"2000","Chestermere, Alberta, Royal Canadian Mounted Police, municipal","48005","All other Criminal Code (includes Part XII.1 Criminal Code)","0","0","0","0","0","0","0","0","0","0","0","0","0","0"
"2001","Chestermere, Alberta, Royal Canadian Mounted Police, municipal","48005","All other Criminal Code (includes Part XII.1 Criminal Code)","0","0","0","0","0","0","0","0","0","0","0","0","0","0"
"2002","Chestermere, Alberta, Royal Canadian Mounted Police, municipal","48005","All other Criminal Code (includes Part XII.1 Criminal Code)","0","0","0","0","0","0","0","0","0","0","0","0","0","0"
"2003","Chestermere, Alberta, Royal Canadian Mounted Police, municipal","48005","All other Criminal Code (includes Part XII.1 Criminal Code)","0","0","0","0","0","0","0","0","0","0","0","0","0","0"
"2004","Chestermere, Alberta, Royal Canadian Mounted Police, municipal","48005","All other Criminal Code (includes Part XII.1 Criminal Code)","0","0","0","0","0","0","0","0","0","0","0","0","0","0"
"2005","Chestermere, Alberta, Royal Canadian Mounted Police, municipal","48005","All other Criminal Code (includes Part XII.1 Criminal Code)","0","0","0","0","0","0","0","0","0","0","0","0","0","0"
"2006","Chestermere, Alberta, Royal Canadian Mounted Police, municipal","48005","All other Criminal Code (includes Part XII.1 Criminal Code)","1","0","0","0","9.62","0","0","0","0","0","0","0","0","0"
"2007","Chestermere, Alberta, Royal Canadian Mounted Police, municipal","48005","All other Criminal Code (includes Part XII.1 Criminal Code)","0","0","0","-100","0","0","0","0","0","0","0","0","0","0"
"2008","Chestermere, Alberta, Royal Canadian Mounted Police, municipal","48005","All other Criminal Code (includes Part XII.1 Criminal Code)","0","0","0","0","0","0","0","0","0","0","0","0","0","0"
"2009","Chestermere, Alberta, Royal Canadian Mounted Police, municipal","48005","All other Criminal Code (includes Part XII.1 Criminal Code)","0","0","0","0","0","0","0","0","0","0","0","0","0","0"
"2010","Chestermere, Alberta, Royal Canadian Mounted Police, municipal","48005","All other Criminal Code (includes Part XII.1 Criminal Code)","0","0","0","0","0","0","0","0","0","0","0","0","0","0"
"2011","Chestermere, Alberta, Royal Canadian Mounted Police, municipal","48005","All other Criminal Code (includes Part XII.1 Criminal Code)","1","0","1","0","6.5","0","0","0","0","1","0","0","0","0"
"2012","Chestermere, Alberta, Royal Canadian Mounted Police, municipal","48005","All other Criminal Code (includes Part XII.1 Criminal Code)","0","0","0","-100","0","0","0","0","0","0","0","0","0","0"
"2013","Chestermere, Alberta, Royal Canadian Mounted Police, municipal","48005","All other Criminal Code (includes Part XII.1 Criminal Code)","1","0","0","0","6.1","0","0","0","0","0","0","0","0","0"
"2014","Chestermere, Alberta, Royal Canadian Mounted Police, municipal","48005","All other Criminal Code (includes Part XII.1 Criminal Code)","0","1","0","-100","0","8.17","7.33","0","0","1","1","1","0","0"
"2015","Chestermere, Alberta, Royal Canadian Mounted Police, municipal","48005","All other Criminal Code (includes Part XII.1 Criminal Code)","0","0","0","0","0","0","0","0","0","0","0","0","0","0"
"2016","Chestermere, Alberta, Royal Canadian Mounted Police, municipal","48005","All other Criminal Code (includes Part XII.1 Criminal Code)","1","0","1","0","5.63","0","0","0","0","1","0","0","0","0"
"1998","Chestermere, Alberta, Royal Canadian Mounted Police, municipal","48005","Total Criminal Code traffic violations","0","0","0","0","0","0","0","0","0","0","0","0","0","0"
"1999","Chestermere, Alberta, Royal Canadian Mounted Police, municipal","48005","Total Criminal Code traffic violations","0","0","0","0","0","0","0","0","0","0","0","0","0","0"
"2000","Chestermere, Alberta, Royal Canadian Mounted Police, municipal","48005","Total Criminal Code traffic violations","0","0","0","0","0","0","0","0","0","0","0","0","0","0"
"2001","Chestermere, Alberta, Royal Canadian Mounted Police, municipal","48005","Total Criminal Code traffic violations","0","0","0","0","0","0","0","0","0","0","0","0","0","0"
"2002","Chestermere, Alberta, Royal Canadian Mounted Police, municipal","48005","Total Criminal Code traffic violations","0","0","0","0","0","0","0","0","0","0","0","0","0","0"
"2003","Chestermere, Alberta, Royal Canadian Mounted Police, municipal","48005","Total Criminal Code traffic violations","0","0","0","0","0","0","0","0","0","0","0","0","0","0"
"2004","Chestermere, Alberta, Royal Canadian Mounted Police, municipal","48005","Total Criminal Code traffic violations","0","0","0","0","0","0","0","0","0","0","0","0","0","0"
"2005","Chestermere, Alberta, Royal Canadian Mounted Police, municipal","48005","Total Criminal Code traffic violations","18","14","1","0","207.8","223.89","197.96","0","0","15","14","14","0","0"
"2006","Chestermere, Alberta, Royal Canadian Mounted Police, municipal","48005","Total Criminal Code traffic violations","75","36","19","247.37","721.85","540.61","475.4","0","0","55","40","40","0","0"
"2007","Chestermere, Alberta, Royal Canadian Mounted Police, municipal","48005","Total Criminal Code traffic violations","100","18","59","21.93","880.13","184.8","184.5","182.32","273.47","77","15","17","2","3"
"2008","Chestermere, Alberta, Royal Canadian Mounted Police, municipal","48005","Total Criminal Code traffic violations","147","16","60","34.99","1188.07","180.53","159.35","0","84.89","76","16","16","0","1"
"2009","Chestermere, Alberta, Royal Canadian Mounted Police, municipal","48005","Total Criminal Code traffic violations","124","21","47","-22.3","923.1","207.02","192.27","79.3","317.21","68","20","21","1","4"
"2010","Chestermere, Alberta, Royal Canadian Mounted Police, municipal","48005","Total Criminal Code traffic violations","90","15","35","-32.37","624.26","144.83","136.58","73.64","73.64","50","15","16","1","1"
"2011","Chestermere, Alberta, Royal Canadian Mounted Police, municipal","48005","Total Criminal Code traffic violations","104","26","30","8.28","675.94","226.47","217.41","144.93","72.46","56","25","27","2","1"
"2012","Chestermere, Alberta, Royal Canadian Mounted Police, municipal","48005","Total Criminal Code traffic violations","116","32","29","8.29","732","272.14","250.41","72.05","288.18","61","31","32","1","4"
"2013","Chestermere, Alberta, Royal Canadian Mounted Police, municipal","48005","Total Criminal Code traffic violations","102","33","7","-15.03","621.99","270.66","249.68","71.74","71.74","40","32","33","1","1"
"2014","Chestermere, Alberta, Royal Canadian Mounted Police, municipal","48005","Total Criminal Code traffic violations","83","25","5","-21.2","490.11","204.23","183.28","0","0","30","25","25","0","0"
"2015","Chestermere, Alberta, Royal Canadian Mounted Police, municipal","48005","Total Criminal Code traffic violations","84","47","2","-1.02","485.13","367.79","330.46","0","0","49","46","46","0","0"
"2016","Chestermere, Alberta, Royal Canadian Mounted Police, municipal","48005","Total Criminal Code traffic violations","52","31","1","-39.61","292.99","250.08","224.7","0","0","32","32","32","0","0"
"1998","Chestermere, Alberta, Royal Canadian Mounted Police, municipal","48005","Total impaired driving","0","0","0","0","0","0","0","0","0","0","0","0","0","0"
"1999","Chestermere, Alberta, Royal Canadian Mounted Police, municipal","48005","Total impaired driving","0","0","0","0","0","0","0","0","0","0","0","0","0","0"
"2000","Chestermere, Alberta, Royal Canadian Mounted Police, municipal","48005","Total impaired driving","0","0","0","0","0","0","0","0","0","0","0","0","0","0"
"2001","Chestermere, Alberta, Royal Canadian Mounted Police, municipal","48005","Total impaired driving","0","0","0","0","0","0","0","0","0","0","0","0","0","0"
"2002","Chestermere, Alberta, Royal Canadian Mounted Police, municipal","48005","Total impaired driving","0","0","0","0","0","0","0","0","0","0","0","0","0","0"
"2003","Chestermere, Alberta, Royal Canadian Mounted Police, municipal","48005","Total impaired driving","0","0","0","0","0","0","0","0","0","0","0","0","0","0"
"2004","Chestermere, Alberta, Royal Canadian Mounted Police, municipal","48005","Total impaired driving","0","0","0","0","0","0","0","0","0","0","0","0","0","0"
"2005","Chestermere, Alberta, Royal Canadian Mounted Police, municipal","48005","Total impaired driving","17","14","1","0","196.26","223.89","197.96","0","0","15","14","14","0","0"
"2006","Chestermere, Alberta, Royal Canadian Mounted Police, municipal","48005","Total impaired driving","51","30","16","150.11","490.86","418.98","368.43","0","0","46","31","31","0","0"
"2007","Chestermere, Alberta, Royal Canadian Mounted Police, municipal","48005","Total impaired driving","65","12","52","16.55","572.08","135.52","130.24","91.16","182.32","64","11","12","1","2"
"2008","Chestermere, Alberta, Royal Canadian Mounted Police, municipal","48005","Total impaired driving","68","8","48","-3.93","549.58","90.26","79.67","0","84.89","56","8","8","0","1"
"2009","Chestermere, Alberta, Royal Canadian Mounted Police, municipal","48005","Total impaired driving","64","6","43","-13.31","476.44","62.11","54.93","0","237.91","49","6","6","0","3"
"2010","Chestermere, Alberta, Royal Canadian Mounted Police, municipal","48005","Total impaired driving","53","9","33","-22.84","367.62","86.9","85.36","73.64","73.64","42","9","10","1","1"
"2011","Chestermere, Alberta, Royal Canadian Mounted Police, municipal","48005","Total impaired driving","65","21","30","14.92","422.46","181.18","177.15","144.93","72.46","51","20","22","2","1"
"2012","Chestermere, Alberta, Royal Canadian Mounted Police, municipal","48005","Total impaired driving","66","25","27","-1.42","416.48","210.69","195.63","72.05","288.18","52","24","25","1","4"
"2013","Chestermere, Alberta, Royal Canadian Mounted Police, municipal","48005","Total impaired driving","60","26","5","-12.15","365.88","211.45","196.72","71.74","71.74","31","25","26","1","1"
"2014","Chestermere, Alberta, Royal Canadian Mounted Police, municipal","48005","Total impaired driving","57","22","3","-8.01","336.58","179.72","161.29","0","0","25","22","22","0","0"
"2015","Chestermere, Alberta, Royal Canadian Mounted Police, municipal","48005","Total impaired driving","74","42","2","26.98","427.38","327.82","294.54","0","0","44","41","41","0","0"
"2016","Chestermere, Alberta, Royal Canadian Mounted Police, municipal","48005","Total impaired driving","46","27","1","-39.35","259.18","211","189.59","0","0","28","27","27","0","0"
"1998","Chestermere, Alberta, Royal Canadian Mounted Police, municipal","48005","Impaired operation, causing death","0","0","0","0","0","0","0","0","0","0","0","0","0","0"
"1999","Chestermere, Alberta, Royal Canadian Mounted Police, municipal","48005","Impaired operation, causing death","0","0","0","0","0","0","0","0","0","0","0","0","0","0"
"2000","Chestermere, Alberta, Royal Canadian Mounted Police, municipal","48005","Impaired operation, causing death","0","0","0","0","0","0","0","0","0","0","0","0","0","0"
"2001","Chestermere, Alberta, Royal Canadian Mounted Police, municipal","48005","Impaired operation, causing death","0","0","0","0","0","0","0","0","0","0","0","0","0","0"
"2002","Chestermere, Alberta, Royal Canadian Mounted Police, municipal","48005","Impaired operation, causing death","0","0","0","0","0","0","0","0","0","0","0","0","0","0"
"2003","Chestermere, Alberta, Royal Canadian Mounted Police, municipal","48005","Impaired operation, causing death","0","0","0","0","0","0","0","0","0","0","0","0","0","0"
"2004","Chestermere, Alberta, Royal Canadian Mounted Police, municipal","48005","Impaired operation, causing death","0","0","0","0","0","0","0","0","0","0","0","0","0","0"
"2005","Chestermere, Alberta, Royal Canadian Mounted Police, municipal","48005","Impaired operation, causing death","0","0","0","0","0","0","0","0","0","0","0","0","0","0"
"2006","Chestermere, Alberta, Royal Canadian Mounted Police, municipal","48005","Impaired operation, causing death","0","0","0","0","0","0","0","0","0","0","0","0","0","0"
"2007","Chestermere, Alberta, Royal Canadian Mounted Police, municipal","48005","Impaired operation, causing death","0","0","0","0","0","0","0","0","0","0","0","0","0","0"
"2008","Chestermere, Alberta, Royal Canadian Mounted Police, municipal","48005","Impaired operation, causing death","0","0","0","0","0","0","0","0","0","0","0","0","0","0"
"2009","Chestermere, Alberta, Royal Canadian Mounted Police, municipal","48005","Impaired operation, causing death","0","0","0","0","0","0","0","0","0","0","0","0","0","0"
"2010","Chestermere, Alberta, Royal Canadian Mounted Police, municipal","48005","Impaired operation, causing death","0","0","0","0","0","0","0","0","0","0","0","0","0","0"
"2011","Chestermere, Alberta, Royal Canadian Mounted Police, municipal","48005","Impaired operation, causing death","0","0","0","0","0","0","0","0","0","0","0","0","0","0"
"2012","Chestermere, Alberta, Royal Canadian Mounted Police, municipal","48005","Impaired operation, causing death","0","0","0","0","0","0","0","0","0","0","0","0","0","0"
"2013","Chestermere, Alberta, Royal Canadian Mounted Police, municipal","48005","Impaired operation, causing death","0","0","0","0","0","0","0","0","0","0","0","0","0","0"
"2014","Chestermere, Alberta, Royal Canadian Mounted Police, municipal","48005","Impaired operation, causing death","0","0","0","0","0","0","0","0","0","0","0","0","0","0"
"2015","Chestermere, Alberta, Royal Canadian Mounted Police, municipal","48005","Impaired operation, causing death","0","0","0","0","0","0","0","0","0","0","0","0","0","0"
"2016","Chestermere, Alberta, Royal Canadian Mounted Police, municipal","48005","Impaired operation, causing death","0","0","0","0","0","0","0","0","0","0","0","0","0","0"
"2005","Chestermere, Alberta, Royal Canadian Mounted Police, municipal","48005","Impaired operation (drugs), causing death","0","0","0","0","0","0","0","0","0","0","0","0","0","0"
"2006","Chestermere, Alberta, Royal Canadian Mounted Police, municipal","48005","Impaired operation (drugs), causing death","0","0","0","0","0","0","0","0","0","0","0","0","0","0"
"2007","Chestermere, Alberta, Royal Canadian Mounted Police, municipal","48005","Impaired operation (drugs), causing death","0","0","0","0","0","0","0","0","0","0","0","0","0","0"
"2008","Chestermere, Alberta, Royal Canadian Mounted Police, municipal","48005","Impaired operation (drugs), causing death","0","0","0","0","0","0","0","0","0","0","0","0","0","0"
"2009","Chestermere, Alberta, Royal Canadian Mounted Police, municipal","48005","Impaired operation (drugs), causing death","0","0","0","0","0","0","0","0","0","0","0","0","0","0"
"2010","Chestermere, Alberta, Royal Canadian Mounted Police, municipal","48005","Impaired operation (drugs), causing death","0","0","0","0","0","0","0","0","0","0","0","0","0","0"
"2011","Chestermere, Alberta, Royal Canadian Mounted Police, municipal","48005","Impaired operation (drugs), causing death","0","0","0","0","0","0","0","0","0","0","0","0","0","0"
"2012","Chestermere, Alberta, Royal Canadian Mounted Police, municipal","48005","Impaired operation (drugs), causing death","0","0","0","0","0","0","0","0","0","0","0","0","0","0"
"2013","Chestermere, Alberta, Royal Canadian Mounted Police, municipal","48005","Impaired operation (drugs), causing death","0","0","0","0","0","0","0","0","0","0","0","0","0","0"
"2014","Chestermere, Alberta, Royal Canadian Mounted Police, municipal","48005","Impaired operation (drugs), causing death","0","0","0","0","0","0","0","0","0","0","0","0","0","0"
"2015","Chestermere, Alberta, Royal Canadian Mounted Police, municipal","48005","Impaired operation (drugs), causing death","0","0","0","0","0","0","0","0","0","0","0","0","0","0"
"2016","Chestermere, Alberta, Royal Canadian Mounted Police, municipal","48005","Impaired operation (drugs), causing death","0","0","0","0","0","0","0","0","0","0","0","0","0","0"
"1998","Chestermere, Alberta, Royal Canadian Mounted Police, municipal","48005","Impaired operation, causing bodily harm","0","0","0","0","0","0","0","0","0","0","0","0","0","0"
"1999","Chestermere, Alberta, Royal Canadian Mounted Police, municipal","48005","Impaired operation, causing bodily harm","0","0","0","0","0","0","0","0","0","0","0","0","0","0"
"2000","Chestermere, Alberta, Royal Canadian Mounted Police, municipal","48005","Impaired operation, causing bodily harm","0","0","0","0","0","0","0","0","0","0","0","0","0","0"
"2001","Chestermere, Alberta, Royal Canadian Mounted Police, municipal","48005","Impaired operation, causing bodily harm","0","0","0","0","0","0","0","0","0","0","0","0","0","0"
"2002","Chestermere, Alberta, Royal Canadian Mounted Police, municipal","48005","Impaired operation, causing bodily harm","0","0","0","0","0","0","0","0","0","0","0","0","0","0"
"2003","Chestermere, Alberta, Royal Canadian Mounted Police, municipal","48005","Impaired operation, causing bodily harm","0","0","0","0","0","0","0","0","0","0","0","0","0","0"
"2004","Chestermere, Alberta, Royal Canadian Mounted Police, municipal","48005","Impaired operation, causing bodily harm","0","0","0","0","0","0","0","0","0","0","0","0","0","0"
"2005","Chestermere, Alberta, Royal Canadian Mounted Police, municipal","48005","Impaired operation, causing bodily harm","1","1","0","0","11.54","15.99","14.14","0","0","1","1","1","0","0"
"2006","Chestermere, Alberta, Royal Canadian Mounted Police, municipal","48005","Impaired operation, causing bodily harm","0","0","0","-100","0","0","0","0","0","0","0","0","0","0"
"2007","Chestermere, Alberta, Royal Canadian Mounted Police, municipal","48005","Impaired operation, causing bodily harm","0","0","0","0","0","0","0","0","0","0","0","0","0","0"
"2008","Chestermere, Alberta, Royal Canadian Mounted Police, municipal","48005","Impaired operation, causing bodily harm","0","0","0","0","0","0","0","0","0","0","0","0","0","0"
"2009","Chestermere, Alberta, Royal Canadian Mounted Police, municipal","48005","Impaired operation, causing bodily harm","1","1","0","0","7.44","10.35","9.16","0","0","1","1","1","0","0"
"2010","Chestermere, Alberta, Royal Canadian Mounted Police, municipal","48005","Impaired operation, causing bodily harm","0","0","0","-100","0","0","0","0","0","0","0","0","0","0"
"2011","Chestermere, Alberta, Royal Canadian Mounted Police, municipal","48005","Impaired operation, causing bodily harm","0","0","0","0","0","0","0","0","0","0","0","0","0","0"
"2012","Chestermere, Alberta, Royal Canadian Mounted Police, municipal","48005","Impaired operation, causing bodily harm","0","0","0","0","0","0","0","0","0","0","0","0","0","0"
"2013","Chestermere, Alberta, Royal Canadian Mounted Police, municipal","48005","Impaired operation, causing bodily harm","0","0","0","0","0","0","0","0","0","0","0","0","0","0"
"2014","Chestermere, Alberta, Royal Canadian Mounted Police, municipal","48005","Impaired operation, causing bodily harm","0","0","0","0","0","0","0","0","0","0","0","0","0","0"
"2015","Chestermere, Alberta, Royal Canadian Mounted Police, municipal","48005","Impaired operation, causing bodily harm","1","0","0","0","5.78","0","0","0","0","0","0","0","0","0"
"2016","Chestermere, Alberta, Royal Canadian Mounted Police, municipal","48005","Impaired operation, causing bodily harm","0","1","0","-100","0","7.81","7.02","0","0","1","1","1","0","0"
"2005","Chestermere, Alberta, Royal Canadian Mounted Police, municipal","48005","Impaired operation (drugs), causing bodily harm","0","0","0","0","0","0","0","0","0","0","0","0","0","0"
"2006","Chestermere, Alberta, Royal Canadian Mounted Police, municipal","48005","Impaired operation (drugs), causing bodily harm","0","0","0","0","0","0","0","0","0","0","0","0","0","0"
"2007","Chestermere, Alberta, Royal Canadian Mounted Police, municipal","48005","Impaired operation (drugs), causing bodily harm","0","0","0","0","0","0","0","0","0","0","0","0","0","0"
"2008","Chestermere, Alberta, Royal Canadian Mounted Police, municipal","48005","Impaired operation (drugs), causing bodily harm","0","0","0","0","0","0","0","0","0","0","0","0","0","0"
"2009","Chestermere, Alberta, Royal Canadian Mounted Police, municipal","48005","Impaired operation (drugs), causing bodily harm","0","0","0","0","0","0","0","0","0","0","0","0","0","0"
"2010","Chestermere, Alberta, Royal Canadian Mounted Police, municipal","48005","Impaired operation (drugs), causing bodily harm","0","0","0","0","0","0","0","0","0","0","0","0","0","0"
"2011","Chestermere, Alberta, Royal Canadian Mounted Police, municipal","48005","Impaired operation (drugs), causing bodily harm","0","0","0","0","0","0","0","0","0","0","0","0","0","0"
"2012","Chestermere, Alberta, Royal Canadian Mounted Police, municipal","48005","Impaired operation (drugs), causing bodily harm","0","0","0","0","0","0","0","0","0","0","0","0","0","0"
"2013","Chestermere, Alberta, Royal Canadian Mounted Police, municipal","48005","Impaired operation (drugs), causing bodily harm","0","0","0","0","0","0","0","0","0","0","0","0","0","0"
"2014","Chestermere, Alberta, Royal Canadian Mounted Police, municipal","48005","Impaired operation (drugs), causing bodily harm","0","0","0","0","0","0","0","0","0","0","0","0","0","0"
"2015","Chestermere, Alberta, Royal Canadian Mounted Police, municipal","48005","Impaired operation (drugs), causing bodily harm","0","0","0","0","0","0","0","0","0","0","0","0","0","0"
"2016","Chestermere, Alberta, Royal Canadian Mounted Police, municipal","48005","Impaired operation (drugs), causing bodily harm","0","0","0","0","0","0","0","0","0","0","0","0","0","0"
"1998","Chestermere, Alberta, Royal Canadian Mounted Police, municipal","48005","Impaired operation of motor vehicle, vessel or aircraft","0","0","0","0","0","0","0","0","0","0","0","0","0","0"
"1999","Chestermere, Alberta, Royal Canadian Mounted Police, municipal","48005","Impaired operation of motor vehicle, vessel or aircraft","0","0","0","0","0","0","0","0","0","0","0","0","0","0"
"2000","Chestermere, Alberta, Royal Canadian Mounted Police, municipal","48005","Impaired operation of motor vehicle, vessel or aircraft","0","0","0","0","0","0","0","0","0","0","0","0","0","0"
"2001","Chestermere, Alberta, Royal Canadian Mounted Police, municipal","48005","Impaired operation of motor vehicle, vessel or aircraft","0","0","0","0","0","0","0","0","0","0","0","0","0","0"
"2002","Chestermere, Alberta, Royal Canadian Mounted Police, municipal","48005","Impaired operation of motor vehicle, vessel or aircraft","0","0","0","0","0","0","0","0","0","0","0","0","0","0"
"2003","Chestermere, Alberta, Royal Canadian Mounted Police, municipal","48005","Impaired operation of motor vehicle, vessel or aircraft","0","0","0","0","0","0","0","0","0","0","0","0","0","0"
"2004","Chestermere, Alberta, Royal Canadian Mounted Police, municipal","48005","Impaired operation of motor vehicle, vessel or aircraft","0","0","0","0","0","0","0","0","0","0","0","0","0","0"
"2005","Chestermere, Alberta, Royal Canadian Mounted Police, municipal","48005","Impaired operation of motor vehicle, vessel or aircraft","15","12","1","0","173.17","191.91","169.68","0","0","13","12","12","0","0"
"2006","Chestermere, Alberta, Royal Canadian Mounted Police, municipal","48005","Impaired operation of motor vehicle, vessel or aircraft","50","29","16","177.9","481.23","405.46","356.55","0","0","45","30","30","0","0"
"2007","Chestermere, Alberta, Royal Canadian Mounted Police, municipal","48005","Impaired operation of motor vehicle, vessel or aircraft","63","10","52","15.22","554.48","110.88","108.53","91.16","182.32","62","9","10","1","2"
"2008","Chestermere, Alberta, Royal Canadian Mounted Police, municipal","48005","Impaired operation of motor vehicle, vessel or aircraft","65","5","48","-5.26","525.34","56.41","49.8","0","84.89","53","5","5","0","1"
"2009","Chestermere, Alberta, Royal Canadian Mounted Police, municipal","48005","Impaired operation of motor vehicle, vessel or aircraft","59","4","41","-16.39","439.22","41.4","36.62","0","237.91","45","4","4","0","3"
"2010","Chestermere, Alberta, Royal Canadian Mounted Police, municipal","48005","Impaired operation of motor vehicle, vessel or aircraft","51","9","31","-19.46","353.75","86.9","85.36","73.64","73.64","40","9","10","1","1"
"2011","Chestermere, Alberta, Royal Canadian Mounted Police, municipal","48005","Impaired operation of motor vehicle, vessel or aircraft","55","19","21","1.05","357.47","163.06","161.04","144.93","72.46","40","18","20","2","1"
"2012","Chestermere, Alberta, Royal Canadian Mounted Police, municipal","48005","Impaired operation of motor vehicle, vessel or aircraft","58","23","22","2.39","366","193.13","179.98","72.05","144.09","45","22","23","1","2"
"2013","Chestermere, Alberta, Royal Canadian Mounted Police, municipal","48005","Impaired operation of motor vehicle, vessel or aircraft","57","23","4","-5.03","347.58","186.08","174.02","71.74","71.74","27","22","23","1","1"
"2014","Chestermere, Alberta, Royal Canadian Mounted Police, municipal","48005","Impaired operation of motor vehicle, vessel or aircraft","50","20","3","-15.06","295.25","163.39","146.63","0","0","23","20","20","0","0"
"2015","Chestermere, Alberta, Royal Canadian Mounted Police, municipal","48005","Impaired operation of motor vehicle, vessel or aircraft","62","32","1","21.28","358.07","247.86","222.7","0","0","33","31","31","0","0"
"2016","Chestermere, Alberta, Royal Canadian Mounted Police, municipal","48005","Impaired operation of motor vehicle, vessel or aircraft","40","25","1","-37.06","225.38","195.37","175.55","0","0","26","25","25","0","0"
"2005","Chestermere, Alberta, Royal Canadian Mounted Police, municipal","48005","Impaired operation (drugs) vehicle, vessel, aircraft","0","0","0","0","0","0","0","0","0","0","0","0","0","0"
"2006","Chestermere, Alberta, Royal Canadian Mounted Police, municipal","48005","Impaired operation (drugs) vehicle, vessel, aircraft","0","0","0","0","0","0","0","0","0","0","0","0","0","0"
"2007","Chestermere, Alberta, Royal Canadian Mounted Police, municipal","48005","Impaired operation (drugs) vehicle, vessel, aircraft","0","0","0","0","0","0","0","0","0","0","0","0","0","0"
"2008","Chestermere, Alberta, Royal Canadian Mounted Police, municipal","48005","Impaired operation (drugs) vehicle, vessel, aircraft","0","0","0","0","0","0","0","0","0","0","0","0","0","0"
"2009","Chestermere, Alberta, Royal Canadian Mounted Police, municipal","48005","Impaired operation (drugs) vehicle, vessel, aircraft","3","0","2","0","22.33","0","0","0","0","2","0","0","0","0"
"2010","Chestermere, Alberta, Royal Canadian Mounted Police, municipal","48005","Impaired operation (drugs) vehicle, vessel, aircraft","2","0","2","-37.88","13.87","0","0","0","0","2","0","0","0","0"
"2011","Chestermere, Alberta, Royal Canadian Mounted Police, municipal","48005","Impaired operation (drugs) vehicle, vessel, aircraft","8","0","9","274.81","52","0","0","0","0","9","0","0","0","0"
"2012","Chestermere, Alberta, Royal Canadian Mounted Police, municipal","48005","Impaired operation (drugs) vehicle, vessel, aircraft","7","1","5","-15.05","44.17","8.78","7.83","0","144.09","6","1","1","0","2"
"2013","Chestermere, Alberta, Royal Canadian Mounted Police, municipal","48005","Impaired operation (drugs) vehicle, vessel, aircraft","1","1","1","-86.2","6.1","8.46","7.57","0","0","2","1","1","0","0"
"2014","Chestermere, Alberta, Royal Canadian Mounted Police, municipal","48005","Impaired operation (drugs) vehicle, vessel, aircraft","5","0","0","384.17","29.52","0","0","0","0","0","0","0","0","0"
"2015","Chestermere, Alberta, Royal Canadian Mounted Police, municipal","48005","Impaired operation (drugs) vehicle, vessel, aircraft","1","0","1","-80.44","5.78","0","0","0","0","1","0","0","0","0"
"2016","Chestermere, Alberta, Royal Canadian Mounted Police, municipal","48005","Impaired operation (drugs) vehicle, vessel, aircraft","4","0","0","290.24","22.54","0","0","0","0","0","0","0","0","0"
"1998","Chestermere, Alberta, Royal Canadian Mounted Police, municipal","48005","Impaired operation, failure to provide breath sample","0","0","0","0","0","0","0","0","0","0","0","0","0","0"
"1999","Chestermere, Alberta, Royal Canadian Mounted Police, municipal","48005","Impaired operation, failure to provide breath sample","0","0","0","0","0","0","0","0","0","0","0","0","0","0"
"2000","Chestermere, Alberta, Royal Canadian Mounted Police, municipal","48005","Impaired operation, failure to provide breath sample","0","0","0","0","0","0","0","0","0","0","0","0","0","0"
"2001","Chestermere, Alberta, Royal Canadian Mounted Police, municipal","48005","Impaired operation, failure to provide breath sample","0","0","0","0","0","0","0","0","0","0","0","0","0","0"
"2002","Chestermere, Alberta, Royal Canadian Mounted Police, municipal","48005","Impaired operation, failure to provide breath sample","0","0","0","0","0","0","0","0","0","0","0","0","0","0"
"2003","Chestermere, Alberta, Royal Canadian Mounted Police, municipal","48005","Impaired operation, failure to provide breath sample","0","0","0","0","0","0","0","0","0","0","0","0","0","0"
"2004","Chestermere, Alberta, Royal Canadian Mounted Police, municipal","48005","Impaired operation, failure to provide breath sample","0","0","0","0","0","0","0","0","0","0","0","0","0","0"
"2005","Chestermere, Alberta, Royal Canadian Mounted Police, municipal","48005","Impaired operation, failure to provide breath sample","1","1","0","0","11.54","15.99","14.14","0","0","1","1","1","0","0"
"2006","Chestermere, Alberta, Royal Canadian Mounted Police, municipal","48005","Impaired operation, failure to provide breath sample","1","1","0","-16.63","9.62","13.52","11.88","0","0","1","1","1","0","0"
"2007","Chestermere, Alberta, Royal Canadian Mounted Police, municipal","48005","Impaired operation, failure to provide breath sample","2","2","0","82.89","17.6","24.64","21.71","0","0","2","2","2","0","0"
"2008","Chestermere, Alberta, Royal Canadian Mounted Police, municipal","48005","Impaired operation, failure to provide breath sample","3","3","0","37.74","24.25","33.85","29.88","0","0","3","3","3","0","0"
"2009","Chestermere, Alberta, Royal Canadian Mounted Police, municipal","48005","Impaired operation, failure to provide breath sample","1","1","0","-69.3","7.44","10.35","9.16","0","0","1","1","1","0","0"
"2010","Chestermere, Alberta, Royal Canadian Mounted Police, municipal","48005","Impaired operation, failure to provide breath sample","0","0","0","-100","0","0","0","0","0","0","0","0","0","0"
"2011","Chestermere, Alberta, Royal Canadian Mounted Police, municipal","48005","Impaired operation, failure to provide breath sample","2","2","0","0","13","18.12","16.1","0","0","2","2","2","0","0"
"2012","Chestermere, Alberta, Royal Canadian Mounted Police, municipal","48005","Impaired operation, failure to provide breath sample","1","1","0","-51.45","6.31","8.78","7.83","0","0","1","1","1","0","0"
"2013","Chestermere, Alberta, Royal Canadian Mounted Police, municipal","48005","Impaired operation, failure to provide breath sample","2","2","0","93.27","12.2","16.92","15.13","0","0","2","2","2","0","0"
"2014","Chestermere, Alberta, Royal Canadian Mounted Police, municipal","48005","Impaired operation, failure to provide breath sample","2","2","0","-3.17","11.81","16.34","14.66","0","0","2","2","2","0","0"
"2015","Chestermere, Alberta, Royal Canadian Mounted Police, municipal","48005","Impaired operation, failure to provide breath sample","10","10","0","389.03","57.75","79.96","71.84","0","0","10","10","10","0","0"
"2016","Chestermere, Alberta, Royal Canadian Mounted Police, municipal","48005","Impaired operation, failure to provide breath sample","1","1","0","-90.24","5.63","7.81","7.02","0","0","1","1","1","0","0"
"2005","Chestermere, Alberta, Royal Canadian Mounted Police, municipal","48005","Failure to comply or refusal (drugs)","0","0","0","0","0","0","0","0","0","0","0","0","0","0"
"2006","Chestermere, Alberta, Royal Canadian Mounted Police, municipal","48005","Failure to comply or refusal (drugs)","0","0","0","0","0","0","0","0","0","0","0","0","0","0"
"2007","Chestermere, Alberta, Royal Canadian Mounted Police, municipal","48005","Failure to comply or refusal (drugs)","0","0","0","0","0","0","0","0","0","0","0","0","0","0"
"2008","Chestermere, Alberta, Royal Canadian Mounted Police, municipal","48005","Failure to comply or refusal (drugs)","0","0","0","0","0","0","0","0","0","0","0","0","0","0"
"2009","Chestermere, Alberta, Royal Canadian Mounted Police, municipal","48005","Failure to comply or refusal (drugs)","0","0","0","0","0","0","0","0","0","0","0","0","0","0"
"2010","Chestermere, Alberta, Royal Canadian Mounted Police, municipal","48005","Failure to comply or refusal (drugs)","0","0","0","0","0","0","0","0","0","0","0","0","0","0"
"2011","Chestermere, Alberta, Royal Canadian Mounted Police, municipal","48005","Failure to comply or refusal (drugs)","0","0","0","0","0","0","0","0","0","0","0","0","0","0"
"2012","Chestermere, Alberta, Royal Canadian Mounted Police, municipal","48005","Failure to comply or refusal (drugs)","0","0","0","0","0","0","0","0","0","0","0","0","0","0"
"2013","Chestermere, Alberta, Royal Canadian Mounted Police, municipal","48005","Failure to comply or refusal (drugs)","0","0","0","0","0","0","0","0","0","0","0","0","0","0"
"2014","Chestermere, Alberta, Royal Canadian Mounted Police, municipal","48005","Failure to comply or refusal (drugs)","0","0","0","0","0","0","0","0","0","0","0","0","0","0"
"2015","Chestermere, Alberta, Royal Canadian Mounted Police, municipal","48005","Failure to comply or refusal (drugs)","0","0","0","0","0","0","0","0","0","0","0","0","0","0"
"2016","Chestermere, Alberta, Royal Canadian Mounted Police, municipal","48005","Failure to comply or refusal (drugs)","0","0","0","0","0","0","0","0","0","0","0","0","0","0"
"1998","Chestermere, Alberta, Royal Canadian Mounted Police, municipal","48005","Impaired operation, failure to provide blood sample","0","0","0","0","0","0","0","0","0","0","0","0","0","0"
"1999","Chestermere, Alberta, Royal Canadian Mounted Police, municipal","48005","Impaired operation, failure to provide blood sample","0","0","0","0","0","0","0","0","0","0","0","0","0","0"
"2000","Chestermere, Alberta, Royal Canadian Mounted Police, municipal","48005","Impaired operation, failure to provide blood sample","0","0","0","0","0","0","0","0","0","0","0","0","0","0"
"2001","Chestermere, Alberta, Royal Canadian Mounted Police, municipal","48005","Impaired operation, failure to provide blood sample","0","0","0","0","0","0","0","0","0","0","0","0","0","0"
"2002","Chestermere, Alberta, Royal Canadian Mounted Police, municipal","48005","Impaired operation, failure to provide blood sample","0","0","0","0","0","0","0","0","0","0","0","0","0","0"
"2003","Chestermere, Alberta, Royal Canadian Mounted Police, municipal","48005","Impaired operation, failure to provide blood sample","0","0","0","0","0","0","0","0","0","0","0","0","0","0"
"2004","Chestermere, Alberta, Royal Canadian Mounted Police, municipal","48005","Impaired operation, failure to provide blood sample","0","0","0","0","0","0","0","0","0","0","0","0","0","0"
"2005","Chestermere, Alberta, Royal Canadian Mounted Police, municipal","48005","Impaired operation, failure to provide blood sample","0","0","0","0","0","0","0","0","0","0","0","0","0","0"
"2006","Chestermere, Alberta, Royal Canadian Mounted Police, municipal","48005","Impaired operation, failure to provide blood sample","0","0","0","0","0","0","0","0","0","0","0","0","0","0"
"2007","Chestermere, Alberta, Royal Canadian Mounted Police, municipal","48005","Impaired operation, failure to provide blood sample","0","0","0","0","0","0","0","0","0","0","0","0","0","0"
"2008","Chestermere, Alberta, Royal Canadian Mounted Police, municipal","48005","Impaired operation, failure to provide blood sample","0","0","0","0","0","0","0","0","0","0","0","0","0","0"
"2009","Chestermere, Alberta, Royal Canadian Mounted Police, municipal","48005","Impaired operation, failure to provide blood sample","0","0","0","0","0","0","0","0","0","0","0","0","0","0"
"2010","Chestermere, Alberta, Royal Canadian Mounted Police, municipal","48005","Impaired operation, failure to provide blood sample","0","0","0","0","0","0","0","0","0","0","0","0","0","0"
"2011","Chestermere, Alberta, Royal Canadian Mounted Police, municipal","48005","Impaired operation, failure to provide blood sample","0","0","0","0","0","0","0","0","0","0","0","0","0","0"
"2012","Chestermere, Alberta, Royal Canadian Mounted Police, municipal","48005","Impaired operation, failure to provide blood sample","0","0","0","0","0","0","0","0","0","0","0","0","0","0"
"2013","Chestermere, Alberta, Royal Canadian Mounted Police, municipal","48005","Impaired operation, failure to provide blood sample","0","0","0","0","0","0","0","0","0","0","0","0","0","0"
"2014","Chestermere, Alberta, Royal Canadian Mounted Police, municipal","48005","Impaired operation, failure to provide blood sample","0","0","0","0","0","0","0","0","0","0","0","0","0","0"
"2015","Chestermere, Alberta, Royal Canadian Mounted Police, municipal","48005","Impaired operation, failure to provide blood sample","0","0","0","0","0","0","0","0","0","0","0","0","0","0"
"2016","Chestermere, Alberta, Royal Canadian Mounted Police, municipal","48005","Impaired operation, failure to provide blood sample","1","0","0","0","5.63","0","0","0","0","0","0","0","0","0"
"2005","Chestermere, Alberta, Royal Canadian Mounted Police, municipal","48005","Failure to provide blood sample (drugs)","0","0","0","0","0","0","0","0","0","0","0","0","0","0"
"2006","Chestermere, Alberta, Royal Canadian Mounted Police, municipal","48005","Failure to provide blood sample (drugs)","0","0","0","0","0","0","0","0","0","0","0","0","0","0"
"2007","Chestermere, Alberta, Royal Canadian Mounted Police, municipal","48005","Failure to provide blood sample (drugs)","0","0","0","0","0","0","0","0","0","0","0","0","0","0"
"2008","Chestermere, Alberta, Royal Canadian Mounted Police, municipal","48005","Failure to provide blood sample (drugs)","0","0","0","0","0","0","0","0","0","0","0","0","0","0"
"2009","Chestermere, Alberta, Royal Canadian Mounted Police, municipal","48005","Failure to provide blood sample (drugs)","0","0","0","0","0","0","0","0","0","0","0","0","0","0"
"2010","Chestermere, Alberta, Royal Canadian Mounted Police, municipal","48005","Failure to provide blood sample (drugs)","0","0","0","0","0","0","0","0","0","0","0","0","0","0"
"2011","Chestermere, Alberta, Royal Canadian Mounted Police, municipal","48005","Failure to provide blood sample (drugs)","0","0","0","0","0","0","0","0","0","0","0","0","0","0"
"2012","Chestermere, Alberta, Royal Canadian Mounted Police, municipal","48005","Failure to provide blood sample (drugs)","0","0","0","0","0","0","0","0","0","0","0","0","0","0"
"2013","Chestermere, Alberta, Royal Canadian Mounted Police, municipal","48005","Failure to provide blood sample (drugs)","0","0","0","0","0","0","0","0","0","0","0","0","0","0"
"2014","Chestermere, Alberta, Royal Canadian Mounted Police, municipal","48005","Failure to provide blood sample (drugs)","0","0","0","0","0","0","0","0","0","0","0","0","0","0"
"2015","Chestermere, Alberta, Royal Canadian Mounted Police, municipal","48005","Failure to provide blood sample (drugs)","0","0","0","0","0","0","0","0","0","0","0","0","0","0"
"2016","Chestermere, Alberta, Royal Canadian Mounted Police, municipal","48005","Failure to provide blood sample (drugs)","0","0","0","0","0","0","0","0","0","0","0","0","0","0"
"1998","Chestermere, Alberta, Royal Canadian Mounted Police, municipal","48005","Total other Criminal Code traffic violations","0","0","0","0","0","0","0","0","0","0","0","0","0","0"
"1999","Chestermere, Alberta, Royal Canadian Mounted Police, municipal","48005","Total other Criminal Code traffic violations","0","0","0","0","0","0","0","0","0","0","0","0","0","0"
"2000","Chestermere, Alberta, Royal Canadian Mounted Police, municipal","48005","Total other Criminal Code traffic violations","0","0","0","0","0","0","0","0","0","0","0","0","0","0"
"2001","Chestermere, Alberta, Royal Canadian Mounted Police, municipal","48005","Total other Criminal Code traffic violations","0","0","0","0","0","0","0","0","0","0","0","0","0","0"
"2002","Chestermere, Alberta, Royal Canadian Mounted Police, municipal","48005","Total other Criminal Code traffic violations","0","0","0","0","0","0","0","0","0","0","0","0","0","0"
"2003","Chestermere, Alberta, Royal Canadian Mounted Police, municipal","48005","Total other Criminal Code traffic violations","0","0","0","0","0","0","0","0","0","0","0","0","0","0"
"2004","Chestermere, Alberta, Royal Canadian Mounted Police, municipal","48005","Total other Criminal Code traffic violations","0","0","0","0","0","0","0","0","0","0","0","0","0","0"
"2005","Chestermere, Alberta, Royal Canadian Mounted Police, municipal","48005","Total other Criminal Code traffic violations","1","0","0","0","11.54","0","0","0","0","0","0","0","0","0"
"2006","Chestermere, Alberta, Royal Canadian Mounted Police, municipal","48005","Total other Criminal Code traffic violations","24","6","3","1900.85","230.99","121.64","106.96","0","0","9","9","9","0","0"
"2007","Chestermere, Alberta, Royal Canadian Mounted Police, municipal","48005","Total other Criminal Code traffic violations","35","6","7","33.36","308.04","49.28","54.27","91.16","91.16","13","4","5","1","1"
"2008","Chestermere, Alberta, Royal Canadian Mounted Police, municipal","48005","Total other Criminal Code traffic violations","79","8","12","107.27","638.49","90.26","79.67","0","0","20","8","8","0","0"
"2009","Chestermere, Alberta, Royal Canadian Mounted Police, municipal","48005","Total other Criminal Code traffic violations","60","15","4","-30.04","446.66","144.91","137.34","79.3","79.3","19","14","15","1","1"
"2010","Chestermere, Alberta, Royal Canadian Mounted Police, municipal","48005","Total other Criminal Code traffic violations","37","6","2","-42.54","256.64","57.93","51.22","0","0","8","6","6","0","0"
"2011","Chestermere, Alberta, Royal Canadian Mounted Police, municipal","48005","Total other Criminal Code traffic violations","39","5","0","-1.23","253.48","45.29","40.26","0","0","5","5","5","0","0"
"2012","Chestermere, Alberta, Royal Canadian Mounted Police, municipal","48005","Total other Criminal Code traffic violations","50","7","2","24.48","315.52","61.45","54.78","0","0","9","7","7","0","0"
"2013","Chestermere, Alberta, Royal Canadian Mounted Police, municipal","48005","Total other Criminal Code traffic violations","42","7","2","-18.83","256.11","59.21","52.96","0","0","9","7","7","0","0"
"2014","Chestermere, Alberta, Royal Canadian Mounted Police, municipal","48005","Total other Criminal Code traffic violations","26","3","2","-40.05","153.53","24.51","21.99","0","0","5","3","3","0","0"
"2015","Chestermere, Alberta, Royal Canadian Mounted Police, municipal","48005","Total other Criminal Code traffic violations","10","5","0","-62.38","57.75","39.98","35.92","0","0","5","5","5","0","0"
"2016","Chestermere, Alberta, Royal Canadian Mounted Police, municipal","48005","Total other Criminal Code traffic violations","6","4","0","-41.46","33.81","39.07","35.11","0","0","4","5","5","0","0"
"1998","Chestermere, Alberta, Royal Canadian Mounted Police, municipal","48005","Dangerous operation, causing death","0","0","0","0","0","0","0","0","0","0","0","0","0","0"
"1999","Chestermere, Alberta, Royal Canadian Mounted Police, municipal","48005","Dangerous operation, causing death","0","0","0","0","0","0","0","0","0","0","0","0","0","0"
"2000","Chestermere, Alberta, Royal Canadian Mounted Police, municipal","48005","Dangerous operation, causing death","0","0","0","0","0","0","0","0","0","0","0","0","0","0"
"2001","Chestermere, Alberta, Royal Canadian Mounted Police, municipal","48005","Dangerous operation, causing death","0","0","0","0","0","0","0","0","0","0","0","0","0","0"
"2002","Chestermere, Alberta, Royal Canadian Mounted Police, municipal","48005","Dangerous operation, causing death","0","0","0","0","0","0","0","0","0","0","0","0","0","0"
"2003","Chestermere, Alberta, Royal Canadian Mounted Police, municipal","48005","Dangerous operation, causing death","0","0","0","0","0","0","0","0","0","0","0","0","0","0"
"2004","Chestermere, Alberta, Royal Canadian Mounted Police, municipal","48005","Dangerous operation, causing death","0","0","0","0","0","0","0","0","0","0","0","0","0","0"
"2005","Chestermere, Alberta, Royal Canadian Mounted Police, municipal","48005","Dangerous operation, causing death","0","0","0","0","0","0","0","0","0","0","0","0","0","0"
"2006","Chestermere, Alberta, Royal Canadian Mounted Police, municipal","48005","Dangerous operation, causing death","0","0","0","0","0","0","0","0","0","0","0","0","0","0"
"2007","Chestermere, Alberta, Royal Canadian Mounted Police, municipal","48005","Dangerous operation, causing death","0","0","0","0","0","0","0","0","0","0","0","0","0","0"
"2008","Chestermere, Alberta, Royal Canadian Mounted Police, municipal","48005","Dangerous operation, causing death","0","0","0","0","0","0","0","0","0","0","0","0","0","0"
"2009","Chestermere, Alberta, Royal Canadian Mounted Police, municipal","48005","Dangerous operation, causing death","0","0","0","0","0","0","0","0","0","0","0","0","0","0"
"2010","Chestermere, Alberta, Royal Canadian Mounted Police, municipal","48005","Dangerous operation, causing death","0","0","0","0","0","0","0","0","0","0","0","0","0","0"
"2011","Chestermere, Alberta, Royal Canadian Mounted Police, municipal","48005","Dangerous operation, causing death","0","0","0","0","0","0","0","0","0","0","0","0","0","0"
"2012","Chestermere, Alberta, Royal Canadian Mounted Police, municipal","48005","Dangerous operation, causing death","0","0","0","0","0","0","0","0","0","0","0","0","0","0"
"2013","Chestermere, Alberta, Royal Canadian Mounted Police, municipal","48005","Dangerous operation, causing death","0","0","0","0","0","0","0","0","0","0","0","0","0","0"
"2014","Chestermere, Alberta, Royal Canadian Mounted Police, municipal","48005","Dangerous operation, causing death","0","0","0","0","0","0","0","0","0","0","0","0","0","0"
"2015","Chestermere, Alberta, Royal Canadian Mounted Police, municipal","48005","Dangerous operation, causing death","0","0","0","0","0","0","0","0","0","0","0","0","0","0"
"2016","Chestermere, Alberta, Royal Canadian Mounted Police, municipal","48005","Dangerous operation, causing death","0","0","0","0","0","0","0","0","0","0","0","0","0","0"
"1998","Chestermere, Alberta, Royal Canadian Mounted Police, municipal","48005","Dangerous operation, causing bodily harm","0","0","0","0","0","0","0","0","0","0","0","0","0","0"
"1999","Chestermere, Alberta, Royal Canadian Mounted Police, municipal","48005","Dangerous operation, causing bodily harm","0","0","0","0","0","0","0","0","0","0","0","0","0","0"
"2000","Chestermere, Alberta, Royal Canadian Mounted Police, municipal","48005","Dangerous operation, causing bodily harm","0","0","0","0","0","0","0","0","0","0","0","0","0","0"
"2001","Chestermere, Alberta, Royal Canadian Mounted Police, municipal","48005","Dangerous operation, causing bodily harm","0","0","0","0","0","0","0","0","0","0","0","0","0","0"
"2002","Chestermere, Alberta, Royal Canadian Mounted Police, municipal","48005","Dangerous operation, causing bodily harm","0","0","0","0","0","0","0","0","0","0","0","0","0","0"
"2003","Chestermere, Alberta, Royal Canadian Mounted Police, municipal","48005","Dangerous operation, causing bodily harm","0","0","0","0","0","0","0","0","0","0","0","0","0","0"
"2004","Chestermere, Alberta, Royal Canadian Mounted Police, municipal","48005","Dangerous operation, causing bodily harm","0","0","0","0","0","0","0","0","0","0","0","0","0","0"
"2005","Chestermere, Alberta, Royal Canadian Mounted Police, municipal","48005","Dangerous operation, causing bodily harm","0","0","0","0","0","0","0","0","0","0","0","0","0","0"
"2006","Chestermere, Alberta, Royal Canadian Mounted Police, municipal","48005","Dangerous operation, causing bodily harm","0","0","0","0","0","0","0","0","0","0","0","0","0","0"
"2007","Chestermere, Alberta, Royal Canadian Mounted Police, municipal","48005","Dangerous operation, causing bodily harm","1","1","0","0","8.8","12.32","10.85","0","0","1","1","1","0","0"
"2008","Chestermere, Alberta, Royal Canadian Mounted Police, municipal","48005","Dangerous operation, causing bodily harm","0","0","0","-100","0","0","0","0","0","0","0","0","0","0"
"2009","Chestermere, Alberta, Royal Canadian Mounted Police, municipal","48005","Dangerous operation, causing bodily harm","1","1","0","0","7.44","10.35","9.16","0","0","1","1","1","0","0"
"2010","Chestermere, Alberta, Royal Canadian Mounted Police, municipal","48005","Dangerous operation, causing bodily harm","0","0","0","-100","0","0","0","0","0","0","0","0","0","0"
"2011","Chestermere, Alberta, Royal Canadian Mounted Police, municipal","48005","Dangerous operation, causing bodily harm","0","0","0","0","0","0","0","0","0","0","0","0","0","0"
"2012","Chestermere, Alberta, Royal Canadian Mounted Police, municipal","48005","Dangerous operation, causing bodily harm","0","0","0","0","0","0","0","0","0","0","0","0","0","0"
"2013","Chestermere, Alberta, Royal Canadian Mounted Police, municipal","48005","Dangerous operation, causing bodily harm","0","0","0","0","0","0","0","0","0","0","0","0","0","0"
"2014","Chestermere, Alberta, Royal Canadian Mounted Police, municipal","48005","Dangerous operation, causing bodily harm","0","0","0","0","0","0","0","0","0","0","0","0","0","0"
"2015","Chestermere, Alberta, Royal Canadian Mounted Police, municipal","48005","Dangerous operation, causing bodily harm","0","0","0","0","0","0","0","0","0","0","0","0","0","0"
"2016","Chestermere, Alberta, Royal Canadian Mounted Police, municipal","48005","Dangerous operation, causing bodily harm","0","0","0","0","0","0","0","0","0","0","0","0","0","0"
"1998","Chestermere, Alberta, Royal Canadian Mounted Police, municipal","48005","Dangerous operation of motor vehicle, vessel or aircraft","0","0","0","0","0","0","0","0","0","0","0","0","0","0"
"1999","Chestermere, Alberta, Royal Canadian Mounted Police, municipal","48005","Dangerous operation of motor vehicle, vessel or aircraft","0","0","0","0","0","0","0","0","0","0","0","0","0","0"
"2000","Chestermere, Alberta, Royal Canadian Mounted Police, municipal","48005","Dangerous operation of motor vehicle, vessel or aircraft","0","0","0","0","0","0","0","0","0","0","0","0","0","0"
"2001","Chestermere, Alberta, Royal Canadian Mounted Police, municipal","48005","Dangerous operation of motor vehicle, vessel or aircraft","0","0","0","0","0","0","0","0","0","0","0","0","0","0"
"2002","Chestermere, Alberta, Royal Canadian Mounted Police, municipal","48005","Dangerous operation of motor vehicle, vessel or aircraft","0","0","0","0","0","0","0","0","0","0","0","0","0","0"
"2003","Chestermere, Alberta, Royal Canadian Mounted Police, municipal","48005","Dangerous operation of motor vehicle, vessel or aircraft","0","0","0","0","0","0","0","0","0","0","0","0","0","0"
"2004","Chestermere, Alberta, Royal Canadian Mounted Police, municipal","48005","Dangerous operation of motor vehicle, vessel or aircraft","0","0","0","0","0","0","0","0","0","0","0","0","0","0"
"2005","Chestermere, Alberta, Royal Canadian Mounted Police, municipal","48005","Dangerous operation of motor vehicle, vessel or aircraft","0","0","0","0","0","0","0","0","0","0","0","0","0","0"
"2006","Chestermere, Alberta, Royal Canadian Mounted Police, municipal","48005","Dangerous operation of motor vehicle, vessel or aircraft","5","3","1","0","48.12","67.58","59.42","0","0","4","5","5","0","0"
"2007","Chestermere, Alberta, Royal Canadian Mounted Police, municipal","48005","Dangerous operation of motor vehicle, vessel or aircraft","12","3","3","119.47","105.62","24.64","32.56","91.16","91.16","6","2","3","1","1"
"2008","Chestermere, Alberta, Royal Canadian Mounted Police, municipal","48005","Dangerous operation of motor vehicle, vessel or aircraft","18","5","6","37.74","145.48","56.41","49.8","0","0","11","5","5","0","0"
"2009","Chestermere, Alberta, Royal Canadian Mounted Police, municipal","48005","Dangerous operation of motor vehicle, vessel or aircraft","17","12","2","-13.01","126.55","113.86","109.87","79.3","79.3","14","11","12","1","1"
"2010","Chestermere, Alberta, Royal Canadian Mounted Police, municipal","48005","Dangerous operation of motor vehicle, vessel or aircraft","6","6","0","-67.11","41.62","57.93","51.22","0","0","6","6","6","0","0"
"2011","Chestermere, Alberta, Royal Canadian Mounted Police, municipal","48005","Dangerous operation of motor vehicle, vessel or aircraft","6","4","0","-6.3","39","36.24","32.21","0","0","4","4","4","0","0"
"2012","Chestermere, Alberta, Royal Canadian Mounted Police, municipal","48005","Dangerous operation of motor vehicle, vessel or aircraft","5","6","1","-19.09","31.55","52.67","46.95","0","0","7","6","6","0","0"
"2013","Chestermere, Alberta, Royal Canadian Mounted Police, municipal","48005","Dangerous operation of motor vehicle, vessel or aircraft","4","4","0","-22.69","24.39","33.83","30.26","0","0","4","4","4","0","0"
"2014","Chestermere, Alberta, Royal Canadian Mounted Police, municipal","48005","Dangerous operation of motor vehicle, vessel or aircraft","2","1","1","-51.58","11.81","8.17","7.33","0","0","2","1","1","0","0"
"2015","Chestermere, Alberta, Royal Canadian Mounted Police, municipal","48005","Dangerous operation of motor vehicle, vessel or aircraft","1","1","0","-51.1","5.78","8","7.18","0","0","1","1","1","0","0"
"2016","Chestermere, Alberta, Royal Canadian Mounted Police, municipal","48005","Dangerous operation of motor vehicle, vessel or aircraft","1","1","0","-2.44","5.63","7.81","7.02","0","0","1","1","1","0","0"
"2000","Chestermere, Alberta, Royal Canadian Mounted Police, municipal","48005","Dangerous operation evading police, causing death","0","0","0","0","0","0","0","0","0","0","0","0","0","0"
"2001","Chestermere, Alberta, Royal Canadian Mounted Police, municipal","48005","Dangerous operation evading police, causing death","0","0","0","0","0","0","0","0","0","0","0","0","0","0"
"2002","Chestermere, Alberta, Royal Canadian Mounted Police, municipal","48005","Dangerous operation evading police, causing death","0","0","0","0","0","0","0","0","0","0","0","0","0","0"
"2003","Chestermere, Alberta, Royal Canadian Mounted Police, municipal","48005","Dangerous operation evading police, causing death","0","0","0","0","0","0","0","0","0","0","0","0","0","0"
"2004","Chestermere, Alberta, Royal Canadian Mounted Police, municipal","48005","Dangerous operation evading police, causing death","0","0","0","0","0","0","0","0","0","0","0","0","0","0"
"2005","Chestermere, Alberta, Royal Canadian Mounted Police, municipal","48005","Dangerous operation evading police, causing death","0","0","0","0","0","0","0","0","0","0","0","0","0","0"
"2006","Chestermere, Alberta, Royal Canadian Mounted Police, municipal","48005","Dangerous operation evading police, causing death","0","0","0","0","0","0","0","0","0","0","0","0","0","0"
"2007","Chestermere, Alberta, Royal Canadian Mounted Police, municipal","48005","Dangerous operation evading police, causing death","0","0","0","0","0","0","0","0","0","0","0","0","0","0"
"2008","Chestermere, Alberta, Royal Canadian Mounted Police, municipal","48005","Dangerous operation evading police, causing death","0","0","0","0","0","0","0","0","0","0","0","0","0","0"
"2009","Chestermere, Alberta, Royal Canadian Mounted Police, municipal","48005","Dangerous operation evading police, causing death","0","0","0","0","0","0","0","0","0","0","0","0","0","0"
"2010","Chestermere, Alberta, Royal Canadian Mounted Police, municipal","48005","Dangerous operation evading police, causing death","0","0","0","0","0","0","0","0","0","0","0","0","0","0"
"2011","Chestermere, Alberta, Royal Canadian Mounted Police, municipal","48005","Dangerous operation evading police, causing death","0","0","0","0","0","0","0","0","0","0","0","0","0","0"
"2012","Chestermere, Alberta, Royal Canadian Mounted Police, municipal","48005","Dangerous operation evading police, causing death","0","0","0","0","0","0","0","0","0","0","0","0","0","0"
"2013","Chestermere, Alberta, Royal Canadian Mounted Police, municipal","48005","Dangerous operation evading police, causing death","0","0","0","0","0","0","0","0","0","0","0","0","0","0"
"2014","Chestermere, Alberta, Royal Canadian Mounted Police, municipal","48005","Dangerous operation evading police, causing death","0","0","0","0","0","0","0","0","0","0","0","0","0","0"
"2015","Chestermere, Alberta, Royal Canadian Mounted Police, municipal","48005","Dangerous operation evading police, causing death","0","0","0","0","0","0","0","0","0","0","0","0","0","0"
"2016","Chestermere, Alberta, Royal Canadian Mounted Police, municipal","48005","Dangerous operation evading police, causing death","0","0","0","0","0","0","0","0","0","0","0","0","0","0"
"2000","Chestermere, Alberta, Royal Canadian Mounted Police, municipal","48005","Dangerous operation evading police, causing bodily harm","0","0","0","0","0","0","0","0","0","0","0","0","0","0"
"2001","Chestermere, Alberta, Royal Canadian Mounted Police, municipal","48005","Dangerous operation evading police, causing bodily harm","0","0","0","0","0","0","0","0","0","0","0","0","0","0"
"2002","Chestermere, Alberta, Royal Canadian Mounted Police, municipal","48005","Dangerous operation evading police, causing bodily harm","0","0","0","0","0","0","0","0","0","0","0","0","0","0"
"2003","Chestermere, Alberta, Royal Canadian Mounted Police, municipal","48005","Dangerous operation evading police, causing bodily harm","0","0","0","0","0","0","0","0","0","0","0","0","0","0"
"2004","Chestermere, Alberta, Royal Canadian Mounted Police, municipal","48005","Dangerous operation evading police, causing bodily harm","0","0","0","0","0","0","0","0","0","0","0","0","0","0"
"2005","Chestermere, Alberta, Royal Canadian Mounted Police, municipal","48005","Dangerous operation evading police, causing bodily harm","0","0","0","0","0","0","0","0","0","0","0","0","0","0"
"2006","Chestermere, Alberta, Royal Canadian Mounted Police, municipal","48005","Dangerous operation evading police, causing bodily harm","0","0","0","0","0","0","0","0","0","0","0","0","0","0"
"2007","Chestermere, Alberta, Royal Canadian Mounted Police, municipal","48005","Dangerous operation evading police, causing bodily harm","0","0","0","0","0","0","0","0","0","0","0","0","0","0"
"2008","Chestermere, Alberta, Royal Canadian Mounted Police, municipal","48005","Dangerous operation evading police, causing bodily harm","0","0","0","0","0","0","0","0","0","0","0","0","0","0"
"2009","Chestermere, Alberta, Royal Canadian Mounted Police, municipal","48005","Dangerous operation evading police, causing bodily harm","0","0","0","0","0","0","0","0","0","0","0","0","0","0"
"2010","Chestermere, Alberta, Royal Canadian Mounted Police, municipal","48005","Dangerous operation evading police, causing bodily harm","0","0","0","0","0","0","0","0","0","0","0","0","0","0"
"2011","Chestermere, Alberta, Royal Canadian Mounted Police, municipal","48005","Dangerous operation evading police, causing bodily harm","0","0","0","0","0","0","0","0","0","0","0","0","0","0"
"2012","Chestermere, Alberta, Royal Canadian Mounted Police, municipal","48005","Dangerous operation evading police, causing bodily harm","0","0","0","0","0","0","0","0","0","0","0","0","0","0"
"2013","Chestermere, Alberta, Royal Canadian Mounted Police, municipal","48005","Dangerous operation evading police, causing bodily harm","0","0","0","0","0","0","0","0","0","0","0","0","0","0"
"2014","Chestermere, Alberta, Royal Canadian Mounted Police, municipal","48005","Dangerous operation evading police, causing bodily harm","0","0","0","0","0","0","0","0","0","0","0","0","0","0"
"2015","Chestermere, Alberta, Royal Canadian Mounted Police, municipal","48005","Dangerous operation evading police, causing bodily harm","0","0","0","0","0","0","0","0","0","0","0","0","0","0"
"2016","Chestermere, Alberta, Royal Canadian Mounted Police, municipal","48005","Dangerous operation evading police, causing bodily harm","0","0","0","0","0","0","0","0","0","0","0","0","0","0"
"2000","Chestermere, Alberta, Royal Canadian Mounted Police, municipal","48005","Dangerous operation of motor vehicle evading police","0","0","0","0","0","0","0","0","0","0","0","0","0","0"
"2001","Chestermere, Alberta, Royal Canadian Mounted Police, municipal","48005","Dangerous operation of motor vehicle evading police","0","0","0","0","0","0","0","0","0","0","0","0","0","0"
"2002","Chestermere, Alberta, Royal Canadian Mounted Police, municipal","48005","Dangerous operation of motor vehicle evading police","0","0","0","0","0","0","0","0","0","0","0","0","0","0"
"2003","Chestermere, Alberta, Royal Canadian Mounted Police, municipal","48005","Dangerous operation of motor vehicle evading police","0","0","0","0","0","0","0","0","0","0","0","0","0","0"
"2004","Chestermere, Alberta, Royal Canadian Mounted Police, municipal","48005","Dangerous operation of motor vehicle evading police","0","0","0","0","0","0","0","0","0","0","0","0","0","0"
"2005","Chestermere, Alberta, Royal Canadian Mounted Police, municipal","48005","Dangerous operation of motor vehicle evading police","0","0","0","0","0","0","0","0","0","0","0","0","0","0"
"2006","Chestermere, Alberta, Royal Canadian Mounted Police, municipal","48005","Dangerous operation of motor vehicle evading police","2","1","0","0","19.25","27.03","23.77","0","0","1","2","2","0","0"
"2007","Chestermere, Alberta, Royal Canadian Mounted Police, municipal","48005","Dangerous operation of motor vehicle evading police","0","0","0","-100","0","0","0","0","0","0","0","0","0","0"
"2008","Chestermere, Alberta, Royal Canadian Mounted Police, municipal","48005","Dangerous operation of motor vehicle evading police","3","0","0","0","24.25","0","0","0","0","0","0","0","0","0"
"2009","Chestermere, Alberta, Royal Canadian Mounted Police, municipal","48005","Dangerous operation of motor vehicle evading police","1","0","0","-69.3","7.44","0","0","0","0","0","0","0","0","0"
"2010","Chestermere, Alberta, Royal Canadian Mounted Police, municipal","48005","Dangerous operation of motor vehicle evading police","0","0","0","-100","0","0","0","0","0","0","0","0","0","0"
"2011","Chestermere, Alberta, Royal Canadian Mounted Police, municipal","48005","Dangerous operation of motor vehicle evading police","2","1","0","0","13","9.06","8.05","0","0","1","1","1","0","0"
"2012","Chestermere, Alberta, Royal Canadian Mounted Police, municipal","48005","Dangerous operation of motor vehicle evading police","0","0","0","-100","0","0","0","0","0","0","0","0","0","0"
"2013","Chestermere, Alberta, Royal Canadian Mounted Police, municipal","48005","Dangerous operation of motor vehicle evading police","0","0","0","0","0","0","0","0","0","0","0","0","0","0"
"2014","Chestermere, Alberta, Royal Canadian Mounted Police, municipal","48005","Dangerous operation of motor vehicle evading police","0","0","0","0","0","0","0","0","0","0","0","0","0","0"
"2015","Chestermere, Alberta, Royal Canadian Mounted Police, municipal","48005","Dangerous operation of motor vehicle evading police","0","0","0","0","0","0","0","0","0","0","0","0","0","0"
"2016","Chestermere, Alberta, Royal Canadian Mounted Police, municipal","48005","Dangerous operation of motor vehicle evading police","2","2","0","0","11.27","23.44","21.07","0","0","2","3","3","0","0"
"1998","Chestermere, Alberta, Royal Canadian Mounted Police, municipal","48005","Total fail to stop or remain","0","0","0","0","0","0","0","0","0","0","0","0","0","0"
"1999","Chestermere, Alberta, Royal Canadian Mounted Police, municipal","48005","Total fail to stop or remain","0","0","0","0","0","0","0","0","0","0","0","0","0","0"
"2000","Chestermere, Alberta, Royal Canadian Mounted Police, municipal","48005","Total fail to stop or remain","0","0","0","0","0","0","0","0","0","0","0","0","0","0"
"2001","Chestermere, Alberta, Royal Canadian Mounted Police, municipal","48005","Total fail to stop or remain","0","0","0","0","0","0","0","0","0","0","0","0","0","0"
"2002","Chestermere, Alberta, Royal Canadian Mounted Police, municipal","48005","Total fail to stop or remain","0","0","0","0","0","0","0","0","0","0","0","0","0","0"
"2003","Chestermere, Alberta, Royal Canadian Mounted Police, municipal","48005","Total fail to stop or remain","0","0","0","0","0","0","0","0","0","0","0","0","0","0"
"2004","Chestermere, Alberta, Royal Canadian Mounted Police, municipal","48005","Total fail to stop or remain","0","0","0","0","0","0","0","0","0","0","0","0","0","0"
"2005","Chestermere, Alberta, Royal Canadian Mounted Police, municipal","48005","Total fail to stop or remain","1","0","0","0","11.54","0","0","0","0","0","0","0","0","0"
"2006","Chestermere, Alberta, Royal Canadian Mounted Police, municipal","48005","Total fail to stop or remain","15","0","2","1150.53","144.37","0","0","0","0","2","0","0","0","0"
"2007","Chestermere, Alberta, Royal Canadian Mounted Police, municipal","48005","Total fail to stop or remain","21","1","4","28.02","184.83","0","0","0","0","5","0","0","0","0"
"2008","Chestermere, Alberta, Royal Canadian Mounted Police, municipal","48005","Total fail to stop or remain","54","1","5","136.13","436.43","11.28","9.96","0","0","6","1","1","0","0"
"2009","Chestermere, Alberta, Royal Canadian Mounted Police, municipal","48005","Total fail to stop or remain","40","1","2","-31.77","297.77","10.35","9.16","0","0","3","1","1","0","0"
"2010","Chestermere, Alberta, Royal Canadian Mounted Police, municipal","48005","Total fail to stop or remain","29","0","0","-32.45","201.15","0","0","0","0","0","0","0","0","0"
"2011","Chestermere, Alberta, Royal Canadian Mounted Police, municipal","48005","Total fail to stop or remain","30","0","0","-3.07","194.98","0","0","0","0","0","0","0","0","0"
"2012","Chestermere, Alberta, Royal Canadian Mounted Police, municipal","48005","Total fail to stop or remain","44","0","1","42.4","277.66","0","0","0","0","1","0","0","0","0"
"2013","Chestermere, Alberta, Royal Canadian Mounted Police, municipal","48005","Total fail to stop or remain","35","0","2","-23.13","213.43","0","0","0","0","2","0","0","0","0"
"2014","Chestermere, Alberta, Royal Canadian Mounted Police, municipal","48005","Total fail to stop or remain","21","0","1","-41.9","124","0","0","0","0","1","0","0","0","0"
"2015","Chestermere, Alberta, Royal Canadian Mounted Police, municipal","48005","Total fail to stop or remain","4","0","0","-81.37","23.1","0","0","0","0","0","0","0","0","0"
"2016","Chestermere, Alberta, Royal Canadian Mounted Police, municipal","48005","Total fail to stop or remain","1","0","0","-75.61","5.63","0","0","0","0","0","0","0","0","0"
"1998","Chestermere, Alberta, Royal Canadian Mounted Police, municipal","48005","Driving while prohibited","0","0","0","0","0","0","0","0","0","0","0","0","0","0"
"1999","Chestermere, Alberta, Royal Canadian Mounted Police, municipal","48005","Driving while prohibited","0","0","0","0","0","0","0","0","0","0","0","0","0","0"
"2000","Chestermere, Alberta, Royal Canadian Mounted Police, municipal","48005","Driving while prohibited","0","0","0","0","0","0","0","0","0","0","0","0","0","0"
"2001","Chestermere, Alberta, Royal Canadian Mounted Police, municipal","48005","Driving while prohibited","0","0","0","0","0","0","0","0","0","0","0","0","0","0"
"2002","Chestermere, Alberta, Royal Canadian Mounted Police, municipal","48005","Driving while prohibited","0","0","0","0","0","0","0","0","0","0","0","0","0","0"
"2003","Chestermere, Alberta, Royal Canadian Mounted Police, municipal","48005","Driving while prohibited","0","0","0","0","0","0","0","0","0","0","0","0","0","0"
"2004","Chestermere, Alberta, Royal Canadian Mounted Police, municipal","48005","Driving while prohibited","0","0","0","0","0","0","0","0","0","0","0","0","0","0"
"2005","Chestermere, Alberta, Royal Canadian Mounted Police, municipal","48005","Driving while prohibited","0","0","0","0","0","0","0","0","0","0","0","0","0","0"
"2006","Chestermere, Alberta, Royal Canadian Mounted Police, municipal","48005","Driving while prohibited","2","2","0","0","19.25","27.03","23.77","0","0","2","2","2","0","0"
"2007","Chestermere, Alberta, Royal Canadian Mounted Police, municipal","48005","Driving while prohibited","1","1","0","-54.28","8.8","12.32","10.85","0","0","1","1","1","0","0"
"2008","Chestermere, Alberta, Royal Canadian Mounted Police, municipal","48005","Driving while prohibited","2","2","0","83.66","16.16","22.57","19.92","0","0","2","2","2","0","0"
"2009","Chestermere, Alberta, Royal Canadian Mounted Police, municipal","48005","Driving while prohibited","1","1","0","-53.95","7.44","10.35","9.16","0","0","1","1","1","0","0"
"2010","Chestermere, Alberta, Royal Canadian Mounted Police, municipal","48005","Driving while prohibited","0","0","0","-100","0","0","0","0","0","0","0","0","0","0"
"2011","Chestermere, Alberta, Royal Canadian Mounted Police, municipal","48005","Driving while prohibited","0","0","0","0","0","0","0","0","0","0","0","0","0","0"
"2012","Chestermere, Alberta, Royal Canadian Mounted Police, municipal","48005","Driving while prohibited","1","1","0","0","6.31","8.78","7.83","0","0","1","1","1","0","0"
"2013","Chestermere, Alberta, Royal Canadian Mounted Police, municipal","48005","Driving while prohibited","3","3","0","189.9","18.29","25.37","22.7","0","0","3","3","3","0","0"
"2014","Chestermere, Alberta, Royal Canadian Mounted Police, municipal","48005","Driving while prohibited","2","2","0","-35.44","11.81","16.34","14.66","0","0","2","2","2","0","0"
"2015","Chestermere, Alberta, Royal Canadian Mounted Police, municipal","48005","Driving while prohibited","4","4","0","95.61","23.1","31.98","28.74","0","0","4","4","4","0","0"
"2016","Chestermere, Alberta, Royal Canadian Mounted Police, municipal","48005","Driving while prohibited","1","1","0","-75.61","5.63","7.81","7.02","0","0","1","1","1","0","0"
"1998","Chestermere, Alberta, Royal Canadian Mounted Police, municipal","48005","Other Criminal Code traffic violations","0","0","0","0","0","0","0","0","0","0","0","0","0","0"
"1999","Chestermere, Alberta, Royal Canadian Mounted Police, municipal","48005","Other Criminal Code traffic violations","0","0","0","0","0","0","0","0","0","0","0","0","0","0"
"2000","Chestermere, Alberta, Royal Canadian Mounted Police, municipal","48005","Other Criminal Code traffic violations","0","0","0","0","0","0","0","0","0","0","0","0","0","0"
"2001","Chestermere, Alberta, Royal Canadian Mounted Police, municipal","48005","Other Criminal Code traffic violations","0","0","0","0","0","0","0","0","0","0","0","0","0","0"
"2002","Chestermere, Alberta, Royal Canadian Mounted Police, municipal","48005","Other Criminal Code traffic violations","0","0","0","0","0","0","0","0","0","0","0","0","0","0"
"2003","Chestermere, Alberta, Royal Canadian Mounted Police, municipal","48005","Other Criminal Code traffic violations","0","0","0","0","0","0","0","0","0","0","0","0","0","0"
"2004","Chestermere, Alberta, Royal Canadian Mounted Police, municipal","48005","Other Criminal Code traffic violations","0","0","0","0","0","0","0","0","0","0","0","0","0","0"
"2005","Chestermere, Alberta, Royal Canadian Mounted Police, municipal","48005","Other Criminal Code traffic violations","0","0","0","0","0","0","0","0","0","0","0","0","0","0"
"2006","Chestermere, Alberta, Royal Canadian Mounted Police, municipal","48005","Other Criminal Code traffic violations","0","0","0","0","0","0","0","0","0","0","0","0","0","0"
"2007","Chestermere, Alberta, Royal Canadian Mounted Police, municipal","48005","Other Criminal Code traffic violations","0","0","0","0","0","0","0","0","0","0","0","0","0","0"
"2008","Chestermere, Alberta, Royal Canadian Mounted Police, municipal","48005","Other Criminal Code traffic violations","2","0","1","0","16.16","0","0","0","0","1","0","0","0","0"
"2009","Chestermere, Alberta, Royal Canadian Mounted Police, municipal","48005","Other Criminal Code traffic violations","0","0","0","-100","0","0","0","0","0","0","0","0","0","0"
"2010","Chestermere, Alberta, Royal Canadian Mounted Police, municipal","48005","Other Criminal Code traffic violations","2","0","2","0","13.87","0","0","0","0","2","0","0","0","0"
"2011","Chestermere, Alberta, Royal Canadian Mounted Police, municipal","48005","Other Criminal Code traffic violations","1","0","0","-53.15","6.5","0","0","0","0","0","0","0","0","0"
"2012","Chestermere, Alberta, Royal Canadian Mounted Police, municipal","48005","Other Criminal Code traffic violations","0","0","0","-100","0","0","0","0","0","0","0","0","0","0"
"2013","Chestermere, Alberta, Royal Canadian Mounted Police, municipal","48005","Other Criminal Code traffic violations","0","0","0","0","0","0","0","0","0","0","0","0","0","0"
"2014","Chestermere, Alberta, Royal Canadian Mounted Police, municipal","48005","Other Criminal Code traffic violations","0","0","0","0","0","0","0","0","0","0","0","0","0","0"
"2015","Chestermere, Alberta, Royal Canadian Mounted Police, municipal","48005","Other Criminal Code traffic violations","1","0","0","0","5.78","0","0","0","0","0","0","0","0","0"
"2016","Chestermere, Alberta, Royal Canadian Mounted Police, municipal","48005","Other Criminal Code traffic violations","0","0","0","-100","0","0","0","0","0","0","0","0","0","0"
"2005","Chestermere, Alberta, Royal Canadian Mounted Police, municipal","48005","Causing death by criminal negligence while street racing","0","0","0","0","0","0","0","0","0","0","0","0","0","0"
"2006","Chestermere, Alberta, Royal Canadian Mounted Police, municipal","48005","Causing death by criminal negligence while street racing","0","0","0","0","0","0","0","0","0","0","0","0","0","0"
"2007","Chestermere, Alberta, Royal Canadian Mounted Police, municipal","48005","Causing death by criminal negligence while street racing","0","0","0","0","0","0","0","0","0","0","0","0","0","0"
"2008","Chestermere, Alberta, Royal Canadian Mounted Police, municipal","48005","Causing death by criminal negligence while street racing","0","0","0","0","0","0","0","0","0","0","0","0","0","0"
"2009","Chestermere, Alberta, Royal Canadian Mounted Police, municipal","48005","Causing death by criminal negligence while street racing","0","0","0","0","0","0","0","0","0","0","0","0","0","0"
"2010","Chestermere, Alberta, Royal Canadian Mounted Police, municipal","48005","Causing death by criminal negligence while street racing","0","0","0","0","0","0","0","0","0","0","0","0","0","0"
"2011","Chestermere, Alberta, Royal Canadian Mounted Police, municipal","48005","Causing death by criminal negligence while street racing","0","0","0","0","0","0","0","0","0","0","0","0","0","0"
"2012","Chestermere, Alberta, Royal Canadian Mounted Police, municipal","48005","Causing death by criminal negligence while street racing","0","0","0","0","0","0","0","0","0","0","0","0","0","0"
"2013","Chestermere, Alberta, Royal Canadian Mounted Police, municipal","48005","Causing death by criminal negligence while street racing","0","0","0","0","0","0","0","0","0","0","0","0","0","0"
"2014","Chestermere, Alberta, Royal Canadian Mounted Police, municipal","48005","Causing death by criminal negligence while street racing","0","0","0","0","0","0","0","0","0","0","0","0","0","0"
"2015","Chestermere, Alberta, Royal Canadian Mounted Police, municipal","48005","Causing death by criminal negligence while street racing","0","0","0","0","0","0","0","0","0","0","0","0","0","0"
"2016","Chestermere, Alberta, Royal Canadian Mounted Police, municipal","48005","Causing death by criminal negligence while street racing","0","0","0","0","0","0","0","0","0","0","0","0","0","0"
"2005","Chestermere, Alberta, Royal Canadian Mounted Police, municipal","48005","Causing bodily harm by criminal negligence while street racing","0","0","0","0","0","0","0","0","0","0","0","0","0","0"
"2006","Chestermere, Alberta, Royal Canadian Mounted Police, municipal","48005","Causing bodily harm by criminal negligence while street racing","0","0","0","0","0","0","0","0","0","0","0","0","0","0"
"2007","Chestermere, Alberta, Royal Canadian Mounted Police, municipal","48005","Causing bodily harm by criminal negligence while street racing","0","0","0","0","0","0","0","0","0","0","0","0","0","0"
"2008","Chestermere, Alberta, Royal Canadian Mounted Police, municipal","48005","Causing bodily harm by criminal negligence while street racing","0","0","0","0","0","0","0","0","0","0","0","0","0","0"
"2009","Chestermere, Alberta, Royal Canadian Mounted Police, municipal","48005","Causing bodily harm by criminal negligence while street racing","0","0","0","0","0","0","0","0","0","0","0","0","0","0"
"2010","Chestermere, Alberta, Royal Canadian Mounted Police, municipal","48005","Causing bodily harm by criminal negligence while street racing","0","0","0","0","0","0","0","0","0","0","0","0","0","0"
"2011","Chestermere, Alberta, Royal Canadian Mounted Police, municipal","48005","Causing bodily harm by criminal negligence while street racing","0","0","0","0","0","0","0","0","0","0","0","0","0","0"
"2012","Chestermere, Alberta, Royal Canadian Mounted Police, municipal","48005","Causing bodily harm by criminal negligence while street racing","0","0","0","0","0","0","0","0","0","0","0","0","0","0"
"2013","Chestermere, Alberta, Royal Canadian Mounted Police, municipal","48005","Causing bodily harm by criminal negligence while street racing","0","0","0","0","0","0","0","0","0","0","0","0","0","0"
"2014","Chestermere, Alberta, Royal Canadian Mounted Police, municipal","48005","Causing bodily harm by criminal negligence while street racing","0","0","0","0","0","0","0","0","0","0","0","0","0","0"
"2015","Chestermere, Alberta, Royal Canadian Mounted Police, municipal","48005","Causing bodily harm by criminal negligence while street racing","0","0","0","0","0","0","0","0","0","0","0","0","0","0"
"2016","Chestermere, Alberta, Royal Canadian Mounted Police, municipal","48005","Causing bodily harm by criminal negligence while street racing","0","0","0","0","0","0","0","0","0","0","0","0","0","0"
"2005","Chestermere, Alberta, Royal Canadian Mounted Police, municipal","48005","Dangerous operation causing death while street racing","0","0","0","0","0","0","0","0","0","0","0","0","0","0"
"2006","Chestermere, Alberta, Royal Canadian Mounted Police, municipal","48005","Dangerous operation causing death while street racing","0","0","0","0","0","0","0","0","0","0","0","0","0","0"
"2007","Chestermere, Alberta, Royal Canadian Mounted Police, municipal","48005","Dangerous operation causing death while street racing","0","0","0","0","0","0","0","0","0","0","0","0","0","0"
"2008","Chestermere, Alberta, Royal Canadian Mounted Police, municipal","48005","Dangerous operation causing death while street racing","0","0","0","0","0","0","0","0","0","0","0","0","0","0"
"2009","Chestermere, Alberta, Royal Canadian Mounted Police, municipal","48005","Dangerous operation causing death while street racing","0","0","0","0","0","0","0","0","0","0","0","0","0","0"
"2010","Chestermere, Alberta, Royal Canadian Mounted Police, municipal","48005","Dangerous operation causing death while street racing","0","0","0","0","0","0","0","0","0","0","0","0","0","0"
"2011","Chestermere, Alberta, Royal Canadian Mounted Police, municipal","48005","Dangerous operation causing death while street racing","0","0","0","0","0","0","0","0","0","0","0","0","0","0"
"2012","Chestermere, Alberta, Royal Canadian Mounted Police, municipal","48005","Dangerous operation causing death while street racing","0","0","0","0","0","0","0","0","0","0","0","0","0","0"
"2013","Chestermere, Alberta, Royal Canadian Mounted Police, municipal","48005","Dangerous operation causing death while street racing","0","0","0","0","0","0","0","0","0","0","0","0","0","0"
"2014","Chestermere, Alberta, Royal Canadian Mounted Police, municipal","48005","Dangerous operation causing death while street racing","0","0","0","0","0","0","0","0","0","0","0","0","0","0"
"2015","Chestermere, Alberta, Royal Canadian Mounted Police, municipal","48005","Dangerous operation causing death while street racing","0","0","0","0","0","0","0","0","0","0","0","0","0","0"
"2016","Chestermere, Alberta, Royal Canadian Mounted Police, municipal","48005","Dangerous operation causing death while street racing","0","0","0","0","0","0","0","0","0","0","0","0","0","0"
"2005","Chestermere, Alberta, Royal Canadian Mounted Police, municipal","48005","Dangerous operation causing bodily harm while street racing","0","0","0","0","0","0","0","0","0","0","0","0","0","0"
"2006","Chestermere, Alberta, Royal Canadian Mounted Police, municipal","48005","Dangerous operation causing bodily harm while street racing","0","0","0","0","0","0","0","0","0","0","0","0","0","0"
"2007","Chestermere, Alberta, Royal Canadian Mounted Police, municipal","48005","Dangerous operation causing bodily harm while street racing","0","0","0","0","0","0","0","0","0","0","0","0","0","0"
"2008","Chestermere, Alberta, Royal Canadian Mounted Police, municipal","48005","Dangerous operation causing bodily harm while street racing","0","0","0","0","0","0","0","0","0","0","0","0","0","0"
"2009","Chestermere, Alberta, Royal Canadian Mounted Police, municipal","48005","Dangerous operation causing bodily harm while street racing","0","0","0","0","0","0","0","0","0","0","0","0","0","0"
"2010","Chestermere, Alberta, Royal Canadian Mounted Police, municipal","48005","Dangerous operation causing bodily harm while street racing","0","0","0","0","0","0","0","0","0","0","0","0","0","0"
"2011","Chestermere, Alberta, Royal Canadian Mounted Police, municipal","48005","Dangerous operation causing bodily harm while street racing","0","0","0","0","0","0","0","0","0","0","0","0","0","0"
"2012","Chestermere, Alberta, Royal Canadian Mounted Police, municipal","48005","Dangerous operation causing bodily harm while street racing","0","0","0","0","0","0","0","0","0","0","0","0","0","0"
"2013","Chestermere, Alberta, Royal Canadian Mounted Police, municipal","48005","Dangerous operation causing bodily harm while street racing","0","0","0","0","0","0","0","0","0","0","0","0","0","0"
"2014","Chestermere, Alberta, Royal Canadian Mounted Police, municipal","48005","Dangerous operation causing bodily harm while street racing","0","0","0","0","0","0","0","0","0","0","0","0","0","0"
"2015","Chestermere, Alberta, Royal Canadian Mounted Police, municipal","48005","Dangerous operation causing bodily harm while street racing","0","0","0","0","0","0","0","0","0","0","0","0","0","0"
"2016","Chestermere, Alberta, Royal Canadian Mounted Police, municipal","48005","Dangerous operation causing bodily harm while street racing","0","0","0","0","0","0","0","0","0","0","0","0","0","0"
"2005","Chestermere, Alberta, Royal Canadian Mounted Police, municipal","48005","Dangerous operation of motor vehicle while street racing","0","0","0","0","0","0","0","0","0","0","0","0","0","0"
"2006","Chestermere, Alberta, Royal Canadian Mounted Police, municipal","48005","Dangerous operation of motor vehicle while street racing","0","0","0","0","0","0","0","0","0","0","0","0","0","0"
"2007","Chestermere, Alberta, Royal Canadian Mounted Police, municipal","48005","Dangerous operation of motor vehicle while street racing","0","0","0","0","0","0","0","0","0","0","0","0","0","0"
"2008","Chestermere, Alberta, Royal Canadian Mounted Police, municipal","48005","Dangerous operation of motor vehicle while street racing","0","0","0","0","0","0","0","0","0","0","0","0","0","0"
"2009","Chestermere, Alberta, Royal Canadian Mounted Police, municipal","48005","Dangerous operation of motor vehicle while street racing","0","0","0","0","0","0","0","0","0","0","0","0","0","0"
"2010","Chestermere, Alberta, Royal Canadian Mounted Police, municipal","48005","Dangerous operation of motor vehicle while street racing","0","0","0","0","0","0","0","0","0","0","0","0","0","0"
"2011","Chestermere, Alberta, Royal Canadian Mounted Police, municipal","48005","Dangerous operation of motor vehicle while street racing","0","0","0","0","0","0","0","0","0","0","0","0","0","0"
"2012","Chestermere, Alberta, Royal Canadian Mounted Police, municipal","48005","Dangerous operation of motor vehicle while street racing","0","0","0","0","0","0","0","0","0","0","0","0","0","0"
"2013","Chestermere, Alberta, Royal Canadian Mounted Police, municipal","48005","Dangerous operation of motor vehicle while street racing","0","0","0","0","0","0","0","0","0","0","0","0","0","0"
"2014","Chestermere, Alberta, Royal Canadian Mounted Police, municipal","48005","Dangerous operation of motor vehicle while street racing","1","0","0","0","5.9","0","0","0","0","0","0","0","0","0"
"2015","Chestermere, Alberta, Royal Canadian Mounted Police, municipal","48005","Dangerous operation of motor vehicle while street racing","0","0","0","-100","0","0","0","0","0","0","0","0","0","0"
"2016","Chestermere, Alberta, Royal Canadian Mounted Police, municipal","48005","Dangerous operation of motor vehicle while street racing","1","0","0","0","5.63","0","0","0","0","0","0","0","0","0"
"1998","Chestermere, Alberta, Royal Canadian Mounted Police, municipal","48005","Total Federal Statute violations","0","0","0","0","0","0","0","0","0","0","0","0","0","0"
"1999","Chestermere, Alberta, Royal Canadian Mounted Police, municipal","48005","Total Federal Statute violations","0","0","0","0","0","0","0","0","0","0","0","0","0","0"
"2000","Chestermere, Alberta, Royal Canadian Mounted Police, municipal","48005","Total Federal Statute violations","0","0","0","0","0","0","0","0","0","0","0","0","0","0"
"2001","Chestermere, Alberta, Royal Canadian Mounted Police, municipal","48005","Total Federal Statute violations","0","0","0","0","0","0","0","0","0","0","0","0","0","0"
"2002","Chestermere, Alberta, Royal Canadian Mounted Police, municipal","48005","Total Federal Statute violations","0","0","0","0","0","0","0","0","0","0","0","0","0","0"
"2003","Chestermere, Alberta, Royal Canadian Mounted Police, municipal","48005","Total Federal Statute violations","0","0","0","0","0","0","0","0","0","0","0","0","0","0"
"2004","Chestermere, Alberta, Royal Canadian Mounted Police, municipal","48005","Total Federal Statute violations","0","0","0","0","0","0","0","0","0","0","0","0","0","0"
"2005","Chestermere, Alberta, Royal Canadian Mounted Police, municipal","48005","Total Federal Statute violations","14","5","6","0","161.63","31.98","70.7","366.3","488.4","11","2","5","3","4"
"2006","Chestermere, Alberta, Royal Canadian Mounted Police, municipal","48005","Total Federal Statute violations","30","8","13","78.65","288.74","67.58","83.19","197.04","1477.83","21","5","7","2","15"
"2007","Chestermere, Alberta, Royal Canadian Mounted Police, municipal","48005","Total Federal Statute violations","100","7","57","204.82","880.13","86.24","86.82","91.16","2552.42","64","7","8","1","28"
"2008","Chestermere, Alberta, Royal Canadian Mounted Police, municipal","48005","Total Federal Statute violations","97","6","74","-10.93","783.97","67.7","69.71","84.89","1188.46","80","6","7","1","14"
"2009","Chestermere, Alberta, Royal Canadian Mounted Police, municipal","48005","Total Federal Statute violations","92","13","47","-12.64","684.88","134.56","164.8","396.51","2379.06","60","13","18","5","30"
"2010","Chestermere, Alberta, Royal Canadian Mounted Police, municipal","48005","Total Federal Statute violations","80","12","36","-18.98","554.9","106.21","110.97","147.28","1178.2","48","11","13","2","16"
"2011","Chestermere, Alberta, Royal Canadian Mounted Police, municipal","48005","Total Federal Statute violations","91","23","25","6.59","591.45","208.35","201.3","144.93","362.32","48","23","25","2","5"
"2012","Chestermere, Alberta, Royal Canadian Mounted Police, municipal","48005","Total Federal Statute violations","72","16","22","-23.18","454.34","114.13","179.98","720.46","1440.92","38","13","23","10","20"
"2013","Chestermere, Alberta, Royal Canadian Mounted Police, municipal","48005","Total Federal Statute violations","62","16","22","-16.79","378.07","126.87","121.06","71.74","789.1","38","15","16","1","11"
"2014","Chestermere, Alberta, Royal Canadian Mounted Police, municipal","48005","Total Federal Statute violations","60","6","15","-6.29","354.3","49.02","65.98","214.44","214.44","21","6","9","3","3"
"2015","Chestermere, Alberta, Royal Canadian Mounted Police, municipal","48005","Total Federal Statute violations","55","17","21","-10.35","317.64","191.89","201.15","283.09","283.09","38","24","28","4","4"
"2016","Chestermere, Alberta, Royal Canadian Mounted Police, municipal","48005","Total Federal Statute violations","73","15","29","29.49","411.31","179.74","189.59","276.82","276.82","44","23","27","4","4"
"1998","Chestermere, Alberta, Royal Canadian Mounted Police, municipal","48005","Total Drug violations","0","0","0","0","0","0","0","0","0","0","0","0","0","0"
"1999","Chestermere, Alberta, Royal Canadian Mounted Police, municipal","48005","Total Drug violations","0","0","0","0","0","0","0","0","0","0","0","0","0","0"
"2000","Chestermere, Alberta, Royal Canadian Mounted Police, municipal","48005","Total Drug violations","0","0","0","0","0","0","0","0","0","0","0","0","0","0"
"2001","Chestermere, Alberta, Royal Canadian Mounted Police, municipal","48005","Total Drug violations","0","0","0","0","0","0","0","0","0","0","0","0","0","0"
"2002","Chestermere, Alberta, Royal Canadian Mounted Police, municipal","48005","Total Drug violations","0","0","0","0","0","0","0","0","0","0","0","0","0","0"
"2003","Chestermere, Alberta, Royal Canadian Mounted Police, municipal","48005","Total Drug violations","0","0","0","0","0","0","0","0","0","0","0","0","0","0"
"2004","Chestermere, Alberta, Royal Canadian Mounted Police, municipal","48005","Total Drug violations","0","0","0","0","0","0","0","0","0","0","0","0","0","0"
"2005","Chestermere, Alberta, Royal Canadian Mounted Police, municipal","48005","Total Drug violations","14","5","6","0","161.63","31.98","70.7","366.3","488.4","11","2","5","3","4"
"2006","Chestermere, Alberta, Royal Canadian Mounted Police, municipal","48005","Total Drug violations","23","7","9","36.96","221.37","54.06","71.31","197.04","1379.31","16","4","6","2","14"
"2007","Chestermere, Alberta, Royal Canadian Mounted Police, municipal","48005","Total Drug violations","77","6","40","206.14","677.7","73.92","75.97","91.16","2552.42","46","6","7","1","28"
"2008","Chestermere, Alberta, Royal Canadian Mounted Police, municipal","48005","Total Drug violations","48","6","27","-42.76","387.94","67.7","69.71","84.89","933.79","33","6","7","1","11"
"2009","Chestermere, Alberta, Royal Canadian Mounted Police, municipal","48005","Total Drug violations","77","11","42","47.76","573.22","113.86","146.49","396.51","2299.76","53","11","16","5","29"
"2010","Chestermere, Alberta, Royal Canadian Mounted Police, municipal","48005","Total Drug violations","67","12","31","-18.93","464.73","106.21","110.97","147.28","1178.2","43","11","13","2","16"
"2011","Chestermere, Alberta, Royal Canadian Mounted Police, municipal","48005","Total Drug violations","68","23","18","-4.9","441.96","208.35","201.3","144.93","362.32","41","23","25","2","5"
"2012","Chestermere, Alberta, Royal Canadian Mounted Police, municipal","48005","Total Drug violations","58","16","21","-17.19","366","114.13","179.98","720.46","1440.92","37","13","23","10","20"
"2013","Chestermere, Alberta, Royal Canadian Mounted Police, municipal","48005","Total Drug violations","51","16","18","-15.03","310.99","126.87","121.06","71.74","645.62","34","15","16","1","9"
"2014","Chestermere, Alberta, Royal Canadian Mounted Police, municipal","48005","Total Drug violations","35","6","11","-33.54","206.67","49.02","65.98","214.44","214.44","17","6","9","3","3"
"2015","Chestermere, Alberta, Royal Canadian Mounted Police, municipal","48005","Total Drug violations","51","17","21","42.52","294.54","191.89","201.15","283.09","283.09","38","24","28","4","4"
"2016","Chestermere, Alberta, Royal Canadian Mounted Police, municipal","48005","Total Drug violations","63","15","26","20.52","354.97","179.74","189.59","276.82","207.61","41","23","27","4","3"
"1998","Chestermere, Alberta, Royal Canadian Mounted Police, municipal","48005","Possession, cannabis","0","0","0","0","0","0","0","0","0","0","0","0","0","0"
"1999","Chestermere, Alberta, Royal Canadian Mounted Police, municipal","48005","Possession, cannabis","0","0","0","0","0","0","0","0","0","0","0","0","0","0"
"2000","Chestermere, Alberta, Royal Canadian Mounted Police, municipal","48005","Possession, cannabis","0","0","0","0","0","0","0","0","0","0","0","0","0","0"
"2001","Chestermere, Alberta, Royal Canadian Mounted Police, municipal","48005","Possession, cannabis","0","0","0","0","0","0","0","0","0","0","0","0","0","0"
"2002","Chestermere, Alberta, Royal Canadian Mounted Police, municipal","48005","Possession, cannabis","0","0","0","0","0","0","0","0","0","0","0","0","0","0"
"2003","Chestermere, Alberta, Royal Canadian Mounted Police, municipal","48005","Possession, cannabis","0","0","0","0","0","0","0","0","0","0","0","0","0","0"
"2004","Chestermere, Alberta, Royal Canadian Mounted Police, municipal","48005","Possession, cannabis","0","0","0","0","0","0","0","0","0","0","0","0","0","0"
"2005","Chestermere, Alberta, Royal Canadian Mounted Police, municipal","48005","Possession, cannabis","10","3","6","0","115.45","31.98","42.42","122.1","366.3","9","2","3","1","3"
"2006","Chestermere, Alberta, Royal Canadian Mounted Police, municipal","48005","Possession, cannabis","14","4","7","16.72","134.74","27.03","35.65","98.52","1280.79","11","2","3","1","13"
"2007","Chestermere, Alberta, Royal Canadian Mounted Police, municipal","48005","Possession, cannabis","49","5","32","220.06","431.26","49.28","54.27","91.16","2187.78","37","4","5","1","24"
"2008","Chestermere, Alberta, Royal Canadian Mounted Police, municipal","48005","Possession, cannabis","28","5","22","-47.53","226.3","45.13","49.8","84.89","933.79","27","4","5","1","11"
"2009","Chestermere, Alberta, Royal Canadian Mounted Police, municipal","48005","Possession, cannabis","52","6","36","71.06","387.11","62.11","64.09","79.3","1982.55","42","6","7","1","25"
"2010","Chestermere, Alberta, Royal Canadian Mounted Police, municipal","48005","Possession, cannabis","42","10","25","-24.74","291.32","86.9","93.9","147.28","1030.93","35","9","11","2","14"
"2011","Chestermere, Alberta, Royal Canadian Mounted Police, municipal","48005","Possession, cannabis","38","14","16","-15.22","246.98","99.65","104.68","144.93","217.39","30","11","13","2","3"
"2012","Chestermere, Alberta, Royal Canadian Mounted Police, municipal","48005","Possession, cannabis","37","10","16","-5.46","233.48","79.01","109.55","360.23","1008.65","26","9","14","5","14"
"2013","Chestermere, Alberta, Royal Canadian Mounted Police, municipal","48005","Possession, cannabis","37","13","17","-3.37","225.62","93.04","90.79","71.74","645.62","30","11","12","1","9"
"2014","Chestermere, Alberta, Royal Canadian Mounted Police, municipal","48005","Possession, cannabis","26","6","11","-31.95","153.53","49.02","65.98","214.44","214.44","17","6","9","3","3"
"2015","Chestermere, Alberta, Royal Canadian Mounted Police, municipal","48005","Possession, cannabis","31","10","20","16.61","179.04","119.93","129.31","212.31","212.31","30","15","18","3","3"
"2016","Chestermere, Alberta, Royal Canadian Mounted Police, municipal","48005","Possession, cannabis","42","8","24","32.18","236.65","93.78","105.33","207.61","207.61","32","12","15","3","3"
"1998","Chestermere, Alberta, Royal Canadian Mounted Police, municipal","48005","Possession, cocaine","0","0","0","0","0","0","0","0","0","0","0","0","0","0"
"1999","Chestermere, Alberta, Royal Canadian Mounted Police, municipal","48005","Possession, cocaine","0","0","0","0","0","0","0","0","0","0","0","0","0","0"
"2000","Chestermere, Alberta, Royal Canadian Mounted Police, municipal","48005","Possession, cocaine","0","0","0","0","0","0","0","0","0","0","0","0","0","0"
"2001","Chestermere, Alberta, Royal Canadian Mounted Police, municipal","48005","Possession, cocaine","0","0","0","0","0","0","0","0","0","0","0","0","0","0"
"2002","Chestermere, Alberta, Royal Canadian Mounted Police, municipal","48005","Possession, cocaine","0","0","0","0","0","0","0","0","0","0","0","0","0","0"
"2003","Chestermere, Alberta, Royal Canadian Mounted Police, municipal","48005","Possession, cocaine","0","0","0","0","0","0","0","0","0","0","0","0","0","0"
"2004","Chestermere, Alberta, Royal Canadian Mounted Police, municipal","48005","Possession, cocaine","0","0","0","0","0","0","0","0","0","0","0","0","0","0"
"2005","Chestermere, Alberta, Royal Canadian Mounted Police, municipal","48005","Possession, cocaine","0","0","0","0","0","0","0","0","0","0","0","0","0","0"
"2006","Chestermere, Alberta, Royal Canadian Mounted Police, municipal","48005","Possession, cocaine","1","1","0","0","9.62","13.52","11.88","0","0","1","1","1","0","0"
"2007","Chestermere, Alberta, Royal Canadian Mounted Police, municipal","48005","Possession, cocaine","6","0","5","448.67","52.81","0","0","0","0","5","0","0","0","0"
"2008","Chestermere, Alberta, Royal Canadian Mounted Police, municipal","48005","Possession, cocaine","3","0","2","-54.09","24.25","0","0","0","0","2","0","0","0","0"
"2009","Chestermere, Alberta, Royal Canadian Mounted Police, municipal","48005","Possession, cocaine","1","0","1","-69.3","7.44","0","0","0","0","1","0","0","0","0"
"2010","Chestermere, Alberta, Royal Canadian Mounted Police, municipal","48005","Possession, cocaine","1","0","0","-6.83","6.94","0","0","0","0","0","0","0","0","0"
"2011","Chestermere, Alberta, Royal Canadian Mounted Police, municipal","48005","Possession, cocaine","3","0","0","181.11","19.5","0","0","0","0","0","0","0","0","0"
"2012","Chestermere, Alberta, Royal Canadian Mounted Police, municipal","48005","Possession, cocaine","1","1","0","-67.64","6.31","8.78","7.83","0","0","1","1","1","0","0"
"2013","Chestermere, Alberta, Royal Canadian Mounted Police, municipal","48005","Possession, cocaine","1","1","0","-3.37","6.1","8.46","7.57","0","0","1","1","1","0","0"
"2014","Chestermere, Alberta, Royal Canadian Mounted Police, municipal","48005","Possession, cocaine","0","0","0","-100","0","0","0","0","0","0","0","0","0","0"
"2015","Chestermere, Alberta, Royal Canadian Mounted Police, municipal","48005","Possession, cocaine","3","3","0","0","17.33","39.98","43.1","70.77","0","3","5","6","1","0"
"2016","Chestermere, Alberta, Royal Canadian Mounted Police, municipal","48005","Possession, cocaine","8","4","0","160.16","45.08","54.7","49.15","0","0","4","7","7","0","0"
"1998","Chestermere, Alberta, Royal Canadian Mounted Police, municipal","48005","Total, possession, other Controlled Drugs and Substances Act drugs","0","0","0","0","0","0","0","0","0","0","0","0","0","0"
"1999","Chestermere, Alberta, Royal Canadian Mounted Police, municipal","48005","Total, possession, other Controlled Drugs and Substances Act drugs","0","0","0","0","0","0","0","0","0","0","0","0","0","0"
"2000","Chestermere, Alberta, Royal Canadian Mounted Police, municipal","48005","Total, possession, other Controlled Drugs and Substances Act drugs","0","0","0","0","0","0","0","0","0","0","0","0","0","0"
"2001","Chestermere, Alberta, Royal Canadian Mounted Police, municipal","48005","Total, possession, other Controlled Drugs and Substances Act drugs","0","0","0","0","0","0","0","0","0","0","0","0","0","0"
"2002","Chestermere, Alberta, Royal Canadian Mounted Police, municipal","48005","Total, possession, other Controlled Drugs and Substances Act drugs","0","0","0","0","0","0","0","0","0","0","0","0","0","0"
"2003","Chestermere, Alberta, Royal Canadian Mounted Police, municipal","48005","Total, possession, other Controlled Drugs and Substances Act drugs","0","0","0","0","0","0","0","0","0","0","0","0","0","0"
"2004","Chestermere, Alberta, Royal Canadian Mounted Police, municipal","48005","Total, possession, other Controlled Drugs and Substances Act drugs","0","0","0","0","0","0","0","0","0","0","0","0","0","0"
"2005","Chestermere, Alberta, Royal Canadian Mounted Police, municipal","48005","Total, possession, other Controlled Drugs and Substances Act drugs","0","0","0","0","0","0","0","0","0","0","0","0","0","0"
"2006","Chestermere, Alberta, Royal Canadian Mounted Police, municipal","48005","Total, possession, other Controlled Drugs and Substances Act drugs","1","0","0","0","9.62","0","0","0","0","0","0","0","0","0"
"2007","Chestermere, Alberta, Royal Canadian Mounted Police, municipal","48005","Total, possession, other Controlled Drugs and Substances Act drugs","1","0","0","-8.55","8.8","0","0","0","0","0","0","0","0","0"
"2008","Chestermere, Alberta, Royal Canadian Mounted Police, municipal","48005","Total, possession, other Controlled Drugs and Substances Act drugs","2","0","0","83.66","16.16","0","0","0","0","0","0","0","0","0"
"2009","Chestermere, Alberta, Royal Canadian Mounted Police, municipal","48005","Total, possession, other Controlled Drugs and Substances Act drugs","1","1","0","-53.95","7.44","10.35","9.16","0","0","1","1","1","0","0"
"2010","Chestermere, Alberta, Royal Canadian Mounted Police, municipal","48005","Total, possession, other Controlled Drugs and Substances Act drugs","3","0","2","179.52","20.81","0","0","0","73.64","2","0","0","0","1"
"2011","Chestermere, Alberta, Royal Canadian Mounted Police, municipal","48005","Total, possession, other Controlled Drugs and Substances Act drugs","1","1","1","-68.77","6.5","9.06","8.05","0","72.46","2","1","1","0","1"
"2012","Chestermere, Alberta, Royal Canadian Mounted Police, municipal","48005","Total, possession, other Controlled Drugs and Substances Act drugs","2","0","2","94.18","12.62","0","0","0","0","2","0","0","0","0"
"2013","Chestermere, Alberta, Royal Canadian Mounted Police, municipal","48005","Total, possession, other Controlled Drugs and Substances Act drugs","0","0","0","-100","0","0","0","0","0","0","0","0","0","0"
"2014","Chestermere, Alberta, Royal Canadian Mounted Police, municipal","48005","Total, possession, other Controlled Drugs and Substances Act drugs","0","0","0","0","0","0","0","0","0","0","0","0","0","0"
"2015","Chestermere, Alberta, Royal Canadian Mounted Police, municipal","48005","Total, possession, other Controlled Drugs and Substances Act drugs","2","2","0","0","11.55","15.99","14.37","0","0","2","2","2","0","0"
"2016","Chestermere, Alberta, Royal Canadian Mounted Police, municipal","48005","Total, possession, other Controlled Drugs and Substances Act drugs","5","1","1","143.9","28.17","0","0","0","0","2","0","0","0","0"
"1998","Chestermere, Alberta, Royal Canadian Mounted Police, municipal","48005","Heroin, possession","0","0","0","0","0","0","0","0","0","0","0","0","0","0"
"1999","Chestermere, Alberta, Royal Canadian Mounted Police, municipal","48005","Heroin, possession","0","0","0","0","0","0","0","0","0","0","0","0","0","0"
"2000","Chestermere, Alberta, Royal Canadian Mounted Police, municipal","48005","Heroin, possession","0","0","0","0","0","0","0","0","0","0","0","0","0","0"
"2001","Chestermere, Alberta, Royal Canadian Mounted Police, municipal","48005","Heroin, possession","0","0","0","0","0","0","0","0","0","0","0","0","0","0"
"2002","Chestermere, Alberta, Royal Canadian Mounted Police, municipal","48005","Heroin, possession","0","0","0","0","0","0","0","0","0","0","0","0","0","0"
"2003","Chestermere, Alberta, Royal Canadian Mounted Police, municipal","48005","Heroin, possession","0","0","0","0","0","0","0","0","0","0","0","0","0","0"
"2004","Chestermere, Alberta, Royal Canadian Mounted Police, municipal","48005","Heroin, possession","0","0","0","0","0","0","0","0","0","0","0","0","0","0"
"2005","Chestermere, Alberta, Royal Canadian Mounted Police, municipal","48005","Heroin, possession","0","0","0","0","0","0","0","0","0","0","0","0","0","0"
"2006","Chestermere, Alberta, Royal Canadian Mounted Police, municipal","48005","Heroin, possession","0","0","0","0","0","0","0","0","0","0","0","0","0","0"
"2007","Chestermere, Alberta, Royal Canadian Mounted Police, municipal","48005","Heroin, possession","0","0","0","0","0","0","0","0","0","0","0","0","0","0"
"2008","Chestermere, Alberta, Royal Canadian Mounted Police, municipal","48005","Heroin, possession","0","0","0","0","0","0","0","0","0","0","0","0","0","0"
"2009","Chestermere, Alberta, Royal Canadian Mounted Police, municipal","48005","Heroin, possession","0","0","0","0","0","0","0","0","0","0","0","0","0","0"
"2010","Chestermere, Alberta, Royal Canadian Mounted Police, municipal","48005","Heroin, possession","0","0","0","0","0","0","0","0","0","0","0","0","0","0"
"2011","Chestermere, Alberta, Royal Canadian Mounted Police, municipal","48005","Heroin, possession","0","0","0","0","0","0","0","0","0","0","0","0","0","0"
"2012","Chestermere, Alberta, Royal Canadian Mounted Police, municipal","48005","Heroin, possession","2","0","2","0","12.62","0","0","0","0","2","0","0","0","0"
"2013","Chestermere, Alberta, Royal Canadian Mounted Police, municipal","48005","Heroin, possession","0","0","0","-100","0","0","0","0","0","0","0","0","0","0"
"2014","Chestermere, Alberta, Royal Canadian Mounted Police, municipal","48005","Heroin, possession","0","0","0","0","0","0","0","0","0","0","0","0","0","0"
"2015","Chestermere, Alberta, Royal Canadian Mounted Police, municipal","48005","Heroin, possession","0","0","0","0","0","0","0","0","0","0","0","0","0","0"
"2016","Chestermere, Alberta, Royal Canadian Mounted Police, municipal","48005","Heroin, possession","0","0","0","0","0","0","0","0","0","0","0","0","0","0"
"1998","Chestermere, Alberta, Royal Canadian Mounted Police, municipal","48005","Other Controlled Drugs and Substances Act, possession","0","0","0","0","0","0","0","0","0","0","0","0","0","0"
"1999","Chestermere, Alberta, Royal Canadian Mounted Police, municipal","48005","Other Controlled Drugs and Substances Act, possession","0","0","0","0","0","0","0","0","0","0","0","0","0","0"
"2000","Chestermere, Alberta, Royal Canadian Mounted Police, municipal","48005","Other Controlled Drugs and Substances Act, possession","0","0","0","0","0","0","0","0","0","0","0","0","0","0"
"2001","Chestermere, Alberta, Royal Canadian Mounted Police, municipal","48005","Other Controlled Drugs and Substances Act, possession","0","0","0","0","0","0","0","0","0","0","0","0","0","0"
"2002","Chestermere, Alberta, Royal Canadian Mounted Police, municipal","48005","Other Controlled Drugs and Substances Act, possession","0","0","0","0","0","0","0","0","0","0","0","0","0","0"
"2003","Chestermere, Alberta, Royal Canadian Mounted Police, municipal","48005","Other Controlled Drugs and Substances Act, possession","0","0","0","0","0","0","0","0","0","0","0","0","0","0"
"2004","Chestermere, Alberta, Royal Canadian Mounted Police, municipal","48005","Other Controlled Drugs and Substances Act, possession","0","0","0","0","0","0","0","0","0","0","0","0","0","0"
"2005","Chestermere, Alberta, Royal Canadian Mounted Police, municipal","48005","Other Controlled Drugs and Substances Act, possession","0","0","0","0","0","0","0","0","0","0","0","0","0","0"
"2006","Chestermere, Alberta, Royal Canadian Mounted Police, municipal","48005","Other Controlled Drugs and Substances Act, possession","1","0","0","0","9.62","0","0","0","0","0","0","0","0","0"
"2007","Chestermere, Alberta, Royal Canadian Mounted Police, municipal","48005","Other Controlled Drugs and Substances Act, possession","1","0","0","-8.55","8.8","0","0","0","0","0","0","0","0","0"
"2008","Chestermere, Alberta, Royal Canadian Mounted Police, municipal","48005","Other Controlled Drugs and Substances Act, possession","2","0","0","83.66","16.16","0","0","0","0","0","0","0","0","0"
"2009","Chestermere, Alberta, Royal Canadian Mounted Police, municipal","48005","Other Controlled Drugs and Substances Act, possession","1","1","0","-53.95","7.44","10.35","9.16","0","0","1","1","1","0","0"
"2010","Chestermere, Alberta, Royal Canadian Mounted Police, municipal","48005","Other Controlled Drugs and Substances Act, possession","2","0","1","86.35","13.87","0","0","0","0","1","0","0","0","0"
"2011","Chestermere, Alberta, Royal Canadian Mounted Police, municipal","48005","Other Controlled Drugs and Substances Act, possession","0","0","1","-100","0","0","0","0","72.46","1","0","0","0","1"
"2012","Chestermere, Alberta, Royal Canadian Mounted Police, municipal","48005","Other Controlled Drugs and Substances Act, possession","0","0","0","0","0","0","0","0","0","0","0","0","0","0"
"2013","Chestermere, Alberta, Royal Canadian Mounted Police, municipal","48005","Other Controlled Drugs and Substances Act, possession","0","0","0","0","0","0","0","0","0","0","0","0","0","0"
"2014","Chestermere, Alberta, Royal Canadian Mounted Police, municipal","48005","Other Controlled Drugs and Substances Act, possession","0","0","0","0","0","0","0","0","0","0","0","0","0","0"
"2015","Chestermere, Alberta, Royal Canadian Mounted Police, municipal","48005","Other Controlled Drugs and Substances Act, possession","2","2","0","0","11.55","15.99","14.37","0","0","2","2","2","0","0"
"2016","Chestermere, Alberta, Royal Canadian Mounted Police, municipal","48005","Other Controlled Drugs and Substances Act, possession","2","0","0","-2.44","11.27","0","0","0","0","0","0","0","0","0"
"2005","Chestermere, Alberta, Royal Canadian Mounted Police, municipal","48005","Methamphetamines (crystal meth), possession","0","0","0","0","0","0","0","0","0","0","0","0","0","0"
"2006","Chestermere, Alberta, Royal Canadian Mounted Police, municipal","48005","Methamphetamines (crystal meth), possession","0","0","0","0","0","0","0","0","0","0","0","0","0","0"
"2007","Chestermere, Alberta, Royal Canadian Mounted Police, municipal","48005","Methamphetamines (crystal meth), possession","0","0","0","0","0","0","0","0","0","0","0","0","0","0"
"2008","Chestermere, Alberta, Royal Canadian Mounted Police, municipal","48005","Methamphetamines (crystal meth), possession","0","0","0","0","0","0","0","0","0","0","0","0","0","0"
"2009","Chestermere, Alberta, Royal Canadian Mounted Police, municipal","48005","Methamphetamines (crystal meth), possession","0","0","0","0","0","0","0","0","0","0","0","0","0","0"
"2010","Chestermere, Alberta, Royal Canadian Mounted Police, municipal","48005","Methamphetamines (crystal meth), possession","0","0","0","0","0","0","0","0","0","0","0","0","0","0"
"2011","Chestermere, Alberta, Royal Canadian Mounted Police, municipal","48005","Methamphetamines (crystal meth), possession","1","1","0","0","6.5","9.06","8.05","0","0","1","1","1","0","0"
"2012","Chestermere, Alberta, Royal Canadian Mounted Police, municipal","48005","Methamphetamines (crystal meth), possession","0","0","0","-100","0","0","0","0","0","0","0","0","0","0"
"2013","Chestermere, Alberta, Royal Canadian Mounted Police, municipal","48005","Methamphetamines (crystal meth), possession","0","0","0","0","0","0","0","0","0","0","0","0","0","0"
"2014","Chestermere, Alberta, Royal Canadian Mounted Police, municipal","48005","Methamphetamines (crystal meth), possession","0","0","0","0","0","0","0","0","0","0","0","0","0","0"
"2015","Chestermere, Alberta, Royal Canadian Mounted Police, municipal","48005","Methamphetamines (crystal meth), possession","0","0","0","0","0","0","0","0","0","0","0","0","0","0"
"2016","Chestermere, Alberta, Royal Canadian Mounted Police, municipal","48005","Methamphetamines (crystal meth), possession","3","1","1","0","16.9","0","0","0","0","2","0","0","0","0"
"2005","Chestermere, Alberta, Royal Canadian Mounted Police, municipal","48005","Methylenedioxyamphetamine (ecstasy), possession","0","0","0","0","0","0","0","0","0","0","0","0","0","0"
"2006","Chestermere, Alberta, Royal Canadian Mounted Police, municipal","48005","Methylenedioxyamphetamine (ecstasy), possession","0","0","0","0","0","0","0","0","0","0","0","0","0","0"
"2007","Chestermere, Alberta, Royal Canadian Mounted Police, municipal","48005","Methylenedioxyamphetamine (ecstasy), possession","0","0","0","0","0","0","0","0","0","0","0","0","0","0"
"2008","Chestermere, Alberta, Royal Canadian Mounted Police, municipal","48005","Methylenedioxyamphetamine (ecstasy), possession","0","0","0","0","0","0","0","0","0","0","0","0","0","0"
"2009","Chestermere, Alberta, Royal Canadian Mounted Police, municipal","48005","Methylenedioxyamphetamine (ecstasy), possession","0","0","0","0","0","0","0","0","0","0","0","0","0","0"
"2010","Chestermere, Alberta, Royal Canadian Mounted Police, municipal","48005","Methylenedioxyamphetamine (ecstasy), possession","1","0","1","0","6.94","0","0","0","73.64","1","0","0","0","1"
"2011","Chestermere, Alberta, Royal Canadian Mounted Police, municipal","48005","Methylenedioxyamphetamine (ecstasy), possession","0","0","0","-100","0","0","0","0","0","0","0","0","0","0"
"2012","Chestermere, Alberta, Royal Canadian Mounted Police, municipal","48005","Methylenedioxyamphetamine (ecstasy), possession","0","0","0","0","0","0","0","0","0","0","0","0","0","0"
"2013","Chestermere, Alberta, Royal Canadian Mounted Police, municipal","48005","Methylenedioxyamphetamine (ecstasy), possession","0","0","0","0","0","0","0","0","0","0","0","0","0","0"
"2014","Chestermere, Alberta, Royal Canadian Mounted Police, municipal","48005","Methylenedioxyamphetamine (ecstasy), possession","0","0","0","0","0","0","0","0","0","0","0","0","0","0"
"2015","Chestermere, Alberta, Royal Canadian Mounted Police, municipal","48005","Methylenedioxyamphetamine (ecstasy), possession","0","0","0","0","0","0","0","0","0","0","0","0","0","0"
"2016","Chestermere, Alberta, Royal Canadian Mounted Police, municipal","48005","Methylenedioxyamphetamine (ecstasy), possession","0","0","0","0","0","0","0","0","0","0","0","0","0","0"
"1998","Chestermere, Alberta, Royal Canadian Mounted Police, municipal","48005","Total cannabis, trafficking, production or distribution","0","0","0","0","0","0","0","0","0","0","0","0","0","0"
"1999","Chestermere, Alberta, Royal Canadian Mounted Police, municipal","48005","Total cannabis, trafficking, production or distribution","0","0","0","0","0","0","0","0","0","0","0","0","0","0"
"2000","Chestermere, Alberta, Royal Canadian Mounted Police, municipal","48005","Total cannabis, trafficking, production or distribution","0","0","0","0","0","0","0","0","0","0","0","0","0","0"
"2001","Chestermere, Alberta, Royal Canadian Mounted Police, municipal","48005","Total cannabis, trafficking, production or distribution","0","0","0","0","0","0","0","0","0","0","0","0","0","0"
"2002","Chestermere, Alberta, Royal Canadian Mounted Police, municipal","48005","Total cannabis, trafficking, production or distribution","0","0","0","0","0","0","0","0","0","0","0","0","0","0"
"2003","Chestermere, Alberta, Royal Canadian Mounted Police, municipal","48005","Total cannabis, trafficking, production or distribution","0","0","0","0","0","0","0","0","0","0","0","0","0","0"
"2004","Chestermere, Alberta, Royal Canadian Mounted Police, municipal","48005","Total cannabis, trafficking, production or distribution","0","0","0","0","0","0","0","0","0","0","0","0","0","0"
"2005","Chestermere, Alberta, Royal Canadian Mounted Police, municipal","48005","Total cannabis, trafficking, production or distribution","2","2","0","0","23.09","0","28.28","244.2","122.1","2","0","2","2","1"
"2006","Chestermere, Alberta, Royal Canadian Mounted Police, municipal","48005","Total cannabis, trafficking, production or distribution","6","2","1","150.11","57.75","13.52","23.77","98.52","0","3","1","2","1","0"
"2007","Chestermere, Alberta, Royal Canadian Mounted Police, municipal","48005","Total cannabis, trafficking, production or distribution","17","1","3","159.09","149.62","24.64","21.71","0","364.63","4","2","2","0","4"
"2008","Chestermere, Alberta, Royal Canadian Mounted Police, municipal","48005","Total cannabis, trafficking, production or distribution","11","1","3","-40.58","88.9","22.57","19.92","0","0","4","2","2","0","0"
"2009","Chestermere, Alberta, Royal Canadian Mounted Police, municipal","48005","Total cannabis, trafficking, production or distribution","17","3","4","42.35","126.55","20.7","54.93","317.21","317.21","7","2","6","4","4"
"2010","Chestermere, Alberta, Royal Canadian Mounted Police, municipal","48005","Total cannabis, trafficking, production or distribution","16","2","3","-12.31","110.98","19.31","17.07","0","73.64","5","2","2","0","1"
"2011","Chestermere, Alberta, Royal Canadian Mounted Police, municipal","48005","Total cannabis, trafficking, production or distribution","22","6","1","28.84","142.99","81.53","72.47","0","72.46","7","9","9","0","1"
"2012","Chestermere, Alberta, Royal Canadian Mounted Police, municipal","48005","Total cannabis, trafficking, production or distribution","10","4","1","-55.87","63.1","17.56","46.95","288.18","144.09","5","2","6","4","2"
"2013","Chestermere, Alberta, Royal Canadian Mounted Police, municipal","48005","Total cannabis, trafficking, production or distribution","10","1","1","-3.37","60.98","16.92","15.13","0","0","2","2","2","0","0"
"2014","Chestermere, Alberta, Royal Canadian Mounted Police, municipal","48005","Total cannabis, trafficking, production or distribution","6","0","0","-41.9","35.43","0","0","0","0","0","0","0","0","0"
"2015","Chestermere, Alberta, Royal Canadian Mounted Police, municipal","48005","Total cannabis, trafficking, production or distribution","8","0","0","30.41","46.2","0","0","0","0","0","0","0","0","0"
"2016","Chestermere, Alberta, Royal Canadian Mounted Police, municipal","48005","Total cannabis, trafficking, production or distribution","4","1","1","-51.22","22.54","7.81","14.04","69.2","0","2","1","2","1","0"
"1998","Chestermere, Alberta, Royal Canadian Mounted Police, municipal","48005","Cannabis, trafficking","0","0","0","0","0","0","0","0","0","0","0","0","0","0"
"1999","Chestermere, Alberta, Royal Canadian Mounted Police, municipal","48005","Cannabis, trafficking","0","0","0","0","0","0","0","0","0","0","0","0","0","0"
"2000","Chestermere, Alberta, Royal Canadian Mounted Police, municipal","48005","Cannabis, trafficking","0","0","0","0","0","0","0","0","0","0","0","0","0","0"
"2001","Chestermere, Alberta, Royal Canadian Mounted Police, municipal","48005","Cannabis, trafficking","0","0","0","0","0","0","0","0","0","0","0","0","0","0"
"2002","Chestermere, Alberta, Royal Canadian Mounted Police, municipal","48005","Cannabis, trafficking","0","0","0","0","0","0","0","0","0","0","0","0","0","0"
"2003","Chestermere, Alberta, Royal Canadian Mounted Police, municipal","48005","Cannabis, trafficking","0","0","0","0","0","0","0","0","0","0","0","0","0","0"
"2004","Chestermere, Alberta, Royal Canadian Mounted Police, municipal","48005","Cannabis, trafficking","0","0","0","0","0","0","0","0","0","0","0","0","0","0"
"2005","Chestermere, Alberta, Royal Canadian Mounted Police, municipal","48005","Cannabis, trafficking","2","2","0","0","23.09","0","28.28","244.2","122.1","2","0","2","2","1"
"2006","Chestermere, Alberta, Royal Canadian Mounted Police, municipal","48005","Cannabis, trafficking","6","2","1","150.11","57.75","13.52","23.77","98.52","0","3","1","2","1","0"
"2007","Chestermere, Alberta, Royal Canadian Mounted Police, municipal","48005","Cannabis, trafficking","11","1","3","67.65","96.81","24.64","21.71","0","364.63","4","2","2","0","4"
"2008","Chestermere, Alberta, Royal Canadian Mounted Police, municipal","48005","Cannabis, trafficking","7","1","0","-41.56","56.57","22.57","19.92","0","0","1","2","2","0","0"
"2009","Chestermere, Alberta, Royal Canadian Mounted Police, municipal","48005","Cannabis, trafficking","10","3","4","31.58","74.44","20.7","54.93","317.21","317.21","7","2","6","4","4"
"2010","Chestermere, Alberta, Royal Canadian Mounted Police, municipal","48005","Cannabis, trafficking","10","2","2","-6.83","69.36","19.31","17.07","0","73.64","4","2","2","0","1"
"2011","Chestermere, Alberta, Royal Canadian Mounted Police, municipal","48005","Cannabis, trafficking","8","5","1","-25.04","52","72.47","64.42","0","72.46","6","8","8","0","1"
"2012","Chestermere, Alberta, Royal Canadian Mounted Police, municipal","48005","Cannabis, trafficking","8","4","1","-2.91","50.48","17.56","46.95","288.18","144.09","5","2","6","4","2"
"2013","Chestermere, Alberta, Royal Canadian Mounted Police, municipal","48005","Cannabis, trafficking","6","0","0","-27.52","36.59","0","0","0","0","0","0","0","0","0"
"2014","Chestermere, Alberta, Royal Canadian Mounted Police, municipal","48005","Cannabis, trafficking","3","0","0","-51.58","17.71","0","0","0","0","0","0","0","0","0"
"2015","Chestermere, Alberta, Royal Canadian Mounted Police, municipal","48005","Cannabis, trafficking","5","0","0","63.01","28.88","0","0","0","0","0","0","0","0","0"
"2016","Chestermere, Alberta, Royal Canadian Mounted Police, municipal","48005","Cannabis, trafficking","1","0","0","-80.49","5.63","0","0","0","0","0","0","0","0","0"
"1998","Chestermere, Alberta, Royal Canadian Mounted Police, municipal","48005","Cannabis, importation and exportation","0","0","0","0","0","0","0","0","0","0","0","0","0","0"
"1999","Chestermere, Alberta, Royal Canadian Mounted Police, municipal","48005","Cannabis, importation and exportation","0","0","0","0","0","0","0","0","0","0","0","0","0","0"
"2000","Chestermere, Alberta, Royal Canadian Mounted Police, municipal","48005","Cannabis, importation and exportation","0","0","0","0","0","0","0","0","0","0","0","0","0","0"
"2001","Chestermere, Alberta, Royal Canadian Mounted Police, municipal","48005","Cannabis, importation and exportation","0","0","0","0","0","0","0","0","0","0","0","0","0","0"
"2002","Chestermere, Alberta, Royal Canadian Mounted Police, municipal","48005","Cannabis, importation and exportation","0","0","0","0","0","0","0","0","0","0","0","0","0","0"
"2003","Chestermere, Alberta, Royal Canadian Mounted Police, municipal","48005","Cannabis, importation and exportation","0","0","0","0","0","0","0","0","0","0","0","0","0","0"
"2004","Chestermere, Alberta, Royal Canadian Mounted Police, municipal","48005","Cannabis, importation and exportation","0","0","0","0","0","0","0","0","0","0","0","0","0","0"
"2005","Chestermere, Alberta, Royal Canadian Mounted Police, municipal","48005","Cannabis, importation and exportation","0","0","0","0","0","0","0","0","0","0","0","0","0","0"
"2006","Chestermere, Alberta, Royal Canadian Mounted Police, municipal","48005","Cannabis, importation and exportation","0","0","0","0","0","0","0","0","0","0","0","0","0","0"
"2007","Chestermere, Alberta, Royal Canadian Mounted Police, municipal","48005","Cannabis, importation and exportation","0","0","0","0","0","0","0","0","0","0","0","0","0","0"
"2008","Chestermere, Alberta, Royal Canadian Mounted Police, municipal","48005","Cannabis, importation and exportation","0","0","0","0","0","0","0","0","0","0","0","0","0","0"
"2009","Chestermere, Alberta, Royal Canadian Mounted Police, municipal","48005","Cannabis, importation and exportation","1","0","0","0","7.44","0","0","0","0","0","0","0","0","0"
"2010","Chestermere, Alberta, Royal Canadian Mounted Police, municipal","48005","Cannabis, importation and exportation","0","0","0","-100","0","0","0","0","0","0","0","0","0","0"
"2011","Chestermere, Alberta, Royal Canadian Mounted Police, municipal","48005","Cannabis, importation and exportation","0","0","0","0","0","0","0","0","0","0","0","0","0","0"
"2012","Chestermere, Alberta, Royal Canadian Mounted Police, municipal","48005","Cannabis, importation and exportation","0","0","0","0","0","0","0","0","0","0","0","0","0","0"
"2013","Chestermere, Alberta, Royal Canadian Mounted Police, municipal","48005","Cannabis, importation and exportation","0","0","0","0","0","0","0","0","0","0","0","0","0","0"
"2014","Chestermere, Alberta, Royal Canadian Mounted Police, municipal","48005","Cannabis, importation and exportation","0","0","0","0","0","0","0","0","0","0","0","0","0","0"
"2015","Chestermere, Alberta, Royal Canadian Mounted Police, municipal","48005","Cannabis, importation and exportation","0","0","0","0","0","0","0","0","0","0","0","0","0","0"
"2016","Chestermere, Alberta, Royal Canadian Mounted Police, municipal","48005","Cannabis, importation and exportation","0","0","0","0","0","0","0","0","0","0","0","0","0","0"
"1998","Chestermere, Alberta, Royal Canadian Mounted Police, municipal","48005","Cannabis, production","0","0","0","0","0","0","0","0","0","0","0","0","0","0"
"1999","Chestermere, Alberta, Royal Canadian Mounted Police, municipal","48005","Cannabis, production","0","0","0","0","0","0","0","0","0","0","0","0","0","0"
"2000","Chestermere, Alberta, Royal Canadian Mounted Police, municipal","48005","Cannabis, production","0","0","0","0","0","0","0","0","0","0","0","0","0","0"
"2001","Chestermere, Alberta, Royal Canadian Mounted Police, municipal","48005","Cannabis, production","0","0","0","0","0","0","0","0","0","0","0","0","0","0"
"2002","Chestermere, Alberta, Royal Canadian Mounted Police, municipal","48005","Cannabis, production","0","0","0","0","0","0","0","0","0","0","0","0","0","0"
"2003","Chestermere, Alberta, Royal Canadian Mounted Police, municipal","48005","Cannabis, production","0","0","0","0","0","0","0","0","0","0","0","0","0","0"
"2004","Chestermere, Alberta, Royal Canadian Mounted Police, municipal","48005","Cannabis, production","0","0","0","0","0","0","0","0","0","0","0","0","0","0"
"2005","Chestermere, Alberta, Royal Canadian Mounted Police, municipal","48005","Cannabis, production","0","0","0","0","0","0","0","0","0","0","0","0","0","0"
"2006","Chestermere, Alberta, Royal Canadian Mounted Police, municipal","48005","Cannabis, production","0","0","0","0","0","0","0","0","0","0","0","0","0","0"
"2007","Chestermere, Alberta, Royal Canadian Mounted Police, municipal","48005","Cannabis, production","6","0","0","0","52.81","0","0","0","0","0","0","0","0","0"
"2008","Chestermere, Alberta, Royal Canadian Mounted Police, municipal","48005","Cannabis, production","4","0","3","-38.78","32.33","0","0","0","0","3","0","0","0","0"
"2009","Chestermere, Alberta, Royal Canadian Mounted Police, municipal","48005","Cannabis, production","6","0","0","38.16","44.67","0","0","0","0","0","0","0","0","0"
"2010","Chestermere, Alberta, Royal Canadian Mounted Police, municipal","48005","Cannabis, production","6","0","1","-6.83","41.62","0","0","0","0","1","0","0","0","0"
"2011","Chestermere, Alberta, Royal Canadian Mounted Police, municipal","48005","Cannabis, production","14","1","0","118.64","90.99","9.06","8.05","0","0","1","1","1","0","0"
"2012","Chestermere, Alberta, Royal Canadian Mounted Police, municipal","48005","Cannabis, production","2","0","0","-86.13","12.62","0","0","0","0","0","0","0","0","0"
"2013","Chestermere, Alberta, Royal Canadian Mounted Police, municipal","48005","Cannabis, production","4","1","1","93.27","24.39","16.92","15.13","0","0","2","2","2","0","0"
"2014","Chestermere, Alberta, Royal Canadian Mounted Police, municipal","48005","Cannabis, production","3","0","0","-27.37","17.71","0","0","0","0","0","0","0","0","0"
"2015","Chestermere, Alberta, Royal Canadian Mounted Police, municipal","48005","Cannabis, production","3","0","0","-2.19","17.33","0","0","0","0","0","0","0","0","0"
"2016","Chestermere, Alberta, Royal Canadian Mounted Police, municipal","48005","Cannabis, production","3","1","1","-2.44","16.9","7.81","14.04","69.2","0","2","1","2","1","0"
"1998","Chestermere, Alberta, Royal Canadian Mounted Police, municipal","48005","Total cocaine, trafficking, production or distribution","0","0","0","0","0","0","0","0","0","0","0","0","0","0"
"1999","Chestermere, Alberta, Royal Canadian Mounted Police, municipal","48005","Total cocaine, trafficking, production or distribution","0","0","0","0","0","0","0","0","0","0","0","0","0","0"
"2000","Chestermere, Alberta, Royal Canadian Mounted Police, municipal","48005","Total cocaine, trafficking, production or distribution","0","0","0","0","0","0","0","0","0","0","0","0","0","0"
"2001","Chestermere, Alberta, Royal Canadian Mounted Police, municipal","48005","Total cocaine, trafficking, production or distribution","0","0","0","0","0","0","0","0","0","0","0","0","0","0"
"2002","Chestermere, Alberta, Royal Canadian Mounted Police, municipal","48005","Total cocaine, trafficking, production or distribution","0","0","0","0","0","0","0","0","0","0","0","0","0","0"
"2003","Chestermere, Alberta, Royal Canadian Mounted Police, municipal","48005","Total cocaine, trafficking, production or distribution","0","0","0","0","0","0","0","0","0","0","0","0","0","0"
"2004","Chestermere, Alberta, Royal Canadian Mounted Police, municipal","48005","Total cocaine, trafficking, production or distribution","0","0","0","0","0","0","0","0","0","0","0","0","0","0"
"2005","Chestermere, Alberta, Royal Canadian Mounted Police, municipal","48005","Total cocaine, trafficking, production or distribution","1","0","0","0","11.54","0","0","0","0","0","0","0","0","0"
"2006","Chestermere, Alberta, Royal Canadian Mounted Police, municipal","48005","Total cocaine, trafficking, production or distribution","0","0","0","-100","0","0","0","0","0","0","0","0","0","0"
"2007","Chestermere, Alberta, Royal Canadian Mounted Police, municipal","48005","Total cocaine, trafficking, production or distribution","2","0","0","0","17.6","0","0","0","0","0","0","0","0","0"
"2008","Chestermere, Alberta, Royal Canadian Mounted Police, municipal","48005","Total cocaine, trafficking, production or distribution","1","0","0","-54.09","8.08","0","0","0","0","0","0","0","0","0"
"2009","Chestermere, Alberta, Royal Canadian Mounted Police, municipal","48005","Total cocaine, trafficking, production or distribution","3","1","1","176.33","22.33","20.7","18.31","0","0","2","2","2","0","0"
"2010","Chestermere, Alberta, Royal Canadian Mounted Police, municipal","48005","Total cocaine, trafficking, production or distribution","2","0","0","-37.88","13.87","0","0","0","0","0","0","0","0","0"
"2011","Chestermere, Alberta, Royal Canadian Mounted Police, municipal","48005","Total cocaine, trafficking, production or distribution","3","1","0","40.55","19.5","9.06","8.05","0","0","1","1","1","0","0"
"2012","Chestermere, Alberta, Royal Canadian Mounted Police, municipal","48005","Total cocaine, trafficking, production or distribution","1","0","0","-67.64","6.31","0","0","0","0","0","0","0","0","0"
"2013","Chestermere, Alberta, Royal Canadian Mounted Police, municipal","48005","Total cocaine, trafficking, production or distribution","1","0","0","-3.37","6.1","0","0","0","0","0","0","0","0","0"
"2014","Chestermere, Alberta, Royal Canadian Mounted Police, municipal","48005","Total cocaine, trafficking, production or distribution","1","0","0","-3.17","5.9","0","0","0","0","0","0","0","0","0"
"2015","Chestermere, Alberta, Royal Canadian Mounted Police, municipal","48005","Total cocaine, trafficking, production or distribution","2","1","0","95.61","11.55","8","7.18","0","0","1","1","1","0","0"
"2016","Chestermere, Alberta, Royal Canadian Mounted Police, municipal","48005","Total cocaine, trafficking, production or distribution","2","0","0","-2.44","11.27","0","0","0","0","0","0","0","0","0"
"1998","Chestermere, Alberta, Royal Canadian Mounted Police, municipal","48005","Cocaine, trafficking","0","0","0","0","0","0","0","0","0","0","0","0","0","0"
"1999","Chestermere, Alberta, Royal Canadian Mounted Police, municipal","48005","Cocaine, trafficking","0","0","0","0","0","0","0","0","0","0","0","0","0","0"
"2000","Chestermere, Alberta, Royal Canadian Mounted Police, municipal","48005","Cocaine, trafficking","0","0","0","0","0","0","0","0","0","0","0","0","0","0"
"2001","Chestermere, Alberta, Royal Canadian Mounted Police, municipal","48005","Cocaine, trafficking","0","0","0","0","0","0","0","0","0","0","0","0","0","0"
"2002","Chestermere, Alberta, Royal Canadian Mounted Police, municipal","48005","Cocaine, trafficking","0","0","0","0","0","0","0","0","0","0","0","0","0","0"
"2003","Chestermere, Alberta, Royal Canadian Mounted Police, municipal","48005","Cocaine, trafficking","0","0","0","0","0","0","0","0","0","0","0","0","0","0"
"2004","Chestermere, Alberta, Royal Canadian Mounted Police, municipal","48005","Cocaine, trafficking","0","0","0","0","0","0","0","0","0","0","0","0","0","0"
"2005","Chestermere, Alberta, Royal Canadian Mounted Police, municipal","48005","Cocaine, trafficking","1","0","0","0","11.54","0","0","0","0","0","0","0","0","0"
"2006","Chestermere, Alberta, Royal Canadian Mounted Police, municipal","48005","Cocaine, trafficking","0","0","0","-100","0","0","0","0","0","0","0","0","0","0"
"2007","Chestermere, Alberta, Royal Canadian Mounted Police, municipal","48005","Cocaine, trafficking","2","0","0","0","17.6","0","0","0","0","0","0","0","0","0"
"2008","Chestermere, Alberta, Royal Canadian Mounted Police, municipal","48005","Cocaine, trafficking","1","0","0","-54.09","8.08","0","0","0","0","0","0","0","0","0"
"2009","Chestermere, Alberta, Royal Canadian Mounted Police, municipal","48005","Cocaine, trafficking","3","1","1","176.33","22.33","20.7","18.31","0","0","2","2","2","0","0"
"2010","Chestermere, Alberta, Royal Canadian Mounted Police, municipal","48005","Cocaine, trafficking","2","0","0","-37.88","13.87","0","0","0","0","0","0","0","0","0"
"2011","Chestermere, Alberta, Royal Canadian Mounted Police, municipal","48005","Cocaine, trafficking","3","1","0","40.55","19.5","9.06","8.05","0","0","1","1","1","0","0"
"2012","Chestermere, Alberta, Royal Canadian Mounted Police, municipal","48005","Cocaine, trafficking","1","0","0","-67.64","6.31","0","0","0","0","0","0","0","0","0"
"2013","Chestermere, Alberta, Royal Canadian Mounted Police, municipal","48005","Cocaine, trafficking","1","0","0","-3.37","6.1","0","0","0","0","0","0","0","0","0"
"2014","Chestermere, Alberta, Royal Canadian Mounted Police, municipal","48005","Cocaine, trafficking","1","0","0","-3.17","5.9","0","0","0","0","0","0","0","0","0"
"2015","Chestermere, Alberta, Royal Canadian Mounted Police, municipal","48005","Cocaine, trafficking","2","1","0","95.61","11.55","8","7.18","0","0","1","1","1","0","0"
"2016","Chestermere, Alberta, Royal Canadian Mounted Police, municipal","48005","Cocaine, trafficking","2","0","0","-2.44","11.27","0","0","0","0","0","0","0","0","0"
"1998","Chestermere, Alberta, Royal Canadian Mounted Police, municipal","48005","Cocaine, importation and exportation","0","0","0","0","0","0","0","0","0","0","0","0","0","0"
"1999","Chestermere, Alberta, Royal Canadian Mounted Police, municipal","48005","Cocaine, importation and exportation","0","0","0","0","0","0","0","0","0","0","0","0","0","0"
"2000","Chestermere, Alberta, Royal Canadian Mounted Police, municipal","48005","Cocaine, importation and exportation","0","0","0","0","0","0","0","0","0","0","0","0","0","0"
"2001","Chestermere, Alberta, Royal Canadian Mounted Police, municipal","48005","Cocaine, importation and exportation","0","0","0","0","0","0","0","0","0","0","0","0","0","0"
"2002","Chestermere, Alberta, Royal Canadian Mounted Police, municipal","48005","Cocaine, importation and exportation","0","0","0","0","0","0","0","0","0","0","0","0","0","0"
"2003","Chestermere, Alberta, Royal Canadian Mounted Police, municipal","48005","Cocaine, importation and exportation","0","0","0","0","0","0","0","0","0","0","0","0","0","0"
"2004","Chestermere, Alberta, Royal Canadian Mounted Police, municipal","48005","Cocaine, importation and exportation","0","0","0","0","0","0","0","0","0","0","0","0","0","0"
"2005","Chestermere, Alberta, Royal Canadian Mounted Police, municipal","48005","Cocaine, importation and exportation","0","0","0","0","0","0","0","0","0","0","0","0","0","0"
"2006","Chestermere, Alberta, Royal Canadian Mounted Police, municipal","48005","Cocaine, importation and exportation","0","0","0","0","0","0","0","0","0","0","0","0","0","0"
"2007","Chestermere, Alberta, Royal Canadian Mounted Police, municipal","48005","Cocaine, importation and exportation","0","0","0","0","0","0","0","0","0","0","0","0","0","0"
"2008","Chestermere, Alberta, Royal Canadian Mounted Police, municipal","48005","Cocaine, importation and exportation","0","0","0","0","0","0","0","0","0","0","0","0","0","0"
"2009","Chestermere, Alberta, Royal Canadian Mounted Police, municipal","48005","Cocaine, importation and exportation","0","0","0","0","0","0","0","0","0","0","0","0","0","0"
"2010","Chestermere, Alberta, Royal Canadian Mounted Police, municipal","48005","Cocaine, importation and exportation","0","0","0","0","0","0","0","0","0","0","0","0","0","0"
"2011","Chestermere, Alberta, Royal Canadian Mounted Police, municipal","48005","Cocaine, importation and exportation","0","0","0","0","0","0","0","0","0","0","0","0","0","0"
"2012","Chestermere, Alberta, Royal Canadian Mounted Police, municipal","48005","Cocaine, importation and exportation","0","0","0","0","0","0","0","0","0","0","0","0","0","0"
"2013","Chestermere, Alberta, Royal Canadian Mounted Police, municipal","48005","Cocaine, importation and exportation","0","0","0","0","0","0","0","0","0","0","0","0","0","0"
"2014","Chestermere, Alberta, Royal Canadian Mounted Police, municipal","48005","Cocaine, importation and exportation","0","0","0","0","0","0","0","0","0","0","0","0","0","0"
"2015","Chestermere, Alberta, Royal Canadian Mounted Police, municipal","48005","Cocaine, importation and exportation","0","0","0","0","0","0","0","0","0","0","0","0","0","0"
"2016","Chestermere, Alberta, Royal Canadian Mounted Police, municipal","48005","Cocaine, importation and exportation","0","0","0","0","0","0","0","0","0","0","0","0","0","0"
"2005","Chestermere, Alberta, Royal Canadian Mounted Police, municipal","48005","Cocaine, production","0","0","0","0","0","0","0","0","0","0","0","0","0","0"
"2006","Chestermere, Alberta, Royal Canadian Mounted Police, municipal","48005","Cocaine, production","0","0","0","0","0","0","0","0","0","0","0","0","0","0"
"2007","Chestermere, Alberta, Royal Canadian Mounted Police, municipal","48005","Cocaine, production","0","0","0","0","0","0","0","0","0","0","0","0","0","0"
"2008","Chestermere, Alberta, Royal Canadian Mounted Police, municipal","48005","Cocaine, production","0","0","0","0","0","0","0","0","0","0","0","0","0","0"
"2009","Chestermere, Alberta, Royal Canadian Mounted Police, municipal","48005","Cocaine, production","0","0","0","0","0","0","0","0","0","0","0","0","0","0"
"2010","Chestermere, Alberta, Royal Canadian Mounted Police, municipal","48005","Cocaine, production","0","0","0","0","0","0","0","0","0","0","0","0","0","0"
"2011","Chestermere, Alberta, Royal Canadian Mounted Police, municipal","48005","Cocaine, production","0","0","0","0","0","0","0","0","0","0","0","0","0","0"
"2012","Chestermere, Alberta, Royal Canadian Mounted Police, municipal","48005","Cocaine, production","0","0","0","0","0","0","0","0","0","0","0","0","0","0"
"2013","Chestermere, Alberta, Royal Canadian Mounted Police, municipal","48005","Cocaine, production","0","0","0","0","0","0","0","0","0","0","0","0","0","0"
"2014","Chestermere, Alberta, Royal Canadian Mounted Police, municipal","48005","Cocaine, production","0","0","0","0","0","0","0","0","0","0","0","0","0","0"
"2015","Chestermere, Alberta, Royal Canadian Mounted Police, municipal","48005","Cocaine, production","0","0","0","0","0","0","0","0","0","0","0","0","0","0"
"2016","Chestermere, Alberta, Royal Canadian Mounted Police, municipal","48005","Cocaine, production","0","0","0","0","0","0","0","0","0","0","0","0","0","0"
"1998","Chestermere, Alberta, Royal Canadian Mounted Police, municipal","48005","Total other Controlled Drugs and Substances Act drugs, trafficking, production or distribution","0","0","0","0","0","0","0","0","0","0","0","0","0","0"
"1999","Chestermere, Alberta, Royal Canadian Mounted Police, municipal","48005","Total other Controlled Drugs and Substances Act drugs, trafficking, production or distribution","0","0","0","0","0","0","0","0","0","0","0","0","0","0"
"2000","Chestermere, Alberta, Royal Canadian Mounted Police, municipal","48005","Total other Controlled Drugs and Substances Act drugs, trafficking, production or distribution","0","0","0","0","0","0","0","0","0","0","0","0","0","0"
"2001","Chestermere, Alberta, Royal Canadian Mounted Police, municipal","48005","Total other Controlled Drugs and Substances Act drugs, trafficking, production or distribution","0","0","0","0","0","0","0","0","0","0","0","0","0","0"
"2002","Chestermere, Alberta, Royal Canadian Mounted Police, municipal","48005","Total other Controlled Drugs and Substances Act drugs, trafficking, production or distribution","0","0","0","0","0","0","0","0","0","0","0","0","0","0"
"2003","Chestermere, Alberta, Royal Canadian Mounted Police, municipal","48005","Total other Controlled Drugs and Substances Act drugs, trafficking, production or distribution","0","0","0","0","0","0","0","0","0","0","0","0","0","0"
"2004","Chestermere, Alberta, Royal Canadian Mounted Police, municipal","48005","Total other Controlled Drugs and Substances Act drugs, trafficking, production or distribution","0","0","0","0","0","0","0","0","0","0","0","0","0","0"
"2005","Chestermere, Alberta, Royal Canadian Mounted Police, municipal","48005","Total other Controlled Drugs and Substances Act drugs, trafficking, production or distribution","1","0","0","0","11.54","0","0","0","0","0","0","0","0","0"
"2006","Chestermere, Alberta, Royal Canadian Mounted Police, municipal","48005","Total other Controlled Drugs and Substances Act drugs, trafficking, production or distribution","1","0","1","-16.63","9.62","0","0","0","98.52","1","0","0","0","1"
"2007","Chestermere, Alberta, Royal Canadian Mounted Police, municipal","48005","Total other Controlled Drugs and Substances Act drugs, trafficking, production or distribution","2","0","0","82.89","17.6","0","0","0","0","0","0","0","0","0"
"2008","Chestermere, Alberta, Royal Canadian Mounted Police, municipal","48005","Total other Controlled Drugs and Substances Act drugs, trafficking, production or distribution","3","0","0","37.74","24.25","0","0","0","0","0","0","0","0","0"
"2009","Chestermere, Alberta, Royal Canadian Mounted Police, municipal","48005","Total other Controlled Drugs and Substances Act drugs, trafficking, production or distribution","3","0","0","-7.89","22.33","0","0","0","0","0","0","0","0","0"
"2010","Chestermere, Alberta, Royal Canadian Mounted Police, municipal","48005","Total other Controlled Drugs and Substances Act drugs, trafficking, production or distribution","3","0","1","-6.83","20.81","0","0","0","0","1","0","0","0","0"
"2011","Chestermere, Alberta, Royal Canadian Mounted Police, municipal","48005","Total other Controlled Drugs and Substances Act drugs, trafficking, production or distribution","1","1","0","-68.77","6.5","9.06","8.05","0","0","1","1","1","0","0"
"2012","Chestermere, Alberta, Royal Canadian Mounted Police, municipal","48005","Total other Controlled Drugs and Substances Act drugs, trafficking, production or distribution","7","1","2","579.64","44.17","8.78","15.65","72.05","288.18","3","1","2","1","4"
"2013","Chestermere, Alberta, Royal Canadian Mounted Police, municipal","48005","Total other Controlled Drugs and Substances Act drugs, trafficking, production or distribution","2","1","0","-72.39","12.2","8.46","7.57","0","0","1","1","1","0","0"
"2014","Chestermere, Alberta, Royal Canadian Mounted Police, municipal","48005","Total other Controlled Drugs and Substances Act drugs, trafficking, production or distribution","2","0","0","-3.17","11.81","0","0","0","0","0","0","0","0","0"
"2015","Chestermere, Alberta, Royal Canadian Mounted Police, municipal","48005","Total other Controlled Drugs and Substances Act drugs, trafficking, production or distribution","5","1","1","144.51","28.88","8","7.18","0","70.77","2","1","1","0","1"
"2016","Chestermere, Alberta, Royal Canadian Mounted Police, municipal","48005","Total other Controlled Drugs and Substances Act drugs, trafficking, production or distribution","2","1","0","-60.98","11.27","23.44","21.07","0","0","1","3","3","0","0"
"1998","Chestermere, Alberta, Royal Canadian Mounted Police, municipal","48005","Heroin, trafficking","0","0","0","0","0","0","0","0","0","0","0","0","0","0"
"1999","Chestermere, Alberta, Royal Canadian Mounted Police, municipal","48005","Heroin, trafficking","0","0","0","0","0","0","0","0","0","0","0","0","0","0"
"2000","Chestermere, Alberta, Royal Canadian Mounted Police, municipal","48005","Heroin, trafficking","0","0","0","0","0","0","0","0","0","0","0","0","0","0"
"2001","Chestermere, Alberta, Royal Canadian Mounted Police, municipal","48005","Heroin, trafficking","0","0","0","0","0","0","0","0","0","0","0","0","0","0"
"2002","Chestermere, Alberta, Royal Canadian Mounted Police, municipal","48005","Heroin, trafficking","0","0","0","0","0","0","0","0","0","0","0","0","0","0"
"2003","Chestermere, Alberta, Royal Canadian Mounted Police, municipal","48005","Heroin, trafficking","0","0","0","0","0","0","0","0","0","0","0","0","0","0"
"2004","Chestermere, Alberta, Royal Canadian Mounted Police, municipal","48005","Heroin, trafficking","0","0","0","0","0","0","0","0","0","0","0","0","0","0"
"2005","Chestermere, Alberta, Royal Canadian Mounted Police, municipal","48005","Heroin, trafficking","0","0","0","0","0","0","0","0","0","0","0","0","0","0"
"2006","Chestermere, Alberta, Royal Canadian Mounted Police, municipal","48005","Heroin, trafficking","0","0","0","0","0","0","0","0","0","0","0","0","0","0"
"2007","Chestermere, Alberta, Royal Canadian Mounted Police, municipal","48005","Heroin, trafficking","0","0","0","0","0","0","0","0","0","0","0","0","0","0"
"2008","Chestermere, Alberta, Royal Canadian Mounted Police, municipal","48005","Heroin, trafficking","0","0","0","0","0","0","0","0","0","0","0","0","0","0"
"2009","Chestermere, Alberta, Royal Canadian Mounted Police, municipal","48005","Heroin, trafficking","0","0","0","0","0","0","0","0","0","0","0","0","0","0"
"2010","Chestermere, Alberta, Royal Canadian Mounted Police, municipal","48005","Heroin, trafficking","0","0","0","0","0","0","0","0","0","0","0","0","0","0"
"2011","Chestermere, Alberta, Royal Canadian Mounted Police, municipal","48005","Heroin, trafficking","0","0","0","0","0","0","0","0","0","0","0","0","0","0"
"2012","Chestermere, Alberta, Royal Canadian Mounted Police, municipal","48005","Heroin, trafficking","1","0","0","0","6.31","0","0","0","0","0","0","0","0","0"
"2013","Chestermere, Alberta, Royal Canadian Mounted Police, municipal","48005","Heroin, trafficking","0","0","0","-100","0","0","0","0","0","0","0","0","0","0"
"2014","Chestermere, Alberta, Royal Canadian Mounted Police, municipal","48005","Heroin, trafficking","0","0","0","0","0","0","0","0","0","0","0","0","0","0"
"2015","Chestermere, Alberta, Royal Canadian Mounted Police, municipal","48005","Heroin, trafficking","0","0","0","0","0","0","0","0","0","0","0","0","0","0"
"2016","Chestermere, Alberta, Royal Canadian Mounted Police, municipal","48005","Heroin, trafficking","1","1","0","0","5.63","23.44","21.07","0","0","1","3","3","0","0"
"1998","Chestermere, Alberta, Royal Canadian Mounted Police, municipal","48005","Other Controlled Drugs and Substances Act, trafficking","0","0","0","0","0","0","0","0","0","0","0","0","0","0"
"1999","Chestermere, Alberta, Royal Canadian Mounted Police, municipal","48005","Other Controlled Drugs and Substances Act, trafficking","0","0","0","0","0","0","0","0","0","0","0","0","0","0"
"2000","Chestermere, Alberta, Royal Canadian Mounted Police, municipal","48005","Other Controlled Drugs and Substances Act, trafficking","0","0","0","0","0","0","0","0","0","0","0","0","0","0"
"2001","Chestermere, Alberta, Royal Canadian Mounted Police, municipal","48005","Other Controlled Drugs and Substances Act, trafficking","0","0","0","0","0","0","0","0","0","0","0","0","0","0"
"2002","Chestermere, Alberta, Royal Canadian Mounted Police, municipal","48005","Other Controlled Drugs and Substances Act, trafficking","0","0","0","0","0","0","0","0","0","0","0","0","0","0"
"2003","Chestermere, Alberta, Royal Canadian Mounted Police, municipal","48005","Other Controlled Drugs and Substances Act, trafficking","0","0","0","0","0","0","0","0","0","0","0","0","0","0"
"2004","Chestermere, Alberta, Royal Canadian Mounted Police, municipal","48005","Other Controlled Drugs and Substances Act, trafficking","0","0","0","0","0","0","0","0","0","0","0","0","0","0"
"2005","Chestermere, Alberta, Royal Canadian Mounted Police, municipal","48005","Other Controlled Drugs and Substances Act, trafficking","0","0","0","0","0","0","0","0","0","0","0","0","0","0"
"2006","Chestermere, Alberta, Royal Canadian Mounted Police, municipal","48005","Other Controlled Drugs and Substances Act, trafficking","1","0","1","0","9.62","0","0","0","98.52","1","0","0","0","1"
"2007","Chestermere, Alberta, Royal Canadian Mounted Police, municipal","48005","Other Controlled Drugs and Substances Act, trafficking","2","0","0","82.89","17.6","0","0","0","0","0","0","0","0","0"
"2008","Chestermere, Alberta, Royal Canadian Mounted Police, municipal","48005","Other Controlled Drugs and Substances Act, trafficking","3","0","0","37.74","24.25","0","0","0","0","0","0","0","0","0"
"2009","Chestermere, Alberta, Royal Canadian Mounted Police, municipal","48005","Other Controlled Drugs and Substances Act, trafficking","2","0","0","-38.59","14.89","0","0","0","0","0","0","0","0","0"
"2010","Chestermere, Alberta, Royal Canadian Mounted Police, municipal","48005","Other Controlled Drugs and Substances Act, trafficking","3","0","1","39.76","20.81","0","0","0","0","1","0","0","0","0"
"2011","Chestermere, Alberta, Royal Canadian Mounted Police, municipal","48005","Other Controlled Drugs and Substances Act, trafficking","1","1","0","-68.77","6.5","9.06","8.05","0","0","1","1","1","0","0"
"2012","Chestermere, Alberta, Royal Canadian Mounted Police, municipal","48005","Other Controlled Drugs and Substances Act, trafficking","4","0","2","288.36","25.24","0","0","0","288.18","2","0","0","0","4"
"2013","Chestermere, Alberta, Royal Canadian Mounted Police, municipal","48005","Other Controlled Drugs and Substances Act, trafficking","1","0","0","-75.84","6.1","0","0","0","0","0","0","0","0","0"
"2014","Chestermere, Alberta, Royal Canadian Mounted Police, municipal","48005","Other Controlled Drugs and Substances Act, trafficking","2","0","0","93.67","11.81","0","0","0","0","0","0","0","0","0"
"2015","Chestermere, Alberta, Royal Canadian Mounted Police, municipal","48005","Other Controlled Drugs and Substances Act, trafficking","4","0","1","95.61","23.1","0","0","0","70.77","1","0","0","0","1"
"2016","Chestermere, Alberta, Royal Canadian Mounted Police, municipal","48005","Other Controlled Drugs and Substances Act, trafficking","0","0","0","-100","0","0","0","0","0","0","0","0","0","0"
"2005","Chestermere, Alberta, Royal Canadian Mounted Police, municipal","48005","Methamphetamines (crystal meth), trafficking","0","0","0","0","0","0","0","0","0","0","0","0","0","0"
"2006","Chestermere, Alberta, Royal Canadian Mounted Police, municipal","48005","Methamphetamines (crystal meth), trafficking","0","0","0","0","0","0","0","0","0","0","0","0","0","0"
"2007","Chestermere, Alberta, Royal Canadian Mounted Police, municipal","48005","Methamphetamines (crystal meth), trafficking","0","0","0","0","0","0","0","0","0","0","0","0","0","0"
"2008","Chestermere, Alberta, Royal Canadian Mounted Police, municipal","48005","Methamphetamines (crystal meth), trafficking","0","0","0","0","0","0","0","0","0","0","0","0","0","0"
"2009","Chestermere, Alberta, Royal Canadian Mounted Police, municipal","48005","Methamphetamines (crystal meth), trafficking","0","0","0","0","0","0","0","0","0","0","0","0","0","0"
"2010","Chestermere, Alberta, Royal Canadian Mounted Police, municipal","48005","Methamphetamines (crystal meth), trafficking","0","0","0","0","0","0","0","0","0","0","0","0","0","0"
"2011","Chestermere, Alberta, Royal Canadian Mounted Police, municipal","48005","Methamphetamines (crystal meth), trafficking","0","0","0","0","0","0","0","0","0","0","0","0","0","0"
"2012","Chestermere, Alberta, Royal Canadian Mounted Police, municipal","48005","Methamphetamines (crystal meth), trafficking","1","0","0","0","6.31","0","0","0","0","0","0","0","0","0"
"2013","Chestermere, Alberta, Royal Canadian Mounted Police, municipal","48005","Methamphetamines (crystal meth), trafficking","0","0","0","-100","0","0","0","0","0","0","0","0","0","0"
"2014","Chestermere, Alberta, Royal Canadian Mounted Police, municipal","48005","Methamphetamines (crystal meth), trafficking","0","0","0","0","0","0","0","0","0","0","0","0","0","0"
"2015","Chestermere, Alberta, Royal Canadian Mounted Police, municipal","48005","Methamphetamines (crystal meth), trafficking","1","1","0","0","5.78","8","7.18","0","0","1","1","1","0","0"
"2016","Chestermere, Alberta, Royal Canadian Mounted Police, municipal","48005","Methamphetamines (crystal meth), trafficking","1","0","0","-2.44","5.63","0","0","0","0","0","0","0","0","0"
"2005","Chestermere, Alberta, Royal Canadian Mounted Police, municipal","48005","Methylenedioxyamphetamine (ecstasy), trafficking","0","0","0","0","0","0","0","0","0","0","0","0","0","0"
"2006","Chestermere, Alberta, Royal Canadian Mounted Police, municipal","48005","Methylenedioxyamphetamine (ecstasy), trafficking","0","0","0","0","0","0","0","0","0","0","0","0","0","0"
"2007","Chestermere, Alberta, Royal Canadian Mounted Police, municipal","48005","Methylenedioxyamphetamine (ecstasy), trafficking","0","0","0","0","0","0","0","0","0","0","0","0","0","0"
"2008","Chestermere, Alberta, Royal Canadian Mounted Police, municipal","48005","Methylenedioxyamphetamine (ecstasy), trafficking","0","0","0","0","0","0","0","0","0","0","0","0","0","0"
"2009","Chestermere, Alberta, Royal Canadian Mounted Police, municipal","48005","Methylenedioxyamphetamine (ecstasy), trafficking","0","0","0","0","0","0","0","0","0","0","0","0","0","0"
"2010","Chestermere, Alberta, Royal Canadian Mounted Police, municipal","48005","Methylenedioxyamphetamine (ecstasy), trafficking","0","0","0","0","0","0","0","0","0","0","0","0","0","0"
"2011","Chestermere, Alberta, Royal Canadian Mounted Police, municipal","48005","Methylenedioxyamphetamine (ecstasy), trafficking","0","0","0","0","0","0","0","0","0","0","0","0","0","0"
"2012","Chestermere, Alberta, Royal Canadian Mounted Police, municipal","48005","Methylenedioxyamphetamine (ecstasy), trafficking","1","1","0","0","6.31","8.78","15.65","72.05","0","1","1","2","1","0"
"2013","Chestermere, Alberta, Royal Canadian Mounted Police, municipal","48005","Methylenedioxyamphetamine (ecstasy), trafficking","1","1","0","-3.37","6.1","8.46","7.57","0","0","1","1","1","0","0"
"2014","Chestermere, Alberta, Royal Canadian Mounted Police, municipal","48005","Methylenedioxyamphetamine (ecstasy), trafficking","0","0","0","-100","0","0","0","0","0","0","0","0","0","0"
"2015","Chestermere, Alberta, Royal Canadian Mounted Police, municipal","48005","Methylenedioxyamphetamine (ecstasy), trafficking","0","0","0","0","0","0","0","0","0","0","0","0","0","0"
"2016","Chestermere, Alberta, Royal Canadian Mounted Police, municipal","48005","Methylenedioxyamphetamine (ecstasy), trafficking","0","0","0","0","0","0","0","0","0","0","0","0","0","0"
"1998","Chestermere, Alberta, Royal Canadian Mounted Police, municipal","48005","Heroin, importation and exportation","0","0","0","0","0","0","0","0","0","0","0","0","0","0"
"1999","Chestermere, Alberta, Royal Canadian Mounted Police, municipal","48005","Heroin, importation and exportation","0","0","0","0","0","0","0","0","0","0","0","0","0","0"
"2000","Chestermere, Alberta, Royal Canadian Mounted Police, municipal","48005","Heroin, importation and exportation","0","0","0","0","0","0","0","0","0","0","0","0","0","0"
"2001","Chestermere, Alberta, Royal Canadian Mounted Police, municipal","48005","Heroin, importation and exportation","0","0","0","0","0","0","0","0","0","0","0","0","0","0"
"2002","Chestermere, Alberta, Royal Canadian Mounted Police, municipal","48005","Heroin, importation and exportation","0","0","0","0","0","0","0","0","0","0","0","0","0","0"
"2003","Chestermere, Alberta, Royal Canadian Mounted Police, municipal","48005","Heroin, importation and exportation","0","0","0","0","0","0","0","0","0","0","0","0","0","0"
"2004","Chestermere, Alberta, Royal Canadian Mounted Police, municipal","48005","Heroin, importation and exportation","0","0","0","0","0","0","0","0","0","0","0","0","0","0"
"2005","Chestermere, Alberta, Royal Canadian Mounted Police, municipal","48005","Heroin, importation and exportation","0","0","0","0","0","0","0","0","0","0","0","0","0","0"
"2006","Chestermere, Alberta, Royal Canadian Mounted Police, municipal","48005","Heroin, importation and exportation","0","0","0","0","0","0","0","0","0","0","0","0","0","0"
"2007","Chestermere, Alberta, Royal Canadian Mounted Police, municipal","48005","Heroin, importation and exportation","0","0","0","0","0","0","0","0","0","0","0","0","0","0"
"2008","Chestermere, Alberta, Royal Canadian Mounted Police, municipal","48005","Heroin, importation and exportation","0","0","0","0","0","0","0","0","0","0","0","0","0","0"
"2009","Chestermere, Alberta, Royal Canadian Mounted Police, municipal","48005","Heroin, importation and exportation","0","0","0","0","0","0","0","0","0","0","0","0","0","0"
"2010","Chestermere, Alberta, Royal Canadian Mounted Police, municipal","48005","Heroin, importation and exportation","0","0","0","0","0","0","0","0","0","0","0","0","0","0"
"2011","Chestermere, Alberta, Royal Canadian Mounted Police, municipal","48005","Heroin, importation and exportation","0","0","0","0","0","0","0","0","0","0","0","0","0","0"
"2012","Chestermere, Alberta, Royal Canadian Mounted Police, municipal","48005","Heroin, importation and exportation","0","0","0","0","0","0","0","0","0","0","0","0","0","0"
"2013","Chestermere, Alberta, Royal Canadian Mounted Police, municipal","48005","Heroin, importation and exportation","0","0","0","0","0","0","0","0","0","0","0","0","0","0"
"2014","Chestermere, Alberta, Royal Canadian Mounted Police, municipal","48005","Heroin, importation and exportation","0","0","0","0","0","0","0","0","0","0","0","0","0","0"
"2015","Chestermere, Alberta, Royal Canadian Mounted Police, municipal","48005","Heroin, importation and exportation","0","0","0","0","0","0","0","0","0","0","0","0","0","0"
"2016","Chestermere, Alberta, Royal Canadian Mounted Police, municipal","48005","Heroin, importation and exportation","0","0","0","0","0","0","0","0","0","0","0","0","0","0"
"1998","Chestermere, Alberta, Royal Canadian Mounted Police, municipal","48005","Other Controlled Drugs and Substances Act, importation and exportation","0","0","0","0","0","0","0","0","0","0","0","0","0","0"
"1999","Chestermere, Alberta, Royal Canadian Mounted Police, municipal","48005","Other Controlled Drugs and Substances Act, importation and exportation","0","0","0","0","0","0","0","0","0","0","0","0","0","0"
"2000","Chestermere, Alberta, Royal Canadian Mounted Police, municipal","48005","Other Controlled Drugs and Substances Act, importation and exportation","0","0","0","0","0","0","0","0","0","0","0","0","0","0"
"2001","Chestermere, Alberta, Royal Canadian Mounted Police, municipal","48005","Other Controlled Drugs and Substances Act, importation and exportation","0","0","0","0","0","0","0","0","0","0","0","0","0","0"
"2002","Chestermere, Alberta, Royal Canadian Mounted Police, municipal","48005","Other Controlled Drugs and Substances Act, importation and exportation","0","0","0","0","0","0","0","0","0","0","0","0","0","0"
"2003","Chestermere, Alberta, Royal Canadian Mounted Police, municipal","48005","Other Controlled Drugs and Substances Act, importation and exportation","0","0","0","0","0","0","0","0","0","0","0","0","0","0"
"2004","Chestermere, Alberta, Royal Canadian Mounted Police, municipal","48005","Other Controlled Drugs and Substances Act, importation and exportation","0","0","0","0","0","0","0","0","0","0","0","0","0","0"
"2005","Chestermere, Alberta, Royal Canadian Mounted Police, municipal","48005","Other Controlled Drugs and Substances Act, importation and exportation","1","0","0","0","11.54","0","0","0","0","0","0","0","0","0"
"2006","Chestermere, Alberta, Royal Canadian Mounted Police, municipal","48005","Other Controlled Drugs and Substances Act, importation and exportation","0","0","0","-100","0","0","0","0","0","0","0","0","0","0"
"2007","Chestermere, Alberta, Royal Canadian Mounted Police, municipal","48005","Other Controlled Drugs and Substances Act, importation and exportation","0","0","0","0","0","0","0","0","0","0","0","0","0","0"
"2008","Chestermere, Alberta, Royal Canadian Mounted Police, municipal","48005","Other Controlled Drugs and Substances Act, importation and exportation","0","0","0","0","0","0","0","0","0","0","0","0","0","0"
"2009","Chestermere, Alberta, Royal Canadian Mounted Police, municipal","48005","Other Controlled Drugs and Substances Act, importation and exportation","1","0","0","0","7.44","0","0","0","0","0","0","0","0","0"
"2010","Chestermere, Alberta, Royal Canadian Mounted Police, municipal","48005","Other Controlled Drugs and Substances Act, importation and exportation","0","0","0","-100","0","0","0","0","0","0","0","0","0","0"
"2011","Chestermere, Alberta, Royal Canadian Mounted Police, municipal","48005","Other Controlled Drugs and Substances Act, importation and exportation","0","0","0","0","0","0","0","0","0","0","0","0","0","0"
"2012","Chestermere, Alberta, Royal Canadian Mounted Police, municipal","48005","Other Controlled Drugs and Substances Act, importation and exportation","0","0","0","0","0","0","0","0","0","0","0","0","0","0"
"2013","Chestermere, Alberta, Royal Canadian Mounted Police, municipal","48005","Other Controlled Drugs and Substances Act, importation and exportation","0","0","0","0","0","0","0","0","0","0","0","0","0","0"
"2014","Chestermere, Alberta, Royal Canadian Mounted Police, municipal","48005","Other Controlled Drugs and Substances Act, importation and exportation","0","0","0","0","0","0","0","0","0","0","0","0","0","0"
"2015","Chestermere, Alberta, Royal Canadian Mounted Police, municipal","48005","Other Controlled Drugs and Substances Act, importation and exportation","0","0","0","0","0","0","0","0","0","0","0","0","0","0"
"2016","Chestermere, Alberta, Royal Canadian Mounted Police, municipal","48005","Other Controlled Drugs and Substances Act, importation and exportation","0","0","0","0","0","0","0","0","0","0","0","0","0","0"
"2005","Chestermere, Alberta, Royal Canadian Mounted Police, municipal","48005","Methamphetamines (crystal meth), importation and exportation","0","0","0","0","0","0","0","0","0","0","0","0","0","0"
"2006","Chestermere, Alberta, Royal Canadian Mounted Police, municipal","48005","Methamphetamines (crystal meth), importation and exportation","0","0","0","0","0","0","0","0","0","0","0","0","0","0"
"2007","Chestermere, Alberta, Royal Canadian Mounted Police, municipal","48005","Methamphetamines (crystal meth), importation and exportation","0","0","0","0","0","0","0","0","0","0","0","0","0","0"
"2008","Chestermere, Alberta, Royal Canadian Mounted Police, municipal","48005","Methamphetamines (crystal meth), importation and exportation","0","0","0","0","0","0","0","0","0","0","0","0","0","0"
"2009","Chestermere, Alberta, Royal Canadian Mounted Police, municipal","48005","Methamphetamines (crystal meth), importation and exportation","0","0","0","0","0","0","0","0","0","0","0","0","0","0"
"2010","Chestermere, Alberta, Royal Canadian Mounted Police, municipal","48005","Methamphetamines (crystal meth), importation and exportation","0","0","0","0","0","0","0","0","0","0","0","0","0","0"
"2011","Chestermere, Alberta, Royal Canadian Mounted Police, municipal","48005","Methamphetamines (crystal meth), importation and exportation","0","0","0","0","0","0","0","0","0","0","0","0","0","0"
"2012","Chestermere, Alberta, Royal Canadian Mounted Police, municipal","48005","Methamphetamines (crystal meth), importation and exportation","0","0","0","0","0","0","0","0","0","0","0","0","0","0"
"2013","Chestermere, Alberta, Royal Canadian Mounted Police, municipal","48005","Methamphetamines (crystal meth), importation and exportation","0","0","0","0","0","0","0","0","0","0","0","0","0","0"
"2014","Chestermere, Alberta, Royal Canadian Mounted Police, municipal","48005","Methamphetamines (crystal meth), importation and exportation","0","0","0","0","0","0","0","0","0","0","0","0","0","0"
"2015","Chestermere, Alberta, Royal Canadian Mounted Police, municipal","48005","Methamphetamines (crystal meth), importation and exportation","0","0","0","0","0","0","0","0","0","0","0","0","0","0"
"2016","Chestermere, Alberta, Royal Canadian Mounted Police, municipal","48005","Methamphetamines (crystal meth), importation and exportation","0","0","0","0","0","0","0","0","0","0","0","0","0","0"
"2005","Chestermere, Alberta, Royal Canadian Mounted Police, municipal","48005","Methylenedioxyamphetamine (ecstasy), importation and exportation","0","0","0","0","0","0","0","0","0","0","0","0","0","0"
"2006","Chestermere, Alberta, Royal Canadian Mounted Police, municipal","48005","Methylenedioxyamphetamine (ecstasy), importation and exportation","0","0","0","0","0","0","0","0","0","0","0","0","0","0"
"2007","Chestermere, Alberta, Royal Canadian Mounted Police, municipal","48005","Methylenedioxyamphetamine (ecstasy), importation and exportation","0","0","0","0","0","0","0","0","0","0","0","0","0","0"
"2008","Chestermere, Alberta, Royal Canadian Mounted Police, municipal","48005","Methylenedioxyamphetamine (ecstasy), importation and exportation","0","0","0","0","0","0","0","0","0","0","0","0","0","0"
"2009","Chestermere, Alberta, Royal Canadian Mounted Police, municipal","48005","Methylenedioxyamphetamine (ecstasy), importation and exportation","0","0","0","0","0","0","0","0","0","0","0","0","0","0"
"2010","Chestermere, Alberta, Royal Canadian Mounted Police, municipal","48005","Methylenedioxyamphetamine (ecstasy), importation and exportation","0","0","0","0","0","0","0","0","0","0","0","0","0","0"
"2011","Chestermere, Alberta, Royal Canadian Mounted Police, municipal","48005","Methylenedioxyamphetamine (ecstasy), importation and exportation","0","0","0","0","0","0","0","0","0","0","0","0","0","0"
"2012","Chestermere, Alberta, Royal Canadian Mounted Police, municipal","48005","Methylenedioxyamphetamine (ecstasy), importation and exportation","0","0","0","0","0","0","0","0","0","0","0","0","0","0"
"2013","Chestermere, Alberta, Royal Canadian Mounted Police, municipal","48005","Methylenedioxyamphetamine (ecstasy), importation and exportation","0","0","0","0","0","0","0","0","0","0","0","0","0","0"
"2014","Chestermere, Alberta, Royal Canadian Mounted Police, municipal","48005","Methylenedioxyamphetamine (ecstasy), importation and exportation","0","0","0","0","0","0","0","0","0","0","0","0","0","0"
"2015","Chestermere, Alberta, Royal Canadian Mounted Police, municipal","48005","Methylenedioxyamphetamine (ecstasy), importation and exportation","0","0","0","0","0","0","0","0","0","0","0","0","0","0"
"2016","Chestermere, Alberta, Royal Canadian Mounted Police, municipal","48005","Methylenedioxyamphetamine (ecstasy), importation and exportation","0","0","0","0","0","0","0","0","0","0","0","0","0","0"
"2005","Chestermere, Alberta, Royal Canadian Mounted Police, municipal","48005","Heroin, production","0","0","0","0","0","0","0","0","0","0","0","0","0","0"
"2006","Chestermere, Alberta, Royal Canadian Mounted Police, municipal","48005","Heroin, production","0","0","0","0","0","0","0","0","0","0","0","0","0","0"
"2007","Chestermere, Alberta, Royal Canadian Mounted Police, municipal","48005","Heroin, production","0","0","0","0","0","0","0","0","0","0","0","0","0","0"
"2008","Chestermere, Alberta, Royal Canadian Mounted Police, municipal","48005","Heroin, production","0","0","0","0","0","0","0","0","0","0","0","0","0","0"
"2009","Chestermere, Alberta, Royal Canadian Mounted Police, municipal","48005","Heroin, production","0","0","0","0","0","0","0","0","0","0","0","0","0","0"
"2010","Chestermere, Alberta, Royal Canadian Mounted Police, municipal","48005","Heroin, production","0","0","0","0","0","0","0","0","0","0","0","0","0","0"
"2011","Chestermere, Alberta, Royal Canadian Mounted Police, municipal","48005","Heroin, production","0","0","0","0","0","0","0","0","0","0","0","0","0","0"
"2012","Chestermere, Alberta, Royal Canadian Mounted Police, municipal","48005","Heroin, production","0","0","0","0","0","0","0","0","0","0","0","0","0","0"
"2013","Chestermere, Alberta, Royal Canadian Mounted Police, municipal","48005","Heroin, production","0","0","0","0","0","0","0","0","0","0","0","0","0","0"
"2014","Chestermere, Alberta, Royal Canadian Mounted Police, municipal","48005","Heroin, production","0","0","0","0","0","0","0","0","0","0","0","0","0","0"
"2015","Chestermere, Alberta, Royal Canadian Mounted Police, municipal","48005","Heroin, production","0","0","0","0","0","0","0","0","0","0","0","0","0","0"
"2016","Chestermere, Alberta, Royal Canadian Mounted Police, municipal","48005","Heroin, production","0","0","0","0","0","0","0","0","0","0","0","0","0","0"
"2005","Chestermere, Alberta, Royal Canadian Mounted Police, municipal","48005","Other Controlled Drugs and Substances Act, production","0","0","0","0","0","0","0","0","0","0","0","0","0","0"
"2006","Chestermere, Alberta, Royal Canadian Mounted Police, municipal","48005","Other Controlled Drugs and Substances Act, production","0","0","0","0","0","0","0","0","0","0","0","0","0","0"
"2007","Chestermere, Alberta, Royal Canadian Mounted Police, municipal","48005","Other Controlled Drugs and Substances Act, production","0","0","0","0","0","0","0","0","0","0","0","0","0","0"
"2008","Chestermere, Alberta, Royal Canadian Mounted Police, municipal","48005","Other Controlled Drugs and Substances Act, production","0","0","0","0","0","0","0","0","0","0","0","0","0","0"
"2009","Chestermere, Alberta, Royal Canadian Mounted Police, municipal","48005","Other Controlled Drugs and Substances Act, production","0","0","0","0","0","0","0","0","0","0","0","0","0","0"
"2010","Chestermere, Alberta, Royal Canadian Mounted Police, municipal","48005","Other Controlled Drugs and Substances Act, production","0","0","0","0","0","0","0","0","0","0","0","0","0","0"
"2011","Chestermere, Alberta, Royal Canadian Mounted Police, municipal","48005","Other Controlled Drugs and Substances Act, production","0","0","0","0","0","0","0","0","0","0","0","0","0","0"
"2012","Chestermere, Alberta, Royal Canadian Mounted Police, municipal","48005","Other Controlled Drugs and Substances Act, production","0","0","0","0","0","0","0","0","0","0","0","0","0","0"
"2013","Chestermere, Alberta, Royal Canadian Mounted Police, municipal","48005","Other Controlled Drugs and Substances Act, production","0","0","0","0","0","0","0","0","0","0","0","0","0","0"
"2014","Chestermere, Alberta, Royal Canadian Mounted Police, municipal","48005","Other Controlled Drugs and Substances Act, production","0","0","0","0","0","0","0","0","0","0","0","0","0","0"
"2015","Chestermere, Alberta, Royal Canadian Mounted Police, municipal","48005","Other Controlled Drugs and Substances Act, production","0","0","0","0","0","0","0","0","0","0","0","0","0","0"
"2016","Chestermere, Alberta, Royal Canadian Mounted Police, municipal","48005","Other Controlled Drugs and Substances Act, production","0","0","0","0","0","0","0","0","0","0","0","0","0","0"
"2005","Chestermere, Alberta, Royal Canadian Mounted Police, municipal","48005","Methamphetamines (crystal meth), production","0","0","0","0","0","0","0","0","0","0","0","0","0","0"
"2006","Chestermere, Alberta, Royal Canadian Mounted Police, municipal","48005","Methamphetamines (crystal meth), production","0","0","0","0","0","0","0","0","0","0","0","0","0","0"
"2007","Chestermere, Alberta, Royal Canadian Mounted Police, municipal","48005","Methamphetamines (crystal meth), production","0","0","0","0","0","0","0","0","0","0","0","0","0","0"
"2008","Chestermere, Alberta, Royal Canadian Mounted Police, municipal","48005","Methamphetamines (crystal meth), production","0","0","0","0","0","0","0","0","0","0","0","0","0","0"
"2009","Chestermere, Alberta, Royal Canadian Mounted Police, municipal","48005","Methamphetamines (crystal meth), production","0","0","0","0","0","0","0","0","0","0","0","0","0","0"
"2010","Chestermere, Alberta, Royal Canadian Mounted Police, municipal","48005","Methamphetamines (crystal meth), production","0","0","0","0","0","0","0","0","0","0","0","0","0","0"
"2011","Chestermere, Alberta, Royal Canadian Mounted Police, municipal","48005","Methamphetamines (crystal meth), production","0","0","0","0","0","0","0","0","0","0","0","0","0","0"
"2012","Chestermere, Alberta, Royal Canadian Mounted Police, municipal","48005","Methamphetamines (crystal meth), production","0","0","0","0","0","0","0","0","0","0","0","0","0","0"
"2013","Chestermere, Alberta, Royal Canadian Mounted Police, municipal","48005","Methamphetamines (crystal meth), production","0","0","0","0","0","0","0","0","0","0","0","0","0","0"
"2014","Chestermere, Alberta, Royal Canadian Mounted Police, municipal","48005","Methamphetamines (crystal meth), production","0","0","0","0","0","0","0","0","0","0","0","0","0","0"
"2015","Chestermere, Alberta, Royal Canadian Mounted Police, municipal","48005","Methamphetamines (crystal meth), production","0","0","0","0","0","0","0","0","0","0","0","0","0","0"
"2016","Chestermere, Alberta, Royal Canadian Mounted Police, municipal","48005","Methamphetamines (crystal meth), production","0","0","0","0","0","0","0","0","0","0","0","0","0","0"
"2005","Chestermere, Alberta, Royal Canadian Mounted Police, municipal","48005","Methylenedioxyamphetamine (ecstasy), production","0","0","0","0","0","0","0","0","0","0","0","0","0","0"
"2006","Chestermere, Alberta, Royal Canadian Mounted Police, municipal","48005","Methylenedioxyamphetamine (ecstasy), production","0","0","0","0","0","0","0","0","0","0","0","0","0","0"
"2007","Chestermere, Alberta, Royal Canadian Mounted Police, municipal","48005","Methylenedioxyamphetamine (ecstasy), production","0","0","0","0","0","0","0","0","0","0","0","0","0","0"
"2008","Chestermere, Alberta, Royal Canadian Mounted Police, municipal","48005","Methylenedioxyamphetamine (ecstasy), production","0","0","0","0","0","0","0","0","0","0","0","0","0","0"
"2009","Chestermere, Alberta, Royal Canadian Mounted Police, municipal","48005","Methylenedioxyamphetamine (ecstasy), production","0","0","0","0","0","0","0","0","0","0","0","0","0","0"
"2010","Chestermere, Alberta, Royal Canadian Mounted Police, municipal","48005","Methylenedioxyamphetamine (ecstasy), production","0","0","0","0","0","0","0","0","0","0","0","0","0","0"
"2011","Chestermere, Alberta, Royal Canadian Mounted Police, municipal","48005","Methylenedioxyamphetamine (ecstasy), production","0","0","0","0","0","0","0","0","0","0","0","0","0","0"
"2012","Chestermere, Alberta, Royal Canadian Mounted Police, municipal","48005","Methylenedioxyamphetamine (ecstasy), production","0","0","0","0","0","0","0","0","0","0","0","0","0","0"
"2013","Chestermere, Alberta, Royal Canadian Mounted Police, municipal","48005","Methylenedioxyamphetamine (ecstasy), production","0","0","0","0","0","0","0","0","0","0","0","0","0","0"
"2014","Chestermere, Alberta, Royal Canadian Mounted Police, municipal","48005","Methylenedioxyamphetamine (ecstasy), production","0","0","0","0","0","0","0","0","0","0","0","0","0","0"
"2015","Chestermere, Alberta, Royal Canadian Mounted Police, municipal","48005","Methylenedioxyamphetamine (ecstasy), production","0","0","0","0","0","0","0","0","0","0","0","0","0","0"
"2016","Chestermere, Alberta, Royal Canadian Mounted Police, municipal","48005","Methylenedioxyamphetamine (ecstasy), production","0","0","0","0","0","0","0","0","0","0","0","0","0","0"
"2005","Chestermere, Alberta, Royal Canadian Mounted Police, municipal","48005","Precursor or equipment (crystal meth, ecstasy)","0","0","0","0","0","0","0","0","0","0","0","0","0","0"
"2006","Chestermere, Alberta, Royal Canadian Mounted Police, municipal","48005","Precursor or equipment (crystal meth, ecstasy)","0","0","0","0","0","0","0","0","0","0","0","0","0","0"
"2007","Chestermere, Alberta, Royal Canadian Mounted Police, municipal","48005","Precursor or equipment (crystal meth, ecstasy)","0","0","0","0","0","0","0","0","0","0","0","0","0","0"
"2008","Chestermere, Alberta, Royal Canadian Mounted Police, municipal","48005","Precursor or equipment (crystal meth, ecstasy)","0","0","0","0","0","0","0","0","0","0","0","0","0","0"
"2009","Chestermere, Alberta, Royal Canadian Mounted Police, municipal","48005","Precursor or equipment (crystal meth, ecstasy)","0","0","0","0","0","0","0","0","0","0","0","0","0","0"
"2010","Chestermere, Alberta, Royal Canadian Mounted Police, municipal","48005","Precursor or equipment (crystal meth, ecstasy)","0","0","0","0","0","0","0","0","0","0","0","0","0","0"
"2011","Chestermere, Alberta, Royal Canadian Mounted Police, municipal","48005","Precursor or equipment (crystal meth, ecstasy)","0","0","0","0","0","0","0","0","0","0","0","0","0","0"
"2012","Chestermere, Alberta, Royal Canadian Mounted Police, municipal","48005","Precursor or equipment (crystal meth, ecstasy)","0","0","0","0","0","0","0","0","0","0","0","0","0","0"
"2013","Chestermere, Alberta, Royal Canadian Mounted Police, municipal","48005","Precursor or equipment (crystal meth, ecstasy)","0","0","0","0","0","0","0","0","0","0","0","0","0","0"
"2014","Chestermere, Alberta, Royal Canadian Mounted Police, municipal","48005","Precursor or equipment (crystal meth, ecstasy)","0","0","0","0","0","0","0","0","0","0","0","0","0","0"
"2015","Chestermere, Alberta, Royal Canadian Mounted Police, municipal","48005","Precursor or equipment (crystal meth, ecstasy)","0","0","0","0","0","0","0","0","0","0","0","0","0","0"
"2016","Chestermere, Alberta, Royal Canadian Mounted Police, municipal","48005","Precursor or equipment (crystal meth, ecstasy)","0","0","0","0","0","0","0","0","0","0","0","0","0","0"
"1998","Chestermere, Alberta, Royal Canadian Mounted Police, municipal","48005","Youth Criminal Justice Act","0","0","0","0","0","0","0","0","0","0","0","0","0","0"
"1999","Chestermere, Alberta, Royal Canadian Mounted Police, municipal","48005","Youth Criminal Justice Act","0","0","0","0","0","0","0","0","0","0","0","0","0","0"
"2000","Chestermere, Alberta, Royal Canadian Mounted Police, municipal","48005","Youth Criminal Justice Act","0","0","0","0","0","0","0","0","0","0","0","0","0","0"
"2001","Chestermere, Alberta, Royal Canadian Mounted Police, municipal","48005","Youth Criminal Justice Act","0","0","0","0","0","0","0","0","0","0","0","0","0","0"
"2002","Chestermere, Alberta, Royal Canadian Mounted Police, municipal","48005","Youth Criminal Justice Act","0","0","0","0","0","0","0","0","0","0","0","0","0","0"
"2003","Chestermere, Alberta, Royal Canadian Mounted Police, municipal","48005","Youth Criminal Justice Act","0","0","0","0","0","0","0","0","0","0","0","0","0","0"
"2004","Chestermere, Alberta, Royal Canadian Mounted Police, municipal","48005","Youth Criminal Justice Act","0","0","0","0","0","0","0","0","0","0","0","0","0","0"
"2005","Chestermere, Alberta, Royal Canadian Mounted Police, municipal","48005","Youth Criminal Justice Act","0","0","0","0","0","0","0","0","0","0","0","0","0","0"
"2006","Chestermere, Alberta, Royal Canadian Mounted Police, municipal","48005","Youth Criminal Justice Act","1","0","0","0","9.62","0","0","0","0","0","0","0","0","0"
"2007","Chestermere, Alberta, Royal Canadian Mounted Police, municipal","48005","Youth Criminal Justice Act","0","0","0","-100","0","0","0","0","0","0","0","0","0","0"
"2008","Chestermere, Alberta, Royal Canadian Mounted Police, municipal","48005","Youth Criminal Justice Act","0","0","0","0","0","0","0","0","0","0","0","0","0","0"
"2009","Chestermere, Alberta, Royal Canadian Mounted Police, municipal","48005","Youth Criminal Justice Act","1","0","1","0","7.44","0","0","0","79.3","1","0","0","0","1"
"2010","Chestermere, Alberta, Royal Canadian Mounted Police, municipal","48005","Youth Criminal Justice Act","0","0","0","-100","0","0","0","0","0","0","0","0","0","0"
"2011","Chestermere, Alberta, Royal Canadian Mounted Police, municipal","48005","Youth Criminal Justice Act","0","0","0","0","0","0","0","0","0","0","0","0","0","0"
"2012","Chestermere, Alberta, Royal Canadian Mounted Police, municipal","48005","Youth Criminal Justice Act","0","0","0","0","0","0","0","0","0","0","0","0","0","0"
"2013","Chestermere, Alberta, Royal Canadian Mounted Police, municipal","48005","Youth Criminal Justice Act","1","0","1","0","6.1","0","0","0","71.74","1","0","0","0","1"
"2014","Chestermere, Alberta, Royal Canadian Mounted Police, municipal","48005","Youth Criminal Justice Act","0","0","0","-100","0","0","0","0","0","0","0","0","0","0"
"2015","Chestermere, Alberta, Royal Canadian Mounted Police, municipal","48005","Youth Criminal Justice Act","0","0","0","0","0","0","0","0","0","0","0","0","0","0"
"2016","Chestermere, Alberta, Royal Canadian Mounted Police, municipal","48005","Youth Criminal Justice Act","0","0","0","0","0","0","0","0","0","0","0","0","0","0"
"1998","Chestermere, Alberta, Royal Canadian Mounted Police, municipal","48005","Total other Federal Statutes","0","0","0","0","0","0","0","0","0","0","0","0","0","0"
"1999","Chestermere, Alberta, Royal Canadian Mounted Police, municipal","48005","Total other Federal Statutes","0","0","0","0","0","0","0","0","0","0","0","0","0","0"
"2000","Chestermere, Alberta, Royal Canadian Mounted Police, municipal","48005","Total other Federal Statutes","0","0","0","0","0","0","0","0","0","0","0","0","0","0"
"2001","Chestermere, Alberta, Royal Canadian Mounted Police, municipal","48005","Total other Federal Statutes","0","0","0","0","0","0","0","0","0","0","0","0","0","0"
"2002","Chestermere, Alberta, Royal Canadian Mounted Police, municipal","48005","Total other Federal Statutes","0","0","0","0","0","0","0","0","0","0","0","0","0","0"
"2003","Chestermere, Alberta, Royal Canadian Mounted Police, municipal","48005","Total other Federal Statutes","0","0","0","0","0","0","0","0","0","0","0","0","0","0"
"2004","Chestermere, Alberta, Royal Canadian Mounted Police, municipal","48005","Total other Federal Statutes","0","0","0","0","0","0","0","0","0","0","0","0","0","0"
"2005","Chestermere, Alberta, Royal Canadian Mounted Police, municipal","48005","Total other Federal Statutes","0","0","0","0","0","0","0","0","0","0","0","0","0","0"
"2006","Chestermere, Alberta, Royal Canadian Mounted Police, municipal","48005","Total other Federal Statutes","6","1","4","0","57.75","13.52","11.88","0","98.52","5","1","1","0","1"
"2007","Chestermere, Alberta, Royal Canadian Mounted Police, municipal","48005","Total other Federal Statutes","23","1","17","250.54","202.43","12.32","10.85","0","0","18","1","1","0","0"
"2008","Chestermere, Alberta, Royal Canadian Mounted Police, municipal","48005","Total other Federal Statutes","49","0","47","95.64","396.02","0","0","0","254.67","47","0","0","0","3"
"2009","Chestermere, Alberta, Royal Canadian Mounted Police, municipal","48005","Total other Federal Statutes","14","2","4","-73.68","104.22","20.7","18.31","0","0","6","2","2","0","0"
"2010","Chestermere, Alberta, Royal Canadian Mounted Police, municipal","48005","Total other Federal Statutes","13","0","5","-13.48","90.17","0","0","0","0","5","0","0","0","0"
"2011","Chestermere, Alberta, Royal Canadian Mounted Police, municipal","48005","Total other Federal Statutes","23","0","7","65.78","149.49","0","0","0","0","7","0","0","0","0"
"2012","Chestermere, Alberta, Royal Canadian Mounted Police, municipal","48005","Total other Federal Statutes","14","0","1","-40.9","88.34","0","0","0","0","1","0","0","0","0"
"2013","Chestermere, Alberta, Royal Canadian Mounted Police, municipal","48005","Total other Federal Statutes","10","0","3","-30.98","60.98","0","0","0","71.74","3","0","0","0","1"
"2014","Chestermere, Alberta, Royal Canadian Mounted Police, municipal","48005","Total other Federal Statutes","25","0","4","142.09","147.62","0","0","0","0","4","0","0","0","0"
"2015","Chestermere, Alberta, Royal Canadian Mounted Police, municipal","48005","Total other Federal Statutes","4","0","0","-84.35","23.1","0","0","0","0","0","0","0","0","0"
"2016","Chestermere, Alberta, Royal Canadian Mounted Police, municipal","48005","Total other Federal Statutes","10","0","3","143.9","56.34","0","0","0","69.2","3","0","0","0","1"
"1998","Chestermere, Alberta, Royal Canadian Mounted Police, municipal","48005","Bankruptcy Act","0","0","0","0","0","0","0","0","0","0","0","0","0","0"
"1999","Chestermere, Alberta, Royal Canadian Mounted Police, municipal","48005","Bankruptcy Act","0","0","0","0","0","0","0","0","0","0","0","0","0","0"
"2000","Chestermere, Alberta, Royal Canadian Mounted Police, municipal","48005","Bankruptcy Act","0","0","0","0","0","0","0","0","0","0","0","0","0","0"
"2001","Chestermere, Alberta, Royal Canadian Mounted Police, municipal","48005","Bankruptcy Act","0","0","0","0","0","0","0","0","0","0","0","0","0","0"
"2002","Chestermere, Alberta, Royal Canadian Mounted Police, municipal","48005","Bankruptcy Act","0","0","0","0","0","0","0","0","0","0","0","0","0","0"
"2003","Chestermere, Alberta, Royal Canadian Mounted Police, municipal","48005","Bankruptcy Act","0","0","0","0","0","0","0","0","0","0","0","0","0","0"
"2004","Chestermere, Alberta, Royal Canadian Mounted Police, municipal","48005","Bankruptcy Act","0","0","0","0","0","0","0","0","0","0","0","0","0","0"
"2005","Chestermere, Alberta, Royal Canadian Mounted Police, municipal","48005","Bankruptcy Act","0","0","0","0","0","0","0","0","0","0","0","0","0","0"
"2006","Chestermere, Alberta, Royal Canadian Mounted Police, municipal","48005","Bankruptcy Act","0","0","0","0","0","0","0","0","0","0","0","0","0","0"
"2007","Chestermere, Alberta, Royal Canadian Mounted Police, municipal","48005","Bankruptcy Act","0","0","0","0","0","0","0","0","0","0","0","0","0","0"
"2008","Chestermere, Alberta, Royal Canadian Mounted Police, municipal","48005","Bankruptcy Act","0","0","0","0","0","0","0","0","0","0","0","0","0","0"
"2009","Chestermere, Alberta, Royal Canadian Mounted Police, municipal","48005","Bankruptcy Act","0","0","0","0","0","0","0","0","0","0","0","0","0","0"
"2010","Chestermere, Alberta, Royal Canadian Mounted Police, municipal","48005","Bankruptcy Act","0","0","0","0","0","0","0","0","0","0","0","0","0","0"
"2011","Chestermere, Alberta, Royal Canadian Mounted Police, municipal","48005","Bankruptcy Act","0","0","0","0","0","0","0","0","0","0","0","0","0","0"
"2012","Chestermere, Alberta, Royal Canadian Mounted Police, municipal","48005","Bankruptcy Act","0","0","0","0","0","0","0","0","0","0","0","0","0","0"
"2013","Chestermere, Alberta, Royal Canadian Mounted Police, municipal","48005","Bankruptcy Act","0","0","0","0","0","0","0","0","0","0","0","0","0","0"
"2014","Chestermere, Alberta, Royal Canadian Mounted Police, municipal","48005","Bankruptcy Act","0","0","0","0","0","0","0","0","0","0","0","0","0","0"
"2015","Chestermere, Alberta, Royal Canadian Mounted Police, municipal","48005","Bankruptcy Act","0","0","0","0","0","0","0","0","0","0","0","0","0","0"
"2016","Chestermere, Alberta, Royal Canadian Mounted Police, municipal","48005","Bankruptcy Act","0","0","0","0","0","0","0","0","0","0","0","0","0","0"
"1998","Chestermere, Alberta, Royal Canadian Mounted Police, municipal","48005","Income Tax Act","0","0","0","0","0","0","0","0","0","0","0","0","0","0"
"1999","Chestermere, Alberta, Royal Canadian Mounted Police, municipal","48005","Income Tax Act","0","0","0","0","0","0","0","0","0","0","0","0","0","0"
"2000","Chestermere, Alberta, Royal Canadian Mounted Police, municipal","48005","Income Tax Act","0","0","0","0","0","0","0","0","0","0","0","0","0","0"
"2001","Chestermere, Alberta, Royal Canadian Mounted Police, municipal","48005","Income Tax Act","0","0","0","0","0","0","0","0","0","0","0","0","0","0"
"2002","Chestermere, Alberta, Royal Canadian Mounted Police, municipal","48005","Income Tax Act","0","0","0","0","0","0","0","0","0","0","0","0","0","0"
"2003","Chestermere, Alberta, Royal Canadian Mounted Police, municipal","48005","Income Tax Act","0","0","0","0","0","0","0","0","0","0","0","0","0","0"
"2004","Chestermere, Alberta, Royal Canadian Mounted Police, municipal","48005","Income Tax Act","0","0","0","0","0","0","0","0","0","0","0","0","0","0"
"2005","Chestermere, Alberta, Royal Canadian Mounted Police, municipal","48005","Income Tax Act","0","0","0","0","0","0","0","0","0","0","0","0","0","0"
"2006","Chestermere, Alberta, Royal Canadian Mounted Police, municipal","48005","Income Tax Act","0","0","0","0","0","0","0","0","0","0","0","0","0","0"
"2007","Chestermere, Alberta, Royal Canadian Mounted Police, municipal","48005","Income Tax Act","1","0","1","0","8.8","12.32","10.85","0","0","1","1","1","0","0"
"2008","Chestermere, Alberta, Royal Canadian Mounted Police, municipal","48005","Income Tax Act","0","0","0","-100","0","0","0","0","0","0","0","0","0","0"
"2009","Chestermere, Alberta, Royal Canadian Mounted Police, municipal","48005","Income Tax Act","0","0","0","0","0","0","0","0","0","0","0","0","0","0"
"2010","Chestermere, Alberta, Royal Canadian Mounted Police, municipal","48005","Income Tax Act","0","0","0","0","0","0","0","0","0","0","0","0","0","0"
"2011","Chestermere, Alberta, Royal Canadian Mounted Police, municipal","48005","Income Tax Act","0","0","0","0","0","0","0","0","0","0","0","0","0","0"
"2012","Chestermere, Alberta, Royal Canadian Mounted Police, municipal","48005","Income Tax Act","0","0","0","0","0","0","0","0","0","0","0","0","0","0"
"2013","Chestermere, Alberta, Royal Canadian Mounted Police, municipal","48005","Income Tax Act","0","0","0","0","0","0","0","0","0","0","0","0","0","0"
"2014","Chestermere, Alberta, Royal Canadian Mounted Police, municipal","48005","Income Tax Act","0","0","0","0","0","0","0","0","0","0","0","0","0","0"
"2015","Chestermere, Alberta, Royal Canadian Mounted Police, municipal","48005","Income Tax Act","0","0","0","0","0","0","0","0","0","0","0","0","0","0"
"2016","Chestermere, Alberta, Royal Canadian Mounted Police, municipal","48005","Income Tax Act","0","0","0","0","0","0","0","0","0","0","0","0","0","0"
"1998","Chestermere, Alberta, Royal Canadian Mounted Police, municipal","48005","Canada Shipping Act","0","0","0","0","0","0","0","0","0","0","0","0","0","0"
"1999","Chestermere, Alberta, Royal Canadian Mounted Police, municipal","48005","Canada Shipping Act","0","0","0","0","0","0","0","0","0","0","0","0","0","0"
"2000","Chestermere, Alberta, Royal Canadian Mounted Police, municipal","48005","Canada Shipping Act","0","0","0","0","0","0","0","0","0","0","0","0","0","0"
"2001","Chestermere, Alberta, Royal Canadian Mounted Police, municipal","48005","Canada Shipping Act","0","0","0","0","0","0","0","0","0","0","0","0","0","0"
"2002","Chestermere, Alberta, Royal Canadian Mounted Police, municipal","48005","Canada Shipping Act","0","0","0","0","0","0","0","0","0","0","0","0","0","0"
"2003","Chestermere, Alberta, Royal Canadian Mounted Police, municipal","48005","Canada Shipping Act","0","0","0","0","0","0","0","0","0","0","0","0","0","0"
"2004","Chestermere, Alberta, Royal Canadian Mounted Police, municipal","48005","Canada Shipping Act","0","0","0","0","0","0","0","0","0","0","0","0","0","0"
"2005","Chestermere, Alberta, Royal Canadian Mounted Police, municipal","48005","Canada Shipping Act","0","0","0","0","0","0","0","0","0","0","0","0","0","0"
"2006","Chestermere, Alberta, Royal Canadian Mounted Police, municipal","48005","Canada Shipping Act","5","1","3","0","48.12","13.52","11.88","0","98.52","4","1","1","0","1"
"2007","Chestermere, Alberta, Royal Canadian Mounted Police, municipal","48005","Canada Shipping Act","17","0","15","210.91","149.62","0","0","0","0","15","0","0","0","0"
"2008","Chestermere, Alberta, Royal Canadian Mounted Police, municipal","48005","Canada Shipping Act","46","0","44","148.48","371.78","0","0","0","0","44","0","0","0","0"
"2009","Chestermere, Alberta, Royal Canadian Mounted Police, municipal","48005","Canada Shipping Act","10","2","2","-79.98","74.44","20.7","18.31","0","0","4","2","2","0","0"
"2010","Chestermere, Alberta, Royal Canadian Mounted Police, municipal","48005","Canada Shipping Act","3","0","3","-72.05","20.81","0","0","0","0","3","0","0","0","0"
"2011","Chestermere, Alberta, Royal Canadian Mounted Police, municipal","48005","Canada Shipping Act","18","0","4","462.21","116.99","0","0","0","0","4","0","0","0","0"
"2012","Chestermere, Alberta, Royal Canadian Mounted Police, municipal","48005","Canada Shipping Act","2","0","0","-89.21","12.62","0","0","0","0","0","0","0","0","0"
"2013","Chestermere, Alberta, Royal Canadian Mounted Police, municipal","48005","Canada Shipping Act","5","0","2","141.58","30.49","0","0","0","0","2","0","0","0","0"
"2014","Chestermere, Alberta, Royal Canadian Mounted Police, municipal","48005","Canada Shipping Act","21","0","3","306.71","124","0","0","0","0","3","0","0","0","0"
"2015","Chestermere, Alberta, Royal Canadian Mounted Police, municipal","48005","Canada Shipping Act","3","0","0","-86.03","17.33","0","0","0","0","0","0","0","0","0"
"2016","Chestermere, Alberta, Royal Canadian Mounted Police, municipal","48005","Canada Shipping Act","6","0","1","95.12","33.81","0","0","0","0","1","0","0","0","0"
"1998","Chestermere, Alberta, Royal Canadian Mounted Police, municipal","48005","Canada Health Act","0","0","0","0","0","0","0","0","0","0","0","0","0","0"
"1999","Chestermere, Alberta, Royal Canadian Mounted Police, municipal","48005","Canada Health Act","0","0","0","0","0","0","0","0","0","0","0","0","0","0"
"2000","Chestermere, Alberta, Royal Canadian Mounted Police, municipal","48005","Canada Health Act","0","0","0","0","0","0","0","0","0","0","0","0","0","0"
"2001","Chestermere, Alberta, Royal Canadian Mounted Police, municipal","48005","Canada Health Act","0","0","0","0","0","0","0","0","0","0","0","0","0","0"
"2002","Chestermere, Alberta, Royal Canadian Mounted Police, municipal","48005","Canada Health Act","0","0","0","0","0","0","0","0","0","0","0","0","0","0"
"2003","Chestermere, Alberta, Royal Canadian Mounted Police, municipal","48005","Canada Health Act","0","0","0","0","0","0","0","0","0","0","0","0","0","0"
"2004","Chestermere, Alberta, Royal Canadian Mounted Police, municipal","48005","Canada Health Act","0","0","0","0","0","0","0","0","0","0","0","0","0","0"
"2005","Chestermere, Alberta, Royal Canadian Mounted Police, municipal","48005","Canada Health Act","0","0","0","0","0","0","0","0","0","0","0","0","0","0"
"2006","Chestermere, Alberta, Royal Canadian Mounted Police, municipal","48005","Canada Health Act","0","0","0","0","0","0","0","0","0","0","0","0","0","0"
"2007","Chestermere, Alberta, Royal Canadian Mounted Police, municipal","48005","Canada Health Act","0","0","0","0","0","0","0","0","0","0","0","0","0","0"
"2008","Chestermere, Alberta, Royal Canadian Mounted Police, municipal","48005","Canada Health Act","0","0","0","0","0","0","0","0","0","0","0","0","0","0"
"2009","Chestermere, Alberta, Royal Canadian Mounted Police, municipal","48005","Canada Health Act","0","0","0","0","0","0","0","0","0","0","0","0","0","0"
"2010","Chestermere, Alberta, Royal Canadian Mounted Police, municipal","48005","Canada Health Act","0","0","0","0","0","0","0","0","0","0","0","0","0","0"
"2011","Chestermere, Alberta, Royal Canadian Mounted Police, municipal","48005","Canada Health Act","0","0","0","0","0","0","0","0","0","0","0","0","0","0"
"2012","Chestermere, Alberta, Royal Canadian Mounted Police, municipal","48005","Canada Health Act","0","0","0","0","0","0","0","0","0","0","0","0","0","0"
"2013","Chestermere, Alberta, Royal Canadian Mounted Police, municipal","48005","Canada Health Act","0","0","0","0","0","0","0","0","0","0","0","0","0","0"
"2014","Chestermere, Alberta, Royal Canadian Mounted Police, municipal","48005","Canada Health Act","0","0","0","0","0","0","0","0","0","0","0","0","0","0"
"2015","Chestermere, Alberta, Royal Canadian Mounted Police, municipal","48005","Canada Health Act","0","0","0","0","0","0","0","0","0","0","0","0","0","0"
"2016","Chestermere, Alberta, Royal Canadian Mounted Police, municipal","48005","Canada Health Act","0","0","0","0","0","0","0","0","0","0","0","0","0","0"
"1998","Chestermere, Alberta, Royal Canadian Mounted Police, municipal","48005","Customs Act","0","0","0","0","0","0","0","0","0","0","0","0","0","0"
"1999","Chestermere, Alberta, Royal Canadian Mounted Police, municipal","48005","Customs Act","0","0","0","0","0","0","0","0","0","0","0","0","0","0"
"2000","Chestermere, Alberta, Royal Canadian Mounted Police, municipal","48005","Customs Act","0","0","0","0","0","0","0","0","0","0","0","0","0","0"
"2001","Chestermere, Alberta, Royal Canadian Mounted Police, municipal","48005","Customs Act","0","0","0","0","0","0","0","0","0","0","0","0","0","0"
"2002","Chestermere, Alberta, Royal Canadian Mounted Police, municipal","48005","Customs Act","0","0","0","0","0","0","0","0","0","0","0","0","0","0"
"2003","Chestermere, Alberta, Royal Canadian Mounted Police, municipal","48005","Customs Act","0","0","0","0","0","0","0","0","0","0","0","0","0","0"
"2004","Chestermere, Alberta, Royal Canadian Mounted Police, municipal","48005","Customs Act","0","0","0","0","0","0","0","0","0","0","0","0","0","0"
"2005","Chestermere, Alberta, Royal Canadian Mounted Police, municipal","48005","Customs Act","0","0","0","0","0","0","0","0","0","0","0","0","0","0"
"2006","Chestermere, Alberta, Royal Canadian Mounted Police, municipal","48005","Customs Act","0","0","0","0","0","0","0","0","0","0","0","0","0","0"
"2007","Chestermere, Alberta, Royal Canadian Mounted Police, municipal","48005","Customs Act","0","0","0","0","0","0","0","0","0","0","0","0","0","0"
"2008","Chestermere, Alberta, Royal Canadian Mounted Police, municipal","48005","Customs Act","0","0","0","0","0","0","0","0","0","0","0","0","0","0"
"2009","Chestermere, Alberta, Royal Canadian Mounted Police, municipal","48005","Customs Act","0","0","0","0","0","0","0","0","0","0","0","0","0","0"
"2010","Chestermere, Alberta, Royal Canadian Mounted Police, municipal","48005","Customs Act","1","0","1","0","6.94","0","0","0","0","1","0","0","0","0"
"2011","Chestermere, Alberta, Royal Canadian Mounted Police, municipal","48005","Customs Act","0","0","0","-100","0","0","0","0","0","0","0","0","0","0"
"2012","Chestermere, Alberta, Royal Canadian Mounted Police, municipal","48005","Customs Act","0","0","0","0","0","0","0","0","0","0","0","0","0","0"
"2013","Chestermere, Alberta, Royal Canadian Mounted Police, municipal","48005","Customs Act","0","0","0","0","0","0","0","0","0","0","0","0","0","0"
"2014","Chestermere, Alberta, Royal Canadian Mounted Police, municipal","48005","Customs Act","0","0","0","0","0","0","0","0","0","0","0","0","0","0"
"2015","Chestermere, Alberta, Royal Canadian Mounted Police, municipal","48005","Customs Act","0","0","0","0","0","0","0","0","0","0","0","0","0","0"
"2016","Chestermere, Alberta, Royal Canadian Mounted Police, municipal","48005","Customs Act","0","0","0","0","0","0","0","0","0","0","0","0","0","0"
"1998","Chestermere, Alberta, Royal Canadian Mounted Police, municipal","48005","Competition Act","0","0","0","0","0","0","0","0","0","0","0","0","0","0"
"1999","Chestermere, Alberta, Royal Canadian Mounted Police, municipal","48005","Competition Act","0","0","0","0","0","0","0","0","0","0","0","0","0","0"
"2000","Chestermere, Alberta, Royal Canadian Mounted Police, municipal","48005","Competition Act","0","0","0","0","0","0","0","0","0","0","0","0","0","0"
"2001","Chestermere, Alberta, Royal Canadian Mounted Police, municipal","48005","Competition Act","0","0","0","0","0","0","0","0","0","0","0","0","0","0"
"2002","Chestermere, Alberta, Royal Canadian Mounted Police, municipal","48005","Competition Act","0","0","0","0","0","0","0","0","0","0","0","0","0","0"
"2003","Chestermere, Alberta, Royal Canadian Mounted Police, municipal","48005","Competition Act","0","0","0","0","0","0","0","0","0","0","0","0","0","0"
"2004","Chestermere, Alberta, Royal Canadian Mounted Police, municipal","48005","Competition Act","0","0","0","0","0","0","0","0","0","0","0","0","0","0"
"2005","Chestermere, Alberta, Royal Canadian Mounted Police, municipal","48005","Competition Act","0","0","0","0","0","0","0","0","0","0","0","0","0","0"
"2006","Chestermere, Alberta, Royal Canadian Mounted Police, municipal","48005","Competition Act","0","0","0","0","0","0","0","0","0","0","0","0","0","0"
"2007","Chestermere, Alberta, Royal Canadian Mounted Police, municipal","48005","Competition Act","0","0","0","0","0","0","0","0","0","0","0","0","0","0"
"2008","Chestermere, Alberta, Royal Canadian Mounted Police, municipal","48005","Competition Act","0","0","0","0","0","0","0","0","0","0","0","0","0","0"
"2009","Chestermere, Alberta, Royal Canadian Mounted Police, municipal","48005","Competition Act","0","0","0","0","0","0","0","0","0","0","0","0","0","0"
"2010","Chestermere, Alberta, Royal Canadian Mounted Police, municipal","48005","Competition Act","0","0","0","0","0","0","0","0","0","0","0","0","0","0"
"2011","Chestermere, Alberta, Royal Canadian Mounted Police, municipal","48005","Competition Act","0","0","0","0","0","0","0","0","0","0","0","0","0","0"
"2012","Chestermere, Alberta, Royal Canadian Mounted Police, municipal","48005","Competition Act","0","0","0","0","0","0","0","0","0","0","0","0","0","0"
"2013","Chestermere, Alberta, Royal Canadian Mounted Police, municipal","48005","Competition Act","0","0","0","0","0","0","0","0","0","0","0","0","0","0"
"2014","Chestermere, Alberta, Royal Canadian Mounted Police, municipal","48005","Competition Act","0","0","0","0","0","0","0","0","0","0","0","0","0","0"
"2015","Chestermere, Alberta, Royal Canadian Mounted Police, municipal","48005","Competition Act","0","0","0","0","0","0","0","0","0","0","0","0","0","0"
"2016","Chestermere, Alberta, Royal Canadian Mounted Police, municipal","48005","Competition Act","0","0","0","0","0","0","0","0","0","0","0","0","0","0"
"1998","Chestermere, Alberta, Royal Canadian Mounted Police, municipal","48005","Excise Act","0","0","0","0","0","0","0","0","0","0","0","0","0","0"
"1999","Chestermere, Alberta, Royal Canadian Mounted Police, municipal","48005","Excise Act","0","0","0","0","0","0","0","0","0","0","0","0","0","0"
"2000","Chestermere, Alberta, Royal Canadian Mounted Police, municipal","48005","Excise Act","0","0","0","0","0","0","0","0","0","0","0","0","0","0"
"2001","Chestermere, Alberta, Royal Canadian Mounted Police, municipal","48005","Excise Act","0","0","0","0","0","0","0","0","0","0","0","0","0","0"
"2002","Chestermere, Alberta, Royal Canadian Mounted Police, municipal","48005","Excise Act","0","0","0","0","0","0","0","0","0","0","0","0","0","0"
"2003","Chestermere, Alberta, Royal Canadian Mounted Police, municipal","48005","Excise Act","0","0","0","0","0","0","0","0","0","0","0","0","0","0"
"2004","Chestermere, Alberta, Royal Canadian Mounted Police, municipal","48005","Excise Act","0","0","0","0","0","0","0","0","0","0","0","0","0","0"
"2005","Chestermere, Alberta, Royal Canadian Mounted Police, municipal","48005","Excise Act","0","0","0","0","0","0","0","0","0","0","0","0","0","0"
"2006","Chestermere, Alberta, Royal Canadian Mounted Police, municipal","48005","Excise Act","0","0","0","0","0","0","0","0","0","0","0","0","0","0"
"2007","Chestermere, Alberta, Royal Canadian Mounted Police, municipal","48005","Excise Act","1","0","0","0","8.8","0","0","0","0","0","0","0","0","0"
"2008","Chestermere, Alberta, Royal Canadian Mounted Police, municipal","48005","Excise Act","0","0","0","-100","0","0","0","0","0","0","0","0","0","0"
"2009","Chestermere, Alberta, Royal Canadian Mounted Police, municipal","48005","Excise Act","0","0","1","0","0","0","0","0","0","1","0","0","0","0"
"2010","Chestermere, Alberta, Royal Canadian Mounted Police, municipal","48005","Excise Act","0","0","0","0","0","0","0","0","0","0","0","0","0","0"
"2011","Chestermere, Alberta, Royal Canadian Mounted Police, municipal","48005","Excise Act","0","0","1","0","0","0","0","0","0","1","0","0","0","0"
"2012","Chestermere, Alberta, Royal Canadian Mounted Police, municipal","48005","Excise Act","0","0","0","0","0","0","0","0","0","0","0","0","0","0"
"2013","Chestermere, Alberta, Royal Canadian Mounted Police, municipal","48005","Excise Act","0","0","0","0","0","0","0","0","0","0","0","0","0","0"
"2014","Chestermere, Alberta, Royal Canadian Mounted Police, municipal","48005","Excise Act","0","0","0","0","0","0","0","0","0","0","0","0","0","0"
"2015","Chestermere, Alberta, Royal Canadian Mounted Police, municipal","48005","Excise Act","0","0","0","0","0","0","0","0","0","0","0","0","0","0"
"2016","Chestermere, Alberta, Royal Canadian Mounted Police, municipal","48005","Excise Act","0","0","0","0","0","0","0","0","0","0","0","0","0","0"
"1998","Chestermere, Alberta, Royal Canadian Mounted Police, municipal","48005","Total Immigration and Refugee Protection Act","0","0","0","0","0","0","0","0","0","0","0","0","0","0"
"1999","Chestermere, Alberta, Royal Canadian Mounted Police, municipal","48005","Total Immigration and Refugee Protection Act","0","0","0","0","0","0","0","0","0","0","0","0","0","0"
"2000","Chestermere, Alberta, Royal Canadian Mounted Police, municipal","48005","Total Immigration and Refugee Protection Act","0","0","0","0","0","0","0","0","0","0","0","0","0","0"
"2001","Chestermere, Alberta, Royal Canadian Mounted Police, municipal","48005","Total Immigration and Refugee Protection Act","0","0","0","0","0","0","0","0","0","0","0","0","0","0"
"2002","Chestermere, Alberta, Royal Canadian Mounted Police, municipal","48005","Total Immigration and Refugee Protection Act","0","0","0","0","0","0","0","0","0","0","0","0","0","0"
"2003","Chestermere, Alberta, Royal Canadian Mounted Police, municipal","48005","Total Immigration and Refugee Protection Act","0","0","0","0","0","0","0","0","0","0","0","0","0","0"
"2004","Chestermere, Alberta, Royal Canadian Mounted Police, municipal","48005","Total Immigration and Refugee Protection Act","0","0","0","0","0","0","0","0","0","0","0","0","0","0"
"2005","Chestermere, Alberta, Royal Canadian Mounted Police, municipal","48005","Total Immigration and Refugee Protection Act","0","0","0","0","0","0","0","0","0","0","0","0","0","0"
"2006","Chestermere, Alberta, Royal Canadian Mounted Police, municipal","48005","Total Immigration and Refugee Protection Act","0","0","0","0","0","0","0","0","0","0","0","0","0","0"
"2007","Chestermere, Alberta, Royal Canadian Mounted Police, municipal","48005","Total Immigration and Refugee Protection Act","0","0","0","0","0","0","0","0","0","0","0","0","0","0"
"2008","Chestermere, Alberta, Royal Canadian Mounted Police, municipal","48005","Total Immigration and Refugee Protection Act","0","0","0","0","0","0","0","0","0","0","0","0","0","0"
"2009","Chestermere, Alberta, Royal Canadian Mounted Police, municipal","48005","Total Immigration and Refugee Protection Act","0","0","0","0","0","0","0","0","0","0","0","0","0","0"
"2010","Chestermere, Alberta, Royal Canadian Mounted Police, municipal","48005","Total Immigration and Refugee Protection Act","0","0","0","0","0","0","0","0","0","0","0","0","0","0"
"2011","Chestermere, Alberta, Royal Canadian Mounted Police, municipal","48005","Total Immigration and Refugee Protection Act","0","0","0","0","0","0","0","0","0","0","0","0","0","0"
"2012","Chestermere, Alberta, Royal Canadian Mounted Police, municipal","48005","Total Immigration and Refugee Protection Act","0","0","0","0","0","0","0","0","0","0","0","0","0","0"
"2013","Chestermere, Alberta, Royal Canadian Mounted Police, municipal","48005","Total Immigration and Refugee Protection Act","0","0","0","0","0","0","0","0","0","0","0","0","0","0"
"2014","Chestermere, Alberta, Royal Canadian Mounted Police, municipal","48005","Total Immigration and Refugee Protection Act","0","0","0","0","0","0","0","0","0","0","0","0","0","0"
"2015","Chestermere, Alberta, Royal Canadian Mounted Police, municipal","48005","Total Immigration and Refugee Protection Act","0","0","0","0","0","0","0","0","0","0","0","0","0","0"
"2016","Chestermere, Alberta, Royal Canadian Mounted Police, municipal","48005","Total Immigration and Refugee Protection Act","0","0","0","0","0","0","0","0","0","0","0","0","0","0"
"1998","Chestermere, Alberta, Royal Canadian Mounted Police, municipal","48005","Firearms Act","0","0","0","0","0","0","0","0","0","0","0","0","0","0"
"1999","Chestermere, Alberta, Royal Canadian Mounted Police, municipal","48005","Firearms Act","0","0","0","0","0","0","0","0","0","0","0","0","0","0"
"2000","Chestermere, Alberta, Royal Canadian Mounted Police, municipal","48005","Firearms Act","0","0","0","0","0","0","0","0","0","0","0","0","0","0"
"2001","Chestermere, Alberta, Royal Canadian Mounted Police, municipal","48005","Firearms Act","0","0","0","0","0","0","0","0","0","0","0","0","0","0"
"2002","Chestermere, Alberta, Royal Canadian Mounted Police, municipal","48005","Firearms Act","0","0","0","0","0","0","0","0","0","0","0","0","0","0"
"2003","Chestermere, Alberta, Royal Canadian Mounted Police, municipal","48005","Firearms Act","0","0","0","0","0","0","0","0","0","0","0","0","0","0"
"2004","Chestermere, Alberta, Royal Canadian Mounted Police, municipal","48005","Firearms Act","0","0","0","0","0","0","0","0","0","0","0","0","0","0"
"2005","Chestermere, Alberta, Royal Canadian Mounted Police, municipal","48005","Firearms Act","0","0","0","0","0","0","0","0","0","0","0","0","0","0"
"2006","Chestermere, Alberta, Royal Canadian Mounted Police, municipal","48005","Firearms Act","0","0","0","0","0","0","0","0","0","0","0","0","0","0"
"2007","Chestermere, Alberta, Royal Canadian Mounted Police, municipal","48005","Firearms Act","3","0","1","0","26.4","0","0","0","0","1","0","0","0","0"
"2008","Chestermere, Alberta, Royal Canadian Mounted Police, municipal","48005","Firearms Act","1","0","1","-69.39","8.08","0","0","0","0","1","0","0","0","0"
"2009","Chestermere, Alberta, Royal Canadian Mounted Police, municipal","48005","Firearms Act","3","0","1","176.33","22.33","0","0","0","0","1","0","0","0","0"
"2010","Chestermere, Alberta, Royal Canadian Mounted Police, municipal","48005","Firearms Act","3","0","1","-6.83","20.81","0","0","0","0","1","0","0","0","0"
"2011","Chestermere, Alberta, Royal Canadian Mounted Police, municipal","48005","Firearms Act","0","0","0","-100","0","0","0","0","0","0","0","0","0","0"
"2012","Chestermere, Alberta, Royal Canadian Mounted Police, municipal","48005","Firearms Act","3","0","0","0","18.93","0","0","0","0","0","0","0","0","0"
"2013","Chestermere, Alberta, Royal Canadian Mounted Police, municipal","48005","Firearms Act","2","0","0","-35.58","12.2","0","0","0","0","0","0","0","0","0"
"2014","Chestermere, Alberta, Royal Canadian Mounted Police, municipal","48005","Firearms Act","0","0","0","-100","0","0","0","0","0","0","0","0","0","0"
"2015","Chestermere, Alberta, Royal Canadian Mounted Police, municipal","48005","Firearms Act","0","0","0","0","0","0","0","0","0","0","0","0","0","0"
"2016","Chestermere, Alberta, Royal Canadian Mounted Police, municipal","48005","Firearms Act","1","0","0","0","5.63","0","0","0","0","0","0","0","0","0"
"2002","Chestermere, Alberta, Royal Canadian Mounted Police, municipal","48005","National Defence Act","0","0","0","0","0","0","0","0","0","0","0","0","0","0"
"2003","Chestermere, Alberta, Royal Canadian Mounted Police, municipal","48005","National Defence Act","0","0","0","0","0","0","0","0","0","0","0","0","0","0"
"2004","Chestermere, Alberta, Royal Canadian Mounted Police, municipal","48005","National Defence Act","0","0","0","0","0","0","0","0","0","0","0","0","0","0"
"2005","Chestermere, Alberta, Royal Canadian Mounted Police, municipal","48005","National Defence Act","0","0","0","0","0","0","0","0","0","0","0","0","0","0"
"2006","Chestermere, Alberta, Royal Canadian Mounted Police, municipal","48005","National Defence Act","0","0","0","0","0","0","0","0","0","0","0","0","0","0"
"2007","Chestermere, Alberta, Royal Canadian Mounted Police, municipal","48005","National Defence Act","0","0","0","0","0","0","0","0","0","0","0","0","0","0"
"2008","Chestermere, Alberta, Royal Canadian Mounted Police, municipal","48005","National Defence Act","0","0","0","0","0","0","0","0","0","0","0","0","0","0"
"2009","Chestermere, Alberta, Royal Canadian Mounted Police, municipal","48005","National Defence Act","0","0","0","0","0","0","0","0","0","0","0","0","0","0"
"2010","Chestermere, Alberta, Royal Canadian Mounted Police, municipal","48005","National Defence Act","0","0","0","0","0","0","0","0","0","0","0","0","0","0"
"2011","Chestermere, Alberta, Royal Canadian Mounted Police, municipal","48005","National Defence Act","0","0","0","0","0","0","0","0","0","0","0","0","0","0"
"2012","Chestermere, Alberta, Royal Canadian Mounted Police, municipal","48005","National Defence Act","0","0","0","0","0","0","0","0","0","0","0","0","0","0"
"2013","Chestermere, Alberta, Royal Canadian Mounted Police, municipal","48005","National Defence Act","0","0","0","0","0","0","0","0","0","0","0","0","0","0"
"2014","Chestermere, Alberta, Royal Canadian Mounted Police, municipal","48005","National Defence Act","0","0","0","0","0","0","0","0","0","0","0","0","0","0"
"2015","Chestermere, Alberta, Royal Canadian Mounted Police, municipal","48005","National Defence Act","0","0","0","0","0","0","0","0","0","0","0","0","0","0"
"2016","Chestermere, Alberta, Royal Canadian Mounted Police, municipal","48005","National Defence Act","0","0","0","0","0","0","0","0","0","0","0","0","0","0"
"1998","Chestermere, Alberta, Royal Canadian Mounted Police, municipal","48005","Other federal statutes","0","0","0","0","0","0","0","0","0","0","0","0","0","0"
"1999","Chestermere, Alberta, Royal Canadian Mounted Police, municipal","48005","Other federal statutes","0","0","0","0","0","0","0","0","0","0","0","0","0","0"
"2000","Chestermere, Alberta, Royal Canadian Mounted Police, municipal","48005","Other federal statutes","0","0","0","0","0","0","0","0","0","0","0","0","0","0"
"2001","Chestermere, Alberta, Royal Canadian Mounted Police, municipal","48005","Other federal statutes","0","0","0","0","0","0","0","0","0","0","0","0","0","0"
"2002","Chestermere, Alberta, Royal Canadian Mounted Police, municipal","48005","Other federal statutes","0","0","0","0","0","0","0","0","0","0","0","0","0","0"
"2003","Chestermere, Alberta, Royal Canadian Mounted Police, municipal","48005","Other federal statutes","0","0","0","0","0","0","0","0","0","0","0","0","0","0"
"2004","Chestermere, Alberta, Royal Canadian Mounted Police, municipal","48005","Other federal statutes","0","0","0","0","0","0","0","0","0","0","0","0","0","0"
"2005","Chestermere, Alberta, Royal Canadian Mounted Police, municipal","48005","Other federal statutes","0","0","0","0","0","0","0","0","0","0","0","0","0","0"
"2006","Chestermere, Alberta, Royal Canadian Mounted Police, municipal","48005","Other federal statutes","1","0","1","0","9.62","0","0","0","0","1","0","0","0","0"
"2007","Chestermere, Alberta, Royal Canadian Mounted Police, municipal","48005","Other federal statutes","1","1","0","-8.55","8.8","0","0","0","0","1","0","0","0","0"
"2008","Chestermere, Alberta, Royal Canadian Mounted Police, municipal","48005","Other federal statutes","2","0","2","83.66","16.16","0","0","0","254.67","2","0","0","0","3"
"2009","Chestermere, Alberta, Royal Canadian Mounted Police, municipal","48005","Other federal statutes","1","0","0","-53.95","7.44","0","0","0","0","0","0","0","0","0"
"2010","Chestermere, Alberta, Royal Canadian Mounted Police, municipal","48005","Other federal statutes","6","0","0","459.05","41.62","0","0","0","0","0","0","0","0","0"
"2011","Chestermere, Alberta, Royal Canadian Mounted Police, municipal","48005","Other federal statutes","5","0","2","-21.91","32.5","0","0","0","0","2","0","0","0","0"
"2012","Chestermere, Alberta, Royal Canadian Mounted Police, municipal","48005","Other federal statutes","9","0","1","74.76","56.79","0","0","0","0","1","0","0","0","0"
"2013","Chestermere, Alberta, Royal Canadian Mounted Police, municipal","48005","Other federal statutes","3","0","1","-67.79","18.29","0","0","0","71.74","1","0","0","0","1"
"2014","Chestermere, Alberta, Royal Canadian Mounted Police, municipal","48005","Other federal statutes","4","0","1","29.11","23.62","0","0","0","0","1","0","0","0","0"
"2015","Chestermere, Alberta, Royal Canadian Mounted Police, municipal","48005","Other federal statutes","1","0","0","-75.55","5.78","0","0","0","0","0","0","0","0","0"
"2016","Chestermere, Alberta, Royal Canadian Mounted Police, municipal","48005","Other federal statutes","3","0","2","192.68","16.9","0","0","0","69.2","2","0","0","0","1"
"1998","Calgary, Alberta, municipal","48014","Total, all violations","71197","19670","4750","0","8469.05","0","0","0","0","24420","14706","18350","3644","1946"
"1999","Calgary, Alberta, municipal","48014","Total, all violations","70585","19818","5872","-3.34","8186.53","0","0","0","0","25690","14742","18455","3713","2164"
"2000","Calgary, Alberta, municipal","48014","Total, all violations","68104","20993","6422","-5.75","7715.86","0","0","0","0","27415","15672","19262","3590","2424"
"2001","Calgary, Alberta, municipal","48014","Total, all violations","69037","21750","6073","-0.82","7652.53","0","0","0","0","27823","16444","19839","3395","2400"
"2002","Calgary, Alberta, municipal","48014","Total, all violations","69850","23056","6110","-1.16","7563.8","0","0","0","0","29166","17540","21380","3840","2280"
"2003","Calgary, Alberta, municipal","48014","Total, all violations","71287","22648","6570","0.46","7598.76","0","0","0","0","29218","17451","20263","2812","3090"
"2004","Calgary, Alberta, municipal","48014","Total, all violations","69667","22734","6210","-5.19","7204.33","2410.77","2508.21","3475.43","3708.88","28944","18143","20778","2635","2812"
"2005","Calgary, Alberta, municipal","48014","Total, all violations","69972","22636","5215","-2.53","7022.26","2339.16","2450.08","3570.32","3232.76","27851","18197","20947","2750","2490"
"2006","Calgary, Alberta, municipal","48014","Total, all violations","70961","22966","4748","-1.67","6904.84","2222.84","2340.43","3557.34","2638.44","27714","17899","20667","2768","2053"
"2007","Calgary, Alberta, municipal","48014","Total, all violations","67232","19569","4260","-7.53","6384.99","1832.65","1970.56","3444.98","2301.82","23829","15186","17856","2670","1784"
"2008","Calgary, Alberta, municipal","48014","Total, all violations","63787","19298","3826","-7.45","5909.55","1788.99","1898.53","3107.84","2111.62","23124","15245","17644","2399","1630"
"2009","Calgary, Alberta, municipal","48014","Total, all violations","61815","20165","4377","-5.53","5583.04","1818.51","1907.44","2911.59","2050.24","24542","15925","18183","2258","1590"
"2010","Calgary, Alberta, municipal","48014","Total, all violations","59636","18896","4765","-4.94","5307.12","1706.45","1765.57","2438.99","1750.38","23661","15158","17060","1902","1365"
"2011","Calgary, Alberta, municipal","48014","Total, all violations","55168","17553","4122","-8.94","4832.58","1580.4","1623.93","2125.13","1716.7","21675","14257","15922","1665","1345"
"2012","Calgary, Alberta, municipal","48014","Total, all violations","53461","16633","3445","-5.99","4543.06","1435.15","1468.95","1868.66","1376.11","20078","13371","14843","1472","1084"
"2013","Calgary, Alberta, municipal","48014","Total, all violations","53591","15451","3235","-3.27","4394.55","1336.78","1347.83","1482.94","1133.05","18686","12939","14113","1174","897"
"2014","Calgary, Alberta, municipal","48014","Total, all violations","54572","15836","3834","-1.48","4329.4","1313.57","1326","1482.94","1184.59","19670","13171","14349","1178","941"
"2015","Calgary, Alberta, municipal","48014","Total, all violations","68521","15808","3591","22.88","5319.98","1344.13","1339.37","1278.58","1175.15","19399","13765","14791","1026","943"
"2016","Calgary, Alberta, municipal","48014","Total, all violations","69574","16205","3446","-0.84","5275.49","1367.64","1337.53","952.76","977.16","19651","14325","15106","781","801"
"1998","Calgary, Alberta, municipal","48014","Total, all Criminal Code violations (including traffic)","69362","18443","4399","0","8250.77","0","0","0","0","22842","13861","17075","3214","1916"
"1999","Calgary, Alberta, municipal","48014","Total, all Criminal Code violations (including traffic)","68804","18501","5506","-3.28","7979.97","0","0","0","0","24007","13894","17226","3332","2107"
"2000","Calgary, Alberta, municipal","48014","Total, all Criminal Code violations (including traffic)","66128","19674","6105","-6.12","7491.98","0","0","0","0","25779","14703","17925","3222","2286"
"2001","Calgary, Alberta, municipal","48014","Total, all Criminal Code violations (including traffic)","66793","20116","5839","-1.18","7403.79","0","0","0","0","25955","15255","18224","2969","2258"
"2002","Calgary, Alberta, municipal","48014","Total, all Criminal Code violations (including traffic)","67452","21186","5899","-1.35","7304.13","0","0","0","0","27085","16137","19492","3355","2143"
"2003","Calgary, Alberta, municipal","48014","Total, all Criminal Code violations (including traffic)","69561","21236","6378","1.51","7414.78","0","0","0","0","27614","16273","18871","2598","2982"
"2004","Calgary, Alberta, municipal","48014","Total, all Criminal Code violations (including traffic)","67605","21065","5973","-5.71","6991.1","2216.91","2294.31","3062.6","3496.53","27038","16684","19006","2322","2651"
"2005","Calgary, Alberta, municipal","48014","Total, all Criminal Code violations (including traffic)","67741","20814","4979","-2.76","6798.36","2132.33","2226.56","3178.23","3008.15","25793","16588","19036","2448","2317"
"2006","Calgary, Alberta, municipal","48014","Total, all Criminal Code violations (including traffic)","68710","21147","4458","-1.66","6685.8","2037.8","2134.78","3138.37","2446.95","25605","16409","18851","2442","1904"
"2007","Calgary, Alberta, municipal","48014","Total, all Criminal Code violations (including traffic)","65307","18009","4003","-7.23","6202.17","1677.82","1800.72","3114.68","2162.47","22012","13903","16317","2414","1676"
"2008","Calgary, Alberta, municipal","48014","Total, all Criminal Code violations (including traffic)","62207","17999","3612","-7.08","5763.17","1667.3","1759.08","2772.31","1998.91","21611","14208","16348","2140","1543"
"2009","Calgary, Alberta, municipal","48014","Total, all Criminal Code violations (including traffic)","59555","18317","4065","-6.67","5378.92","1660.01","1735.19","2584.07","1896.79","22382","14537","16541","2004","1471"
"2010","Calgary, Alberta, municipal","48014","Total, all Criminal Code violations (including traffic)","57439","17141","4345","-4.97","5111.6","1547.15","1589.63","2073.53","1567.01","21486","13743","15360","1617","1222"
"2011","Calgary, Alberta, municipal","48014","Total, all Criminal Code violations (including traffic)","53345","16196","3719","-8.58","4672.89","1459.02","1491.04","1859.65","1567.37","19915","13162","14619","1457","1228"
"2012","Calgary, Alberta, municipal","48014","Total, all Criminal Code violations (including traffic)","51699","15244","3061","-5.98","4393.32","1318.16","1342.17","1626.19","1175.53","18305","12281","13562","1281","926"
"2013","Calgary, Alberta, municipal","48014","Total, all Criminal Code violations (including traffic)","51981","14230","2890","-2.98","4262.53","1226.23","1228.16","1251.78","975.15","17120","11869","12860","991","772"
"2014","Calgary, Alberta, municipal","48014","Total, all Criminal Code violations (including traffic)","52871","14493","3492","-1.6","4194.45","1199.98","1202.73","1237.46","1051.15","17985","12032","13015","983","835"
"2015","Calgary, Alberta, municipal","48014","Total, all Criminal Code violations (including traffic)","67182","14663","3405","24.36","5216.02","1236.13","1226","1096.64","1115.33","18068","12659","13539","880","895"
"2016","Calgary, Alberta, municipal","48014","Total, all Criminal Code violations (including traffic)","68271","15127","3235","-0.75","5176.68","1264.34","1233.31","836.87","908.85","18362","13243","13929","686","745"
"1998","Calgary, Alberta, municipal","48014","Total, all Criminal Code violations (excluding traffic)","67107","16218","4392","0","7982.53","0","0","0","0","20610","11644","14858","3214","1916"
"1999","Calgary, Alberta, municipal","48014","Total, all Criminal Code violations (excluding traffic)","66569","16289","5490","-3.28","7720.75","0","0","0","0","21779","11695","15027","3332","2107"
"2000","Calgary, Alberta, municipal","48014","Total, all Criminal Code violations (excluding traffic)","63824","17435","6067","-6.34","7230.95","0","0","0","0","23502","12471","15693","3222","2286"
"2001","Calgary, Alberta, municipal","48014","Total, all Criminal Code violations (excluding traffic)","64402","17773","5814","-1.28","7138.76","0","0","0","0","23587","12915","15884","2969","2258"
"2002","Calgary, Alberta, municipal","48014","Total, all Criminal Code violations (excluding traffic)","64931","18684","5881","-1.51","7031.14","0","0","0","0","24565","13649","17004","3355","2143"
"2003","Calgary, Alberta, municipal","48014","Total, all Criminal Code violations (excluding traffic)","67271","18955","6364","1.98","7170.68","0","0","0","0","25319","14015","16613","2598","2982"
"2004","Calgary, Alberta, municipal","48014","Total, all Criminal Code violations (excluding traffic)","65253","18762","5954","-5.9","6747.88","1912.62","2017.87","3062.6","3496.53","24716","14394","16716","2322","2651"
"2005","Calgary, Alberta, municipal","48014","Total, all Criminal Code violations (excluding traffic)","65510","18655","4910","-2.57","6574.46","1855.7","1974.85","3178.23","3008.15","23565","14436","16884","2448","2317"
"2006","Calgary, Alberta, municipal","48014","Total, all Criminal Code violations (excluding traffic)","66579","19088","4408","-1.46","6478.45","1783.83","1903.19","3138.37","2446.95","23496","14364","16806","2442","1904"
"2007","Calgary, Alberta, municipal","48014","Total, all Criminal Code violations (excluding traffic)","63271","16075","3920","-7.25","6008.81","1448.17","1587.95","3082.42","2161.18","19995","12000","14389","2389","1675"
"2008","Calgary, Alberta, municipal","48014","Total, all Criminal Code violations (excluding traffic)","60142","16005","3547","-7.27","5571.86","1437.29","1545.7","2742.51","1998.91","19552","12248","14365","2117","1543"
"2009","Calgary, Alberta, municipal","48014","Total, all Criminal Code violations (excluding traffic)","57394","16241","4006","-6.97","5183.74","1428.89","1519.93","2547.97","1896.79","20247","12513","14489","1976","1471"
"2010","Calgary, Alberta, municipal","48014","Total, all Criminal Code violations (excluding traffic)","55340","15098","4296","-5","4924.81","1321.99","1379.23","2031.21","1565.73","19394","11743","13327","1584","1221"
"2011","Calgary, Alberta, municipal","48014","Total, all Criminal Code violations (excluding traffic)","51184","14070","3690","-8.96","4483.59","1228.67","1277.16","1835.4","1566.09","17760","11084","12522","1438","1227"
"2012","Calgary, Alberta, municipal","48014","Total, all Criminal Code violations (excluding traffic)","49590","13168","3030","-6.01","4214.1","1098.88","1137.81","1598.26","1175.53","16198","10238","11497","1259","926"
"2013","Calgary, Alberta, municipal","48014","Total, all Criminal Code violations (excluding traffic)","50145","12434","2868","-2.42","4111.97","1045.02","1058.55","1223.99","973.89","15302","10115","11084","969","771"
"2014","Calgary, Alberta, municipal","48014","Total, all Criminal Code violations (excluding traffic)","51086","12728","3476","-1.44","4052.84","1026.44","1040.08","1212.28","1051.15","16204","10292","11255","963","835"
"2015","Calgary, Alberta, municipal","48014","Total, all Criminal Code violations (excluding traffic)","65515","13034","3395","25.51","5086.59","1079.6","1079.48","1077.95","1115.33","16429","11056","11921","865","895"
"2016","Calgary, Alberta, municipal","48014","Total, all Criminal Code violations (excluding traffic)","66812","13678","3223","-0.4","5066.06","1127.15","1105.37","827.11","908.85","16901","11806","12484","678","745"
"1998","Calgary, Alberta, municipal","48014","Total violent Criminal Code violations","7972","4334","1504","0","948.29","0","0","0","0","5838","3298","4077","779","310"
"1999","Calgary, Alberta, municipal","48014","Total violent Criminal Code violations","8959","4451","2110","9.57","1039.08","0","0","0","0","6561","3270","4067","797","431"
"2000","Calgary, Alberta, municipal","48014","Total violent Criminal Code violations","9688","4920","2436","5.63","1097.6","0","0","0","0","7356","3678","4567","889","532"
"2001","Calgary, Alberta, municipal","48014","Total violent Criminal Code violations","9729","4951","2453","-1.75","1078.43","0","0","0","0","7404","3619","4468","849","501"
"2002","Calgary, Alberta, municipal","48014","Total violent Criminal Code violations","9229","4810","2113","-7.33","999.37","0","0","0","0","6923","3506","4336","830","434"
"2003","Calgary, Alberta, municipal","48014","Total violent Criminal Code violations","9700","5054","2067","3.46","1033.96","0","0","0","0","7121","3647","4413","766","624"
"2004","Calgary, Alberta, municipal","48014","Total violent Criminal Code violations","9589","4784","2022","-4.1","991.61","477.03","514.37","885.01","675.3","6806","3590","4261","671","512"
"2005","Calgary, Alberta, municipal","48014","Total violent Criminal Code violations","9626","5095","1733","-2.58","966.05","488.09","525.76","906.21","572.55","6828","3797","4495","698","441"
"2006","Calgary, Alberta, municipal","48014","Total violent Criminal Code violations","9360","4875","1479","-5.72","910.77","443.23","477.21","828.93","487.08","6354","3569","4214","645","379"
"2007","Calgary, Alberta, municipal","48014","Total violent Criminal Code violations","8633","4260","1377","-9.98","819.87","375.08","410.64","790.93","432.24","5637","3108","3721","613","335"
"2008","Calgary, Alberta, municipal","48014","Total violent Criminal Code violations","8709","4588","1128","-1.59","806.85","402.98","429.76","725.46","396.41","5716","3434","3994","560","306"
"2009","Calgary, Alberta, municipal","48014","Total violent Criminal Code violations","9041","4539","1457","1.21","816.57","382.43","404.19","649.89","343","5996","3349","3853","504","266"
"2010","Calgary, Alberta, municipal","48014","Total violent Criminal Code violations","9368","4537","1734","2.09","833.68","378.15","398.86","634.75","344.95","6271","3359","3854","495","269"
"2011","Calgary, Alberta, municipal","48014","Total violent Criminal Code violations","8753","4092","1578","-8.03","766.74","339.76","363.71","639.45","325.47","5670","3065","3566","501","255"
"2012","Calgary, Alberta, municipal","48014","Total violent Criminal Code violations","8110","3807","1251","-10.12","689.18","307.08","321.24","488.75","247.55","5058","2861","3246","385","195"
"2013","Calgary, Alberta, municipal","48014","Total violent Criminal Code violations","8099","3580","1238","-3.63","664.13","293.72","302.93","415.58","253.89","4818","2843","3172","329","201"
"2014","Calgary, Alberta, municipal","48014","Total violent Criminal Code violations","8962","3610","1736","7.06","710.99","282.54","291.56","405.35","269.4","5346","2833","3155","322","214"
"2015","Calgary, Alberta, municipal","48014","Total violent Criminal Code violations","9641","4104","1732","5.28","748.53","315.21","323.55","429.93","316.53","5836","3228","3573","345","254"
"2016","Calgary, Alberta, municipal","48014","Total violent Criminal Code violations","9664","3889","1846","-2.1","732.78","298.73","298.21","291.56","261.06","5735","3129","3368","239","214"
"1998","Calgary, Alberta, municipal","48014","Homicide","19","17","2","0","2.26","0","0","0","0","19","13","18","5","0"
"1999","Calgary, Alberta, municipal","48014","Homicide","11","10","0","-43.55","1.28","0","0","0","0","10","11","11","0","0"
"2000","Calgary, Alberta, municipal","48014","Homicide","14","14","0","24.33","1.59","0","0","0","0","14","13","15","2","0"
"2001","Calgary, Alberta, municipal","48014","Homicide","14","11","0","-2.16","1.55","0","0","0","0","11","9","11","2","0"
"2002","Calgary, Alberta, municipal","48014","Homicide","15","12","0","4.67","1.62","0","0","0","0","12","11","12","1","0"
"2003","Calgary, Alberta, municipal","48014","Homicide","8","4","2","-47.5","0.85","0","0","0","0","6","4","4","0","0"
"2004","Calgary, Alberta, municipal","48014","Homicide","16","11","1","94.03","1.65","1.99","1.81","0","0","12","15","15","0","0"
"2005","Calgary, Alberta, municipal","48014","Homicide","24","14","0","45.57","2.41","2.06","1.87","0","0","14","16","16","0","0"
"2006","Calgary, Alberta, municipal","48014","Homicide","24","17","1","-3.04","2.34","2.98","2.83","1.29","0","18","24","25","1","0"
"2007","Calgary, Alberta, municipal","48014","Homicide","35","20","2","42.33","3.32","1.81","1.66","0","0","22","15","15","0","0"
"2008","Calgary, Alberta, municipal","48014","Homicide","33","13","8","-8.02","3.06","1.53","1.61","2.59","0","21","13","15","2","0"
"2009","Calgary, Alberta, municipal","48014","Homicide","24","20","1","-29.1","2.17","2.28","2.2","1.29","0","21","20","21","1","0"
"2010","Calgary, Alberta, municipal","48014","Homicide","15","7","1","-38.42","1.33","0.9","0.83","0","0","8","8","8","0","0"
"2011","Calgary, Alberta, municipal","48014","Homicide","13","10","0","-14.69","1.14","1.22","1.12","0","0","10","11","11","0","0"
"2012","Calgary, Alberta, municipal","48014","Homicide","18","9","2","34.32","1.53","1.5","1.39","0","0","11","14","14","0","0"
"2013","Calgary, Alberta, municipal","48014","Homicide","23","19","0","23.3","1.89","2.17","2.2","2.53","0","19","21","23","2","0"
"2014","Calgary, Alberta, municipal","48014","Homicide","32","24","0","34.6","2.54","1.8","2.03","5.04","0","24","18","22","4","0"
"2015","Calgary, Alberta, municipal","48014","Homicide","36","24","0","10.1","2.8","2.64","2.63","2.49","0","24","27","29","2","0"
"2016","Calgary, Alberta, municipal","48014","Homicide","30","19","0","-18.61","2.27","2.1","2.04","1.22","0","19","22","23","1","0"
"1998","Calgary, Alberta, municipal","48014","Murder, first degree","7","6","1","0","0.83","0","0","0","0","7","3","4","1","0"
"1999","Calgary, Alberta, municipal","48014","Murder, first degree","4","3","0","-44.28","0.46","0","0","0","0","3","2","2","0","0"
"2000","Calgary, Alberta, municipal","48014","Murder, first degree","5","5","0","22.11","0.57","0","0","0","0","5","6","6","0","0"
"2001","Calgary, Alberta, municipal","48014","Murder, first degree","4","2","0","-21.73","0.44","0","0","0","0","2","2","2","0","0"
"2002","Calgary, Alberta, municipal","48014","Murder, first degree","7","5","0","70.96","0.76","0","0","0","0","5","5","5","0","0"
"2003","Calgary, Alberta, municipal","48014","Murder, first degree","3","1","2","-57.81","0.32","0","0","0","0","3","1","1","0","0"
"2004","Calgary, Alberta, municipal","48014","Murder, first degree","3","2","0","-2.99","0.31","0.27","0.24","0","0","2","2","2","0","0"
"2005","Calgary, Alberta, municipal","48014","Murder, first degree","7","2","0","126.45","0.7","0.26","0.23","0","0","2","2","2","0","0"
"2006","Calgary, Alberta, municipal","48014","Murder, first degree","6","3","0","-16.89","0.58","0.87","0.79","0","0","3","7","7","0","0"
"2007","Calgary, Alberta, municipal","48014","Murder, first degree","5","0","0","-18.67","0.47","0","0","0","0","0","0","0","0","0"
"2008","Calgary, Alberta, municipal","48014","Murder, first degree","21","5","6","309.72","1.95","0.7","0.65","0","0","11","6","6","0","0"
"2009","Calgary, Alberta, municipal","48014","Murder, first degree","10","7","0","-53.58","0.9","0.69","0.73","1.29","0","7","6","7","1","0"
"2010","Calgary, Alberta, municipal","48014","Murder, first degree","6","2","0","-40.88","0.53","0.23","0.21","0","0","2","2","2","0","0"
"2011","Calgary, Alberta, municipal","48014","Murder, first degree","3","2","0","-50.78","0.26","0.33","0.31","0","0","2","3","3","0","0"
"2012","Calgary, Alberta, municipal","48014","Murder, first degree","7","1","1","126.36","0.59","0.32","0.3","0","0","2","3","3","0","0"
"2013","Calgary, Alberta, municipal","48014","Murder, first degree","11","8","0","51.64","0.9","1.24","1.24","1.26","0","8","12","13","1","0"
"2014","Calgary, Alberta, municipal","48014","Murder, first degree","17","10","0","49.52","1.35","0.5","0.46","0","0","10","5","5","0","0"
"2015","Calgary, Alberta, municipal","48014","Murder, first degree","16","8","0","-7.89","1.24","0.78","0.81","1.25","0","8","8","9","1","0"
"2016","Calgary, Alberta, municipal","48014","Murder, first degree","15","7","0","-8.44","1.14","0.76","0.71","0","0","7","8","8","0","0"
"1998","Calgary, Alberta, municipal","48014","Murder, second degree","9","8","1","0","1.07","0","0","0","0","9","7","11","4","0"
"1999","Calgary, Alberta, municipal","48014","Murder, second degree","5","5","0","-45.83","0.58","0","0","0","0","5","5","5","0","0"
"2000","Calgary, Alberta, municipal","48014","Murder, second degree","5","5","0","-2.32","0.57","0","0","0","0","5","3","5","2","0"
"2001","Calgary, Alberta, municipal","48014","Murder, second degree","9","8","0","76.11","1","0","0","0","0","8","6","8","2","0"
"2002","Calgary, Alberta, municipal","48014","Murder, second degree","4","3","0","-56.58","0.43","0","0","0","0","3","2","3","1","0"
"2003","Calgary, Alberta, municipal","48014","Murder, second degree","4","3","0","-1.56","0.43","0","0","0","0","3","3","3","0","0"
"2004","Calgary, Alberta, municipal","48014","Murder, second degree","11","7","1","166.79","1.14","1.06","0.97","0","0","8","8","8","0","0"
"2005","Calgary, Alberta, municipal","48014","Murder, second degree","14","11","0","23.52","1.41","1.67","1.52","0","0","11","13","13","0","0"
"2006","Calgary, Alberta, municipal","48014","Murder, second degree","17","13","1","17.73","1.65","1.99","1.93","1.29","0","14","16","17","1","0"
"2007","Calgary, Alberta, municipal","48014","Murder, second degree","23","13","2","32.05","2.18","1.45","1.32","0","0","15","12","12","0","0"
"2008","Calgary, Alberta, municipal","48014","Murder, second degree","10","7","1","-57.59","0.93","0.7","0.86","2.59","0","8","6","8","2","0"
"2009","Calgary, Alberta, municipal","48014","Murder, second degree","10","9","1","-2.51","0.9","1.14","1.05","0","0","10","10","10","0","0"
"2010","Calgary, Alberta, municipal","48014","Murder, second degree","9","5","1","-11.32","0.8","0.68","0.62","0","0","6","6","6","0","0"
"2011","Calgary, Alberta, municipal","48014","Murder, second degree","10","8","0","9.37","0.88","0.89","0.82","0","0","8","8","8","0","0"
"2012","Calgary, Alberta, municipal","48014","Murder, second degree","8","6","1","-22.39","0.68","0.86","0.79","0","0","7","8","8","0","0"
"2013","Calgary, Alberta, municipal","48014","Murder, second degree","12","11","0","44.74","0.98","0.93","0.96","1.26","0","11","9","10","1","0"
"2014","Calgary, Alberta, municipal","48014","Murder, second degree","13","12","0","4.81","1.03","1.1","1.39","5.04","0","12","11","15","4","0"
"2015","Calgary, Alberta, municipal","48014","Murder, second degree","15","11","0","12.92","1.16","1.27","1.27","1.25","0","11","13","14","1","0"
"2016","Calgary, Alberta, municipal","48014","Murder, second degree","9","7","0","-41.4","0.68","0.76","0.8","1.22","0","7","8","9","1","0"
"1998","Calgary, Alberta, municipal","48014","Manslaughter","3","3","0","0","0.36","0","0","0","0","3","3","3","0","0"
"1999","Calgary, Alberta, municipal","48014","Manslaughter","2","2","0","-35","0.23","0","0","0","0","2","4","4","0","0"
"2000","Calgary, Alberta, municipal","48014","Manslaughter","4","4","0","95.37","0.45","0","0","0","0","4","4","4","0","0"
"2001","Calgary, Alberta, municipal","48014","Manslaughter","1","1","0","-75.54","0.11","0","0","0","0","1","1","1","0","0"
"2002","Calgary, Alberta, municipal","48014","Manslaughter","4","4","0","290.76","0.43","0","0","0","0","4","4","4","0","0"
"2003","Calgary, Alberta, municipal","48014","Manslaughter","1","0","0","-75.39","0.11","0","0","0","0","0","0","0","0","0"
"2004","Calgary, Alberta, municipal","48014","Manslaughter","2","2","0","94.03","0.21","0.66","0.6","0","0","2","5","5","0","0"
"2005","Calgary, Alberta, municipal","48014","Manslaughter","3","1","0","45.57","0.3","0.13","0.12","0","0","1","1","1","0","0"
"2006","Calgary, Alberta, municipal","48014","Manslaughter","1","1","0","-67.68","0.1","0.12","0.11","0","0","1","1","1","0","0"
"2007","Calgary, Alberta, municipal","48014","Manslaughter","7","7","0","583.2","0.66","0.36","0.33","0","0","7","3","3","0","0"
"2008","Calgary, Alberta, municipal","48014","Manslaughter","2","1","1","-72.13","0.19","0.12","0.11","0","0","2","1","1","0","0"
"2009","Calgary, Alberta, municipal","48014","Manslaughter","4","4","0","94.98","0.36","0.46","0.42","0","0","4","4","4","0","0"
"2010","Calgary, Alberta, municipal","48014","Manslaughter","0","0","0","-100","0","0","0","0","0","0","0","0","0","0"
"2011","Calgary, Alberta, municipal","48014","Manslaughter","0","0","0","0","0","0","0","0","0","0","0","0","0","0"
"2012","Calgary, Alberta, municipal","48014","Manslaughter","3","2","0","0","0.25","0.32","0.3","0","0","2","3","3","0","0"
"2013","Calgary, Alberta, municipal","48014","Manslaughter","0","0","0","-100","0","0","0","0","0","0","0","0","0","0"
"2014","Calgary, Alberta, municipal","48014","Manslaughter","2","2","0","0","0.16","0.2","0.18","0","0","2","2","2","0","0"
"2015","Calgary, Alberta, municipal","48014","Manslaughter","5","5","0","144.66","0.39","0.59","0.54","0","0","5","6","6","0","0"
"2016","Calgary, Alberta, municipal","48014","Manslaughter","6","5","0","17.2","0.45","0.57","0.53","0","0","5","6","6","0","0"
"1998","Calgary, Alberta, municipal","48014","Infanticide","0","0","0","0","0","0","0","0","0","0","0","0","0","0"
"1999","Calgary, Alberta, municipal","48014","Infanticide","0","0","0","0","0","0","0","0","0","0","0","0","0","0"
"2000","Calgary, Alberta, municipal","48014","Infanticide","0","0","0","0","0","0","0","0","0","0","0","0","0","0"
"2001","Calgary, Alberta, municipal","48014","Infanticide","0","0","0","0","0","0","0","0","0","0","0","0","0","0"
"2002","Calgary, Alberta, municipal","48014","Infanticide","0","0","0","0","0","0","0","0","0","0","0","0","0","0"
"2003","Calgary, Alberta, municipal","48014","Infanticide","0","0","0","0","0","0","0","0","0","0","0","0","0","0"
"2004","Calgary, Alberta, municipal","48014","Infanticide","0","0","0","0","0","0","0","0","0","0","0","0","0","0"
"2005","Calgary, Alberta, municipal","48014","Infanticide","0","0","0","0","0","0","0","0","0","0","0","0","0","0"
"2006","Calgary, Alberta, municipal","48014","Infanticide","0","0","0","0","0","0","0","0","0","0","0","0","0","0"
"2007","Calgary, Alberta, municipal","48014","Infanticide","0","0","0","0","0","0","0","0","0","0","0","0","0","0"
"2008","Calgary, Alberta, municipal","48014","Infanticide","0","0","0","0","0","0","0","0","0","0","0","0","0","0"
"2009","Calgary, Alberta, municipal","48014","Infanticide","0","0","0","0","0","0","0","0","0","0","0","0","0","0"
"2010","Calgary, Alberta, municipal","48014","Infanticide","0","0","0","0","0","0","0","0","0","0","0","0","0","0"
"2011","Calgary, Alberta, municipal","48014","Infanticide","0","0","0","0","0","0","0","0","0","0","0","0","0","0"
"2012","Calgary, Alberta, municipal","48014","Infanticide","0","0","0","0","0","0","0","0","0","0","0","0","0","0"
"2013","Calgary, Alberta, municipal","48014","Infanticide","0","0","0","0","0","0","0","0","0","0","0","0","0","0"
"2014","Calgary, Alberta, municipal","48014","Infanticide","0","0","0","0","0","0","0","0","0","0","0","0","0","0"
"2015","Calgary, Alberta, municipal","48014","Infanticide","0","0","0","0","0","0","0","0","0","0","0","0","0","0"
"2016","Calgary, Alberta, municipal","48014","Infanticide","0","0","0","0","0","0","0","0","0","0","0","0","0","0"
"1998","Calgary, Alberta, municipal","48014","Total other violations causing death","3","2","0","0","0.36","0","0","0","0","2","1","2","1","0"
"1999","Calgary, Alberta, municipal","48014","Total other violations causing death","0","0","0","-100","0","0","0","0","0","0","0","0","0","0"
"2000","Calgary, Alberta, municipal","48014","Total other violations causing death","1","1","0","0","0.11","0","0","0","0","1","1","1","0","0"
"2001","Calgary, Alberta, municipal","48014","Total other violations causing death","1","1","0","-2.16","0.11","0","0","0","0","1","1","1","0","0"
"2002","Calgary, Alberta, municipal","48014","Total other violations causing death","2","2","0","95.38","0.22","0","0","0","0","2","2","2","0","0"
"2003","Calgary, Alberta, municipal","48014","Total other violations causing death","5","3","2","146.09","0.53","0","0","0","0","5","3","3","0","0"
"2004","Calgary, Alberta, municipal","48014","Total other violations causing death","3","0","0","-41.79","0.31","0","0","0","0","0","0","0","0","0"
"2005","Calgary, Alberta, municipal","48014","Total other violations causing death","1","1","0","-67.65","0.1","0.26","0.23","0","0","1","2","2","0","0"
"2006","Calgary, Alberta, municipal","48014","Total other violations causing death","3","2","0","190.87","0.29","0.25","0.23","0","0","2","2","2","0","0"
"2007","Calgary, Alberta, municipal","48014","Total other violations causing death","0","0","0","-100","0","0","0","0","0","0","0","0","0","0"
"2008","Calgary, Alberta, municipal","48014","Total other violations causing death","0","2","0","0","0","0.12","0.11","0","0","2","1","1","0","0"
"2009","Calgary, Alberta, municipal","48014","Total other violations causing death","1","1","0","0","0.09","0.11","0.1","0","0","1","1","1","0","0"
"2010","Calgary, Alberta, municipal","48014","Total other violations causing death","0","0","0","-100","0","0","0","0","0","0","0","0","0","0"
"2011","Calgary, Alberta, municipal","48014","Total other violations causing death","2","0","0","0","0.18","0","0","0","0","0","0","0","0","0"
"2012","Calgary, Alberta, municipal","48014","Total other violations causing death","0","2","0","-100","0","0.11","0.1","0","0","2","1","1","0","0"
"2013","Calgary, Alberta, municipal","48014","Total other violations causing death","4","0","0","0","0.33","0","0","0","0","0","0","0","0","0"
"2014","Calgary, Alberta, municipal","48014","Total other violations causing death","0","4","0","-100","0","0.3","0.28","0","0","4","3","3","0","0"
"2015","Calgary, Alberta, municipal","48014","Total other violations causing death","2","1","0","0","0.16","0.1","0.09","0","0","1","1","1","0","0"
"2016","Calgary, Alberta, municipal","48014","Total other violations causing death","1","2","0","-51.17","0.08","0.19","0.18","0","0","2","2","2","0","0"
"1998","Calgary, Alberta, municipal","48014","Criminal negligence causing death","3","2","0","0","0.36","0","0","0","0","2","1","2","1","0"
"1999","Calgary, Alberta, municipal","48014","Criminal negligence causing death","0","0","0","-100","0","0","0","0","0","0","0","0","0","0"
"2000","Calgary, Alberta, municipal","48014","Criminal negligence causing death","1","1","0","0","0.11","0","0","0","0","1","1","1","0","0"
"2001","Calgary, Alberta, municipal","48014","Criminal negligence causing death","1","1","0","-2.16","0.11","0","0","0","0","1","1","1","0","0"
"2002","Calgary, Alberta, municipal","48014","Criminal negligence causing death","2","2","0","95.38","0.22","0","0","0","0","2","2","2","0","0"
"2003","Calgary, Alberta, municipal","48014","Criminal negligence causing death","5","3","2","146.09","0.53","0","0","0","0","5","3","3","0","0"
"2004","Calgary, Alberta, municipal","48014","Criminal negligence causing death","3","0","0","-41.79","0.31","0","0","0","0","0","0","0","0","0"
"2005","Calgary, Alberta, municipal","48014","Criminal negligence causing death","1","1","0","-67.65","0.1","0.26","0.23","0","0","1","2","2","0","0"
"2006","Calgary, Alberta, municipal","48014","Criminal negligence causing death","3","2","0","190.87","0.29","0.25","0.23","0","0","2","2","2","0","0"
"2007","Calgary, Alberta, municipal","48014","Criminal negligence causing death","0","0","0","-100","0","0","0","0","0","0","0","0","0","0"
"2008","Calgary, Alberta, municipal","48014","Criminal negligence causing death","0","2","0","0","0","0.12","0.11","0","0","2","1","1","0","0"
"2009","Calgary, Alberta, municipal","48014","Criminal negligence causing death","1","1","0","0","0.09","0.11","0.1","0","0","1","1","1","0","0"
"2010","Calgary, Alberta, municipal","48014","Criminal negligence causing death","0","0","0","-100","0","0","0","0","0","0","0","0","0","0"
"2011","Calgary, Alberta, municipal","48014","Criminal negligence causing death","2","0","0","0","0.18","0","0","0","0","0","0","0","0","0"
"2012","Calgary, Alberta, municipal","48014","Criminal negligence causing death","0","2","0","-100","0","0.11","0.1","0","0","2","1","1","0","0"
"2013","Calgary, Alberta, municipal","48014","Criminal negligence causing death","4","0","0","0","0.33","0","0","0","0","0","0","0","0","0"
"2014","Calgary, Alberta, municipal","48014","Criminal negligence causing death","0","4","0","-100","0","0.3","0.28","0","0","4","3","3","0","0"
"2015","Calgary, Alberta, municipal","48014","Criminal negligence causing death","2","1","0","0","0.16","0.1","0.09","0","0","1","1","1","0","0"
"2016","Calgary, Alberta, municipal","48014","Criminal negligence causing death","1","2","0","-51.17","0.08","0.19","0.18","0","0","2","2","2","0","0"
"1998","Calgary, Alberta, municipal","48014","Other related violations causing death","0","0","0","0","0","0","0","0","0","0","0","0","0","0"
"1999","Calgary, Alberta, municipal","48014","Other related violations causing death","0","0","0","0","0","0","0","0","0","0","0","0","0","0"
"2000","Calgary, Alberta, municipal","48014","Other related violations causing death","0","0","0","0","0","0","0","0","0","0","0","0","0","0"
"2001","Calgary, Alberta, municipal","48014","Other related violations causing death","0","0","0","0","0","0","0","0","0","0","0","0","0","0"
"2002","Calgary, Alberta, municipal","48014","Other related violations causing death","0","0","0","0","0","0","0","0","0","0","0","0","0","0"
"2003","Calgary, Alberta, municipal","48014","Other related violations causing death","0","0","0","0","0","0","0","0","0","0","0","0","0","0"
"2004","Calgary, Alberta, municipal","48014","Other related violations causing death","0","0","0","0","0","0","0","0","0","0","0","0","0","0"
"2005","Calgary, Alberta, municipal","48014","Other related violations causing death","0","0","0","0","0","0","0","0","0","0","0","0","0","0"
"2006","Calgary, Alberta, municipal","48014","Other related violations causing death","0","0","0","0","0","0","0","0","0","0","0","0","0","0"
"2007","Calgary, Alberta, municipal","48014","Other related violations causing death","0","0","0","0","0","0","0","0","0","0","0","0","0","0"
"2008","Calgary, Alberta, municipal","48014","Other related violations causing death","0","0","0","0","0","0","0","0","0","0","0","0","0","0"
"2009","Calgary, Alberta, municipal","48014","Other related violations causing death","0","0","0","0","0","0","0","0","0","0","0","0","0","0"
"2010","Calgary, Alberta, municipal","48014","Other related violations causing death","0","0","0","0","0","0","0","0","0","0","0","0","0","0"
"2011","Calgary, Alberta, municipal","48014","Other related violations causing death","0","0","0","0","0","0","0","0","0","0","0","0","0","0"
"2012","Calgary, Alberta, municipal","48014","Other related violations causing death","0","0","0","0","0","0","0","0","0","0","0","0","0","0"
"2013","Calgary, Alberta, municipal","48014","Other related violations causing death","0","0","0","0","0","0","0","0","0","0","0","0","0","0"
"2014","Calgary, Alberta, municipal","48014","Other related violations causing death","0","0","0","0","0","0","0","0","0","0","0","0","0","0"
"2015","Calgary, Alberta, municipal","48014","Other related violations causing death","0","0","0","0","0","0","0","0","0","0","0","0","0","0"
"2016","Calgary, Alberta, municipal","48014","Other related violations causing death","0","0","0","0","0","0","0","0","0","0","0","0","0","0"
"1998","Calgary, Alberta, municipal","48014","Attempted murder","8","5","1","0","0.95","0","0","0","0","6","3","10","7","0"
"1999","Calgary, Alberta, municipal","48014","Attempted murder","1","1","0","-87.81","0.12","0","0","0","0","1","1","8","7","0"
"2000","Calgary, Alberta, municipal","48014","Attempted murder","5","4","0","388.42","0.57","0","0","0","0","4","2","2","0","0"
"2001","Calgary, Alberta, municipal","48014","Attempted murder","4","2","0","-21.73","0.44","0","0","0","0","2","2","2","0","0"
"2002","Calgary, Alberta, municipal","48014","Attempted murder","7","2","1","70.96","0.76","0","0","0","0","3","3","5","2","0"
"2003","Calgary, Alberta, municipal","48014","Attempted murder","8","8","0","12.5","0.85","0","0","0","0","8","7","7","0","0"
"2004","Calgary, Alberta, municipal","48014","Attempted murder","7","3","1","-15.11","0.72","0.53","0.48","0","0","4","4","4","0","0"
"2005","Calgary, Alberta, municipal","48014","Attempted murder","15","7","0","107.96","1.51","0.77","0.7","0","0","7","6","6","0","0"
"2006","Calgary, Alberta, municipal","48014","Attempted murder","18","10","0","16.35","1.75","0.87","0.79","0","0","10","7","7","0","0"
"2007","Calgary, Alberta, municipal","48014","Attempted murder","21","10","1","13.87","1.99","1.21","1.21","1.29","0","11","10","11","1","0"
"2008","Calgary, Alberta, municipal","48014","Attempted murder","35","19","0","62.59","3.24","1.41","1.4","1.3","0","19","12","13","1","0"
"2009","Calgary, Alberta, municipal","48014","Attempted murder","35","19","1","-2.51","3.16","1.37","1.36","1.29","0","20","12","13","1","0"
"2010","Calgary, Alberta, municipal","48014","Attempted murder","14","8","0","-60.59","1.25","0.79","0.83","1.28","0","8","7","8","1","0"
"2011","Calgary, Alberta, municipal","48014","Attempted murder","12","6","0","-15.63","1.05","0.55","0.51","0","0","6","5","5","0","0"
"2012","Calgary, Alberta, municipal","48014","Attempted murder","14","6","2","13.18","1.19","0.54","0.49","0","0","8","5","5","0","0"
"2013","Calgary, Alberta, municipal","48014","Attempted murder","9","8","0","-37.97","0.74","0.72","0.67","0","0","8","7","7","0","0"
"2014","Calgary, Alberta, municipal","48014","Attempted murder","7","4","0","-24.75","0.56","0.3","0.28","0","0","4","3","3","0","0"
"2015","Calgary, Alberta, municipal","48014","Attempted murder","22","13","0","207.58","1.71","1.37","1.27","0","0","13","14","14","0","0"
"2016","Calgary, Alberta, municipal","48014","Attempted murder","11","9","2","-51.17","0.83","0.95","0.97","1.22","0","11","10","11","1","0"
"1998","Calgary, Alberta, municipal","48014","Sexual assault, level 3, aggravated","3","3","0","0","0.36","0","0","0","0","3","4","4","0","0"
"1999","Calgary, Alberta, municipal","48014","Sexual assault, level 3, aggravated","1","0","0","-67.5","0.12","0","0","0","0","0","0","0","0","0"
"2000","Calgary, Alberta, municipal","48014","Sexual assault, level 3, aggravated","2","1","0","95.37","0.23","0","0","0","0","1","1","1","0","0"
"2001","Calgary, Alberta, municipal","48014","Sexual assault, level 3, aggravated","5","2","1","144.6","0.55","0","0","0","0","3","2","2","0","0"
"2002","Calgary, Alberta, municipal","48014","Sexual assault, level 3, aggravated","1","0","0","-80.46","0.11","0","0","0","0","0","0","0","0","0"
"2003","Calgary, Alberta, municipal","48014","Sexual assault, level 3, aggravated","2","1","0","96.87","0.21","0","0","0","0","1","1","1","0","0"
"2004","Calgary, Alberta, municipal","48014","Sexual assault, level 3, aggravated","1","0","1","-51.49","0.1","0","0","0","0","1","0","0","0","0"
"2005","Calgary, Alberta, municipal","48014","Sexual assault, level 3, aggravated","1","1","0","-2.95","0.1","0.13","0.12","0","0","1","1","1","0","0"
"2006","Calgary, Alberta, municipal","48014","Sexual assault, level 3, aggravated","3","2","0","190.87","0.29","0.25","0.23","0","0","2","2","2","0","0"
"2007","Calgary, Alberta, municipal","48014","Sexual assault, level 3, aggravated","4","1","0","30.13","0.38","0.12","0.11","0","0","1","1","1","0","0"
"2008","Calgary, Alberta, municipal","48014","Sexual assault, level 3, aggravated","1","1","0","-75.61","0.09","0.12","0.11","0","0","1","1","1","0","0"
"2009","Calgary, Alberta, municipal","48014","Sexual assault, level 3, aggravated","3","1","0","192.47","0.27","0.11","0.1","0","0","1","1","1","0","0"
"2010","Calgary, Alberta, municipal","48014","Sexual assault, level 3, aggravated","6","4","0","97.06","0.53","0.11","0.1","0","0","4","1","1","0","0"
"2011","Calgary, Alberta, municipal","48014","Sexual assault, level 3, aggravated","4","5","0","-34.38","0.35","0.55","0.51","0","0","5","5","5","0","0"
"2012","Calgary, Alberta, municipal","48014","Sexual assault, level 3, aggravated","0","0","0","-100","0","0","0","0","0","0","0","0","0","0"
"2013","Calgary, Alberta, municipal","48014","Sexual assault, level 3, aggravated","4","3","0","0","0.33","0.31","0.29","0","0","3","3","3","0","0"
"2014","Calgary, Alberta, municipal","48014","Sexual assault, level 3, aggravated","3","2","0","-27.44","0.24","0.3","0.28","0","0","2","3","3","0","0"
"2015","Calgary, Alberta, municipal","48014","Sexual assault, level 3, aggravated","2","1","0","-34.76","0.16","0.1","0.09","0","0","1","1","1","0","0"
"2016","Calgary, Alberta, municipal","48014","Sexual assault, level 3, aggravated","3","2","0","46.49","0.23","0.19","0.18","0","0","2","2","2","0","0"
"1998","Calgary, Alberta, municipal","48014","Sexual assault, level 2, weapon or bodily harm","13","7","1","0","1.55","0","0","0","0","8","5","7","2","0"
"1999","Calgary, Alberta, municipal","48014","Sexual assault, level 2, weapon or bodily harm","10","3","1","-25","1.16","0","0","0","0","4","3","3","0","1"
"2000","Calgary, Alberta, municipal","48014","Sexual assault, level 2, weapon or bodily harm","14","5","1","36.76","1.59","0","0","0","0","6","5","6","1","0"
"2001","Calgary, Alberta, municipal","48014","Sexual assault, level 2, weapon or bodily harm","6","2","2","-58.07","0.67","0","0","0","0","4","2","2","0","1"
"2002","Calgary, Alberta, municipal","48014","Sexual assault, level 2, weapon or bodily harm","9","4","1","46.54","0.97","0","0","0","0","5","4","4","0","0"
"2003","Calgary, Alberta, municipal","48014","Sexual assault, level 2, weapon or bodily harm","12","4","0","31.25","1.28","0","0","0","0","4","2","4","2","0"
"2004","Calgary, Alberta, municipal","48014","Sexual assault, level 2, weapon or bodily harm","9","5","1","-27.24","0.93","0.27","0.6","3.96","1.32","6","2","5","3","1"
"2005","Calgary, Alberta, municipal","48014","Sexual assault, level 2, weapon or bodily harm","10","6","0","7.83","1","0.9","0.82","0","0","6","7","7","0","0"
"2006","Calgary, Alberta, municipal","48014","Sexual assault, level 2, weapon or bodily harm","3","0","1","-70.91","0.29","0","0","0","0","1","0","0","0","0"
"2007","Calgary, Alberta, municipal","48014","Sexual assault, level 2, weapon or bodily harm","6","3","0","95.2","0.57","0.36","0.33","0","0","3","3","3","0","0"
"2008","Calgary, Alberta, municipal","48014","Sexual assault, level 2, weapon or bodily harm","5","2","2","-18.71","0.46","0.23","0.22","0","0","4","2","2","0","0"
"2009","Calgary, Alberta, municipal","48014","Sexual assault, level 2, weapon or bodily harm","4","1","1","-22.01","0.36","0.11","0.1","0","0","2","1","1","0","0"
"2010","Calgary, Alberta, municipal","48014","Sexual assault, level 2, weapon or bodily harm","8","5","1","97.06","0.71","0.79","0.72","0","0","6","7","7","0","0"
"2011","Calgary, Alberta, municipal","48014","Sexual assault, level 2, weapon or bodily harm","9","3","1","10.74","0.79","0.22","0.31","1.28","0","4","2","3","1","0"
"2012","Calgary, Alberta, municipal","48014","Sexual assault, level 2, weapon or bodily harm","1","3","0","-89.22","0.08","0.32","0.3","0","0","3","3","3","0","0"
"2013","Calgary, Alberta, municipal","48014","Sexual assault, level 2, weapon or bodily harm","7","4","0","575.48","0.57","0.41","0.38","0","0","4","4","4","0","0"
"2014","Calgary, Alberta, municipal","48014","Sexual assault, level 2, weapon or bodily harm","4","0","0","-44.72","0.32","0","0","0","0","0","0","0","0","0"
"2015","Calgary, Alberta, municipal","48014","Sexual assault, level 2, weapon or bodily harm","8","4","1","95.73","0.62","0.29","0.36","1.25","0","5","3","4","1","0"
"2016","Calgary, Alberta, municipal","48014","Sexual assault, level 2, weapon or bodily harm","4","2","0","-51.17","0.3","0.29","0.35","1.22","0","2","3","4","1","0"
"1998","Calgary, Alberta, municipal","48014","Sexual assault, level 1","580","215","128","0","68.99","0","0","0","0","343","143","177","34","24"
"1999","Calgary, Alberta, municipal","48014","Sexual assault, level 1","574","214","126","-3.51","66.57","0","0","0","0","340","159","186","27","20"
"2000","Calgary, Alberta, municipal","48014","Sexual assault, level 1","541","190","119","-7.93","61.29","0","0","0","0","309","133","174","41","24"
"2001","Calgary, Alberta, municipal","48014","Sexual assault, level 1","594","205","158","7.42","65.84","0","0","0","0","363","142","180","38","37"
"2002","Calgary, Alberta, municipal","48014","Sexual assault, level 1","520","170","123","-14.48","56.31","0","0","0","0","293","125","154","29","25"
"2003","Calgary, Alberta, municipal","48014","Sexual assault, level 1","490","151","105","-7.24","52.23","0","0","0","0","256","103","126","23","15"
"2004","Calgary, Alberta, municipal","48014","Sexual assault, level 1","504","155","74","-0.21","52.12","15.41","16.42","26.38","29.02","229","116","136","20","22"
"2005","Calgary, Alberta, municipal","48014","Sexual assault, level 1","524","142","84","0.9","52.59","13.63","14.39","22.07","29.86","226","106","123","17","23"
"2006","Calgary, Alberta, municipal","48014","Sexual assault, level 1","502","182","70","-7.11","48.85","16.02","17.67","34.7","19.28","252","129","156","27","15"
"2007","Calgary, Alberta, municipal","48014","Sexual assault, level 1","462","104","98","-10.18","43.88","10.74","10.93","12.9","29.68","202","89","99","10","23"
"2008","Calgary, Alberta, municipal","48014","Sexual assault, level 1","517","143","66","9.17","47.9","11.15","12.7","29.8","29.8","209","95","118","23","23"
"2009","Calgary, Alberta, municipal","48014","Sexual assault, level 1","521","127","66","-1.76","47.06","11.99","12.27","15.47","18.05","193","105","117","12","14"
"2010","Calgary, Alberta, municipal","48014","Sexual assault, level 1","588","143","74","11.2","52.33","11.48","12.94","29.49","17.95","217","102","125","23","14"
"2011","Calgary, Alberta, municipal","48014","Sexual assault, level 1","582","154","76","-2.57","50.98","13.86","14.48","21.7","29.36","230","125","142","17","23"
"2012","Calgary, Alberta, municipal","48014","Sexual assault, level 1","611","148","59","1.84","51.92","12.45","12.77","16.5","21.58","207","116","129","13","17"
"2013","Calgary, Alberta, municipal","48014","Sexual assault, level 1","619","168","45","-2.24","50.76","15.29","15.47","17.68","25.26","213","148","162","14","20"
"2014","Calgary, Alberta, municipal","48014","Sexual assault, level 1","575","146","55","-10.13","45.62","11.47","12.01","18.88","18.88","201","115","130","15","15"
"2015","Calgary, Alberta, municipal","48014","Sexual assault, level 1","656","171","71","11.65","50.93","14.65","14.85","17.45","42.37","242","150","164","14","34"
"2016","Calgary, Alberta, municipal","48014","Sexual assault, level 1","587","135","41","-12.61","44.51","10.12","10.45","14.64","13.42","176","106","118","12","11"
"1998","Calgary, Alberta, municipal","48014","Total sexual violations against children","0","0","0","0","0","0","0","0","0","0","0","0","0","0"
"1999","Calgary, Alberta, municipal","48014","Total sexual violations against children","1","1","0","0","0.12","0","0","0","0","1","1","1","0","0"
"2000","Calgary, Alberta, municipal","48014","Total sexual violations against children","0","0","0","-100","0","0","0","0","0","0","0","0","0","0"
"2001","Calgary, Alberta, municipal","48014","Total sexual violations against children","0","0","0","0","0","0","0","0","0","0","0","0","0","0"
"2002","Calgary, Alberta, municipal","48014","Total sexual violations against children","0","0","0","0","0","0","0","0","0","0","0","0","0","0"
"2003","Calgary, Alberta, municipal","48014","Total sexual violations against children","4","2","0","0","0.43","0","0","0","0","2","2","2","0","0"
"2004","Calgary, Alberta, municipal","48014","Total sexual violations against children","2","1","0","-51.49","0.21","0.13","0.12","0","0","1","1","1","0","0"
"2005","Calgary, Alberta, municipal","48014","Total sexual violations against children","3","0","0","45.57","0.3","0","0","0","0","0","0","0","0","0"
"2006","Calgary, Alberta, municipal","48014","Total sexual violations against children","4","4","0","29.28","0.39","0.25","0.34","1.29","0","4","2","3","1","0"
"2007","Calgary, Alberta, municipal","48014","Total sexual violations against children","23","3","5","461.2","2.18","0.36","0.33","0","2.58","8","3","3","0","2"
"2008","Calgary, Alberta, municipal","48014","Total sexual violations against children","52","23","4","120.55","4.82","1.99","1.94","1.3","0","27","17","18","1","0"
"2009","Calgary, Alberta, municipal","48014","Total sexual violations against children","64","16","9","19.99","5.78","1.6","1.57","1.29","2.58","25","14","15","1","2"
"2010","Calgary, Alberta, municipal","48014","Total sexual violations against children","71","31","14","9.31","6.32","1.91","2.07","3.85","1.28","45","17","20","3","1"
"2011","Calgary, Alberta, municipal","48014","Total sexual violations against children","68","25","9","-5.73","5.96","2.33","2.24","1.28","1.28","34","21","22","1","1"
"2012","Calgary, Alberta, municipal","48014","Total sexual violations against children","43","19","7","-38.66","3.65","1.29","1.29","1.27","2.54","26","12","13","1","2"
"2013","Calgary, Alberta, municipal","48014","Total sexual violations against children","71","17","10","59.33","5.82","1.24","1.24","1.26","6.32","27","12","13","1","5"
"2014","Calgary, Alberta, municipal","48014","Total sexual violations against children","69","13","12","-5.98","5.47","1.2","1.11","0","2.52","25","12","12","0","2"
"2015","Calgary, Alberta, municipal","48014","Total sexual violations against children","91","27","8","29.07","7.07","1.66","1.9","4.98","4.98","35","17","21","4","4"
"2016","Calgary, Alberta, municipal","48014","Total sexual violations against children","85","25","4","-8.78","6.45","1.72","1.95","4.88","2.44","29","18","22","4","2"
"1999","Calgary, Alberta, municipal","48014","Sexual interference","1","1","0","0","0.12","0","0","0","0","1","1","1","0","0"
"2000","Calgary, Alberta, municipal","48014","Sexual interference","0","0","0","-100","0","0","0","0","0","0","0","0","0","0"
"2001","Calgary, Alberta, municipal","48014","Sexual interference","0","0","0","0","0","0","0","0","0","0","0","0","0","0"
"2002","Calgary, Alberta, municipal","48014","Sexual interference","0","0","0","0","0","0","0","0","0","0","0","0","0","0"
"2003","Calgary, Alberta, municipal","48014","Sexual interference","1","0","0","0","0.11","0","0","0","0","0","0","0","0","0"
"2004","Calgary, Alberta, municipal","48014","Sexual interference","0","0","0","-100","0","0","0","0","0","0","0","0","0","0"
"2005","Calgary, Alberta, municipal","48014","Sexual interference","1","0","0","0","0.1","0","0","0","0","0","0","0","0","0"
"2006","Calgary, Alberta, municipal","48014","Sexual interference","3","3","0","190.87","0.29","0.12","0.23","1.29","0","3","1","2","1","0"
"2007","Calgary, Alberta, municipal","48014","Sexual interference","15","2","2","388","1.42","0.24","0.22","0","0","4","2","2","0","0"
"2008","Calgary, Alberta, municipal","48014","Sexual interference","33","12","2","114.62","3.06","0.94","0.97","1.3","0","14","8","9","1","0"
"2009","Calgary, Alberta, municipal","48014","Sexual interference","36","9","6","6.35","3.25","0.91","0.94","1.29","2.58","15","8","9","1","2"
"2010","Calgary, Alberta, municipal","48014","Sexual interference","43","10","7","17.69","3.83","0.9","1.03","2.56","0","17","8","10","2","0"
"2011","Calgary, Alberta, municipal","48014","Sexual interference","55","18","6","25.9","4.82","1.66","1.53","0","1.28","24","15","15","0","1"
"2012","Calgary, Alberta, municipal","48014","Sexual interference","27","12","2","-52.38","2.29","0.75","0.79","1.27","0","14","7","8","1","0"
"2013","Calgary, Alberta, municipal","48014","Sexual interference","45","10","4","60.83","3.69","0.72","0.76","1.26","3.79","14","7","8","1","3"
"2014","Calgary, Alberta, municipal","48014","Sexual interference","38","4","7","-18.3","3.01","0.4","0.37","0","1.26","11","4","4","0","1"
"2015","Calgary, Alberta, municipal","48014","Sexual interference","42","11","6","8.17","3.26","0.68","0.91","3.74","3.74","17","7","10","3","3"
"2016","Calgary, Alberta, municipal","48014","Sexual interference","41","8","2","-4.66","3.11","0.67","0.71","1.22","0","10","7","8","1","0"
"2003","Calgary, Alberta, municipal","48014","Invitation to sexual touching","1","0","0","0","0.11","0","0","0","0","0","0","0","0","0"
"2004","Calgary, Alberta, municipal","48014","Invitation to sexual touching","1","1","0","-2.99","0.1","0.13","0.12","0","0","1","1","1","0","0"
"2005","Calgary, Alberta, municipal","48014","Invitation to sexual touching","1","0","0","-2.95","0.1","0","0","0","0","0","0","0","0","0"
"2006","Calgary, Alberta, municipal","48014","Invitation to sexual touching","1","1","0","-3.04","0.1","0.12","0.11","0","0","1","1","1","0","0"
"2007","Calgary, Alberta, municipal","48014","Invitation to sexual touching","2","0","1","95.2","0.19","0","0","0","1.29","1","0","0","0","1"
"2008","Calgary, Alberta, municipal","48014","Invitation to sexual touching","3","1","0","46.33","0.28","0.12","0.11","0","0","1","1","1","0","0"
"2009","Calgary, Alberta, municipal","48014","Invitation to sexual touching","9","2","0","192.47","0.81","0.11","0.1","0","0","2","1","1","0","0"
"2010","Calgary, Alberta, municipal","48014","Invitation to sexual touching","12","8","4","31.37","1.07","0.45","0.52","1.28","1.28","12","4","5","1","1"
"2011","Calgary, Alberta, municipal","48014","Invitation to sexual touching","6","2","0","-50.78","0.53","0.11","0.2","1.28","0","2","1","2","1","0"
"2012","Calgary, Alberta, municipal","48014","Invitation to sexual touching","5","2","2","-19.16","0.42","0.11","0.1","0","2.54","4","1","1","0","2"
"2013","Calgary, Alberta, municipal","48014","Invitation to sexual touching","10","2","3","92.99","0.82","0.1","0.1","0","2.53","5","1","1","0","2"
"2014","Calgary, Alberta, municipal","48014","Invitation to sexual touching","11","2","4","6.42","0.87","0.2","0.18","0","1.26","6","2","2","0","1"
"2015","Calgary, Alberta, municipal","48014","Invitation to sexual touching","11","5","0","-2.13","0.85","0.29","0.36","1.25","0","5","3","4","1","0"
"2016","Calgary, Alberta, municipal","48014","Invitation to sexual touching","16","5","1","42.06","1.21","0.29","0.35","1.22","1.22","6","3","4","1","1"
"2003","Calgary, Alberta, municipal","48014","Sexual exploitation","1","1","0","0","0.11","0","0","0","0","1","1","1","0","0"
"2004","Calgary, Alberta, municipal","48014","Sexual exploitation","0","0","0","-100","0","0","0","0","0","0","0","0","0","0"
"2005","Calgary, Alberta, municipal","48014","Sexual exploitation","0","0","0","0","0","0","0","0","0","0","0","0","0","0"
"2006","Calgary, Alberta, municipal","48014","Sexual exploitation","0","0","0","0","0","0","0","0","0","0","0","0","0","0"
"2007","Calgary, Alberta, municipal","48014","Sexual exploitation","1","1","0","0","0.09","0.12","0.11","0","0","1","1","1","0","0"
"2008","Calgary, Alberta, municipal","48014","Sexual exploitation","6","4","0","485.31","0.56","0.47","0.43","0","0","4","4","4","0","0"
"2009","Calgary, Alberta, municipal","48014","Sexual exploitation","5","1","1","-18.76","0.45","0.11","0.1","0","0","2","1","1","0","0"
"2010","Calgary, Alberta, municipal","48014","Sexual exploitation","3","5","0","-40.88","0.27","0.11","0.1","0","0","5","1","1","0","0"
"2011","Calgary, Alberta, municipal","48014","Sexual exploitation","1","2","0","-67.19","0.09","0.22","0.2","0","0","2","2","2","0","0"
"2012","Calgary, Alberta, municipal","48014","Sexual exploitation","1","1","0","-2.99","0.08","0","0","0","0","1","0","0","0","0"
"2013","Calgary, Alberta, municipal","48014","Sexual exploitation","2","0","1","92.99","0.16","0","0","0","0","1","0","0","0","0"
"2014","Calgary, Alberta, municipal","48014","Sexual exploitation","0","1","0","-100","0","0.1","0.09","0","0","1","1","1","0","0"
"2015","Calgary, Alberta, municipal","48014","Sexual exploitation","0","0","0","0","0","0","0","0","0","0","0","0","0","0"
"2016","Calgary, Alberta, municipal","48014","Sexual exploitation","0","0","0","0","0","0","0","0","0","0","0","0","0","0"
"2005","Calgary, Alberta, municipal","48014","Making sexually explicit material available to children","0","0","0","0","0","0","0","0","0","0","0","0","0","0"
"2006","Calgary, Alberta, municipal","48014","Making sexually explicit material available to children","0","0","0","0","0","0","0","0","0","0","0","0","0","0"
"2007","Calgary, Alberta, municipal","48014","Making sexually explicit material available to children","0","0","0","0","0","0","0","0","0","0","0","0","0","0"
"2008","Calgary, Alberta, municipal","48014","Making sexually explicit material available to children","0","0","0","0","0","0","0","0","0","0","0","0","0","0"
"2009","Calgary, Alberta, municipal","48014","Making sexually explicit material available to children","0","0","0","0","0","0","0","0","0","0","0","0","0","0"
"2010","Calgary, Alberta, municipal","48014","Making sexually explicit material available to children","0","0","0","0","0","0","0","0","0","0","0","0","0","0"
"2011","Calgary, Alberta, municipal","48014","Making sexually explicit material available to children","0","0","0","0","0","0","0","0","0","0","0","0","0","0"
"2012","Calgary, Alberta, municipal","48014","Making sexually explicit material available to children","0","0","0","0","0","0","0","0","0","0","0","0","0","0"
"2013","Calgary, Alberta, municipal","48014","Making sexually explicit material available to children","0","0","0","0","0","0","0","0","0","0","0","0","0","0"
"2014","Calgary, Alberta, municipal","48014","Making sexually explicit material available to children","0","0","0","0","0","0","0","0","0","0","0","0","0","0"
"2015","Calgary, Alberta, municipal","48014","Making sexually explicit material available to children","8","1","1","0","0.62","0.1","0.09","0","1.25","2","1","1","0","1"
"2016","Calgary, Alberta, municipal","48014","Making sexually explicit material available to children","7","6","1","-14.55","0.53","0.38","0.44","1.22","1.22","7","4","5","1","1"
"2012","Calgary, Alberta, municipal","48014","Parent or guardian procuring sexual activity: person procured under the age of 16 years","0","0","0","0","0","0","0","0","0","0","0","0","0","0"
"2013","Calgary, Alberta, municipal","48014","Parent or guardian procuring sexual activity: person procured under the age of 16 years","0","0","0","0","0","0","0","0","0","0","0","0","0","0"
"2014","Calgary, Alberta, municipal","48014","Parent or guardian procuring sexual activity: person procured under the age of 16 years","0","0","0","0","0","0","0","0","0","0","0","0","0","0"
"2012","Calgary, Alberta, municipal","48014","Parent or guardian procuring sexual activity","0","0","0","0","0","0","0","0","0","0","0","0","0","0"
"2013","Calgary, Alberta, municipal","48014","Parent or guardian procuring sexual activity","0","0","0","0","0","0","0","0","0","0","0","0","0","0"
"2014","Calgary, Alberta, municipal","48014","Parent or guardian procuring sexual activity","0","0","0","0","0","0","0","0","0","0","0","0","0","0"
"2015","Calgary, Alberta, municipal","48014","Parent or guardian procuring sexual activity","0","0","0","0","0","0","0","0","0","0","0","0","0","0"
"2016","Calgary, Alberta, municipal","48014","Parent or guardian procuring sexual activity","0","0","0","0","0","0","0","0","0","0","0","0","0","0"
"2012","Calgary, Alberta, municipal","48014","Householder permitting illegal sexual activity: person under the age of 16 years","0","0","0","0","0","0","0","0","0","0","0","0","0","0"
"2013","Calgary, Alberta, municipal","48014","Householder permitting illegal sexual activity: person under the age of 16 years","0","0","0","0","0","0","0","0","0","0","0","0","0","0"
"2014","Calgary, Alberta, municipal","48014","Householder permitting illegal sexual activity: person under the age of 16 years","0","0","0","0","0","0","0","0","0","0","0","0","0","0"
"2012","Calgary, Alberta, municipal","48014","Householder permitting prohibited sexual activity","0","0","0","0","0","0","0","0","0","0","0","0","0","0"
"2013","Calgary, Alberta, municipal","48014","Householder permitting prohibited sexual activity","0","0","0","0","0","0","0","0","0","0","0","0","0","0"
"2014","Calgary, Alberta, municipal","48014","Householder permitting prohibited sexual activity","0","0","0","0","0","0","0","0","0","0","0","0","0","0"
"2015","Calgary, Alberta, municipal","48014","Householder permitting prohibited sexual activity","0","0","0","0","0","0","0","0","0","0","0","0","0","0"
"2016","Calgary, Alberta, municipal","48014","Householder permitting prohibited sexual activity","0","0","0","0","0","0","0","0","0","0","0","0","0","0"
"1998","Calgary, Alberta, municipal","48014","Luring a child via a computer","0","0","0","0","0","0","0","0","0","0","0","0","0","0"
"1999","Calgary, Alberta, municipal","48014","Luring a child via a computer","0","0","0","0","0","0","0","0","0","0","0","0","0","0"
"2000","Calgary, Alberta, municipal","48014","Luring a child via a computer","0","0","0","0","0","0","0","0","0","0","0","0","0","0"
"2001","Calgary, Alberta, municipal","48014","Luring a child via a computer","0","0","0","0","0","0","0","0","0","0","0","0","0","0"
"2002","Calgary, Alberta, municipal","48014","Luring a child via a computer","0","0","0","0","0","0","0","0","0","0","0","0","0","0"
"2003","Calgary, Alberta, municipal","48014","Luring a child via a computer","1","1","0","0","0.11","0","0","0","0","1","1","1","0","0"
"2004","Calgary, Alberta, municipal","48014","Luring a child via a computer","1","0","0","-2.99","0.1","0","0","0","0","0","0","0","0","0"
"2005","Calgary, Alberta, municipal","48014","Luring a child via a computer","1","0","0","-2.95","0.1","0","0","0","0","0","0","0","0","0"
"2006","Calgary, Alberta, municipal","48014","Luring a child via a computer","0","0","0","-100","0","0","0","0","0","0","0","0","0","0"
"2007","Calgary, Alberta, municipal","48014","Luring a child via a computer","5","0","2","0","0.47","0","0","0","1.29","2","0","0","0","1"
"2008","Calgary, Alberta, municipal","48014","Luring a child via a computer","10","6","2","95.1","0.93","0.47","0.43","0","0","8","4","4","0","0"
"2009","Calgary, Alberta, municipal","48014","Luring a child via a computer","14","4","2","36.48","1.26","0.46","0.42","0","0","6","4","4","0","0"
"2010","Calgary, Alberta, municipal","48014","Luring a child via a computer","13","8","3","-8.51","1.16","0.45","0.41","0","0","11","4","4","0","0"
"2011","Calgary, Alberta, municipal","48014","Luring a child via a computer","6","3","3","-54.57","0.53","0.33","0.31","0","0","6","3","3","0","0"
"2012","Calgary, Alberta, municipal","48014","Luring a child via a computer","10","4","3","61.68","0.85","0.43","0.4","0","0","7","4","4","0","0"
"2013","Calgary, Alberta, municipal","48014","Luring a child via a computer","14","5","2","35.1","1.15","0.41","0.38","0","0","7","4","4","0","0"
"2014","Calgary, Alberta, municipal","48014","Luring a child via a computer","20","6","1","38.21","1.59","0.5","0.46","0","0","7","5","5","0","0"
"2015","Calgary, Alberta, municipal","48014","Luring a child via a computer","30","10","1","46.8","2.33","0.59","0.54","0","0","11","6","6","0","0"
"2016","Calgary, Alberta, municipal","48014","Luring a child via a computer","21","6","0","-31.64","1.59","0.38","0.44","1.22","0","6","4","5","1","0"
"1998","Calgary, Alberta, municipal","48014","Assault, level 3, aggravated","55","43","1","0","6.54","0","0","0","0","44","44","53","9","0"
"1999","Calgary, Alberta, municipal","48014","Assault, level 3, aggravated","65","44","2","15.23","7.54","0","0","0","0","46","37","49","12","0"
"2000","Calgary, Alberta, municipal","48014","Assault, level 3, aggravated","65","56","1","-2.32","7.36","0","0","0","0","57","58","66","8","0"
"2001","Calgary, Alberta, municipal","48014","Assault, level 3, aggravated","81","54","2","21.92","8.98","0","0","0","0","56","48","57","9","0"
"2002","Calgary, Alberta, municipal","48014","Assault, level 3, aggravated","95","65","2","14.57","10.29","0","0","0","0","67","59","70","11","2"
"2003","Calgary, Alberta, municipal","48014","Assault, level 3, aggravated","116","93","2","20.2","12.36","0","0","0","0","95","91","114","23","0"
"2004","Calgary, Alberta, municipal","48014","Assault, level 3, aggravated","108","68","2","-9.68","11.17","9.04","10.5","25.06","2.64","70","68","87","19","2"
"2005","Calgary, Alberta, municipal","48014","Assault, level 3, aggravated","128","90","4","15.02","12.85","10.8","11.35","16.88","1.3","94","84","97","13","1"
"2006","Calgary, Alberta, municipal","48014","Assault, level 3, aggravated","104","73","5","-21.22","10.12","9.19","9.85","16.71","1.29","78","74","87","13","1"
"2007","Calgary, Alberta, municipal","48014","Assault, level 3, aggravated","131","84","4","22.94","12.44","9.41","10.04","16.77","2.58","88","78","91","13","2"
"2008","Calgary, Alberta, municipal","48014","Assault, level 3, aggravated","101","72","8","-24.79","9.36","7.63","8.82","22.02","0","80","65","82","17","0"
"2009","Calgary, Alberta, municipal","48014","Assault, level 3, aggravated","99","58","4","-4.44","8.94","6.39","6.5","7.74","1.29","62","56","62","6","1"
"2010","Calgary, Alberta, municipal","48014","Assault, level 3, aggravated","91","72","2","-9.43","8.1","7.66","8.18","14.11","0","74","68","79","11","0"
"2011","Calgary, Alberta, municipal","48014","Assault, level 3, aggravated","104","68","2","12.5","9.11","6.54","6.94","11.49","0","70","59","68","9","0"
"2012","Calgary, Alberta, municipal","48014","Assault, level 3, aggravated","91","61","3","-15.12","7.73","6.65","6.63","6.35","1.27","64","62","67","5","1"
"2013","Calgary, Alberta, municipal","48014","Assault, level 3, aggravated","102","78","1","8.16","8.36","8.27","7.93","3.79","0","79","80","83","3","0"
"2014","Calgary, Alberta, municipal","48014","Assault, level 3, aggravated","96","72","4","-8.94","7.62","7.48","7.49","7.55","0","76","75","81","6","0"
"2015","Calgary, Alberta, municipal","48014","Assault, level 3, aggravated","97","61","2","-1.12","7.53","6.05","6.34","9.97","0","63","62","70","8","0"
"2016","Calgary, Alberta, municipal","48014","Assault, level 3, aggravated","60","44","3","-39.59","4.55","3.82","3.63","1.22","1.22","47","40","41","1","1"
"1998","Calgary, Alberta, municipal","48014","Assault, level 2, weapon or bodily harm","1083","702","94","0","128.83","0","0","0","0","796","583","716","133","33"
"1999","Calgary, Alberta, municipal","48014","Assault, level 2, weapon or bodily harm","1057","672","131","-4.84","122.59","0","0","0","0","803","521","670","149","35"
"2000","Calgary, Alberta, municipal","48014","Assault, level 2, weapon or bodily harm","1166","643","184","7.76","132.1","0","0","0","0","827","525","647","122","59"
"2001","Calgary, Alberta, municipal","48014","Assault, level 2, weapon or bodily harm","1263","762","186","5.98","140","0","0","0","0","948","580","767","187","52"
"2002","Calgary, Alberta, municipal","48014","Assault, level 2, weapon or bodily harm","1154","677","146","-10.74","124.96","0","0","0","0","823","515","665","150","38"
"2003","Calgary, Alberta, municipal","48014","Assault, level 2, weapon or bodily harm","1397","788","194","19.17","148.91","0","0","0","0","982","554","732","178","98"
"2004","Calgary, Alberta, municipal","48014","Assault, level 2, weapon or bodily harm","1443","821","194","0.21","149.22","83.18","94.88","211.03","79.14","1015","626","786","160","60"
"2005","Calgary, Alberta, municipal","48014","Assault, level 2, weapon or bodily harm","1472","840","173","-1","147.73","78.28","91.93","229.8","72.7","1013","609","786","177","56"
"2006","Calgary, Alberta, municipal","48014","Assault, level 2, weapon or bodily harm","1582","796","159","4.2","153.94","73.27","82.9","182.49","84.82","955","590","732","142","66"
"2007","Calgary, Alberta, municipal","48014","Assault, level 2, weapon or bodily harm","1402","715","154","-13.5","133.15","63.6","74.82","194.83","65.8","869","527","678","151","51"
"2008","Calgary, Alberta, municipal","48014","Assault, level 2, weapon or bodily harm","1366","781","110","-4.95","126.55","69.35","76.29","152.87","57","891","591","709","118","44"
"2009","Calgary, Alberta, municipal","48014","Assault, level 2, weapon or bodily harm","1284","730","127","-8.36","115.97","60.52","66.93","139.26","36.1","857","530","638","108","28"
"2010","Calgary, Alberta, municipal","48014","Assault, level 2, weapon or bodily harm","1345","777","160","3.21","119.69","69.46","73.69","121.82","48.73","937","617","712","95","38"
"2011","Calgary, Alberta, municipal","48014","Assault, level 2, weapon or bodily harm","1235","654","142","-9.62","108.18","56.53","62.32","128.91","33.19","796","510","611","101","26"
"2012","Calgary, Alberta, municipal","48014","Assault, level 2, weapon or bodily harm","1194","605","98","-6.21","101.46","48.84","53.05","102.83","26.66","703","455","536","81","21"
"2013","Calgary, Alberta, municipal","48014","Assault, level 2, weapon or bodily harm","1311","631","134","5.95","107.5","54.34","56.44","82.1","39.16","765","526","591","65","31"
"2014","Calgary, Alberta, municipal","48014","Assault, level 2, weapon or bodily harm","1356","609","148","0.07","107.58","48.77","52.3","96.93","26.44","757","489","566","77","21"
"2015","Calgary, Alberta, municipal","48014","Assault, level 2, weapon or bodily harm","1496","763","172","7.97","116.15","56.34","59.13","94.71","33.65","935","577","653","76","27"
"2016","Calgary, Alberta, municipal","48014","Assault, level 2, weapon or bodily harm","1572","718","175","2.62","119.2","54.8","55.96","70.76","41.48","893","574","632","58","34"
"1998","Calgary, Alberta, municipal","48014","Assault, level 1","4266","2425","1130","0","507.45","0","0","0","0","3555","1908","2260","352","218"
"1999","Calgary, Alberta, municipal","48014","Assault, level 1","4539","2278","1511","3.74","526.44","0","0","0","0","3789","1731","2099","368","286"
"2000","Calgary, Alberta, municipal","48014","Assault, level 1","4944","2537","1728","6.4","560.13","0","0","0","0","4265","1994","2375","381","330"
"2001","Calgary, Alberta, municipal","48014","Assault, level 1","4715","2396","1634","-6.69","522.64","0","0","0","0","4030","1826","2199","373","284"
"2002","Calgary, Alberta, municipal","48014","Assault, level 1","4437","2312","1413","-8.07","480.47","0","0","0","0","3725","1745","2116","371","253"
"2003","Calgary, Alberta, municipal","48014","Assault, level 1","4439","2273","1372","-1.52","473.17","0","0","0","0","3645","1764","2005","241","372"
"2004","Calgary, Alberta, municipal","48014","Assault, level 1","4364","2195","1308","-4.63","451.29","226.02","241.43","394.37","407.55","3503","1701","2000","299","309"
"2005","Calgary, Alberta, municipal","48014","Assault, level 1","4195","2298","1097","-6.71","421","228.56","242.7","385.59","354.43","3395","1778","2075","297","273"
"2006","Calgary, Alberta, municipal","48014","Assault, level 1","3886","2155","929","-10.18","378.13","202.18","216.18","361.13","281.45","3084","1628","1909","281","219"
"2007","Calgary, Alberta, municipal","48014","Assault, level 1","3418","1781","803","-14.15","324.61","170.04","179.33","278.7","242.57","2584","1409","1625","216","188"
"2008","Calgary, Alberta, municipal","48014","Assault, level 1","3562","2027","665","1.66","330","189.28","198.85","304.44","217.64","2692","1613","1848","235","168"
"2009","Calgary, Alberta, municipal","48014","Assault, level 1","3641","1925","903","-0.35","328.85","176.2","182.63","255.31","198.58","2828","1543","1741","198","154"
"2010","Calgary, Alberta, municipal","48014","Assault, level 1","3800","1872","1078","2.83","338.17","163.24","170.24","250.05","200.04","2950","1450","1645","195","156"
"2011","Calgary, Alberta, municipal","48014","Assault, level 1","3729","1792","1026","-3.41","326.65","158.52","166.04","252.72","200.39","2818","1430","1628","198","157"
"2012","Calgary, Alberta, municipal","48014","Assault, level 1","3498","1628","880","-9","297.26","144.26","146.57","173.92","158.68","2508","1344","1481","137","125"
"2013","Calgary, Alberta, municipal","48014","Assault, level 1","3431","1542","841","-5.35","281.35","129.14","133.23","183.16","135.16","2383","1250","1395","145","107"
"2014","Calgary, Alberta, municipal","48014","Assault, level 1","4176","1616","1297","17.75","331.3","134.04","135.66","156.1","176.24","2913","1344","1468","124","140"
"2015","Calgary, Alberta, municipal","48014","Assault, level 1","4208","1740","1273","-1.38","326.71","143.35","143.62","147.05","184.44","3013","1468","1586","118","148"
"2016","Calgary, Alberta, municipal","48014","Assault, level 1","4527","1703","1429","5.07","343.26","136.72","135.65","121.99","165.91","3132","1432","1532","100","136"
"1998","Calgary, Alberta, municipal","48014","Total assaults against a peace officer","212","209","2","0","25.22","0","0","0","0","211","174","198","24","1"
"1999","Calgary, Alberta, municipal","48014","Total assaults against a peace officer","212","208","2","-2.5","24.59","0","0","0","0","210","166","181","15","0"
"2000","Calgary, Alberta, municipal","48014","Total assaults against a peace officer","256","242","7","17.96","29","0","0","0","0","249","195","207","12","0"
"2001","Calgary, Alberta, municipal","48014","Total assaults against a peace officer","318","308","6","21.53","35.25","0","0","0","0","314","251","274","23","16"
"2002","Calgary, Alberta, municipal","48014","Total assaults against a peace officer","419","407","9","28.72","45.37","0","0","0","0","416","329","356","27","2"
"2003","Calgary, Alberta, municipal","48014","Total assaults against a peace officer","438","423","12","2.9","46.69","0","0","0","0","435","332","362","30","4"
"2004","Calgary, Alberta, municipal","48014","Total assaults against a peace officer","405","384","20","-10.3","41.88","41.72","42.01","44.84","5.28","404","314","348","34","4"
"2005","Calgary, Alberta, municipal","48014","Total assaults against a peace officer","457","440","13","9.51","45.86","44.61","44.1","38.95","0","453","347","377","30","0"
"2006","Calgary, Alberta, municipal","48014","Total assaults against a peace officer","447","433","13","-5.16","43.5","42.47","41.9","35.98","0","446","342","370","28","0"
"2007","Calgary, Alberta, municipal","48014","Total assaults against a peace officer","428","408","15","-6.55","40.65","34.76","34.21","28.39","2.58","423","288","310","22","2"
"2008","Calgary, Alberta, municipal","48014","Total assaults against a peace officer","417","403","13","-4.95","38.63","32.39","32.6","34.98","6.48","416","276","303","27","5"
"2009","Calgary, Alberta, municipal","48014","Total assaults against a peace officer","492","468","17","15.02","44.44","37.11","38.08","49","6.45","485","325","363","38","5"
"2010","Calgary, Alberta, municipal","48014","Total assaults against a peace officer","472","441","25","-5.47","42","32.99","32.08","21.8","5.13","466","293","310","17","4"
"2011","Calgary, Alberta, municipal","48014","Total assaults against a peace officer","356","337","16","-25.76","31.18","24.94","24.38","17.87","2.55","353","225","239","14","2"
"2012","Calgary, Alberta, municipal","48014","Total assaults against a peace officer","300","275","20","-18.25","25.49","19.64","20.68","33.01","1.27","295","183","209","26","1"
"2013","Calgary, Alberta, municipal","48014","Total assaults against a peace officer","272","249","17","-12.51","22.3","19.42","19.48","20.21","3.79","266","188","204","16","3"
"2014","Calgary, Alberta, municipal","48014","Total assaults against a peace officer","241","219","15","-14.28","19.12","14.36","14.23","12.59","1.26","234","144","154","10","1"
"2015","Calgary, Alberta, municipal","48014","Total assaults against a peace officer","287","270","11","16.54","22.28","17.38","17.02","12.46","2.49","281","178","188","10","2"
"2016","Calgary, Alberta, municipal","48014","Total assaults against a peace officer","291","274","13","-0.98","22.07","20.34","20.01","15.86","1.22","287","213","226","13","1"
"1998","Calgary, Alberta, municipal","48014","Total other assaults","8","1","1","0","0.95","0","0","0","0","2","3","3","0","0"
"1999","Calgary, Alberta, municipal","48014","Total other assaults","5","2","2","-39.06","0.58","0","0","0","0","4","1","3","2","3"
"2000","Calgary, Alberta, municipal","48014","Total other assaults","8","3","1","56.29","0.91","0","0","0","0","4","1","2","1","0"
"2001","Calgary, Alberta, municipal","48014","Total other assaults","7","6","1","-14.39","0.78","0","0","0","0","7","2","6","4","0"
"2002","Calgary, Alberta, municipal","48014","Total other assaults","7","5","0","-2.31","0.76","0","0","0","0","5","4","6","2","0"
"2003","Calgary, Alberta, municipal","48014","Total other assaults","8","5","1","12.5","0.85","0","0","0","0","6","2","2","0","1"
"2004","Calgary, Alberta, municipal","48014","Total other assaults","19","14","0","130.41","1.96","1.33","1.21","0","0","14","10","10","0","0"
"2005","Calgary, Alberta, municipal","48014","Total other assaults","14","12","0","-28.49","1.41","1.03","0.94","0","0","12","8","8","0","0"
"2006","Calgary, Alberta, municipal","48014","Total other assaults","12","6","1","-16.89","1.17","0.37","0.57","2.57","1.29","7","3","5","2","1"
"2007","Calgary, Alberta, municipal","48014","Total other assaults","9","4","0","-26.8","0.85","0.12","0.22","1.29","0","4","1","2","1","0"
"2008","Calgary, Alberta, municipal","48014","Total other assaults","9","6","1","-2.45","0.83","0.59","0.54","0","0","7","5","5","0","0"
"2009","Calgary, Alberta, municipal","48014","Total other assaults","10","2","2","8.32","0.9","0.23","0.21","0","0","4","2","2","0","0"
"2010","Calgary, Alberta, municipal","48014","Total other assaults","8","4","1","-21.18","0.71","0.34","0.41","1.28","0","5","3","4","1","0"
"2011","Calgary, Alberta, municipal","48014","Total other assaults","4","1","0","-50.78","0.35","0.11","0.1","0","0","1","1","1","0","0"
"2012","Calgary, Alberta, municipal","48014","Total other assaults","6","7","0","45.52","0.51","0.21","0.2","0","0","7","2","2","0","0"
"2013","Calgary, Alberta, municipal","48014","Total other assaults","7","4","3","12.58","0.57","0.31","0.29","0","1.26","7","3","3","0","1"
"2014","Calgary, Alberta, municipal","48014","Total other assaults","4","3","0","-44.72","0.32","0.1","0.09","0","0","3","1","1","0","0"
"2015","Calgary, Alberta, municipal","48014","Total other assaults","9","7","1","120.2","0.7","0.49","0.54","1.25","0","8","5","6","1","0"
"2016","Calgary, Alberta, municipal","48014","Total other assaults","6","3","2","-34.89","0.45","0.19","0.18","0","1.22","5","2","2","0","1"
"1998","Calgary, Alberta, municipal","48014","Unlawfully causing bodily harm","3","1","0","0","0.36","0","0","0","0","1","3","3","0","0"
"1999","Calgary, Alberta, municipal","48014","Unlawfully causing bodily harm","0","0","0","-100","0","0","0","0","0","0","0","0","0","0"
"2000","Calgary, Alberta, municipal","48014","Unlawfully causing bodily harm","1","1","0","0","0.11","0","0","0","0","1","1","1","0","0"
"2001","Calgary, Alberta, municipal","48014","Unlawfully causing bodily harm","0","0","0","-100","0","0","0","0","0","0","0","0","0","0"
"2002","Calgary, Alberta, municipal","48014","Unlawfully causing bodily harm","2","2","0","0","0.22","0","0","0","0","2","3","3","0","0"
"2003","Calgary, Alberta, municipal","48014","Unlawfully causing bodily harm","0","0","0","-100","0","0","0","0","0","0","0","0","0","0"
"2004","Calgary, Alberta, municipal","48014","Unlawfully causing bodily harm","0","0","0","0","0","0","0","0","0","0","0","0","0","0"
"2005","Calgary, Alberta, municipal","48014","Unlawfully causing bodily harm","4","4","0","0","0.4","0.51","0.47","0","0","4","4","4","0","0"
"2006","Calgary, Alberta, municipal","48014","Unlawfully causing bodily harm","0","0","0","-100","0","0","0","0","0","0","0","0","0","0"
"2007","Calgary, Alberta, municipal","48014","Unlawfully causing bodily harm","0","0","0","0","0","0","0","0","0","0","0","0","0","0"
"2008","Calgary, Alberta, municipal","48014","Unlawfully causing bodily harm","1","1","0","0","0.09","0.12","0.11","0","0","1","1","1","0","0"
"2009","Calgary, Alberta, municipal","48014","Unlawfully causing bodily harm","2","1","0","94.98","0.18","0.11","0.1","0","0","1","1","1","0","0"
"2010","Calgary, Alberta, municipal","48014","Unlawfully causing bodily harm","1","2","0","-50.73","0.09","0.23","0.21","0","0","2","2","2","0","0"
"2011","Calgary, Alberta, municipal","48014","Unlawfully causing bodily harm","0","0","0","-100","0","0","0","0","0","0","0","0","0","0"
"2012","Calgary, Alberta, municipal","48014","Unlawfully causing bodily harm","2","1","0","0","0.17","0","0","0","0","1","0","0","0","0"
"2013","Calgary, Alberta, municipal","48014","Unlawfully causing bodily harm","0","1","0","-100","0","0.1","0.1","0","0","1","1","1","0","0"
"2014","Calgary, Alberta, municipal","48014","Unlawfully causing bodily harm","0","0","0","0","0","0","0","0","0","0","0","0","0","0"
"2015","Calgary, Alberta, municipal","48014","Unlawfully causing bodily harm","0","0","0","0","0","0","0","0","0","0","0","0","0","0"
"2016","Calgary, Alberta, municipal","48014","Unlawfully causing bodily harm","0","0","0","0","0","0","0","0","0","0","0","0","0","0"
"1998","Calgary, Alberta, municipal","48014","Criminal negligence causing bodily harm","0","0","0","0","0","0","0","0","0","0","0","0","0","0"
"1999","Calgary, Alberta, municipal","48014","Criminal negligence causing bodily harm","1","1","0","0","0.12","0","0","0","0","1","1","1","0","0"
"2000","Calgary, Alberta, municipal","48014","Criminal negligence causing bodily harm","1","1","0","-2.32","0.11","0","0","0","0","1","0","1","1","0"
"2001","Calgary, Alberta, municipal","48014","Criminal negligence causing bodily harm","4","4","0","291.36","0.44","0","0","0","0","4","1","5","4","0"
"2002","Calgary, Alberta, municipal","48014","Criminal negligence causing bodily harm","0","0","0","-100","0","0","0","0","0","0","0","0","0","0"
"2003","Calgary, Alberta, municipal","48014","Criminal negligence causing bodily harm","1","1","0","0","0.11","0","0","0","0","1","0","0","0","0"
"2004","Calgary, Alberta, municipal","48014","Criminal negligence causing bodily harm","14","11","0","1258.2","1.45","1.06","0.97","0","0","11","8","8","0","0"
"2005","Calgary, Alberta, municipal","48014","Criminal negligence causing bodily harm","5","5","0","-65.34","0.5","0.39","0.35","0","0","5","3","3","0","0"
"2006","Calgary, Alberta, municipal","48014","Criminal negligence causing bodily harm","6","5","0","16.35","0.58","0.25","0.45","2.57","0","5","2","4","2","0"
"2007","Calgary, Alberta, municipal","48014","Criminal negligence causing bodily harm","3","1","0","-51.2","0.28","0.12","0.22","1.29","0","1","1","2","1","0"
"2008","Calgary, Alberta, municipal","48014","Criminal negligence causing bodily harm","5","4","0","62.59","0.46","0.35","0.32","0","0","4","3","3","0","0"
"2009","Calgary, Alberta, municipal","48014","Criminal negligence causing bodily harm","2","1","0","-61","0.18","0.11","0.1","0","0","1","1","1","0","0"
"2010","Calgary, Alberta, municipal","48014","Criminal negligence causing bodily harm","1","0","1","-50.73","0.09","0","0","0","0","1","0","0","0","0"
"2011","Calgary, Alberta, municipal","48014","Criminal negligence causing bodily harm","2","0","0","96.87","0.18","0","0","0","0","0","0","0","0","0"
"2012","Calgary, Alberta, municipal","48014","Criminal negligence causing bodily harm","3","5","0","45.52","0.25","0.11","0.1","0","0","5","1","1","0","0"
"2013","Calgary, Alberta, municipal","48014","Criminal negligence causing bodily harm","3","3","0","-3.5","0.25","0.21","0.19","0","0","3","2","2","0","0"
"2014","Calgary, Alberta, municipal","48014","Criminal negligence causing bodily harm","3","3","0","-3.25","0.24","0.1","0.09","0","0","3","1","1","0","0"
"2015","Calgary, Alberta, municipal","48014","Criminal negligence causing bodily harm","0","0","0","-100","0","0","0","0","0","0","0","0","0","0"
"2016","Calgary, Alberta, municipal","48014","Criminal negligence causing bodily harm","2","1","1","0","0.15","0","0","0","1.22","2","0","0","0","1"
"1998","Calgary, Alberta, municipal","48014","Other assaults","5","0","1","0","0.59","0","0","0","0","1","0","0","0","0"
"1999","Calgary, Alberta, municipal","48014","Other assaults","4","1","2","-22","0.46","0","0","0","0","3","0","2","2","3"
"2000","Calgary, Alberta, municipal","48014","Other assaults","6","1","1","46.53","0.68","0","0","0","0","2","0","0","0","0"
"2001","Calgary, Alberta, municipal","48014","Other assaults","3","2","1","-51.08","0.33","0","0","0","0","3","1","1","0","0"
"2002","Calgary, Alberta, municipal","48014","Other assaults","5","3","0","62.82","0.54","0","0","0","0","3","1","3","2","0"
"2003","Calgary, Alberta, municipal","48014","Other assaults","7","4","1","37.81","0.75","0","0","0","0","5","2","2","0","1"
"2004","Calgary, Alberta, municipal","48014","Other assaults","5","3","0","-30.7","0.52","0.27","0.24","0","0","3","2","2","0","0"
"2005","Calgary, Alberta, municipal","48014","Other assaults","5","3","0","-2.95","0.5","0.13","0.12","0","0","3","1","1","0","0"
"2006","Calgary, Alberta, municipal","48014","Other assaults","6","1","1","16.35","0.58","0.12","0.11","0","1.29","2","1","1","0","1"
"2007","Calgary, Alberta, municipal","48014","Other assaults","6","3","0","-2.4","0.57","0","0","0","0","3","0","0","0","0"
"2008","Calgary, Alberta, municipal","48014","Other assaults","3","1","1","-51.22","0.28","0.12","0.11","0","0","2","1","1","0","0"
"2009","Calgary, Alberta, municipal","48014","Other assaults","6","0","2","94.98","0.54","0","0","0","0","2","0","0","0","0"
"2010","Calgary, Alberta, municipal","48014","Other assaults","6","2","0","-1.47","0.53","0.11","0.21","1.28","0","2","1","2","1","0"
"2011","Calgary, Alberta, municipal","48014","Other assaults","2","1","0","-67.19","0.18","0.11","0.1","0","0","1","1","1","0","0"
"2012","Calgary, Alberta, municipal","48014","Other assaults","1","1","0","-51.49","0.08","0.11","0.1","0","0","1","1","1","0","0"
"2013","Calgary, Alberta, municipal","48014","Other assaults","4","0","3","285.99","0.33","0","0","0","1.26","3","0","0","0","1"
"2014","Calgary, Alberta, municipal","48014","Other assaults","1","0","0","-75.81","0.08","0","0","0","0","0","0","0","0","0"
"2015","Calgary, Alberta, municipal","48014","Other assaults","9","7","1","780.79","0.7","0.49","0.54","1.25","0","8","5","6","1","0"
"2016","Calgary, Alberta, municipal","48014","Other assaults","4","2","1","-56.59","0.3","0.19","0.18","0","0","3","2","2","0","0"
"1998","Calgary, Alberta, municipal","48014","Total firearms, use of, discharge, pointing","11","2","3","0","1.31","0","0","0","0","5","2","2","0","2"
"1999","Calgary, Alberta, municipal","48014","Total firearms, use of, discharge, pointing","26","14","2","130.46","3.02","0","0","0","0","16","7","7","0","2"
"2000","Calgary, Alberta, municipal","48014","Total firearms, use of, discharge, pointing","10","2","1","-62.43","1.13","0","0","0","0","3","0","7","7","0"
"2001","Calgary, Alberta, municipal","48014","Total firearms, use of, discharge, pointing","14","4","3","36.97","1.55","0","0","0","0","7","3","9","6","2"
"2002","Calgary, Alberta, municipal","48014","Total firearms, use of, discharge, pointing","9","2","2","-37.2","0.97","0","0","0","0","4","0","2","2","0"
"2003","Calgary, Alberta, municipal","48014","Total firearms, use of, discharge, pointing","11","8","2","20.31","1.17","0","0","0","0","10","5","7","2","3"
"2004","Calgary, Alberta, municipal","48014","Total firearms, use of, discharge, pointing","18","8","3","58.75","1.86","0.93","0.85","0","2.64","11","7","7","0","2"
"2005","Calgary, Alberta, municipal","48014","Total firearms, use of, discharge, pointing","38","11","8","104.88","3.81","0.39","0.7","3.89","1.3","19","3","6","3","1"
"2006","Calgary, Alberta, municipal","48014","Total firearms, use of, discharge, pointing","15","7","1","-61.73","1.46","0.99","1.02","1.29","3.86","8","8","9","1","3"
"2007","Calgary, Alberta, municipal","48014","Total firearms, use of, discharge, pointing","19","12","1","23.63","1.8","1.33","1.55","3.87","0","13","11","14","3","0"
"2008","Calgary, Alberta, municipal","48014","Total firearms, use of, discharge, pointing","18","8","2","-7.58","1.67","0.94","1.18","3.89","0","10","8","11","3","0"
"2009","Calgary, Alberta, municipal","48014","Total firearms, use of, discharge, pointing","20","14","2","8.32","1.81","1.6","1.78","3.87","0","16","14","17","3","0"
"2010","Calgary, Alberta, municipal","48014","Total firearms, use of, discharge, pointing","14","6","1","-31.03","1.25","0.79","0.83","1.28","0","7","7","8","1","0"
"2011","Calgary, Alberta, municipal","48014","Total firearms, use of, discharge, pointing","13","7","0","-8.6","1.14","0.78","0.82","1.28","0","7","7","8","1","0"
"2012","Calgary, Alberta, municipal","48014","Total firearms, use of, discharge, pointing","14","13","1","4.47","1.19","1.61","1.98","6.35","0","14","15","20","5","0"
"2013","Calgary, Alberta, municipal","48014","Total firearms, use of, discharge, pointing","19","8","1","30.96","1.56","1.03","0.96","0","0","9","10","10","0","0"
"2014","Calgary, Alberta, municipal","48014","Total firearms, use of, discharge, pointing","27","7","0","37.48","2.14","0.6","0.65","1.26","0","7","6","7","1","0"
"2015","Calgary, Alberta, municipal","48014","Total firearms, use of, discharge, pointing","17","9","1","-38.38","1.32","1.27","1.63","6.23","0","10","13","18","5","0"
"2016","Calgary, Alberta, municipal","48014","Total firearms, use of, discharge, pointing","22","14","1","26.39","1.67","1.34","1.42","2.44","0","15","14","16","2","0"
"1998","Calgary, Alberta, municipal","48014","Discharge firearm with intent","1","0","0","0","0.12","0","0","0","0","0","0","0","0","0"
"1999","Calgary, Alberta, municipal","48014","Discharge firearm with intent","6","3","0","485.01","0.7","0","0","0","0","3","1","1","0","0"
"2000","Calgary, Alberta, municipal","48014","Discharge firearm with intent","1","0","0","-83.72","0.11","0","0","0","0","0","0","2","2","0"
"2001","Calgary, Alberta, municipal","48014","Discharge firearm with intent","6","2","0","487.03","0.67","0","0","0","0","2","2","6","4","0"
"2002","Calgary, Alberta, municipal","48014","Discharge firearm with intent","4","0","0","-34.87","0.43","0","0","0","0","0","0","0","0","0"
"2003","Calgary, Alberta, municipal","48014","Discharge firearm with intent","4","5","0","-1.56","0.43","0","0","0","0","5","2","3","1","0"
"2004","Calgary, Alberta, municipal","48014","Discharge firearm with intent","6","5","0","45.52","0.62","0.53","0.48","0","0","5","4","4","0","0"
"2005","Calgary, Alberta, municipal","48014","Discharge firearm with intent","23","8","1","272.02","2.31","0.39","0.58","2.6","0","9","3","5","2","0"
"2006","Calgary, Alberta, municipal","48014","Discharge firearm with intent","5","1","0","-78.92","0.49","0.25","0.23","0","1.29","1","2","2","0","1"
"2007","Calgary, Alberta, municipal","48014","Discharge firearm with intent","8","2","0","56.16","0.76","0.36","0.33","0","0","2","3","3","0","0"
"2008","Calgary, Alberta, municipal","48014","Discharge firearm with intent","8","0","0","-2.45","0.74","0.35","0.43","1.3","0","0","3","4","1","0"
"2009","Calgary, Alberta, municipal","48014","Discharge firearm with intent","2","0","0","-75.63","0.18","0","0","0","0","0","0","0","0","0"
"2010","Calgary, Alberta, municipal","48014","Discharge firearm with intent","5","1","0","146.33","0.44","0.23","0.21","0","0","1","2","2","0","0"
"2011","Calgary, Alberta, municipal","48014","Discharge firearm with intent","5","2","0","-1.57","0.44","0.33","0.31","0","0","2","3","3","0","0"
"2012","Calgary, Alberta, municipal","48014","Discharge firearm with intent","3","4","0","-41.79","0.25","0.54","0.49","0","0","4","5","5","0","0"
"2013","Calgary, Alberta, municipal","48014","Discharge firearm with intent","9","3","0","189.49","0.74","0.41","0.38","0","0","3","4","4","0","0"
"2014","Calgary, Alberta, municipal","48014","Discharge firearm with intent","15","0","0","61.24","1.19","0","0","0","0","0","0","0","0","0"
"2015","Calgary, Alberta, municipal","48014","Discharge firearm with intent","7","1","0","-54.33","0.54","0.29","0.36","1.25","0","1","3","4","1","0"
"2016","Calgary, Alberta, municipal","48014","Discharge firearm with intent","8","5","1","11.61","0.61","0.57","0.53","0","0","6","6","6","0","0"
"1998","Calgary, Alberta, municipal","48014","Using firearm in commission of offence","0","0","0","0","0","0","0","0","0","0","0","0","0","0"
"1999","Calgary, Alberta, municipal","48014","Using firearm in commission of offence","1","1","0","0","0.12","0","0","0","0","1","1","1","0","0"
"2000","Calgary, Alberta, municipal","48014","Using firearm in commission of offence","1","1","0","-2.32","0.11","0","0","0","0","1","0","2","2","0"
"2001","Calgary, Alberta, municipal","48014","Using firearm in commission of offence","1","1","0","-2.16","0.11","0","0","0","0","1","0","0","0","0"
"2002","Calgary, Alberta, municipal","48014","Using firearm in commission of offence","0","0","0","-100","0","0","0","0","0","0","0","0","0","0"
"2003","Calgary, Alberta, municipal","48014","Using firearm in commission of offence","0","0","0","0","0","0","0","0","0","0","0","0","0","0"
"2004","Calgary, Alberta, municipal","48014","Using firearm in commission of offence","1","1","0","0","0.1","0.13","0.12","0","0","1","1","1","0","0"
"2005","Calgary, Alberta, municipal","48014","Using firearm in commission of offence","3","2","1","191.14","0.3","0","0","0","0","3","0","0","0","0"
"2006","Calgary, Alberta, municipal","48014","Using firearm in commission of offence","3","3","0","-3.04","0.29","0.5","0.45","0","0","3","4","4","0","0"
"2007","Calgary, Alberta, municipal","48014","Using firearm in commission of offence","9","8","1","192.8","0.85","0.72","0.99","3.87","0","9","6","9","3","0"
"2008","Calgary, Alberta, municipal","48014","Using firearm in commission of offence","8","7","1","-13.29","0.74","0.59","0.75","2.59","0","8","5","7","2","0"
"2009","Calgary, Alberta, municipal","48014","Using firearm in commission of offence","9","9","0","9.67","0.81","0.91","1.15","3.87","0","9","8","11","3","0"
"2010","Calgary, Alberta, municipal","48014","Using firearm in commission of offence","3","3","0","-67.16","0.27","0.34","0.41","1.28","0","3","3","4","1","0"
"2011","Calgary, Alberta, municipal","48014","Using firearm in commission of offence","4","4","0","31.24","0.35","0.33","0.41","1.28","0","4","3","4","1","0"
"2012","Calgary, Alberta, municipal","48014","Using firearm in commission of offence","4","4","0","-2.99","0.34","0.32","0.79","6.35","0","4","3","8","5","0"
"2013","Calgary, Alberta, municipal","48014","Using firearm in commission of offence","1","1","0","-75.88","0.08","0.21","0.19","0","0","1","2","2","0","0"
"2014","Calgary, Alberta, municipal","48014","Using firearm in commission of offence","5","5","0","383.73","0.4","0.4","0.46","1.26","0","5","4","5","1","0"
"2015","Calgary, Alberta, municipal","48014","Using firearm in commission of offence","3","3","0","-41.28","0.23","0.29","0.36","1.25","0","3","3","4","1","0"
"2016","Calgary, Alberta, municipal","48014","Using firearm in commission of offence","6","6","0","95.33","0.45","0.48","0.62","2.44","0","6","5","7","2","0"
"1998","Calgary, Alberta, municipal","48014","Pointing a firearm","10","2","3","0","1.19","0","0","0","0","5","2","2","0","2"
"1999","Calgary, Alberta, municipal","48014","Pointing a firearm","19","10","2","85.25","2.2","0","0","0","0","12","5","5","0","2"
"2000","Calgary, Alberta, municipal","48014","Pointing a firearm","8","1","1","-58.87","0.91","0","0","0","0","2","0","3","3","0"
"2001","Calgary, Alberta, municipal","48014","Pointing a firearm","7","1","3","-14.39","0.78","0","0","0","0","4","1","3","2","2"
"2002","Calgary, Alberta, municipal","48014","Pointing a firearm","5","2","2","-30.22","0.54","0","0","0","0","4","0","2","2","0"
"2003","Calgary, Alberta, municipal","48014","Pointing a firearm","7","3","2","37.81","0.75","0","0","0","0","5","3","4","1","3"
"2004","Calgary, Alberta, municipal","48014","Pointing a firearm","11","2","3","52.45","1.14","0.27","0.24","0","2.64","5","2","2","0","2"
"2011","Calgary, Alberta, municipal","48014","Robbery","1164","399","35","-13.2","101.96","27.82","36.31","134.02","16.59","434","251","356","105","13"
"2005","Calgary, Alberta, municipal","48014","Pointing a firearm","12","1","6","5.87","1.2","0","0.12","1.3","1.3","7","0","1","1","1"
"2012","Calgary, Alberta, municipal","48014","Robbery","924","343","23","-22.99","78.52","24.04","30.88","111.71","8.89","366","224","312","88","7"
"2006","Calgary, Alberta, municipal","48014","Pointing a firearm","7","3","1","-43.44","0.68","0.25","0.34","1.29","2.57","4","2","3","1","2"
"2013","Calgary, Alberta, municipal","48014","Robbery","943","258","23","-1.52","77.33","17.05","21.2","72","6.32","281","165","222","57","5"
"2007","Calgary, Alberta, municipal","48014","Pointing a firearm","2","2","0","-72.11","0.19","0.24","0.22","0","0","2","2","2","0","0"
"2014","Calgary, Alberta, municipal","48014","Robbery","931","257","16","-4.48","73.86","17.25","21.35","73.01","5.04","273","173","231","58","4"
"2015","Calgary, Alberta, municipal","48014","Robbery","1144","315","15","20.26","88.82","20.8","25.08","79.76","1.25","330","213","277","64","1"
"2008","Calgary, Alberta, municipal","48014","Pointing a firearm","2","1","1","-2.45","0.19","0","0","0","0","2","0","0","0","0"
"2016","Calgary, Alberta, municipal","48014","Robbery","896","265","6","-23.51","67.94","18.14","19.39","35.38","3.66","271","190","219","29","3"
"2009","Calgary, Alberta, municipal","48014","Pointing a firearm","9","5","2","338.7","0.81","0.69","0.63","0","0","7","6","6","0","0"
"1998","Calgary, Alberta, municipal","48014","Robbery","1102","399","45","0","131.09","0","0","0","0","444","204","397","193","15"
"2010","Calgary, Alberta, municipal","48014","Pointing a firearm","6","2","1","-34.31","0.53","0.23","0.21","0","0","3","2","2","0","0"
"1999","Calgary, Alberta, municipal","48014","Robbery","1160","409","27","2.63","134.54","0","0","0","0","436","269","419","150","13"
"2011","Calgary, Alberta, municipal","48014","Pointing a firearm","4","1","0","-34.38","0.35","0.11","0.1","0","0","1","1","1","0","0"
"2000","Calgary, Alberta, municipal","48014","Robbery","1131","438","33","-4.76","128.14","0","0","0","0","471","249","472","223","28"
"2012","Calgary, Alberta, municipal","48014","Pointing a firearm","7","5","1","69.77","0.59","0.75","0.69","0","0","6","7","7","0","0"
"2001","Calgary, Alberta, municipal","48014","Robbery","1197","467","68","3.55","132.68","0","0","0","0","535","298","447","149","16"
"2013","Calgary, Alberta, municipal","48014","Pointing a firearm","9","4","1","24.07","0.74","0.41","0.38","0","0","5","4","4","0","0"
"2002","Calgary, Alberta, municipal","48014","Robbery","1111","456","38","-9.33","120.31","0","0","0","0","494","254","437","183","18"
"2014","Calgary, Alberta, municipal","48014","Pointing a firearm","7","2","0","-24.75","0.56","0.2","0.18","0","0","2","2","2","0","0"
"2003","Calgary, Alberta, municipal","48014","Robbery","1338","524","56","18.55","142.62","0","0","0","0","580","292","474","182","43"
"2015","Calgary, Alberta, municipal","48014","Pointing a firearm","7","5","1","-2.13","0.54","0.68","0.91","3.74","0","6","7","10","3","0"
"2004","Calgary, Alberta, municipal","48014","Robbery","1083","371","44","-21.48","111.99","32.16","39.23","109.47","26.38","415","242","325","83","20"
"2016","Calgary, Alberta, municipal","48014","Pointing a firearm","8","3","0","11.61","0.61","0.29","0.27","0","0","3","3","3","0","0"
"2005","Calgary, Alberta, municipal","48014","Robbery","1216","428","53","8.97","122.04","39.21","46.44","119.44","12.98","481","305","397","92","10"
"2006","Calgary, Alberta, municipal","48014","Robbery","1321","431","46","5.33","128.54","34.28","41.33","114.38","21.85","477","276","365","89","17"
"2007","Calgary, Alberta, municipal","48014","Robbery","1415","493","39","4.55","134.38","34.64","48.89","201.28","19.35","532","287","443","156","15"
"2008","Calgary, Alberta, municipal","48014","Robbery","1241","392","34","-14.44","114.97","28.99","37.02","125.66","16.84","426","247","344","97","13"
"2009","Calgary, Alberta, municipal","48014","Robbery","1382","438","39","8.57","124.82","29.8","37.35","122.5","14.18","477","261","356","95","11"
"2010","Calgary, Alberta, municipal","48014","Robbery","1320","446","55","-5.89","117.47","34","42.33","137.21","8.98","501","302","409","107","7"
"2005","Calgary, Alberta, municipal","48014","Robbery to steal a firearm","0","0","0","0","0","0","0","0","0","0","0","0","0","0"
"2006","Calgary, Alberta, municipal","48014","Robbery to steal a firearm","0","0","0","0","0","0","0","0","0","0","0","0","0","0"
"2007","Calgary, Alberta, municipal","48014","Robbery to steal a firearm","0","0","0","0","0","0","0","0","0","0","0","0","0","0"
"2008","Calgary, Alberta, municipal","48014","Robbery to steal a firearm","0","0","0","0","0","0","0","0","0","0","0","0","0","0"
"2009","Calgary, Alberta, municipal","48014","Robbery to steal a firearm","0","0","0","0","0","0","0","0","0","0","0","0","0","0"
"2010","Calgary, Alberta, municipal","48014","Robbery to steal a firearm","0","0","0","0","0","0","0","0","0","0","0","0","0","0"
"2011","Calgary, Alberta, municipal","48014","Robbery to steal a firearm","0","0","0","0","0","0","0","0","0","0","0","0","0","0"
"2012","Calgary, Alberta, municipal","48014","Robbery to steal a firearm","0","0","0","0","0","0","0","0","0","0","0","0","0","0"
"2013","Calgary, Alberta, municipal","48014","Robbery to steal a firearm","0","0","0","0","0","0","0","0","0","0","0","0","0","0"
"2014","Calgary, Alberta, municipal","48014","Robbery to steal a firearm","0","0","0","0","0","0","0","0","0","0","0","0","0","0"
"2015","Calgary, Alberta, municipal","48014","Robbery to steal a firearm","0","0","0","0","0","0","0","0","0","0","0","0","0","0"
"2016","Calgary, Alberta, municipal","48014","Robbery to steal a firearm","0","0","0","0","0","0","0","0","0","0","0","0","0","0"
"1998","Calgary, Alberta, municipal","48014","Total forcible confinement or kidnapping","78","63","4","0","9.28","0","0","0","0","67","57","63","6","1"
"1999","Calgary, Alberta, municipal","48014","Total forcible confinement or kidnapping","113","80","6","41.25","13.11","0","0","0","0","86","88","94","6","1"
"2000","Calgary, Alberta, municipal","48014","Total forcible confinement or kidnapping","120","102","6","3.74","13.6","0","0","0","0","108","95","107","12","2"
"2001","Calgary, Alberta, municipal","48014","Total forcible confinement or kidnapping","108","79","9","-11.94","11.97","0","0","0","0","88","77","85","8","0"
"2002","Calgary, Alberta, municipal","48014","Total forcible confinement or kidnapping","121","90","6","9.45","13.1","0","0","0","0","96","88","94","6","1"
"2003","Calgary, Alberta, municipal","48014","Total forcible confinement or kidnapping","124","105","7","0.88","13.22","0","0","0","0","112","112","131","19","3"
"2004","Calgary, Alberta, municipal","48014","Total forcible confinement or kidnapping","143","94","3","11.88","14.79","11.96","11.83","10.55","0","97","90","98","8","0"
"1998","Calgary, Alberta, municipal","48014","Total robbery","1102","399","45","0","131.09","0","0","0","0","444","204","397","193","15"
"2005","Calgary, Alberta, municipal","48014","Total forcible confinement or kidnapping","176","137","5","19.44","17.66","17.23","16.84","12.98","1.3","142","134","144","10","1"
"1999","Calgary, Alberta, municipal","48014","Total robbery","1160","409","27","2.63","134.54","0","0","0","0","436","269","419","150","13"
"2006","Calgary, Alberta, municipal","48014","Total forcible confinement or kidnapping","159","113","6","-12.41","15.47","12.54","12.12","7.71","0","119","101","107","6","0"
"2000","Calgary, Alberta, municipal","48014","Total robbery","1131","438","33","-4.76","128.14","0","0","0","0","471","249","472","223","28"
"2007","Calgary, Alberta, municipal","48014","Total forcible confinement or kidnapping","131","106","5","-19.59","12.44","10.5","10.48","10.32","0","111","87","95","8","0"
"2001","Calgary, Alberta, municipal","48014","Total robbery","1197","467","68","3.55","132.68","0","0","0","0","535","298","447","149","16"
"2008","Calgary, Alberta, municipal","48014","Total forcible confinement or kidnapping","159","132","5","18.4","14.73","17.49","16.36","3.89","0","137","149","152","3","0"
"2002","Calgary, Alberta, municipal","48014","Total robbery","1111","456","38","-9.33","120.31","0","0","0","0","494","254","437","183","18"
"2009","Calgary, Alberta, municipal","48014","Total forcible confinement or kidnapping","185","130","9","13.43","16.71","14.27","13.32","2.58","3.87","139","125","127","2","3"
"2003","Calgary, Alberta, municipal","48014","Total robbery","1338","524","56","18.55","142.62","0","0","0","0","580","292","474","182","43"
"2010","Calgary, Alberta, municipal","48014","Total forcible confinement or kidnapping","171","140","7","-8.93","15.22","15.42","15.01","10.26","1.28","147","137","145","8","1"
"2004","Calgary, Alberta, municipal","48014","Total robbery","1083","371","44","-21.48","111.99","32.16","39.23","109.47","26.38","415","242","325","83","20"
"2011","Calgary, Alberta, municipal","48014","Total forcible confinement or kidnapping","143","107","7","-17.68","12.53","11.75","11.73","11.49","1.28","114","106","115","9","1"
"2005","Calgary, Alberta, municipal","48014","Total robbery","1216","428","53","8.97","122.04","39.21","46.44","119.44","12.98","481","305","397","92","10"
"2012","Calgary, Alberta, municipal","48014","Total forcible confinement or kidnapping","137","101","3","-7.06","11.64","10.3","9.7","2.54","0","104","96","98","2","0"
"2006","Calgary, Alberta, municipal","48014","Total robbery","1321","431","46","5.33","128.54","34.28","41.33","114.38","21.85","477","276","365","89","17"
"2013","Calgary, Alberta, municipal","48014","Total forcible confinement or kidnapping","124","97","2","-12.66","10.17","10.43","9.65","0","0","99","101","101","0","0"
"2007","Calgary, Alberta, municipal","48014","Total robbery","1415","493","39","4.55","134.38","34.64","48.89","201.28","19.35","532","287","443","156","15"
"2014","Calgary, Alberta, municipal","48014","Total forcible confinement or kidnapping","150","119","3","17.03","11.9","11.77","11.37","6.29","0","122","118","123","5","0"
"2008","Calgary, Alberta, municipal","48014","Total robbery","1241","392","34","-14.44","114.97","28.99","37.02","125.66","16.84","426","247","344","97","13"
"2015","Calgary, Alberta, municipal","48014","Total forcible confinement or kidnapping","138","99","5","-9.96","10.71","10.35","9.78","2.49","0","104","106","108","2","0"
"2009","Calgary, Alberta, municipal","48014","Total robbery","1382","438","39","8.57","124.82","29.8","37.35","122.5","14.18","477","261","356","95","11"
"2016","Calgary, Alberta, municipal","48014","Total forcible confinement or kidnapping","133","100","6","-5.88","10.08","10.6","10.09","3.66","0","106","111","114","3","0"
"2010","Calgary, Alberta, municipal","48014","Total robbery","1320","446","55","-5.89","117.47","34","42.33","137.21","8.98","501","302","409","107","7"
"2011","Calgary, Alberta, municipal","48014","Total robbery","1164","399","35","-13.2","101.96","27.82","36.31","134.02","16.59","434","251","356","105","13"
"2012","Calgary, Alberta, municipal","48014","Total robbery","924","343","23","-22.99","78.52","24.04","30.88","111.71","8.89","366","224","312","88","7"
"2013","Calgary, Alberta, municipal","48014","Total robbery","943","258","23","-1.52","77.33","17.05","21.2","72","6.32","281","165","222","57","5"
"2014","Calgary, Alberta, municipal","48014","Total robbery","931","257","16","-4.48","73.86","17.25","21.35","73.01","5.04","273","173","231","58","4"
"2015","Calgary, Alberta, municipal","48014","Total robbery","1144","315","15","20.26","88.82","20.8","25.08","79.76","1.25","330","213","277","64","1"
"2016","Calgary, Alberta, municipal","48014","Total robbery","896","265","6","-23.51","67.94","18.14","19.39","35.38","3.66","271","190","219","29","3"
"1998","Calgary, Alberta, municipal","48014","Forcible confinement or kidnapping","78","63","4","0","9.28","0","0","0","0","67","57","63","6","1"
"1999","Calgary, Alberta, municipal","48014","Forcible confinement or kidnapping","113","80","6","41.25","13.11","0","0","0","0","86","88","94","6","1"
"2000","Calgary, Alberta, municipal","48014","Forcible confinement or kidnapping","120","102","6","3.74","13.6","0","0","0","0","108","95","107","12","2"
"2001","Calgary, Alberta, municipal","48014","Forcible confinement or kidnapping","108","79","9","-11.94","11.97","0","0","0","0","88","77","85","8","0"
"2002","Calgary, Alberta, municipal","48014","Forcible confinement or kidnapping","121","90","6","9.45","13.1","0","0","0","0","96","88","94","6","1"
"2003","Calgary, Alberta, municipal","48014","Forcible confinement or kidnapping","124","105","7","0.88","13.22","0","0","0","0","112","112","131","19","3"
"2004","Calgary, Alberta, municipal","48014","Forcible confinement or kidnapping","143","94","3","11.88","14.79","11.96","11.83","10.55","0","97","90","98","8","0"
"2005","Calgary, Alberta, municipal","48014","Forcible confinement or kidnapping","176","137","5","19.44","17.66","17.23","16.84","12.98","1.3","142","134","144","10","1"
"2006","Calgary, Alberta, municipal","48014","Forcible confinement or kidnapping","159","113","6","-12.41","15.47","12.54","12.12","7.71","0","119","101","107","6","0"
"2007","Calgary, Alberta, municipal","48014","Forcible confinement or kidnapping","131","106","5","-19.59","12.44","10.5","10.48","10.32","0","111","87","95","8","0"
"2008","Calgary, Alberta, municipal","48014","Forcible confinement or kidnapping","159","132","5","18.4","14.73","17.49","16.36","3.89","0","137","149","152","3","0"
"2009","Calgary, Alberta, municipal","48014","Forcible confinement or kidnapping","185","130","9","13.43","16.71","14.27","13.32","2.58","3.87","139","125","127","2","3"
"2010","Calgary, Alberta, municipal","48014","Forcible confinement or kidnapping","171","140","7","-8.93","15.22","15.42","15.01","10.26","1.28","147","137","145","8","1"
"2011","Calgary, Alberta, municipal","48014","Forcible confinement or kidnapping","143","107","7","-17.68","12.53","11.75","11.73","11.49","1.28","114","106","115","9","1"
"2012","Calgary, Alberta, municipal","48014","Forcible confinement or kidnapping","137","101","3","-7.06","11.64","10.3","9.7","2.54","0","104","96","98","2","0"
"2013","Calgary, Alberta, municipal","48014","Forcible confinement or kidnapping","124","97","2","-12.66","10.17","10.43","9.65","0","0","99","101","101","0","0"
"2014","Calgary, Alberta, municipal","48014","Forcible confinement or kidnapping","150","119","3","17.03","11.9","11.77","11.37","6.29","0","122","118","123","5","0"
"2015","Calgary, Alberta, municipal","48014","Forcible confinement or kidnapping","138","99","5","-9.96","10.71","10.35","9.78","2.49","0","104","106","108","2","0"
"2016","Calgary, Alberta, municipal","48014","Forcible confinement or kidnapping","115","91","5","-18.61","8.72","9.83","9.39","3.66","0","96","103","106","3","0"
"2005","Calgary, Alberta, municipal","48014","Kidnapping","0","0","0","0","0","0","0","0","0","0","0","0","0","0"
"2006","Calgary, Alberta, municipal","48014","Kidnapping","0","0","0","0","0","0","0","0","0","0","0","0","0","0"
"2007","Calgary, Alberta, municipal","48014","Kidnapping","0","0","0","0","0","0","0","0","0","0","0","0","0","0"
"2008","Calgary, Alberta, municipal","48014","Kidnapping","0","0","0","0","0","0","0","0","0","0","0","0","0","0"
"2009","Calgary, Alberta, municipal","48014","Kidnapping","0","0","0","0","0","0","0","0","0","0","0","0","0","0"
"2010","Calgary, Alberta, municipal","48014","Kidnapping","0","0","0","0","0","0","0","0","0","0","0","0","0","0"
"2011","Calgary, Alberta, municipal","48014","Kidnapping","0","0","0","0","0","0","0","0","0","0","0","0","0","0"
"2012","Calgary, Alberta, municipal","48014","Kidnapping","0","0","0","0","0","0","0","0","0","0","0","0","0","0"
"2013","Calgary, Alberta, municipal","48014","Kidnapping","0","0","0","0","0","0","0","0","0","0","0","0","0","0"
"2014","Calgary, Alberta, municipal","48014","Kidnapping","0","0","0","0","0","0","0","0","0","0","0","0","0","0"
"2015","Calgary, Alberta, municipal","48014","Kidnapping","0","0","0","0","0","0","0","0","0","0","0","0","0","0"
"2016","Calgary, Alberta, municipal","48014","Kidnapping","4","0","0","0","0.3","0","0","0","0","0","0","0","0","0"
"2005","Calgary, Alberta, municipal","48014","Forcible confinement","0","0","0","0","0","0","0","0","0","0","0","0","0","0"
"2006","Calgary, Alberta, municipal","48014","Forcible confinement","0","0","0","0","0","0","0","0","0","0","0","0","0","0"
"2007","Calgary, Alberta, municipal","48014","Forcible confinement","0","0","0","0","0","0","0","0","0","0","0","0","0","0"
"2008","Calgary, Alberta, municipal","48014","Forcible confinement","0","0","0","0","0","0","0","0","0","0","0","0","0","0"
"2009","Calgary, Alberta, municipal","48014","Forcible confinement","0","0","0","0","0","0","0","0","0","0","0","0","0","0"
"2010","Calgary, Alberta, municipal","48014","Forcible confinement","0","0","0","0","0","0","0","0","0","0","0","0","0","0"
"2011","Calgary, Alberta, municipal","48014","Forcible confinement","0","0","0","0","0","0","0","0","0","0","0","0","0","0"
"2012","Calgary, Alberta, municipal","48014","Forcible confinement","0","0","0","0","0","0","0","0","0","0","0","0","0","0"
"2013","Calgary, Alberta, municipal","48014","Forcible confinement","0","0","0","0","0","0","0","0","0","0","0","0","0","0"
"2014","Calgary, Alberta, municipal","48014","Forcible confinement","0","0","0","0","0","0","0","0","0","0","0","0","0","0"
"2015","Calgary, Alberta, municipal","48014","Forcible confinement","0","0","0","0","0","0","0","0","0","0","0","0","0","0"
"2016","Calgary, Alberta, municipal","48014","Forcible confinement","14","9","1","0","1.06","0.76","0.71","0","0","10","8","8","0","0"
"1998","Calgary, Alberta, municipal","48014","Total abduction","32","14","2","0","3.81","0","0","0","0","16","12","12","0","0"
"1999","Calgary, Alberta, municipal","48014","Total abduction","23","5","3","-29.92","2.67","0","0","0","0","8","4","4","0","0"
"2000","Calgary, Alberta, municipal","48014","Total abduction","19","9","5","-19.3","2.15","0","0","0","0","14","7","7","0","0"
"2001","Calgary, Alberta, municipal","48014","Total abduction","23","3","5","18.44","2.55","0","0","0","0","8","3","3","0","0"
"2002","Calgary, Alberta, municipal","48014","Total abduction","14","8","4","-40.54","1.52","0","0","0","0","12","5","5","0","0"
"2003","Calgary, Alberta, municipal","48014","Total abduction","24","14","2","68.75","2.56","0","0","0","0","16","7","7","0","0"
"2004","Calgary, Alberta, municipal","48014","Total abduction","13","6","2","-47.45","1.34","0.66","0.6","0","0","8","5","5","0","0"
"2005","Calgary, Alberta, municipal","48014","Total abduction","18","4","2","34.37","1.81","0.51","0.47","0","0","6","4","4","0","0"
"2006","Calgary, Alberta, municipal","48014","Total abduction","17","7","1","-8.43","1.65","0.75","0.68","0","0","8","6","6","0","0"
"2007","Calgary, Alberta, municipal","48014","Total abduction","11","6","2","-36.85","1.04","0.6","0.55","0","1.29","8","5","5","0","1"
"2008","Calgary, Alberta, municipal","48014","Total abduction","12","4","4","6.42","1.11","0.35","0.32","0","0","8","3","3","0","0"
"2009","Calgary, Alberta, municipal","48014","Total abduction","10","5","2","-18.76","0.9","0.46","0.42","0","0","7","4","4","0","0"
"2010","Calgary, Alberta, municipal","48014","Total abduction","12","5","2","18.24","1.07","0.34","0.31","0","0","7","3","3","0","0"
"2011","Calgary, Alberta, municipal","48014","Total abduction","16","6","3","31.24","1.4","0.55","0.51","0","0","9","5","5","0","0"
"2012","Calgary, Alberta, municipal","48014","Total abduction","11","7","0","-33.31","0.93","0.43","0.4","0","0","7","4","4","0","0"
"2013","Calgary, Alberta, municipal","48014","Total abduction","8","3","1","-29.82","0.66","0.31","0.29","0","0","4","3","3","0","0"
"2014","Calgary, Alberta, municipal","48014","Total abduction","10","6","0","20.93","0.79","0.5","0.46","0","0","6","5","5","0","0"
"2015","Calgary, Alberta, municipal","48014","Total abduction","9","3","0","-11.92","0.7","0.1","0.09","0","0","3","1","1","0","0"
"2016","Calgary, Alberta, municipal","48014","Total abduction","16","10","0","73.62","1.21","0.38","0.35","0","0","10","4","4","0","0"
"1998","Calgary, Alberta, municipal","48014","Abduction under the age 14, not parent or guardian","2","1","0","0","0.24","0","0","0","0","1","1","1","0","0"
"1999","Calgary, Alberta, municipal","48014","Abduction under the age 14, not parent or guardian","1","0","0","-51.25","0.12","0","0","0","0","0","0","0","0","0"
"2000","Calgary, Alberta, municipal","48014","Abduction under the age 14, not parent or guardian","5","1","1","388.42","0.57","0","0","0","0","2","1","1","0","0"
"2001","Calgary, Alberta, municipal","48014","Abduction under the age 14, not parent or guardian","5","1","1","-2.16","0.55","0","0","0","0","2","1","1","0","0"
"2002","Calgary, Alberta, municipal","48014","Abduction under the age 14, not parent or guardian","1","0","0","-80.46","0.11","0","0","0","0","0","0","0","0","0"
"2003","Calgary, Alberta, municipal","48014","Abduction under the age 14, not parent or guardian","6","2","0","490.62","0.64","0","0","0","0","2","2","2","0","0"
"2004","Calgary, Alberta, municipal","48014","Abduction under the age 14, not parent or guardian","2","0","0","-67.66","0.21","0","0","0","0","0","0","0","0","0"
"2005","Calgary, Alberta, municipal","48014","Abduction under the age 14, not parent or guardian","10","0","0","385.24","1","0","0","0","0","0","0","0","0","0"
"2006","Calgary, Alberta, municipal","48014","Abduction under the age 14, not parent or guardian","6","0","0","-41.83","0.58","0","0","0","0","0","0","0","0","0"
"2007","Calgary, Alberta, municipal","48014","Abduction under the age 14, not parent or guardian","2","0","1","-67.47","0.19","0","0","0","1.29","1","0","0","0","1"
"2008","Calgary, Alberta, municipal","48014","Abduction under the age 14, not parent or guardian","1","0","0","-51.22","0.09","0","0","0","0","0","0","0","0","0"
"2009","Calgary, Alberta, municipal","48014","Abduction under the age 14, not parent or guardian","4","2","0","289.96","0.36","0.11","0.1","0","0","2","1","1","0","0"
"2010","Calgary, Alberta, municipal","48014","Abduction under the age 14, not parent or guardian","2","0","0","-50.73","0.18","0","0","0","0","0","0","0","0","0"
"2011","Calgary, Alberta, municipal","48014","Abduction under the age 14, not parent or guardian","6","1","0","195.3","0.53","0.11","0.1","0","0","1","1","1","0","0"
"2012","Calgary, Alberta, municipal","48014","Abduction under the age 14, not parent or guardian","4","0","0","-35.33","0.34","0","0","0","0","0","0","0","0","0"
"2013","Calgary, Alberta, municipal","48014","Abduction under the age 14, not parent or guardian","3","0","0","-27.63","0.25","0","0","0","0","0","0","0","0","0"
"2014","Calgary, Alberta, municipal","48014","Abduction under the age 14, not parent or guardian","2","0","0","-35.5","0.16","0","0","0","0","0","0","0","0","0"
"2015","Calgary, Alberta, municipal","48014","Abduction under the age 14, not parent or guardian","1","0","0","-51.07","0.08","0","0","0","0","0","0","0","0","0"
"2016","Calgary, Alberta, municipal","48014","Abduction under the age 14, not parent or guardian","12","7","0","1071.95","0.91","0.19","0.18","0","0","7","2","2","0","0"
"1998","Calgary, Alberta, municipal","48014","Abduction under the age 16","7","2","0","0","0.83","0","0","0","0","2","3","3","0","0"
"1999","Calgary, Alberta, municipal","48014","Abduction under the age 16","4","0","0","-44.28","0.46","0","0","0","0","0","0","0","0","0"
"2000","Calgary, Alberta, municipal","48014","Abduction under the age 16","1","1","1","-75.58","0.11","0","0","0","0","2","0","0","0","0"
"2001","Calgary, Alberta, municipal","48014","Abduction under the age 16","5","2","1","389.19","0.55","0","0","0","0","3","2","2","0","0"
"2002","Calgary, Alberta, municipal","48014","Abduction under the age 16","0","0","0","-100","0","0","0","0","0","0","0","0","0","0"
"2003","Calgary, Alberta, municipal","48014","Abduction under the age 16","1","0","0","0","0.11","0","0","0","0","0","0","0","0","0"
"2004","Calgary, Alberta, municipal","48014","Abduction under the age 16","2","0","1","94.03","0.21","0","0","0","0","1","0","0","0","0"
"2005","Calgary, Alberta, municipal","48014","Abduction under the age 16","2","1","0","-2.95","0.2","0.13","0.12","0","0","1","1","1","0","0"
"2006","Calgary, Alberta, municipal","48014","Abduction under the age 16","2","0","0","-3.04","0.19","0","0","0","0","0","0","0","0","0"
"2007","Calgary, Alberta, municipal","48014","Abduction under the age 16","2","1","0","-2.4","0.19","0.12","0.11","0","0","1","1","1","0","0"
"2008","Calgary, Alberta, municipal","48014","Abduction under the age 16","1","1","0","-51.22","0.09","0.12","0.11","0","0","1","1","1","0","0"
"2009","Calgary, Alberta, municipal","48014","Abduction under the age 16","2","0","0","94.98","0.18","0","0","0","0","0","0","0","0","0"
"2010","Calgary, Alberta, municipal","48014","Abduction under the age 16","0","0","0","-100","0","0","0","0","0","0","0","0","0","0"
"2011","Calgary, Alberta, municipal","48014","Abduction under the age 16","1","1","0","0","0.09","0.11","0.1","0","0","1","1","1","0","0"
"2012","Calgary, Alberta, municipal","48014","Abduction under the age 16","0","0","0","-100","0","0","0","0","0","0","0","0","0","0"
"2013","Calgary, Alberta, municipal","48014","Abduction under the age 16","0","0","0","0","0","0","0","0","0","0","0","0","0","0"
"2014","Calgary, Alberta, municipal","48014","Abduction under the age 16","3","1","0","0","0.24","0.1","0.09","0","0","1","1","1","0","0"
"2015","Calgary, Alberta, municipal","48014","Abduction under the age 16","5","2","0","63.11","0.39","0","0","0","0","2","0","0","0","0"
"2016","Calgary, Alberta, municipal","48014","Abduction under the age 16","0","0","0","-100","0","0","0","0","0","0","0","0","0","0"
"1998","Calgary, Alberta, municipal","48014","Removal of children from Canada","0","0","0","0","0","0","0","0","0","0","0","0","0","0"
"1999","Calgary, Alberta, municipal","48014","Removal of children from Canada","0","0","0","0","0","0","0","0","0","0","0","0","0","0"
"2000","Calgary, Alberta, municipal","48014","Removal of children from Canada","0","0","0","0","0","0","0","0","0","0","0","0","0","0"
"2001","Calgary, Alberta, municipal","48014","Removal of children from Canada","0","0","0","0","0","0","0","0","0","0","0","0","0","0"
"2002","Calgary, Alberta, municipal","48014","Removal of children from Canada","0","0","0","0","0","0","0","0","0","0","0","0","0","0"
"2003","Calgary, Alberta, municipal","48014","Removal of children from Canada","0","0","0","0","0","0","0","0","0","0","0","0","0","0"
"2004","Calgary, Alberta, municipal","48014","Removal of children from Canada","1","0","0","0","0.1","0","0","0","0","0","0","0","0","0"
"2005","Calgary, Alberta, municipal","48014","Removal of children from Canada","0","0","0","-100","0","0","0","0","0","0","0","0","0","0"
"2006","Calgary, Alberta, municipal","48014","Removal of children from Canada","1","0","0","0","0.1","0","0","0","0","0","0","0","0","0"
"2007","Calgary, Alberta, municipal","48014","Removal of children from Canada","0","0","0","-100","0","0","0","0","0","0","0","0","0","0"
"2008","Calgary, Alberta, municipal","48014","Removal of children from Canada","0","0","0","0","0","0","0","0","0","0","0","0","0","0"
"2009","Calgary, Alberta, municipal","48014","Removal of children from Canada","0","0","0","0","0","0","0","0","0","0","0","0","0","0"
"2010","Calgary, Alberta, municipal","48014","Removal of children from Canada","0","0","0","0","0","0","0","0","0","0","0","0","0","0"
"2011","Calgary, Alberta, municipal","48014","Removal of children from Canada","0","0","0","0","0","0","0","0","0","0","0","0","0","0"
"2012","Calgary, Alberta, municipal","48014","Removal of children from Canada","0","0","0","0","0","0","0","0","0","0","0","0","0","0"
"2013","Calgary, Alberta, municipal","48014","Removal of children from Canada","0","0","0","0","0","0","0","0","0","0","0","0","0","0"
"2014","Calgary, Alberta, municipal","48014","Removal of children from Canada","0","0","0","0","0","0","0","0","0","0","0","0","0","0"
"2015","Calgary, Alberta, municipal","48014","Removal of children from Canada","0","0","0","0","0","0","0","0","0","0","0","0","0","0"
"2016","Calgary, Alberta, municipal","48014","Removal of children from Canada","0","0","0","0","0","0","0","0","0","0","0","0","0","0"
"1998","Calgary, Alberta, municipal","48014","Abduction under the age 14 contravening a custody order","9","4","0","0","1.07","0","0","0","0","4","3","3","0","0"
"1999","Calgary, Alberta, municipal","48014","Abduction under the age 14 contravening a custody order","12","3","3","30","1.39","0","0","0","0","6","2","2","0","0"
"2000","Calgary, Alberta, municipal","48014","Abduction under the age 14 contravening a custody order","7","5","2","-43.02","0.79","0","0","0","0","7","4","4","0","0"
"2001","Calgary, Alberta, municipal","48014","Abduction under the age 14 contravening a custody order","2","0","0","-72.05","0.22","0","0","0","0","0","0","0","0","0"
"2002","Calgary, Alberta, municipal","48014","Abduction under the age 14 contravening a custody order","12","4","3","486.14","1.3","0","0","0","0","7","3","3","0","0"
"2003","Calgary, Alberta, municipal","48014","Abduction under the age 14 contravening a custody order","14","12","2","14.84","1.49","0","0","0","0","14","5","5","0","0"
"2004","Calgary, Alberta, municipal","48014","Abduction under the age 14 contravening a custody order","3","2","0","-79.21","0.31","0.27","0.24","0","0","2","2","2","0","0"
"2005","Calgary, Alberta, municipal","48014","Abduction under the age 14 contravening a custody order","3","2","0","-2.95","0.3","0.26","0.23","0","0","2","2","2","0","0"
"2006","Calgary, Alberta, municipal","48014","Abduction under the age 14 contravening a custody order","3","2","1","-3.04","0.29","0.37","0.34","0","0","3","3","3","0","0"
"2007","Calgary, Alberta, municipal","48014","Abduction under the age 14 contravening a custody order","5","4","1","62.67","0.47","0.36","0.33","0","0","5","3","3","0","0"
"2008","Calgary, Alberta, municipal","48014","Abduction under the age 14 contravening a custody order","2","2","0","-60.98","0.19","0.12","0.11","0","0","2","1","1","0","0"
"2009","Calgary, Alberta, municipal","48014","Abduction under the age 14 contravening a custody order","2","1","1","-2.51","0.18","0.11","0.1","0","0","2","1","1","0","0"
"2010","Calgary, Alberta, municipal","48014","Abduction under the age 14 contravening a custody order","3","1","1","47.8","0.27","0","0","0","0","2","0","0","0","0"
"2011","Calgary, Alberta, municipal","48014","Abduction under the age 14 contravening a custody order","6","3","3","96.87","0.53","0.22","0.2","0","0","6","2","2","0","0"
"2012","Calgary, Alberta, municipal","48014","Abduction under the age 14 contravening a custody order","7","7","0","13.18","0.59","0.43","0.4","0","0","7","4","4","0","0"
"2013","Calgary, Alberta, municipal","48014","Abduction under the age 14 contravening a custody order","5","3","1","-31.07","0.41","0.31","0.29","0","0","4","3","3","0","0"
"2014","Calgary, Alberta, municipal","48014","Abduction under the age 14 contravening a custody order","5","5","0","-3.25","0.4","0.4","0.37","0","0","5","4","4","0","0"
"2015","Calgary, Alberta, municipal","48014","Abduction under the age 14 contravening a custody order","1","1","0","-80.43","0.08","0.1","0.09","0","0","1","1","1","0","0"
"2016","Calgary, Alberta, municipal","48014","Abduction under the age 14 contravening a custody order","4","3","0","290.65","0.3","0.19","0.18","0","0","3","2","2","0","0"
"1998","Calgary, Alberta, municipal","48014","Abduction under age 14, by parent or guardian","14","7","2","0","1.67","0","0","0","0","9","5","5","0","0"
"1999","Calgary, Alberta, municipal","48014","Abduction under age 14, by parent or guardian","6","2","0","-58.21","0.7","0","0","0","0","2","2","2","0","0"
"2000","Calgary, Alberta, municipal","48014","Abduction under age 14, by parent or guardian","6","2","1","-2.32","0.68","0","0","0","0","3","2","2","0","0"
"2001","Calgary, Alberta, municipal","48014","Abduction under age 14, by parent or guardian","11","0","3","79.37","1.22","0","0","0","0","3","0","0","0","0"
"2002","Calgary, Alberta, municipal","48014","Abduction under age 14, by parent or guardian","1","4","1","-91.12","0.11","0","0","0","0","5","2","2","0","0"
"2003","Calgary, Alberta, municipal","48014","Abduction under age 14, by parent or guardian","3","0","0","195.31","0.32","0","0","0","0","0","0","0","0","0"
"2004","Calgary, Alberta, municipal","48014","Abduction under age 14, by parent or guardian","5","4","1","61.69","0.52","0.4","0.36","0","0","5","3","3","0","0"
"2005","Calgary, Alberta, municipal","48014","Abduction under age 14, by parent or guardian","3","1","2","-41.77","0.3","0.13","0.12","0","0","3","1","1","0","0"
"2006","Calgary, Alberta, municipal","48014","Abduction under age 14, by parent or guardian","5","5","0","61.6","0.49","0.37","0.34","0","0","5","3","3","0","0"
"2007","Calgary, Alberta, municipal","48014","Abduction under age 14, by parent or guardian","2","1","0","-60.96","0.19","0.12","0.11","0","0","1","1","1","0","0"
"2008","Calgary, Alberta, municipal","48014","Abduction under age 14, by parent or guardian","8","1","4","290.21","0.74","0.12","0.11","0","0","5","1","1","0","0"
"2009","Calgary, Alberta, municipal","48014","Abduction under age 14, by parent or guardian","2","2","1","-75.63","0.18","0.23","0.21","0","0","3","2","2","0","0"
"2010","Calgary, Alberta, municipal","48014","Abduction under age 14, by parent or guardian","7","4","1","244.86","0.62","0.34","0.31","0","0","5","3","3","0","0"
"2011","Calgary, Alberta, municipal","48014","Abduction under age 14, by parent or guardian","3","1","0","-57.81","0.26","0.11","0.1","0","0","1","1","1","0","0"
"2012","Calgary, Alberta, municipal","48014","Abduction under age 14, by parent or guardian","0","0","0","-100","0","0","0","0","0","0","0","0","0","0"
"2013","Calgary, Alberta, municipal","48014","Abduction under age 14, by parent or guardian","0","0","0","0","0","0","0","0","0","0","0","0","0","0"
"2014","Calgary, Alberta, municipal","48014","Abduction under age 14, by parent or guardian","0","0","0","0","0","0","0","0","0","0","0","0","0","0"
"2015","Calgary, Alberta, municipal","48014","Abduction under age 14, by parent or guardian","2","0","0","0","0.16","0","0","0","0","0","0","0","0","0"
"2016","Calgary, Alberta, municipal","48014","Abduction under age 14, by parent or guardian","0","0","0","-100","0","0","0","0","0","0","0","0","0","0"
"1998","Calgary, Alberta, municipal","48014","Extortion","36","26","4","0","4.28","0","0","0","0","30","19","21","2","3"
"1999","Calgary, Alberta, municipal","48014","Extortion","30","13","9","-18.75","3.48","0","0","0","0","22","10","13","3","1"
"2000","Calgary, Alberta, municipal","48014","Extortion","13","7","3","-57.67","1.47","0","0","0","0","10","6","7","1","1"
"2001","Calgary, Alberta, municipal","48014","Extortion","20","13","2","50.52","2.22","0","0","0","0","15","13","13","0","0"
"2002","Calgary, Alberta, municipal","48014","Extortion","28","18","3","36.77","3.03","0","0","0","0","21","15","20","5","1"
"2003","Calgary, Alberta, municipal","48014","Extortion","20","17","0","-29.69","2.13","0","0","0","0","17","17","18","1","1"
"2004","Calgary, Alberta, municipal","48014","Extortion","19","10","3","-7.84","1.96","1.33","1.33","1.32","5.28","13","10","11","1","4"
"2005","Calgary, Alberta, municipal","48014","Extortion","35","23","6","78.77","3.51","2.83","2.81","2.6","3.89","29","22","24","2","3"
"2006","Calgary, Alberta, municipal","48014","Extortion","35","26","1","-3.04","3.41","2.36","2.94","9","0","27","19","26","7","0"
"2007","Calgary, Alberta, municipal","48014","Extortion","14","8","1","-60.96","1.33","0.97","0.88","0","0","9","8","8","0","0"
"2008","Calgary, Alberta, municipal","48014","Extortion","22","11","1","53.3","2.04","0.82","0.75","0","0","12","7","7","0","0"
"2009","Calgary, Alberta, municipal","48014","Extortion","32","21","1","41.8","2.89","2.06","2.41","6.45","1.29","22","18","23","5","1"
"2010","Calgary, Alberta, municipal","48014","Extortion","23","13","1","-29.18","2.05","0.79","1.03","3.85","1.28","14","7","10","3","1"
"2011","Calgary, Alberta, municipal","48014","Extortion","34","8","4","45.51","2.98","0.67","0.71","1.28","0","12","6","7","1","0"
"2012","Calgary, Alberta, municipal","48014","Extortion","27","17","5","-22.96","2.29","1.18","1.68","7.62","0","22","11","17","6","0"
"2013","Calgary, Alberta, municipal","48014","Extortion","28","15","2","0.07","2.3","1.03","1.15","2.53","0","17","10","12","2","0"
"2014","Calgary, Alberta, municipal","48014","Extortion","52","21","3","79.67","4.13","1.6","1.66","2.52","5.04","24","16","18","2","4"
"2015","Calgary, Alberta, municipal","48014","Extortion","70","8","6","31.74","5.43","0.88","0.81","0","1.25","14","9","9","0","1"
"2016","Calgary, Alberta, municipal","48014","Extortion","56","13","3","-21.87","4.25","1.15","1.06","0","1.22","16","12","12","0","1"
"1998","Calgary, Alberta, municipal","48014","Criminal harassment","123","62","21","0","14.63","0","0","0","0","83","48","49","1","2"
"1999","Calgary, Alberta, municipal","48014","Criminal harassment","105","65","15","-16.77","12.18","0","0","0","0","80","56","56","0","1"
"2000","Calgary, Alberta, municipal","48014","Criminal harassment","202","113","37","87.93","22.89","0","0","0","0","150","89","92","3","2"
"2001","Calgary, Alberta, municipal","48014","Criminal harassment","183","100","31","-11.36","20.28","0","0","0","0","131","81","83","2","18"
"2002","Calgary, Alberta, municipal","48014","Criminal harassment","164","93","34","-12.45","17.76","0","0","0","0","127","74","75","1","7"
"2003","Calgary, Alberta, municipal","48014","Criminal harassment","196","113","40","17.64","20.89","0","0","0","0","153","88","92","4","3"
"2004","Calgary, Alberta, municipal","48014","Criminal harassment","241","152","47","19.29","24.92","15.41","14.85","9.23","5.28","199","116","123","7","4"
"2005","Calgary, Alberta, municipal","48014","Criminal harassment","178","104","27","-28.32","17.86","11.31","11.23","10.39","9.09","131","88","96","8","7"
"2006","Calgary, Alberta, municipal","48014","Criminal harassment","194","117","28","5.67","18.88","11.55","10.76","2.57","11.57","145","93","95","2","9"
"2007","Calgary, Alberta, municipal","48014","Criminal harassment","211","129","29","6.15","20.04","12.07","11.37","3.87","3.87","158","100","103","3","3"
"2008","Calgary, Alberta, municipal","48014","Criminal harassment","236","129","37","9.11","21.86","11.73","10.76","0","1.3","166","100","100","0","1"
"2009","Calgary, Alberta, municipal","48014","Criminal harassment","259","149","64","6.99","23.39","12.79","12.17","5.16","7.74","213","112","116","4","6"
"2010","Calgary, Alberta, municipal","48014","Criminal harassment","319","174","54","21.36","28.39","15.09","14.28","5.13","14.11","228","134","138","4","11"
"2011","Calgary, Alberta, municipal","48014","Criminal harassment","298","143","52","-8.05","26.1","11.97","11.53","6.38","2.55","195","108","113","5","2"
"2012","Calgary, Alberta, municipal","48014","Criminal harassment","297","167","29","-3.31","25.24","13.52","12.57","1.27","2.54","196","126","127","1","2"
"2013","Calgary, Alberta, municipal","48014","Criminal harassment","291","146","28","-5.45","23.86","11.16","10.7","5.05","15.16","174","108","112","4","12"
"2014","Calgary, Alberta, municipal","48014","Criminal harassment","243","95","31","-19.21","19.28","8.58","7.95","0","2.52","126","86","86","0","2"
"2015","Calgary, Alberta, municipal","48014","Criminal harassment","337","117","42","35.72","26.16","9.28","8.69","1.25","3.74","159","95","96","1","3"
"2016","Calgary, Alberta, municipal","48014","Criminal harassment","339","135","36","-1.76","25.7","9.17","8.59","1.22","7.32","171","96","97","1","6"
"1998","Calgary, Alberta, municipal","48014","Uttering threats","164","87","16","0","19.51","0","0","0","0","103","44","49","5","0"
"1999","Calgary, Alberta, municipal","48014","Uttering threats","863","379","234","413.08","100.09","0","0","0","0","613","181","228","47","56"
"2000","Calgary, Alberta, municipal","48014","Uttering threats","1030","500","275","16.59","116.69","0","0","0","0","775","264","326","62","72"
"2001","Calgary, Alberta, municipal","48014","Uttering threats","1026","486","293","-2.54","113.73","0","0","0","0","779","247","285","38","57"
"2002","Calgary, Alberta, municipal","48014","Uttering threats","952","438","278","-9.36","103.09","0","0","0","0","716","245","284","39","77"
"2003","Calgary, Alberta, municipal","48014","Uttering threats","914","464","226","-5.49","97.43","0","0","0","0","690","225","275","50","68"
"2004","Calgary, Alberta, municipal","48014","Uttering threats","1052","445","291","11.66","108.79","31.36","32.47","43.53","96.28","736","236","269","33","73"
"2005","Calgary, Alberta, municipal","48014","Uttering threats","967","486","219","-10.79","97.05","31.75","33.8","54.53","71.41","705","247","289","42","55"
"2006","Calgary, Alberta, municipal","48014","Uttering threats","899","457","197","-9.86","87.48","28.56","30.8","53.98","57.83","654","230","272","42","45"
"2007","Calgary, Alberta, municipal","48014","Uttering threats","819","340","205","-11.09","77.78","19.55","20.86","34.84","56.77","545","162","189","27","44"
"2008","Calgary, Alberta, municipal","48014","Uttering threats","820","386","147","-2.33","75.97","24.41","25.5","37.57","54.41","533","208","237","29","42"
"2009","Calgary, Alberta, municipal","48014","Uttering threats","859","369","191","2.13","77.58","20.1","21.4","36.1","49","560","176","204","28","38"
"2010","Calgary, Alberta, municipal","48014","Uttering threats","987","362","233","13.21","87.83","20.15","21.22","33.34","44.88","595","179","205","26","35"
"2011","Calgary, Alberta, municipal","48014","Uttering threats","868","331","189","-13.43","76.03","19.29","21.42","45.95","35.74","520","174","210","36","28"
"2012","Calgary, Alberta, municipal","48014","Uttering threats","784","312","108","-12.38","66.62","17.82","18.21","22.85","24.12","420","166","184","18","19"
"2013","Calgary, Alberta, municipal","48014","Uttering threats","757","280","125","-6.83","62.08","16.43","17","24","20.21","405","159","178","19","16"
"2014","Calgary, Alberta, municipal","48014","Uttering threats","898","358","145","14.77","71.24","19.15","19.31","21.4","27.69","503","192","209","17","22"
"2015","Calgary, Alberta, municipal","48014","Uttering threats","844","350","113","-8.02","65.53","17.77","19.38","39.88","39.88","463","182","214","32","32"
"2016","Calgary, Alberta, municipal","48014","Uttering threats","883","336","122","2.18","66.95","18.71","18.33","13.42","20.74","458","196","207","11","17"
"1998","Calgary, Alberta, municipal","48014","Indecent/Harassing communications","85","18","34","0","10.11","0","0","0","0","52","12","14","2","10"
"1999","Calgary, Alberta, municipal","48014","Indecent/Harassing communications","66","16","23","-24.29","7.65","0","0","0","0","39","9","10","1","6"
"2000","Calgary, Alberta, municipal","48014","Indecent/Harassing communications","70","10","15","3.6","7.93","0","0","0","0","25","8","9","1","8"
"2001","Calgary, Alberta, municipal","48014","Indecent/Harassing communications","72","10","34","0.63","7.98","0","0","0","0","44","9","10","1","14"
"2002","Calgary, Alberta, municipal","48014","Indecent/Harassing communications","83","20","33","12.61","8.99","0","0","0","0","53","10","10","0","7"
"2003","Calgary, Alberta, municipal","48014","Indecent/Harassing communications","63","8","21","-25.28","6.72","0","0","0","0","29","8","8","0","7"
"2004","Calgary, Alberta, municipal","48014","Indecent/Harassing communications","58","8","20","-10.69","6","0.8","0.85","1.32","10.55","28","6","7","1","8"
"2005","Calgary, Alberta, municipal","48014","Indecent/Harassing communications","71","16","26","18.8","7.13","1.41","1.52","2.6","7.79","42","11","13","2","6"
"2006","Calgary, Alberta, municipal","48014","Indecent/Harassing communications","49","11","12","-33.09","4.77","0.99","1.13","2.57","2.57","23","8","10","2","2"
"2007","Calgary, Alberta, municipal","48014","Indecent/Harassing communications","36","7","9","-28.29","3.42","0.84","0.77","0","3.87","16","7","7","0","3"
"2008","Calgary, Alberta, municipal","48014","Indecent/Harassing communications","47","7","12","27.36","4.35","0.47","0.65","2.59","12.95","19","4","6","2","10"
"2009","Calgary, Alberta, municipal","48014","Indecent/Harassing communications","54","10","14","12.01","4.88","0.8","0.73","0","3.87","24","7","7","0","3"
"2010","Calgary, Alberta, municipal","48014","Indecent/Harassing communications","59","6","16","7.65","5.25","0.11","0.1","0","0","22","1","1","0","0"
"2011","Calgary, Alberta, municipal","48014","Indecent/Harassing communications","46","2","13","-23.26","4.03","0","0","0","0","15","0","0","0","0"
"2012","Calgary, Alberta, municipal","48014","Indecent/Harassing communications","36","4","4","-24.08","3.06","0","0","0","0","8","0","0","0","0"
"2013","Calgary, Alberta, municipal","48014","Indecent/Harassing communications","1","0","0","-97.32","0.08","0","0","0","0","0","0","0","0","0"
"2014","Calgary, Alberta, municipal","48014","Indecent/Harassing communications","9","0","2","770.72","0.71","0","0","0","0","2","0","0","0","0"
"2015","Calgary, Alberta, municipal","48014","Indecent/Harassing communications","39","9","3","324.08","3.03","0.68","0.63","0","0","12","7","7","0","0"
"2016","Calgary, Alberta, municipal","48014","Indecent/Harassing communications","45","9","1","12.69","3.41","0.67","0.62","0","0","10","7","7","0","0"
"2012","Calgary, Alberta, municipal","48014","Total commodification of sexual activity violations","0","0","0","0","0","0","0","0","0","0","0","0","0","0"
"2013","Calgary, Alberta, municipal","48014","Total commodification of sexual activity violations","0","0","0","0","0","0","0","0","0","0","0","0","0","0"
"2014","Calgary, Alberta, municipal","48014","Total commodification of sexual activity violations","0","0","0","0","0","0","0","0","0","0","0","0","0","0"
"2015","Calgary, Alberta, municipal","48014","Total commodification of sexual activity violations","68","66","1","0","5.28","6.74","6.34","1.25","0","67","69","70","1","0"
"2016","Calgary, Alberta, municipal","48014","Total commodification of sexual activity violations","47","45","0","-32.5","3.56","4.49","4.16","0","0","45","47","47","0","0"
"2012","Calgary, Alberta, municipal","48014","Obtaining sexual services for consideration","0","0","0","0","0","0","0","0","0","0","0","0","0","0"
"2013","Calgary, Alberta, municipal","48014","Obtaining sexual services for consideration","0","0","0","0","0","0","0","0","0","0","0","0","0","0"
"2014","Calgary, Alberta, municipal","48014","Obtaining sexual services for consideration","0","0","0","0","0","0","0","0","0","0","0","0","0","0"
"2015","Calgary, Alberta, municipal","48014","Obtaining sexual services for consideration","60","59","0","0","4.66","5.96","5.61","1.25","0","59","61","62","1","0"
"2016","Calgary, Alberta, municipal","48014","Obtaining sexual services for consideration","27","27","0","-56.05","2.05","2.58","2.39","0","0","27","27","27","0","0"
"2012","Calgary, Alberta, municipal","48014","Obtaining sexual services for consideration from person under 18 years","0","0","0","0","0","0","0","0","0","0","0","0","0","0"
"2013","Calgary, Alberta, municipal","48014","Obtaining sexual services for consideration from person under 18 years","0","0","0","0","0","0","0","0","0","0","0","0","0","0"
"2014","Calgary, Alberta, municipal","48014","Obtaining sexual services for consideration from person under 18 years","0","0","0","0","0","0","0","0","0","0","0","0","0","0"
"2015","Calgary, Alberta, municipal","48014","Obtaining sexual services for consideration from person under 18 years","5","5","0","0","0.39","0.49","0.45","0","0","5","5","5","0","0"
"2016","Calgary, Alberta, municipal","48014","Obtaining sexual services for consideration from person under 18 years","1","0","0","-80.47","0.08","0","0","0","0","0","0","0","0","0"
"2012","Calgary, Alberta, municipal","48014","Receive material benefit from sexual services","0","0","0","0","0","0","0","0","0","0","0","0","0","0"
"2013","Calgary, Alberta, municipal","48014","Receive material benefit from sexual services","0","0","0","0","0","0","0","0","0","0","0","0","0","0"
"2014","Calgary, Alberta, municipal","48014","Receive material benefit from sexual services","0","0","0","0","0","0","0","0","0","0","0","0","0","0"
"2015","Calgary, Alberta, municipal","48014","Receive material benefit from sexual services","2","2","0","0","0.16","0.29","0.27","0","0","2","3","3","0","0"
"2016","Calgary, Alberta, municipal","48014","Receive material benefit from sexual services","0","0","0","-100","0","0.19","0.18","0","0","0","2","2","0","0"
"2012","Calgary, Alberta, municipal","48014","Receive material benefit from sexual services provided by a person under 18 years","0","0","0","0","0","0","0","0","0","0","0","0","0","0"
"2013","Calgary, Alberta, municipal","48014","Receive material benefit from sexual services provided by a person under 18 years","0","0","0","0","0","0","0","0","0","0","0","0","0","0"
"2014","Calgary, Alberta, municipal","48014","Receive material benefit from sexual services provided by a person under 18 years","0","0","0","0","0","0","0","0","0","0","0","0","0","0"
"2015","Calgary, Alberta, municipal","48014","Receive material benefit from sexual services provided by a person under 18 years","0","0","0","0","0","0","0","0","0","0","0","0","0","0"
"2016","Calgary, Alberta, municipal","48014","Receive material benefit from sexual services provided by a person under 18 years","0","0","0","0","0","0","0","0","0","0","0","0","0","0"
"2012","Calgary, Alberta, municipal","48014","Procuring","3","3","0","-2.99","0.25","0.32","0.3","0","0","3","3","3","0","0"
"2013","Calgary, Alberta, municipal","48014","Procuring","46","40","0","1379.61","3.77","4.13","3.82","0","0","40","40","40","0","0"
"2014","Calgary, Alberta, municipal","48014","Procuring","7","12","0","-85.28","0.56","1.2","1.11","0","0","12","12","12","0","0"
"2015","Calgary, Alberta, municipal","48014","Procuring","3","3","0","-58.06","0.23","0.29","0.27","0","0","3","3","3","0","0"
"2016","Calgary, Alberta, municipal","48014","Procuring","23","24","0","30.22","1.74","2.29","2.12","0","0","24","24","24","0","0"
"2012","Calgary, Alberta, municipal","48014","Procuring - person under 18 years","0","0","0","0","0","0","0","0","0","0","0","0","0","0"
"2013","Calgary, Alberta, municipal","48014","Procuring - person under 18 years","0","0","0","0","0","0","0","0","0","0","0","0","0","0"
"2014","Calgary, Alberta, municipal","48014","Procuring - person under 18 years","0","0","0","0","0","0","0","0","0","0","0","0","0","0"
"2015","Calgary, Alberta, municipal","48014","Procuring - person under 18 years","1","0","1","0","0.08","0","0","0","0","1","0","0","0","0"
"2016","Calgary, Alberta, municipal","48014","Procuring - person under 18 years","0","0","0","-100","0","0","0","0","0","0","0","0","0","0"
"2012","Calgary, Alberta, municipal","48014","Advertising sexual services","0","0","0","0","0","0","0","0","0","0","0","0","0","0"
"2013","Calgary, Alberta, municipal","48014","Advertising sexual services","0","0","0","0","0","0","0","0","0","0","0","0","0","0"
"2014","Calgary, Alberta, municipal","48014","Advertising sexual services","0","0","0","0","0","0","0","0","0","0","0","0","0","0"
"2015","Calgary, Alberta, municipal","48014","Advertising sexual services","0","0","0","0","0","0","0","0","0","0","0","0","0","0"
"2016","Calgary, Alberta, municipal","48014","Advertising sexual services","0","0","0","0","0","0","0","0","0","0","0","0","0","0"
"1998","Calgary, Alberta, municipal","48014","Total other violent violations","91","34","15","0","10.82","0","0","0","0","49","19","22","3","1"
"1999","Calgary, Alberta, municipal","48014","Total other violent violations","97","37","16","3.93","11.25","0","0","0","0","53","15","25","10","6"
"2000","Calgary, Alberta, municipal","48014","Total other violent violations","77","43","20","-22.46","8.72","0","0","0","0","63","32","44","12","6"
"2001","Calgary, Alberta, municipal","48014","Total other violent violations","78","40","18","-0.89","8.65","0","0","0","0","58","23","32","9","4"
"2002","Calgary, Alberta, municipal","48014","Total other violent violations","81","29","20","1.45","8.77","0","0","0","0","49","18","19","1","3"
"2003","Calgary, Alberta, municipal","48014","Total other violent violations","83","46","23","0.87","8.85","0","0","0","0","69","28","39","11","6"
"2004","Calgary, Alberta, municipal","48014","Total other violent violations","81","33","7","-5.32","8.38","2.79","2.9","3.96","3.96","40","21","24","3","3"
"2005","Calgary, Alberta, municipal","48014","Total other violent violations","83","35","16","-0.56","8.33","2.44","2.81","6.49","6.49","51","19","24","5","5"
"2006","Calgary, Alberta, municipal","48014","Total other violent violations","83","26","8","-3.04","8.08","3.1","2.94","1.29","1.29","34","25","26","1","1"
"2007","Calgary, Alberta, municipal","48014","Total other violent violations","38","26","4","-55.32","3.61","2.05","2.1","2.58","1.29","30","17","19","2","1"
"2008","Calgary, Alberta, municipal","48014","Total other violent violations","56","27","9","43.76","5.19","1.99","2.04","2.59","0","36","17","19","2","0"
"2009","Calgary, Alberta, municipal","48014","Total other violent violations","62","35","4","7.93","5.6","2.51","2.52","2.58","0","39","22","24","2","0"
"2010","Calgary, Alberta, municipal","48014","Total other violent violations","45","21","9","-28.49","4","1.8","1.66","0","1.28","30","16","16","0","1"
"2011","Calgary, Alberta, municipal","48014","Total other violent violations","53","34","3","15.93","4.64","1.55","1.73","3.83","2.55","37","14","17","3","2"
"2012","Calgary, Alberta, municipal","48014","Total other violent violations","104","80","7","90.36","8.84","2.36","2.38","2.54","0","87","22","24","2","0"
"2013","Calgary, Alberta, municipal","48014","Total other violent violations","68","50","5","-36.91","5.58","4.65","4.39","1.26","1.26","55","45","46","1","1"
"2014","Calgary, Alberta, municipal","48014","Total other violent violations","79","35","5","12.4","6.27","2.99","3.05","3.78","3.78","40","30","33","3","3"
"2015","Calgary, Alberta, municipal","48014","Total other violent violations","61","46","7","-24.43","4.74","2.93","3.26","7.48","2.49","53","30","36","6","2"
"2016","Calgary, Alberta, municipal","48014","Total other violent violations","50","26","2","-19.95","3.79","2.67","2.66","2.44","1.22","28","28","30","2","1"
"1998","Calgary, Alberta, municipal","48014","Conspire to commit murder","1","1","0","0","0.12","0","0","0","0","1","1","1","0","0"
"1999","Calgary, Alberta, municipal","48014","Conspire to commit murder","0","0","0","-100","0","0","0","0","0","0","0","0","0","0"
"2000","Calgary, Alberta, municipal","48014","Conspire to commit murder","0","0","0","0","0","0","0","0","0","0","0","0","0","0"
"2001","Calgary, Alberta, municipal","48014","Conspire to commit murder","0","0","0","0","0","0","0","0","0","0","0","0","0","0"
"2002","Calgary, Alberta, municipal","48014","Conspire to commit murder","0","0","0","0","0","0","0","0","0","0","0","0","0","0"
"2003","Calgary, Alberta, municipal","48014","Conspire to commit murder","1","1","0","0","0.11","0","0","0","0","1","1","1","0","0"
"2004","Calgary, Alberta, municipal","48014","Conspire to commit murder","0","0","0","-100","0","0","0","0","0","0","0","0","0","0"
"2005","Calgary, Alberta, municipal","48014","Conspire to commit murder","0","0","0","0","0","0","0","0","0","0","0","0","0","0"
"2006","Calgary, Alberta, municipal","48014","Conspire to commit murder","0","0","0","0","0","0","0","0","0","0","0","0","0","0"
"2007","Calgary, Alberta, municipal","48014","Conspire to commit murder","0","0","0","0","0","0","0","0","0","0","0","0","0","0"
"2008","Calgary, Alberta, municipal","48014","Conspire to commit murder","1","0","0","0","0.09","0","0","0","0","0","0","0","0","0"
"2009","Calgary, Alberta, municipal","48014","Conspire to commit murder","0","0","0","-100","0","0","0","0","0","0","0","0","0","0"
"2010","Calgary, Alberta, municipal","48014","Conspire to commit murder","0","0","0","0","0","0","0","0","0","0","0","0","0","0"
"2011","Calgary, Alberta, municipal","48014","Conspire to commit murder","0","0","0","0","0","0","0","0","0","0","0","0","0","0"
"2012","Calgary, Alberta, municipal","48014","Conspire to commit murder","1","0","0","0","0.08","0","0","0","0","0","0","0","0","0"
"2013","Calgary, Alberta, municipal","48014","Conspire to commit murder","1","2","0","-3.5","0.08","0.62","0.57","0","0","2","6","6","0","0"
"2014","Calgary, Alberta, municipal","48014","Conspire to commit murder","0","0","0","-100","0","0","0","0","0","0","0","0","0","0"
"2015","Calgary, Alberta, municipal","48014","Conspire to commit murder","3","0","0","0","0.23","0","0","0","0","0","0","0","0","0"
"2016","Calgary, Alberta, municipal","48014","Conspire to commit murder","1","1","0","-67.45","0.08","0.29","0.27","0","0","1","3","3","0","0"
"1998","Calgary, Alberta, municipal","48014","Other sexual violations","71","31","13","0","8.45","0","0","0","0","44","16","19","3","1"
"1999","Calgary, Alberta, municipal","48014","Other sexual violations","66","26","10","-9.36","7.65","0","0","0","0","36","10","19","9","5"
"2000","Calgary, Alberta, municipal","48014","Other sexual violations","61","30","17","-9.72","6.91","0","0","0","0","47","22","25","3","6"
"2001","Calgary, Alberta, municipal","48014","Other sexual violations","57","27","14","-8.58","6.32","0","0","0","0","41","14","18","4","4"
"2002","Calgary, Alberta, municipal","48014","Other sexual violations","59","15","17","1.12","6.39","0","0","0","0","32","9","10","1","3"
"2003","Calgary, Alberta, municipal","48014","Other sexual violations","47","24","17","-21.58","5.01","0","0","0","0","41","11","13","2","5"
"2004","Calgary, Alberta, municipal","48014","Other sexual violations","53","15","6","9.4","5.48","1.2","1.09","0","2.64","21","9","9","0","2"
"2005","Calgary, Alberta, municipal","48014","Other sexual violations","48","17","9","-12.11","4.82","1.16","1.4","3.89","3.89","26","9","12","3","3"
"2006","Calgary, Alberta, municipal","48014","Other sexual violations","44","7","2","-11.12","4.28","0.99","0.91","0","0","9","8","8","0","0"
"2007","Calgary, Alberta, municipal","48014","Other sexual violations","10","8","2","-77.82","0.95","0.12","0.11","0","0","10","1","1","0","0"
"2008","Calgary, Alberta, municipal","48014","Other sexual violations","10","1","7","-2.45","0.93","0.12","0.11","0","0","8","1","1","0","0"
"2009","Calgary, Alberta, municipal","48014","Other sexual violations","2","0","0","-80.5","0.18","0","0","0","0","0","0","0","0","0"
"2010","Calgary, Alberta, municipal","48014","Other sexual violations","5","1","0","146.33","0.44","0","0","0","0","1","0","0","0","0"
"2011","Calgary, Alberta, municipal","48014","Other sexual violations","9","1","1","77.18","0.79","0","0","0","0","2","0","0","0","0"
"2012","Calgary, Alberta, municipal","48014","Other sexual violations","10","2","1","7.79","0.85","0","0","0","0","3","0","0","0","0"
"2013","Calgary, Alberta, municipal","48014","Other sexual violations","0","0","0","-100","0","0","0","0","0","0","0","0","0","0"
"2014","Calgary, Alberta, municipal","48014","Other sexual violations","5","0","0","0","0.4","0","0","0","0","0","0","0","0","0"
"2015","Calgary, Alberta, municipal","48014","Other sexual violations","10","3","1","95.73","0.78","0.1","0.09","0","1.25","4","1","1","0","1"
"2016","Calgary, Alberta, municipal","48014","Other sexual violations","2","1","0","-80.47","0.15","0.19","0.18","0","0","1","2","2","0","0"
"2005","Calgary, Alberta, municipal","48014","Sexual Exploitation of a person with a disability","0","0","0","0","0","0","0","0","0","0","0","0","0","0"
"2006","Calgary, Alberta, municipal","48014","Sexual Exploitation of a person with a disability","0","0","0","0","0","0","0","0","0","0","0","0","0","0"
"2007","Calgary, Alberta, municipal","48014","Sexual Exploitation of a person with a disability","0","0","0","0","0","0","0","0","0","0","0","0","0","0"
"2008","Calgary, Alberta, municipal","48014","Sexual Exploitation of a person with a disability","0","0","0","0","0","0","0","0","0","0","0","0","0","0"
"2009","Calgary, Alberta, municipal","48014","Sexual Exploitation of a person with a disability","0","0","0","0","0","0","0","0","0","0","0","0","0","0"
"2010","Calgary, Alberta, municipal","48014","Sexual Exploitation of a person with a disability","0","0","0","0","0","0","0","0","0","0","0","0","0","0"
"2011","Calgary, Alberta, municipal","48014","Sexual Exploitation of a person with a disability","0","0","0","0","0","0","0","0","0","0","0","0","0","0"
"2012","Calgary, Alberta, municipal","48014","Sexual Exploitation of a person with a disability","0","0","0","0","0","0","0","0","0","0","0","0","0","0"
"2013","Calgary, Alberta, municipal","48014","Sexual Exploitation of a person with a disability","0","0","0","0","0","0","0","0","0","0","0","0","0","0"
"2014","Calgary, Alberta, municipal","48014","Sexual Exploitation of a person with a disability","0","0","0","0","0","0","0","0","0","0","0","0","0","0"
"2015","Calgary, Alberta, municipal","48014","Sexual Exploitation of a person with a disability","0","0","0","0","0","0","0","0","0","0","0","0","0","0"
"2016","Calgary, Alberta, municipal","48014","Sexual Exploitation of a person with a disability","0","0","0","0","0","0","0","0","0","0","0","0","0","0"
"2005","Calgary, Alberta, municipal","48014","Incest","1","1","0","0","0.1","0","0","0","0","1","0","0","0","0"
"2006","Calgary, Alberta, municipal","48014","Incest","1","1","0","-3.04","0.1","0","0","0","0","1","0","0","0","0"
"2007","Calgary, Alberta, municipal","48014","Incest","2","1","0","95.2","0.19","0","0","0","0","1","0","0","0","0"
"2008","Calgary, Alberta, municipal","48014","Incest","5","4","1","143.88","0.46","0","0","0","0","5","0","0","0","0"
"2009","Calgary, Alberta, municipal","48014","Incest","7","4","1","36.48","0.63","0.11","0.1","0","0","5","1","1","0","0"
"2010","Calgary, Alberta, municipal","48014","Incest","4","2","1","-43.7","0.36","0.11","0.1","0","1.28","3","1","1","0","1"
"2011","Calgary, Alberta, municipal","48014","Incest","1","0","0","-75.39","0.09","0","0","0","0","0","0","0","0","0"
"2012","Calgary, Alberta, municipal","48014","Incest","3","3","1","191.03","0.25","0.32","0.3","0","0","4","3","3","0","0"
"2013","Calgary, Alberta, municipal","48014","Incest","3","1","1","-3.5","0.25","0.1","0.1","0","1.26","2","1","1","0","1"
"2014","Calgary, Alberta, municipal","48014","Incest","3","2","0","-3.25","0.24","0.2","0.18","0","0","2","2","2","0","0"
"2015","Calgary, Alberta, municipal","48014","Incest","2","2","1","-34.76","0.16","0.2","0.18","0","0","3","2","2","0","0"
"2016","Calgary, Alberta, municipal","48014","Incest","5","3","0","144.16","0.38","0.1","0.27","2.44","0","3","1","3","2","0"
"2005","Calgary, Alberta, municipal","48014","Corrupting morals of a child","0","0","0","0","0","0","0","0","0","0","0","0","0","0"
"2006","Calgary, Alberta, municipal","48014","Corrupting morals of a child","0","0","0","0","0","0","0","0","0","0","0","0","0","0"
"2007","Calgary, Alberta, municipal","48014","Corrupting morals of a child","0","0","0","0","0","0","0","0","0","0","0","0","0","0"
"2008","Calgary, Alberta, municipal","48014","Corrupting morals of a child","0","0","0","0","0","0","0","0","0","0","0","0","0","0"
"2009","Calgary, Alberta, municipal","48014","Corrupting morals of a child","1","0","0","0","0.09","0","0","0","0","0","0","0","0","0"
"2010","Calgary, Alberta, municipal","48014","Corrupting morals of a child","1","0","1","-1.47","0.09","0","0","0","0","1","0","0","0","0"
"2011","Calgary, Alberta, municipal","48014","Corrupting morals of a child","0","0","0","-100","0","0","0","0","0","0","0","0","0","0"
"2012","Calgary, Alberta, municipal","48014","Corrupting morals of a child","0","0","0","0","0","0","0","0","0","0","0","0","0","0"
"2013","Calgary, Alberta, municipal","48014","Corrupting morals of a child","0","0","0","0","0","0","0","0","0","0","0","0","0","0"
"2014","Calgary, Alberta, municipal","48014","Corrupting morals of a child","0","0","0","0","0","0","0","0","0","0","0","0","0","0"
"2015","Calgary, Alberta, municipal","48014","Corrupting morals of a child","0","0","0","0","0","0","0","0","0","0","0","0","0","0"
"2016","Calgary, Alberta, municipal","48014","Corrupting morals of a child","0","0","0","0","0","0","0","0","0","0","0","0","0","0"
"2005","Calgary, Alberta, municipal","48014","Anal intercourse","0","0","0","0","0","0","0","0","0","0","0","0","0","0"
"2006","Calgary, Alberta, municipal","48014","Anal intercourse","0","0","0","0","0","0","0","0","0","0","0","0","0","0"
"2007","Calgary, Alberta, municipal","48014","Anal intercourse","0","0","0","0","0","0","0","0","0","0","0","0","0","0"
"2008","Calgary, Alberta, municipal","48014","Anal intercourse","0","0","0","0","0","0","0","0","0","0","0","0","0","0"
"2009","Calgary, Alberta, municipal","48014","Anal intercourse","0","0","0","0","0","0","0","0","0","0","0","0","0","0"
"2010","Calgary, Alberta, municipal","48014","Anal intercourse","0","0","0","0","0","0","0","0","0","0","0","0","0","0"
"2011","Calgary, Alberta, municipal","48014","Anal intercourse","0","0","0","0","0","0","0","0","0","0","0","0","0","0"
"2012","Calgary, Alberta, municipal","48014","Anal intercourse","0","0","0","0","0","0","0","0","0","0","0","0","0","0"
"2013","Calgary, Alberta, municipal","48014","Anal intercourse","0","0","0","0","0","0","0","0","0","0","0","0","0","0"
"2014","Calgary, Alberta, municipal","48014","Anal intercourse","0","0","0","0","0","0","0","0","0","0","0","0","0","0"
"2015","Calgary, Alberta, municipal","48014","Anal intercourse","0","0","0","0","0","0","0","0","0","0","0","0","0","0"
"2016","Calgary, Alberta, municipal","48014","Anal intercourse","0","0","0","0","0","0","0","0","0","0","0","0","0","0"
"2005","Calgary, Alberta, municipal","48014","Bestiality, commit or compel person","0","0","0","0","0","0","0","0","0","0","0","0","0","0"
"2006","Calgary, Alberta, municipal","48014","Bestiality, commit or compel person","0","0","0","0","0","0","0","0","0","0","0","0","0","0"
"2007","Calgary, Alberta, municipal","48014","Bestiality, commit or compel person","0","0","0","0","0","0","0","0","0","0","0","0","0","0"
"2008","Calgary, Alberta, municipal","48014","Bestiality, commit or compel person","0","0","0","0","0","0","0","0","0","0","0","0","0","0"
"2009","Calgary, Alberta, municipal","48014","Bestiality, commit or compel person","0","0","0","0","0","0","0","0","0","0","0","0","0","0"
"2010","Calgary, Alberta, municipal","48014","Bestiality, commit or compel person","0","0","0","0","0","0","0","0","0","0","0","0","0","0"
"2011","Calgary, Alberta, municipal","48014","Bestiality, commit or compel person","0","0","0","0","0","0","0","0","0","0","0","0","0","0"
"2012","Calgary, Alberta, municipal","48014","Bestiality, commit or compel person","0","0","0","0","0","0","0","0","0","0","0","0","0","0"
"2013","Calgary, Alberta, municipal","48014","Bestiality, commit or compel person","0","0","0","0","0","0","0","0","0","0","0","0","0","0"
"2014","Calgary, Alberta, municipal","48014","Bestiality, commit or compel person","0","0","0","0","0","0","0","0","0","0","0","0","0","0"
"2015","Calgary, Alberta, municipal","48014","Bestiality, commit or compel person","0","0","0","0","0","0","0","0","0","0","0","0","0","0"
"2016","Calgary, Alberta, municipal","48014","Bestiality, commit or compel person","0","0","0","0","0","0","0","0","0","0","0","0","0","0"
"1998","Calgary, Alberta, municipal","48014","Voyeurism","0","0","0","0","0","0","0","0","0","0","0","0","0","0"
"1999","Calgary, Alberta, municipal","48014","Voyeurism","0","0","0","0","0","0","0","0","0","0","0","0","0","0"
"2000","Calgary, Alberta, municipal","48014","Voyeurism","0","0","0","0","0","0","0","0","0","0","0","0","0","0"
"2001","Calgary, Alberta, municipal","48014","Voyeurism","0","0","0","0","0","0","0","0","0","0","0","0","0","0"
"2002","Calgary, Alberta, municipal","48014","Voyeurism","0","0","0","0","0","0","0","0","0","0","0","0","0","0"
"2003","Calgary, Alberta, municipal","48014","Voyeurism","0","0","0","0","0","0","0","0","0","0","0","0","0","0"
"2004","Calgary, Alberta, municipal","48014","Voyeurism","0","0","0","0","0","0","0","0","0","0","0","0","0","0"
"2005","Calgary, Alberta, municipal","48014","Voyeurism","0","0","0","0","0","0","0","0","0","0","0","0","0","0"
"2006","Calgary, Alberta, municipal","48014","Voyeurism","4","4","0","0","0.39","0.5","0.45","0","0","4","4","4","0","0"
"2007","Calgary, Alberta, municipal","48014","Voyeurism","4","2","1","-2.4","0.38","0.12","0.22","1.29","0","3","1","2","1","0"
"2008","Calgary, Alberta, municipal","48014","Voyeurism","6","6","0","46.33","0.56","0.59","0.54","0","0","6","5","5","0","0"
"2009","Calgary, Alberta, municipal","48014","Voyeurism","7","3","1","13.74","0.63","0.34","0.31","0","0","4","3","3","0","0"
"2010","Calgary, Alberta, municipal","48014","Voyeurism","8","5","0","12.61","0.71","0.56","0.52","0","0","5","5","5","0","0"
"2011","Calgary, Alberta, municipal","48014","Voyeurism","9","4","1","10.74","0.79","0.33","0.41","1.28","0","5","3","4","1","0"
"2012","Calgary, Alberta, municipal","48014","Voyeurism","14","9","3","50.91","1.19","0.97","0.89","0","0","12","9","9","0","0"
"2013","Calgary, Alberta, municipal","48014","Voyeurism","21","12","3","44.74","1.72","1.14","1.05","0","0","15","11","11","0","0"
"2014","Calgary, Alberta, municipal","48014","Voyeurism","37","20","3","70.46","2.94","1.89","1.85","1.26","3.78","23","19","20","1","3"
"2015","Calgary, Alberta, municipal","48014","Voyeurism","17","7","3","-55.03","1.32","0.59","0.63","1.25","1.25","10","6","7","1","1"
"2016","Calgary, Alberta, municipal","48014","Voyeurism","10","3","1","-42.55","0.76","0.29","0.27","0","1.22","4","3","3","0","1"
"2012","Calgary, Alberta, municipal","48014","Nonconsensual distribution of intimate images","0","0","0","0","0","0","0","0","0","0","0","0","0","0"
"2013","Calgary, Alberta, municipal","48014","Nonconsensual distribution of intimate images","0","0","0","0","0","0","0","0","0","0","0","0","0","0"
"2014","Calgary, Alberta, municipal","48014","Nonconsensual distribution of intimate images","0","0","0","0","0","0","0","0","0","0","0","0","0","0"
"2015","Calgary, Alberta, municipal","48014","Nonconsensual distribution of intimate images","0","0","0","0","0","0","0","0","0","0","0","0","0","0"
"2016","Calgary, Alberta, municipal","48014","Nonconsensual distribution of intimate images","2","0","0","0","0.15","0","0","0","0","0","0","0","0","0"
"2005","Calgary, Alberta, municipal","48014","Trap likely to or causing bodily harm","0","0","0","0","0","0","0","0","0","0","0","0","0","0"
"2006","Calgary, Alberta, municipal","48014","Trap likely to or causing bodily harm","0","0","0","0","0","0","0","0","0","0","0","0","0","0"
"2007","Calgary, Alberta, municipal","48014","Trap likely to or causing bodily harm","0","0","0","0","0","0","0","0","0","0","0","0","0","0"
"2008","Calgary, Alberta, municipal","48014","Trap likely to or causing bodily harm","0","0","0","0","0","0","0","0","0","0","0","0","0","0"
"2009","Calgary, Alberta, municipal","48014","Trap likely to or causing bodily harm","0","0","0","0","0","0","0","0","0","0","0","0","0","0"
"2010","Calgary, Alberta, municipal","48014","Trap likely to or causing bodily harm","0","0","0","0","0","0","0","0","0","0","0","0","0","0"
"2011","Calgary, Alberta, municipal","48014","Trap likely to or causing bodily harm","0","0","0","0","0","0","0","0","0","0","0","0","0","0"
"2012","Calgary, Alberta, municipal","48014","Trap likely to or causing bodily harm","0","0","0","0","0","0","0","0","0","0","0","0","0","0"
"2013","Calgary, Alberta, municipal","48014","Trap likely to or causing bodily harm","0","0","0","0","0","0","0","0","0","0","0","0","0","0"
"2014","Calgary, Alberta, municipal","48014","Trap likely to or causing bodily harm","0","0","0","0","0","0","0","0","0","0","0","0","0","0"
"2015","Calgary, Alberta, municipal","48014","Trap likely to or causing bodily harm","0","0","0","0","0","0","0","0","0","0","0","0","0","0"
"2016","Calgary, Alberta, municipal","48014","Trap likely to or causing bodily harm","0","0","0","0","0","0","0","0","0","0","0","0","0","0"
"1998","Calgary, Alberta, municipal","48014","Hostage-taking","0","0","0","0","0","0","0","0","0","0","0","0","0","0"
"1999","Calgary, Alberta, municipal","48014","Hostage-taking","4","4","0","0","0.46","0","0","0","0","4","1","1","0","0"
"2000","Calgary, Alberta, municipal","48014","Hostage-taking","0","0","0","-100","0","0","0","0","0","0","0","0","0","0"
"2001","Calgary, Alberta, municipal","48014","Hostage-taking","0","0","0","0","0","0","0","0","0","0","0","0","0","0"
"2002","Calgary, Alberta, municipal","48014","Hostage-taking","1","1","0","0","0.11","0","0","0","0","1","1","1","0","0"
"2003","Calgary, Alberta, municipal","48014","Hostage-taking","0","0","0","-100","0","0","0","0","0","0","0","0","0","0"
"2004","Calgary, Alberta, municipal","48014","Hostage-taking","0","0","0","0","0","0","0","0","0","0","0","0","0","0"
"2005","Calgary, Alberta, municipal","48014","Hostage-taking","1","1","0","0","0.1","0.13","0.12","0","0","1","1","1","0","0"
"2006","Calgary, Alberta, municipal","48014","Hostage-taking","0","0","0","-100","0","0","0","0","0","0","0","0","0","0"
"2007","Calgary, Alberta, municipal","48014","Hostage-taking","0","0","0","0","0","0","0","0","0","0","0","0","0","0"
"2008","Calgary, Alberta, municipal","48014","Hostage-taking","0","0","0","0","0","0","0","0","0","0","0","0","0","0"
"2009","Calgary, Alberta, municipal","48014","Hostage-taking","0","0","0","0","0","0","0","0","0","0","0","0","0","0"
"2010","Calgary, Alberta, municipal","48014","Hostage-taking","0","0","0","0","0","0","0","0","0","0","0","0","0","0"
"2011","Calgary, Alberta, municipal","48014","Hostage-taking","0","0","0","0","0","0","0","0","0","0","0","0","0","0"
"2012","Calgary, Alberta, municipal","48014","Hostage-taking","0","0","0","0","0","0","0","0","0","0","0","0","0","0"
"2013","Calgary, Alberta, municipal","48014","Hostage-taking","0","0","0","0","0","0","0","0","0","0","0","0","0","0"
"2014","Calgary, Alberta, municipal","48014","Hostage-taking","1","1","0","0","0.08","0","0","0","0","1","0","0","0","0"
"2015","Calgary, Alberta, municipal","48014","Hostage-taking","0","0","0","-100","0","0","0","0","0","0","0","0","0","0"
"2016","Calgary, Alberta, municipal","48014","Hostage-taking","0","0","0","0","0","0","0","0","0","0","0","0","0","0"
"2005","Calgary, Alberta, municipal","48014","Trafficking in persons","0","0","0","0","0","0","0","0","0","0","0","0","0","0"
"2006","Calgary, Alberta, municipal","48014","Trafficking in persons","0","0","0","0","0","0","0","0","0","0","0","0","0","0"
"2007","Calgary, Alberta, municipal","48014","Trafficking in persons","0","0","0","0","0","0","0","0","0","0","0","0","0","0"
"2008","Calgary, Alberta, municipal","48014","Trafficking in persons","2","0","0","0","0.19","0","0","0","0","0","0","0","0","0"
"2009","Calgary, Alberta, municipal","48014","Trafficking in persons","7","5","2","241.21","0.63","0.23","0.21","0","0","7","2","2","0","0"
"2010","Calgary, Alberta, municipal","48014","Trafficking in persons","1","0","0","-85.92","0.09","0","0","0","0","0","0","0","0","0"
"2011","Calgary, Alberta, municipal","48014","Trafficking in persons","0","0","0","-100","0","0","0","0","0","0","0","0","0","0"
"2012","Calgary, Alberta, municipal","48014","Trafficking in persons","1","0","0","0","0.08","0","0","0","0","0","0","0","0","0"
"2013","Calgary, Alberta, municipal","48014","Trafficking in persons","6","5","0","478.98","0.49","0.72","0.67","0","0","5","7","7","0","0"
"2014","Calgary, Alberta, municipal","48014","Trafficking in persons","1","2","0","-83.88","0.08","0.3","0.28","0","0","2","3","3","0","0"
"2015","Calgary, Alberta, municipal","48014","Trafficking in persons","1","0","0","-2.13","0.08","0","0","0","0","0","0","0","0","0"
"2016","Calgary, Alberta, municipal","48014","Trafficking in persons","5","1","0","388.31","0.38","0.1","0.09","0","0","1","1","1","0","0"
"1998","Calgary, Alberta, municipal","48014","Intimidation of a justice system participant or a journalist","0","0","0","0","0","0","0","0","0","0","0","0","0","0"
"1999","Calgary, Alberta, municipal","48014","Intimidation of a justice system participant or a journalist","0","0","0","0","0","0","0","0","0","0","0","0","0","0"
"2000","Calgary, Alberta, municipal","48014","Intimidation of a justice system participant or a journalist","0","0","0","0","0","0","0","0","0","0","0","0","0","0"
"2001","Calgary, Alberta, municipal","48014","Intimidation of a justice system participant or a journalist","0","0","0","0","0","0","0","0","0","0","0","0","0","0"
"2002","Calgary, Alberta, municipal","48014","Intimidation of a justice system participant or a journalist","0","0","0","0","0","0","0","0","0","0","0","0","0","0"
"2003","Calgary, Alberta, municipal","48014","Intimidation of a justice system participant or a journalist","0","0","0","0","0","0","0","0","0","0","0","0","0","0"
"2004","Calgary, Alberta, municipal","48014","Intimidation of a justice system participant or a journalist","1","1","0","0","0.1","0.13","0.12","0","0","1","1","1","0","0"
"2005","Calgary, Alberta, municipal","48014","Intimidation of a justice system participant or a journalist","3","0","2","191.14","0.3","0","0","0","0","2","0","0","0","0"
"2006","Calgary, Alberta, municipal","48014","Intimidation of a justice system participant or a journalist","0","0","0","-100","0","0","0","0","0","0","0","0","0","0"
"2007","Calgary, Alberta, municipal","48014","Intimidation of a justice system participant or a journalist","0","0","0","0","0","0","0","0","0","0","0","0","0","0"
"2008","Calgary, Alberta, municipal","48014","Intimidation of a justice system participant or a journalist","1","0","1","0","0.09","0","0","0","0","1","0","0","0","0"
"2009","Calgary, Alberta, municipal","48014","Intimidation of a justice system participant or a journalist","1","1","0","-2.51","0.09","0.11","0.1","0","0","1","1","1","0","0"
"2010","Calgary, Alberta, municipal","48014","Intimidation of a justice system participant or a journalist","5","2","1","392.66","0.44","0.23","0.21","0","0","3","2","2","0","0"
"2011","Calgary, Alberta, municipal","48014","Intimidation of a justice system participant or a journalist","1","1","0","-80.31","0.09","0.11","0.1","0","0","1","1","1","0","0"
"2012","Calgary, Alberta, municipal","48014","Intimidation of a justice system participant or a journalist","2","1","0","94.02","0.17","0.11","0.1","0","0","1","1","1","0","0"
"2013","Calgary, Alberta, municipal","48014","Intimidation of a justice system participant or a journalist","8","5","0","285.99","0.66","1.14","1.15","1.26","0","5","11","12","1","0"
"2014","Calgary, Alberta, municipal","48014","Intimidation of a justice system participant or a journalist","5","4","1","-39.53","0.4","0.3","0.28","0","0","5","3","3","0","0"
"2015","Calgary, Alberta, municipal","48014","Intimidation of a justice system participant or a journalist","9","7","0","76.16","0.7","0.68","0.63","0","0","7","7","7","0","0"
"2016","Calgary, Alberta, municipal","48014","Intimidation of a justice system participant or a journalist","9","9","0","-2.34","0.68","0.67","0.62","0","0","9","7","7","0","0"
"2005","Calgary, Alberta, municipal","48014","Intimidation of a non-justice participant","0","0","0","0","0","0","0","0","0","0","0","0","0","0"
"2006","Calgary, Alberta, municipal","48014","Intimidation of a non-justice participant","0","0","0","0","0","0","0","0","0","0","0","0","0","0"
"2007","Calgary, Alberta, municipal","48014","Intimidation of a non-justice participant","0","0","0","0","0","0","0","0","0","0","0","0","0","0"
"2008","Calgary, Alberta, municipal","48014","Intimidation of a non-justice participant","0","0","0","0","0","0","0","0","0","0","0","0","0","0"
"2009","Calgary, Alberta, municipal","48014","Intimidation of a non-justice participant","0","0","0","0","0","0","0","0","0","0","0","0","0","0"
"2010","Calgary, Alberta, municipal","48014","Intimidation of a non-justice participant","0","0","0","0","0","0","0","0","0","0","0","0","0","0"
"2011","Calgary, Alberta, municipal","48014","Intimidation of a non-justice participant","0","0","0","0","0","0","0","0","0","0","0","0","0","0"
"2012","Calgary, Alberta, municipal","48014","Intimidation of a non-justice participant","0","0","0","0","0","0","0","0","0","0","0","0","0","0"
"2013","Calgary, Alberta, municipal","48014","Intimidation of a non-justice participant","0","0","0","0","0","0","0","0","0","0","0","0","0","0"
"2014","Calgary, Alberta, municipal","48014","Intimidation of a non-justice participant","0","0","0","0","0","0","0","0","0","0","0","0","0","0"
"2015","Calgary, Alberta, municipal","48014","Intimidation of a non-justice participant","0","0","0","0","0","0","0","0","0","0","0","0","0","0"
"2016","Calgary, Alberta, municipal","48014","Intimidation of a non-justice participant","4","3","1","0","0.3","0.29","0.27","0","0","4","3","3","0","0"
"1998","Calgary, Alberta, municipal","48014","Explosives causing death or bodily harm","0","0","0","0","0","0","0","0","0","0","0","0","0","0"
"1999","Calgary, Alberta, municipal","48014","Explosives causing death or bodily harm","3","0","0","0","0.35","0","0","0","0","0","0","0","0","0"
"2000","Calgary, Alberta, municipal","48014","Explosives causing death or bodily harm","0","0","0","-100","0","0","0","0","0","0","0","0","0","0"
"2001","Calgary, Alberta, municipal","48014","Explosives causing death or bodily harm","2","2","0","0","0.22","0","0","0","0","2","1","2","1","0"
"2002","Calgary, Alberta, municipal","48014","Explosives causing death or bodily harm","3","1","0","46.54","0.32","0","0","0","0","1","1","1","0","0"
"2003","Calgary, Alberta, municipal","48014","Explosives causing death or bodily harm","0","0","0","-100","0","0","0","0","0","0","0","0","0","0"
"2004","Calgary, Alberta, municipal","48014","Explosives causing death or bodily harm","4","1","0","0","0.41","0.13","0.12","0","0","1","1","1","0","0"
"2005","Calgary, Alberta, municipal","48014","Explosives causing death or bodily harm","1","1","0","-75.74","0.1","0.13","0.23","1.3","0","1","1","2","1","0"
"2006","Calgary, Alberta, municipal","48014","Explosives causing death or bodily harm","1","1","0","-3.04","0.1","0.12","0.11","0","0","1","1","1","0","0"
"2007","Calgary, Alberta, municipal","48014","Explosives causing death or bodily harm","2","0","0","95.2","0.19","0","0","0","0","0","0","0","0","0"
"2008","Calgary, Alberta, municipal","48014","Explosives causing death or bodily harm","0","0","0","-100","0","0","0","0","0","0","0","0","0","0"
"2009","Calgary, Alberta, municipal","48014","Explosives causing death or bodily harm","1","0","0","0","0.09","0","0","0","0","0","0","0","0","0"
"2010","Calgary, Alberta, municipal","48014","Explosives causing death or bodily harm","0","0","0","-100","0","0","0","0","0","0","0","0","0","0"
"2011","Calgary, Alberta, municipal","48014","Explosives causing death or bodily harm","0","0","0","0","0","0","0","0","0","0","0","0","0","0"
"2012","Calgary, Alberta, municipal","48014","Explosives causing death or bodily harm","0","0","0","0","0","0","0","0","0","0","0","0","0","0"
"2013","Calgary, Alberta, municipal","48014","Explosives causing death or bodily harm","0","0","0","0","0","0","0","0","0","0","0","0","0","0"
"2014","Calgary, Alberta, municipal","48014","Explosives causing death or bodily harm","0","0","0","0","0","0","0","0","0","0","0","0","0","0"
"2015","Calgary, Alberta, municipal","48014","Explosives causing death or bodily harm","0","0","0","0","0","0","0","0","0","0","0","0","0","0"
"2016","Calgary, Alberta, municipal","48014","Explosives causing death or bodily harm","0","0","0","0","0","0","0","0","0","0","0","0","0","0"
"1998","Calgary, Alberta, municipal","48014","Arson, disregard for human life","10","2","0","0","1.19","0","0","0","0","2","2","2","0","0"
"1999","Calgary, Alberta, municipal","48014","Arson, disregard for human life","12","4","0","17","1.39","0","0","0","0","4","2","3","1","0"
"2000","Calgary, Alberta, municipal","48014","Arson, disregard for human life","8","8","0","-34.88","0.91","0","0","0","0","8","5","14","9","0"
"2001","Calgary, Alberta, municipal","48014","Arson, disregard for human life","5","5","0","-38.85","0.55","0","0","0","0","5","2","6","4","0"
"2002","Calgary, Alberta, municipal","48014","Arson, disregard for human life","10","8","0","95.38","1.08","0","0","0","0","8","3","3","0","0"
"2003","Calgary, Alberta, municipal","48014","Arson, disregard for human life","28","14","6","175.62","2.98","0","0","0","0","20","11","17","6","0"
"2004","Calgary, Alberta, municipal","48014","Arson, disregard for human life","14","11","0","-51.49","1.45","0.8","0.85","1.32","0","11","6","7","1","0"
"2005","Calgary, Alberta, municipal","48014","Arson, disregard for human life","19","11","1","31.71","1.91","0.64","0.7","1.3","0","12","5","6","1","0"
"2006","Calgary, Alberta, municipal","48014","Arson, disregard for human life","25","9","6","27.58","2.43","0.99","0.91","0","1.29","15","8","8","0","1"
"2007","Calgary, Alberta, municipal","48014","Arson, disregard for human life","13","8","1","-49.25","1.23","0.97","0.99","1.29","1.29","9","8","9","1","1"
"2008","Calgary, Alberta, municipal","48014","Arson, disregard for human life","23","10","0","72.59","2.13","0.7","0.86","2.59","0","10","6","8","2","0"
"2009","Calgary, Alberta, municipal","48014","Arson, disregard for human life","25","14","0","5.97","2.26","0.91","0.84","0","0","14","8","8","0","0"
"2010","Calgary, Alberta, municipal","48014","Arson, disregard for human life","15","9","2","-40.88","1.33","0.68","0.62","0","0","11","6","6","0","0"
"2011","Calgary, Alberta, municipal","48014","Arson, disregard for human life","25","23","1","64.06","2.19","0.67","0.82","2.55","2.55","24","6","8","2","2"
"2012","Calgary, Alberta, municipal","48014","Arson, disregard for human life","68","61","2","163.87","5.78","0.64","0.79","2.54","0","63","6","8","2","0"
"2013","Calgary, Alberta, municipal","48014","Arson, disregard for human life","20","17","1","-71.62","1.64","0.62","0.57","0","0","18","6","6","0","0"
"2014","Calgary, Alberta, municipal","48014","Arson, disregard for human life","20","3","1","-3.25","1.59","0.2","0.18","0","0","4","2","2","0","0"
"2015","Calgary, Alberta, municipal","48014","Arson, disregard for human life","7","17","0","-65.75","0.54","0.39","0.72","4.98","0","17","4","8","4","0"
"2016","Calgary, Alberta, municipal","48014","Arson, disregard for human life","6","0","0","-16.29","0.45","0","0","0","0","0","0","0","0","0"
"2012","Calgary, Alberta, municipal","48014","Failure to comply with mandatory safeguards in relation to medical assistance in dying","0","0","0","0","0","0","0","0","0","0","0","0","0","0"
"2013","Calgary, Alberta, municipal","48014","Failure to comply with mandatory safeguards in relation to medical assistance in dying","0","0","0","0","0","0","0","0","0","0","0","0","0","0"
"2014","Calgary, Alberta, municipal","48014","Failure to comply with mandatory safeguards in relation to medical assistance in dying","0","0","0","0","0","0","0","0","0","0","0","0","0","0"
"2015","Calgary, Alberta, municipal","48014","Failure to comply with mandatory safeguards in relation to medical assistance in dying","0","0","0","0","0","0","0","0","0","0","0","0","0","0"
"2016","Calgary, Alberta, municipal","48014","Failure to comply with mandatory safeguards in relation to medical assistance in dying","0","0","0","0","0","0","0","0","0","0","0","0","0","0"
"2012","Calgary, Alberta, municipal","48014","Forging or destroying documents related to assistance requests with criminal intent","0","0","0","0","0","0","0","0","0","0","0","0","0","0"
"2013","Calgary, Alberta, municipal","48014","Forging or destroying documents related to assistance requests with criminal intent","0","0","0","0","0","0","0","0","0","0","0","0","0","0"
"2014","Calgary, Alberta, municipal","48014","Forging or destroying documents related to assistance requests with criminal intent","0","0","0","0","0","0","0","0","0","0","0","0","0","0"
"2015","Calgary, Alberta, municipal","48014","Forging or destroying documents related to assistance requests with criminal intent","0","0","0","0","0","0","0","0","0","0","0","0","0","0"
"2016","Calgary, Alberta, municipal","48014","Forging or destroying documents related to assistance requests with criminal intent","0","0","0","0","0","0","0","0","0","0","0","0","0","0"
"1998","Calgary, Alberta, municipal","48014","Other violent violations","9","0","2","0","1.07","0","0","0","0","2","0","0","0","0"
"1999","Calgary, Alberta, municipal","48014","Other violent violations","12","3","6","30","1.39","0","0","0","0","9","2","2","0","1"
"2000","Calgary, Alberta, municipal","48014","Other violent violations","8","5","3","-34.88","0.91","0","0","0","0","8","5","5","0","0"
"2001","Calgary, Alberta, municipal","48014","Other violent violations","14","6","4","71.22","1.55","0","0","0","0","10","6","6","0","0"
"2002","Calgary, Alberta, municipal","48014","Other violent violations","8","4","3","-44.18","0.87","0","0","0","0","7","4","4","0","0"
"2003","Calgary, Alberta, municipal","48014","Other violent violations","7","7","0","-13.87","0.75","0","0","0","0","7","5","8","3","1"
"2004","Calgary, Alberta, municipal","48014","Other violent violations","9","5","1","24.73","0.93","0.53","0.72","2.64","1.32","6","4","6","2","1"
"2005","Calgary, Alberta, municipal","48014","Other violent violations","10","4","4","7.83","1","0.39","0.35","0","2.6","8","3","3","0","2"
"2006","Calgary, Alberta, municipal","48014","Other violent violations","8","4","0","-22.43","0.78","0.5","0.57","1.29","0","4","4","5","1","0"
"2007","Calgary, Alberta, municipal","48014","Other violent violations","7","7","0","-14.6","0.66","0.84","0.77","0","0","7","7","7","0","0"
"2008","Calgary, Alberta, municipal","48014","Other violent violations","8","6","0","11.49","0.74","0.59","0.54","0","0","6","5","5","0","0"
"2009","Calgary, Alberta, municipal","48014","Other violent violations","11","8","0","34.05","0.99","0.8","0.94","2.58","0","8","7","9","2","0"
"2010","Calgary, Alberta, municipal","48014","Other violent violations","6","2","4","-46.26","0.53","0.23","0.21","0","0","6","2","2","0","0"
"2011","Calgary, Alberta, municipal","48014","Other violent violations","8","5","0","31.24","0.7","0.44","0.41","0","0","5","4","4","0","0"
"2012","Calgary, Alberta, municipal","48014","Other violent violations","5","4","0","-39.37","0.42","0.32","0.3","0","0","4","3","3","0","0"
"2013","Calgary, Alberta, municipal","48014","Other violent violations","9","8","0","73.69","0.74","0.31","0.29","0","0","8","3","3","0","0"
"2014","Calgary, Alberta, municipal","48014","Other violent violations","7","3","0","-24.75","0.56","0.1","0.28","2.52","0","3","1","3","2","0"
"2015","Calgary, Alberta, municipal","48014","Other violent violations","12","10","2","67.77","0.93","0.98","1","1.25","0","12","10","11","1","0"
"2016","Calgary, Alberta, municipal","48014","Other violent violations","6","5","0","-51.17","0.45","0.76","0.71","0","0","5","8","8","0","0"
"1998","Calgary, Alberta, municipal","48014","Total property crime violations","54648","8025","2585","0","6500.51","0","0","0","0","10610","5437","7183","1746","1536"
"1999","Calgary, Alberta, municipal","48014","Total property crime violations","53616","8226","3217","-4.34","6218.45","0","0","0","0","11443","5701","7542","1841","1616"
"2000","Calgary, Alberta, municipal","48014","Total property crime violations","49836","8573","3417","-9.2","5646.18","0","0","0","0","11990","5778","7433","1655","1681"
"2001","Calgary, Alberta, municipal","48014","Total property crime violations","50033","8565","3135","-1.77","5546","0","0","0","0","11700","5900","7375","1475","1679"
"2002","Calgary, Alberta, municipal","48014","Total property crime violations","50541","9072","3516","-1.32","5472.9","0","0","0","0","12588","6274","8088","1814","1620"
"2003","Calgary, Alberta, municipal","48014","Total property crime violations","52597","9368","4002","2.44","5606.52","0","0","0","0","13370","6638","7878","1240","2214"
"2004","Calgary, Alberta, municipal","48014","Total property crime violations","50227","8983","3659","-7.36","5194.02","887.88","927.33","1318.95","2655.04","12642","6682","7682","1000","2013"
"2005","Calgary, Alberta, municipal","48014","Total property crime violations","50496","8668","2890","-2.43","5067.69","839.28","894.79","1455.39","2291.49","11558","6529","7650","1121","1765"
"2006","Calgary, Alberta, municipal","48014","Total property crime violations","51712","9108","2678","-0.71","5031.82","821.13","878.55","1472.8","1854.49","11786","6612","7758","1146","1443"
"2007","Calgary, Alberta, municipal","48014","Total property crime violations","50011","7681","2314","-5.61","4749.52","665.19","745.36","1602.5","1628.3","9995","5512","6754","1242","1262"
"2008","Calgary, Alberta, municipal","48014","Total property crime violations","47282","7699","2218","-7.77","4380.44","665.84","734.06","1487.2","1524.77","9917","5674","6822","1148","1177"
"2009","Calgary, Alberta, municipal","48014","Total property crime violations","43680","7514","2337","-9.94","3945.12","642.67","700.54","1353.93","1509.95","9851","5628","6678","1050","1171"
"2010","Calgary, Alberta, municipal","48014","Total property crime violations","41578","6643","2299","-6.21","3700.1","563.56","591.97","915.58","1141.27","8942","5006","5720","714","890"
"2011","Calgary, Alberta, municipal","48014","Total property crime violations","38280","6188","1899","-9.37","3353.23","525.55","544.03","756.88","1202.33","8087","4741","5334","593","942"
"2012","Calgary, Alberta, municipal","48014","Total property crime violations","37538","5669","1628","-4.87","3189.94","449.51","468.11","688.05","881.01","7297","4188","4730","542","694"
"2013","Calgary, Alberta, municipal","48014","Total property crime violations","38150","5284","1458","-1.93","3128.36","428.24","432.15","480","668.21","6742","4145","4525","380","529"
"2014","Calgary, Alberta, municipal","48014","Total property crime violations","38291","5659","1541","-2.9","3037.77","447.9","447.64","444.38","707.48","7200","4491","4844","353","562"
"2015","Calgary, Alberta, municipal","48014","Total property crime violations","52744","6139","1468","34.8","4095.05","521.64","514.97","429.93","750.2","7607","5342","5687","345","602"
"2016","Calgary, Alberta, municipal","48014","Total property crime violations","53067","6134","1178","-1.74","4023.83","504.48","492.21","335.48","603.86","7312","5284","5559","275","495"
"1998","Calgary, Alberta, municipal","48014","Total breaking and entering","9585","879","335","0","1140.16","0","0","0","0","1214","584","869","285","77"
"1999","Calgary, Alberta, municipal","48014","Total breaking and entering","9145","955","763","-6.97","1060.65","0","0","0","0","1718","619","927","308","71"
"2000","Calgary, Alberta, municipal","48014","Total breaking and entering","7478","916","801","-20.12","847.22","0","0","0","0","1717","597","831","234","91"
"2001","Calgary, Alberta, municipal","48014","Total breaking and entering","7639","794","573","-0.05","846.76","0","0","0","0","1367","558","765","207","84"
"2002","Calgary, Alberta, municipal","48014","Total breaking and entering","7516","914","823","-3.88","813.88","0","0","0","0","1737","577","865","288","95"
"2003","Calgary, Alberta, municipal","48014","Total breaking and entering","8188","1025","769","7.24","872.79","0","0","0","0","1794","638","915","277","203"
"2004","Calgary, Alberta, municipal","48014","Total breaking and entering","8019","979","917","-4.99","829.25","86.9","98.99","218.95","316.55","1896","654","820","166","240"
"2005","Calgary, Alberta, municipal","48014","Total breaking and entering","7730","848","561","-6.45","775.77","79.57","94.27","242.78","170.08","1409","619","806","187","131"
"2006","Calgary, Alberta, municipal","48014","Total breaking and entering","7131","862","649","-10.56","693.88","75.88","85.73","187.63","113.09","1511","611","757","146","88"
"2007","Calgary, Alberta, municipal","48014","Total breaking and entering","6359","623","534","-12.97","603.91","56.36","63.35","138.06","112.25","1157","467","574","107","87"
"2008","Calgary, Alberta, municipal","48014","Total breaking and entering","5778","662","528","-11.36","535.3","50.58","57.67","136.02","82.91","1190","431","536","105","64"
"2009","Calgary, Alberta, municipal","48014","Total breaking and entering","5650","494","625","-4.67","510.3","43.16","47.21","92.84","166.34","1119","378","450","72","129"
"2010","Calgary, Alberta, municipal","48014","Total breaking and entering","6540","567","641","14.05","582.01","46.94","51.75","106.43","42.32","1208","417","500","83","33"
"2011","Calgary, Alberta, municipal","48014","Total breaking and entering","5147","468","192","-22.53","450.86","43.68","45.69","68.92","26.8","660","394","448","54","21"
"2012","Calgary, Alberta, municipal","48014","Total breaking and entering","5174","449","256","-2.48","439.68","34.13","39.78","106.64","43.16","705","318","402","84","34"
"2013","Calgary, Alberta, municipal","48014","Total breaking and entering","5234","587","328","-2.38","429.2","42.36","42.69","46.74","26.53","915","410","447","37","21"
"2014","Calgary, Alberta, municipal","48014","Total breaking and entering","5321","536","198","-1.65","422.13","38.9","41.68","76.79","41.54","734","390","451","61","33"
"2015","Calgary, Alberta, municipal","48014","Total breaking and entering","8375","671","206","54.04","650.24","50","49.44","42.37","46.11","877","512","546","34","37"
"2016","Calgary, Alberta, municipal","48014","Total breaking and entering","7782","604","70","-9.25","590.07","53.46","51.53","26.84","12.2","674","560","582","22","10"
"1998","Calgary, Alberta, municipal","48014","Breaking and entering","9585","879","335","0","1140.16","0","0","0","0","1214","584","869","285","77"
"1999","Calgary, Alberta, municipal","48014","Breaking and entering","9145","955","763","-6.97","1060.65","0","0","0","0","1718","619","927","308","71"
"2000","Calgary, Alberta, municipal","48014","Breaking and entering","7478","916","801","-20.12","847.22","0","0","0","0","1717","597","831","234","91"
"2001","Calgary, Alberta, municipal","48014","Breaking and entering","7639","794","573","-0.05","846.76","0","0","0","0","1367","558","765","207","84"
"2002","Calgary, Alberta, municipal","48014","Breaking and entering","7516","914","823","-3.88","813.88","0","0","0","0","1737","577","865","288","95"
"2003","Calgary, Alberta, municipal","48014","Breaking and entering","8188","1025","769","7.24","872.79","0","0","0","0","1794","638","915","277","203"
"2004","Calgary, Alberta, municipal","48014","Breaking and entering","8019","979","917","-4.99","829.25","86.9","98.99","218.95","316.55","1896","654","820","166","240"
"2005","Calgary, Alberta, municipal","48014","Breaking and entering","7730","848","561","-6.45","775.77","79.57","94.27","242.78","170.08","1409","619","806","187","131"
"2006","Calgary, Alberta, municipal","48014","Breaking and entering","7131","862","649","-10.56","693.88","75.88","85.73","187.63","113.09","1511","611","757","146","88"
"2007","Calgary, Alberta, municipal","48014","Breaking and entering","6359","623","534","-12.97","603.91","56.36","63.35","138.06","112.25","1157","467","574","107","87"
"2008","Calgary, Alberta, municipal","48014","Breaking and entering","5778","662","528","-11.36","535.3","50.58","57.67","136.02","82.91","1190","431","536","105","64"
"2009","Calgary, Alberta, municipal","48014","Breaking and entering","5650","494","625","-4.67","510.3","43.16","47.21","92.84","166.34","1119","378","450","72","129"
"2010","Calgary, Alberta, municipal","48014","Breaking and entering","6533","567","641","13.93","581.38","46.94","51.75","106.43","42.32","1208","417","500","83","33"
"2011","Calgary, Alberta, municipal","48014","Breaking and entering","5134","468","192","-22.65","449.73","43.68","45.69","68.92","26.8","660","394","448","54","21"
"2012","Calgary, Alberta, municipal","48014","Breaking and entering","5164","449","256","-2.42","438.83","34.13","39.78","106.64","43.16","705","318","402","84","34"
"2013","Calgary, Alberta, municipal","48014","Breaking and entering","5219","586","328","-2.48","427.97","42.36","42.59","45.47","26.53","914","410","446","36","21"
"2014","Calgary, Alberta, municipal","48014","Breaking and entering","5282","535","198","-2.09","419.04","38.8","41.22","71.75","41.54","733","389","446","57","33"
"2015","Calgary, Alberta, municipal","48014","Breaking and entering","8305","666","206","53.88","644.8","49.7","49.17","42.37","46.11","872","509","543","34","37"
"2016","Calgary, Alberta, municipal","48014","Breaking and entering","7707","602","69","-9.37","584.39","53.37","51.44","26.84","12.2","671","559","581","22","10"
"2005","Calgary, Alberta, municipal","48014","Breaking and entering to steal a firearm","0","0","0","0","0","0","0","0","0","0","0","0","0","0"
"2006","Calgary, Alberta, municipal","48014","Breaking and entering to steal a firearm","0","0","0","0","0","0","0","0","0","0","0","0","0","0"
"2007","Calgary, Alberta, municipal","48014","Breaking and entering to steal a firearm","0","0","0","0","0","0","0","0","0","0","0","0","0","0"
"2008","Calgary, Alberta, municipal","48014","Breaking and entering to steal a firearm","0","0","0","0","0","0","0","0","0","0","0","0","0","0"
"2009","Calgary, Alberta, municipal","48014","Breaking and entering to steal a firearm","0","0","0","0","0","0","0","0","0","0","0","0","0","0"
"2010","Calgary, Alberta, municipal","48014","Breaking and entering to steal a firearm","0","0","0","0","0","0","0","0","0","0","0","0","0","0"
"2011","Calgary, Alberta, municipal","48014","Breaking and entering to steal a firearm","0","0","0","0","0","0","0","0","0","0","0","0","0","0"
"2012","Calgary, Alberta, municipal","48014","Breaking and entering to steal a firearm","0","0","0","0","0","0","0","0","0","0","0","0","0","0"
"2013","Calgary, Alberta, municipal","48014","Breaking and entering to steal a firearm","1","1","0","0","0.08","0","0.1","1.26","0","1","0","1","1","0"
"2014","Calgary, Alberta, municipal","48014","Breaking and entering to steal a firearm","32","1","0","2995.89","2.54","0.1","0.46","5.04","0","1","1","5","4","0"
"2015","Calgary, Alberta, municipal","48014","Breaking and entering to steal a firearm","63","5","0","92.67","4.89","0.29","0.27","0","0","5","3","3","0","0"
"2016","Calgary, Alberta, municipal","48014","Breaking and entering to steal a firearm","59","2","1","-8.54","4.47","0.1","0.09","0","0","3","1","1","0","0"
"2005","Calgary, Alberta, municipal","48014","Break and enter to steal a firearm from a motor vehicle","0","0","0","0","0","0","0","0","0","0","0","0","0","0"
"2006","Calgary, Alberta, municipal","48014","Break and enter to steal a firearm from a motor vehicle","0","0","0","0","0","0","0","0","0","0","0","0","0","0"
"2007","Calgary, Alberta, municipal","48014","Break and enter to steal a firearm from a motor vehicle","0","0","0","0","0","0","0","0","0","0","0","0","0","0"
"2008","Calgary, Alberta, municipal","48014","Break and enter to steal a firearm from a motor vehicle","0","0","0","0","0","0","0","0","0","0","0","0","0","0"
"2009","Calgary, Alberta, municipal","48014","Break and enter to steal a firearm from a motor vehicle","0","0","0","0","0","0","0","0","0","0","0","0","0","0"
"2010","Calgary, Alberta, municipal","48014","Break and enter to steal a firearm from a motor vehicle","7","0","0","0","0.62","0","0","0","0","0","0","0","0","0"
"2011","Calgary, Alberta, municipal","48014","Break and enter to steal a firearm from a motor vehicle","13","0","0","82.8","1.14","0","0","0","0","0","0","0","0","0"
"2012","Calgary, Alberta, municipal","48014","Break and enter to steal a firearm from a motor vehicle","10","0","0","-25.38","0.85","0","0","0","0","0","0","0","0","0"
"2013","Calgary, Alberta, municipal","48014","Break and enter to steal a firearm from a motor vehicle","14","0","0","35.1","1.15","0","0","0","0","0","0","0","0","0"
"2014","Calgary, Alberta, municipal","48014","Break and enter to steal a firearm from a motor vehicle","7","0","0","-51.63","0.56","0","0","0","0","0","0","0","0","0"
"2015","Calgary, Alberta, municipal","48014","Break and enter to steal a firearm from a motor vehicle","7","0","0","-2.13","0.54","0","0","0","0","0","0","0","0","0"
"2016","Calgary, Alberta, municipal","48014","Break and enter to steal a firearm from a motor vehicle","16","0","0","123.23","1.21","0","0","0","0","0","0","0","0","0"
"1998","Calgary, Alberta, municipal","48014","Total possession of stolen property","452","296","75","0","53.77","0","0","0","0","371","195","260","65","63"
"1999","Calgary, Alberta, municipal","48014","Total possession of stolen property","1064","974","121","129.52","123.4","0","0","0","0","1095","640","842","202","58"
"2000","Calgary, Alberta, municipal","48014","Total possession of stolen property","1119","1042","146","2.73","126.78","0","0","0","0","1188","722","912","190","73"
"2001","Calgary, Alberta, municipal","48014","Total possession of stolen property","1128","984","140","-1.37","125.04","0","0","0","0","1124","687","805","118","80"
"2002","Calgary, Alberta, municipal","48014","Total possession of stolen property","1182","1119","111","2.37","127.99","0","0","0","0","1230","746","888","142","46"
"2003","Calgary, Alberta, municipal","48014","Total possession of stolen property","1388","1241","169","15.59","147.95","0","0","0","0","1410","864","978","114","95"
"2004","Calgary, Alberta, municipal","48014","Total possession of stolen property","1681","1285","158","17.49","173.83","113.61","113.83","116.07","101.56","1443","855","943","88","77"
"2005","Calgary, Alberta, municipal","48014","Total possession of stolen property","1805","1164","158","4.21","181.15","96.67","101.18","146.71","75.3","1322","752","865","113","58"
"2006","Calgary, Alberta, municipal","48014","Total possession of stolen property","2000","1406","150","7.43","194.61","91.65","97.16","154.22","73.25","1556","738","858","120","57"
"2007","Calgary, Alberta, municipal","48014","Total possession of stolen property","1854","1194","156","-9.52","176.07","94.61","105.94","227.09","78.71","1350","784","960","176","61"
"2008","Calgary, Alberta, municipal","48014","Total possession of stolen property","1731","1100","142","-8.92","160.37","93.06","98.46","158.05","54.41","1242","793","915","122","42"
"2009","Calgary, Alberta, municipal","48014","Total possession of stolen property","1540","921","113","-13.27","139.09","72.28","77.52","136.68","61.89","1034","633","739","106","48"
"2010","Calgary, Alberta, municipal","48014","Total possession of stolen property","1253","737","107","-19.83","111.51","55.61","57.75","82.07","44.88","844","494","558","64","35"
"2011","Calgary, Alberta, municipal","48014","Total possession of stolen property","700","662","64","-45.01","61.32","45.34","46.41","58.71","30.63","726","409","455","46","24"
"2012","Calgary, Alberta, municipal","48014","Total possession of stolen property","635","569","52","-12","53.96","39.07","43.35","93.94","20.31","621","364","438","74","16"
"2013","Calgary, Alberta, municipal","48014","Total possession of stolen property","670","637","47","1.82","54.94","46.8","47.46","55.58","17.68","684","453","497","44","14"
"2014","Calgary, Alberta, municipal","48014","Total possession of stolen property","659","608","58","-4.84","52.28","47.77","47.87","49.1","15.11","666","479","518","39","12"
"2015","Calgary, Alberta, municipal","48014","Total possession of stolen property","990","942","45","47.02","76.86","78.9","77.15","54.83","14.95","987","808","852","44","12"
"2016","Calgary, Alberta, municipal","48014","Total possession of stolen property","976","965","40","-3.72","74.01","77.52","75.79","53.68","12.2","1005","812","856","44","10"
"2005","Calgary, Alberta, municipal","48014","Total trafficking in stolen property","0","0","0","0","0","0","0","0","0","0","0","0","0","0"
"2006","Calgary, Alberta, municipal","48014","Total trafficking in stolen property","0","0","0","0","0","0","0","0","0","0","0","0","0","0"
"2007","Calgary, Alberta, municipal","48014","Total trafficking in stolen property","0","0","0","0","0","0","0","0","0","0","0","0","0","0"
"2008","Calgary, Alberta, municipal","48014","Total trafficking in stolen property","0","0","0","0","0","0","0","0","0","0","0","0","0","0"
"2009","Calgary, Alberta, municipal","48014","Total trafficking in stolen property","0","0","0","0","0","0","0","0","0","0","0","0","0","0"
"2010","Calgary, Alberta, municipal","48014","Total trafficking in stolen property","0","0","0","0","0","0","0","0","0","0","0","0","0","0"
"2011","Calgary, Alberta, municipal","48014","Total trafficking in stolen property","10","3","0","0","0.88","0.33","0.31","0","0","3","3","3","0","0"
"2012","Calgary, Alberta, municipal","48014","Total trafficking in stolen property","17","23","0","64.92","1.44","1.07","1.29","3.81","0","23","10","13","3","0"
"2013","Calgary, Alberta, municipal","48014","Total trafficking in stolen property","19","18","0","7.85","1.56","1.14","1.24","2.53","0","18","11","13","2","0"
"2014","Calgary, Alberta, municipal","48014","Total trafficking in stolen property","21","17","3","6.93","1.67","0.6","0.83","3.78","1.26","20","6","9","3","1"
"2015","Calgary, Alberta, municipal","48014","Total trafficking in stolen property","25","20","0","16.51","1.94","1.27","1.18","0","0","20","13","13","0","0"
"2016","Calgary, Alberta, municipal","48014","Total trafficking in stolen property","28","28","2","9.38","2.12","1.43","1.33","0","1.22","30","15","15","0","1"
"1998","Calgary, Alberta, municipal","48014","Total theft of motor vehicle","6639","601","156","0","789.72","0","0","0","0","757","396","651","255","79"
"1999","Calgary, Alberta, municipal","48014","Total theft of motor vehicle","6059","595","103","-11.02","702.73","0","0","0","0","698","411","661","250","45"
"2000","Calgary, Alberta, municipal","48014","Total theft of motor vehicle","5425","590","163","-12.54","614.63","0","0","0","0","753","405","599","194","58"
"2001","Calgary, Alberta, municipal","48014","Total theft of motor vehicle","5467","645","178","-1.4","606","0","0","0","0","823","443","650","207","59"
"2002","Calgary, Alberta, municipal","48014","Total theft of motor vehicle","5168","619","192","-7.65","559.62","0","0","0","0","811","453","620","167","37"
"2003","Calgary, Alberta, municipal","48014","Total theft of motor vehicle","5467","590","189","4.13","582.75","0","0","0","0","779","440","546","106","36"
"2004","Calgary, Alberta, municipal","48014","Total theft of motor vehicle","4602","374","67","-18.34","475.9","34.95","37.66","64.63","35.61","441","263","312","49","27"
"2005","Calgary, Alberta, municipal","48014","Total theft of motor vehicle","4446","319","68","-6.24","446.19","31.49","34.27","62.32","29.86","387","245","293","48","23"
"2006","Calgary, Alberta, municipal","48014","Total theft of motor vehicle","6510","534","95","41.97","633.45","43.34","52.43","146.51","34.7","629","349","463","114","27"
"2007","Calgary, Alberta, municipal","48014","Total theft of motor vehicle","6972","446","117","4.53","662.13","19.43","23.4","65.8","16.77","563","161","212","51","13"
"2008","Calgary, Alberta, municipal","48014","Total theft of motor vehicle","6550","359","82","-8.35","606.82","18.78","20.01","33.68","20.73","441","160","186","26","16"
"2009","Calgary, Alberta, municipal","48014","Total theft of motor vehicle","4817","338","54","-28.3","435.06","15.76","18.46","49","15.47","392","138","176","38","12"
"2010","Calgary, Alberta, municipal","48014","Total theft of motor vehicle","4291","223","46","-12.23","381.86","11.6","12.73","25.65","12.82","269","103","123","20","10"
"2011","Calgary, Alberta, municipal","48014","Total theft of motor vehicle","3792","250","58","-13.01","332.17","16.85","18.26","34.46","15.32","308","152","179","27","12"
"2012","Calgary, Alberta, municipal","48014","Total theft of motor vehicle","3969","304","66","1.54","337.28","14.81","17.22","45.7","12.69","370","138","174","36","10"
"2013","Calgary, Alberta, municipal","48014","Total theft of motor vehicle","4498","202","46","9.36","368.84","14.36","16.62","44.21","12.63","248","139","174","35","10"
"2014","Calgary, Alberta, municipal","48014","Total theft of motor vehicle","4155","193","48","-10.63","329.63","14.66","15.34","23.92","12.59","241","147","166","19","10"
"2015","Calgary, Alberta, municipal","48014","Total theft of motor vehicle","7103","199","47","67.3","551.48","15.04","15.58","22.43","7.48","246","154","172","18","6"
"2016","Calgary, Alberta, municipal","48014","Total theft of motor vehicle","7162","211","63","-1.53","543.06","15.18","16.56","34.16","19.52","274","159","187","28","16"
"1998","Calgary, Alberta, municipal","48014","Total theft over $5,000 (non-motor vehicle)","711","88","20","0","84.58","0","0","0","0","108","85","89","4","8"
"1999","Calgary, Alberta, municipal","48014","Total theft over $5,000 (non-motor vehicle)","719","103","23","-1.4","83.39","0","0","0","0","126","104","115","11","3"
"2000","Calgary, Alberta, municipal","48014","Total theft over $5,000 (non-motor vehicle)","684","111","25","-7.07","77.49","0","0","0","0","136","113","123","10","2"
"2001","Calgary, Alberta, municipal","48014","Total theft over $5,000 (non-motor vehicle)","694","114","23","-0.73","76.93","0","0","0","0","137","99","103","4","2"
"2002","Calgary, Alberta, municipal","48014","Total theft over $5,000 (non-motor vehicle)","621","87","32","-12.59","67.25","0","0","0","0","119","76","79","3","3"
"2003","Calgary, Alberta, municipal","48014","Total theft over $5,000 (non-motor vehicle)","606","101","22","-3.94","64.6","0","0","0","0","123","94","97","3","1"
"2004","Calgary, Alberta, municipal","48014","Total theft over $5,000 (non-motor vehicle)","689","85","25","10.3","71.25","10.5","10.26","7.91","2.64","110","79","85","6","2"
"2005","Calgary, Alberta, municipal","48014","Total theft over $5,000 (non-motor vehicle)","586","86","14","-17.46","58.81","10.93","10.64","7.79","1.3","100","85","91","6","1"
"2006","Calgary, Alberta, municipal","48014","Total theft over $5,000 (non-motor vehicle)","675","68","9","11.68","65.68","7.82","7.36","2.57","1.29","77","63","65","2","1"
"2007","Calgary, Alberta, municipal","48014","Total theft over $5,000 (non-motor vehicle)","721","88","10","4.25","68.47","8.09","8.5","12.9","2.58","98","67","77","10","2"
"2008","Calgary, Alberta, municipal","48014","Total theft over $5,000 (non-motor vehicle)","718","74","17","-2.85","66.52","5.87","5.7","3.89","7.77","91","50","53","3","6"
"2009","Calgary, Alberta, municipal","48014","Total theft over $5,000 (non-motor vehicle)","550","73","7","-25.32","49.68","4.68","4.41","1.29","0","80","41","42","1","0"
"2010","Calgary, Alberta, municipal","48014","Total theft over $5,000 (non-motor vehicle)","531","106","16","-4.87","47.25","7.2","6.93","3.85","5.13","122","64","67","3","4"
"2011","Calgary, Alberta, municipal","48014","Total theft over $5,000 (non-motor vehicle)","420","50","8","-22.14","36.79","3.44","3.16","0","0","58","31","31","0","0"
"2012","Calgary, Alberta, municipal","48014","Total theft over $5,000 (non-motor vehicle)","430","58","19","-0.68","36.54","4.51","4.16","0","3.81","77","42","42","0","3"
"2013","Calgary, Alberta, municipal","48014","Total theft over $5,000 (non-motor vehicle)","390","46","7","-12.48","31.98","3","2.77","0","0","53","29","29","0","0"
"2014","Calgary, Alberta, municipal","48014","Total theft over $5,000 (non-motor vehicle)","492","43","5","22.05","39.03","2.99","3.05","3.78","1.26","48","30","33","3","1"
"2015","Calgary, Alberta, municipal","48014","Total theft over $5,000 (non-motor vehicle)","516","53","1","2.64","40.06","3.52","3.35","1.25","0","54","36","37","1","0"
"2016","Calgary, Alberta, municipal","48014","Total theft over $5,000 (non-motor vehicle)","797","66","4","50.85","60.43","4.11","3.98","2.44","0","70","43","45","2","0"
"1998","Calgary, Alberta, municipal","48014","Theft over $5,000","408","77","19","0","48.53","0","0","0","0","96","77","81","4","6"
"1999","Calgary, Alberta, municipal","48014","Theft over $5,000","387","86","19","-7.52","44.88","0","0","0","0","105","86","96","10","3"
"2000","Calgary, Alberta, municipal","48014","Theft over $5,000","405","90","23","2.23","45.88","0","0","0","0","113","93","99","6","2"
"2001","Calgary, Alberta, municipal","48014","Theft over $5,000","438","92","20","5.81","48.55","0","0","0","0","112","84","87","3","2"
"2002","Calgary, Alberta, municipal","48014","Theft over $5,000","351","63","26","-21.71","38.01","0","0","0","0","89","56","59","3","3"
"2003","Calgary, Alberta, municipal","48014","Theft over $5,000","318","72","15","-10.82","33.9","0","0","0","0","87","76","79","3","1"
"2004","Calgary, Alberta, municipal","48014","Theft over $5,000","382","76","25","16.54","39.5","9.3","8.81","3.96","2.64","101","70","73","3","2"
"2005","Calgary, Alberta, municipal","48014","Theft over $5,000","302","76","12","-23.28","30.31","9.77","9.59","7.79","1.3","88","76","82","6","1"
"2006","Calgary, Alberta, municipal","48014","Theft over $5,000","279","57","8","-10.43","27.15","6.33","6","2.57","1.29","65","51","53","2","1"
"2007","Calgary, Alberta, municipal","48014","Theft over $5,000","308","76","10","7.74","29.25","7.24","7.5","10.32","2.58","86","60","68","8","2"
"2008","Calgary, Alberta, municipal","48014","Theft over $5,000","325","67","16","2.94","30.11","5.28","5.16","3.89","7.77","83","45","48","3","6"
"2009","Calgary, Alberta, municipal","48014","Theft over $5,000","265","71","7","-20.51","23.93","4.57","4.3","1.29","0","78","40","41","1","0"
"2010","Calgary, Alberta, municipal","48014","Theft over $5,000","281","96","13","4.48","25.01","6.3","6.11","3.85","2.56","109","56","59","3","2"
"2011","Calgary, Alberta, municipal","48014","Theft over $5,000","222","46","8","-22.23","19.45","2.99","2.75","0","0","54","27","27","0","0"
"2012","Calgary, Alberta, municipal","48014","Theft over $5,000","228","51","18","-0.37","19.38","3.76","3.46","0","3.81","69","35","35","0","3"
"2013","Calgary, Alberta, municipal","48014","Theft over $5,000","241","45","7","2","19.76","2.89","2.67","0","0","52","28","28","0","0"
"2014","Calgary, Alberta, municipal","48014","Theft over $5,000","205","39","5","-17.71","16.26","2.69","2.59","1.26","1.26","44","27","28","1","1"
"2015","Calgary, Alberta, municipal","48014","Theft over $5,000","243","48","1","16.01","18.87","2.93","2.81","1.25","0","49","30","31","1","0"
"2016","Calgary, Alberta, municipal","48014","Theft over $5,000","297","54","4","19.37","22.52","3.15","3.1","2.44","0","58","33","35","2","0"
"1998","Calgary, Alberta, municipal","48014","Theft over $5,000 from a motor vehicle","299","9","1","0","35.57","0","0","0","0","10","6","6","0","2"
"1999","Calgary, Alberta, municipal","48014","Theft over $5,000 from a motor vehicle","318","13","4","3.7","36.88","0","0","0","0","17","9","10","1","0"
"2000","Calgary, Alberta, municipal","48014","Theft over $5,000 from a motor vehicle","272","16","2","-16.45","30.82","0","0","0","0","18","14","17","3","0"
"2001","Calgary, Alberta, municipal","48014","Theft over $5,000 from a motor vehicle","243","16","3","-12.59","26.94","0","0","0","0","19","11","11","0","0"
"2002","Calgary, Alberta, municipal","48014","Theft over $5,000 from a motor vehicle","258","18","5","3.72","27.94","0","0","0","0","23","14","14","0","0"
"2003","Calgary, Alberta, municipal","48014","Theft over $5,000 from a motor vehicle","279","24","6","6.45","29.74","0","0","0","0","30","12","12","0","0"
"2004","Calgary, Alberta, municipal","48014","Theft over $5,000 from a motor vehicle","296","5","0","2.93","30.61","0.66","0.97","3.96","0","5","5","8","3","0"
"2005","Calgary, Alberta, municipal","48014","Theft over $5,000 from a motor vehicle","273","7","0","-10.49","27.4","0.51","0.47","0","0","7","4","4","0","0"
"2006","Calgary, Alberta, municipal","48014","Theft over $5,000 from a motor vehicle","378","6","1","34.25","36.78","0.75","0.68","0","0","7","6","6","0","0"
"2007","Calgary, Alberta, municipal","48014","Theft over $5,000 from a motor vehicle","396","6","0","2.25","37.61","0.36","0.55","2.58","0","6","3","5","2","0"
"2008","Calgary, Alberta, municipal","48014","Theft over $5,000 from a motor vehicle","379","3","1","-6.64","35.11","0","0","0","0","4","0","0","0","0"
"2009","Calgary, Alberta, municipal","48014","Theft over $5,000 from a motor vehicle","274","1","0","-29.52","24.75","0","0","0","0","1","0","0","0","0"
"2010","Calgary, Alberta, municipal","48014","Theft over $5,000 from a motor vehicle","242","8","0","-12.98","21.54","0.68","0.62","0","0","8","6","6","0","0"
"2011","Calgary, Alberta, municipal","48014","Theft over $5,000 from a motor vehicle","188","1","0","-23.53","16.47","0","0","0","0","1","0","0","0","0"
"2012","Calgary, Alberta, municipal","48014","Theft over $5,000 from a motor vehicle","195","3","1","0.62","16.57","0.32","0.3","0","0","4","3","3","0","0"
"2013","Calgary, Alberta, municipal","48014","Theft over $5,000 from a motor vehicle","143","0","0","-29.24","11.73","0","0","0","0","0","0","0","0","0"
"2014","Calgary, Alberta, municipal","48014","Theft over $5,000 from a motor vehicle","274","0","0","85.37","21.74","0","0","0","0","0","0","0","0","0"
"2015","Calgary, Alberta, municipal","48014","Theft over $5,000 from a motor vehicle","255","1","0","-8.92","19.8","0.1","0.09","0","0","1","1","1","0","0"
"2016","Calgary, Alberta, municipal","48014","Theft over $5,000 from a motor vehicle","473","1","0","81.15","35.87","0.1","0.09","0","0","1","1","1","0","0"
"1998","Calgary, Alberta, municipal","48014","Shoplifting over $5,000","4","2","0","0","0.48","0","0","0","0","2","2","2","0","0"
"1999","Calgary, Alberta, municipal","48014","Shoplifting over $5,000","14","4","0","241.26","1.62","0","0","0","0","4","9","9","0","0"
"2000","Calgary, Alberta, municipal","48014","Shoplifting over $5,000","7","5","0","-51.16","0.79","0","0","0","0","5","6","7","1","0"
"2001","Calgary, Alberta, municipal","48014","Shoplifting over $5,000","13","6","0","81.7","1.44","0","0","0","0","6","4","5","1","0"
"2002","Calgary, Alberta, municipal","48014","Shoplifting over $5,000","12","6","1","-9.82","1.3","0","0","0","0","7","6","6","0","0"
"2003","Calgary, Alberta, municipal","48014","Shoplifting over $5,000","9","5","1","-26.17","0.96","0","0","0","0","6","6","6","0","0"
"2004","Calgary, Alberta, municipal","48014","Shoplifting over $5,000","11","4","0","18.57","1.14","0.53","0.48","0","0","4","4","4","0","0"
"2005","Calgary, Alberta, municipal","48014","Shoplifting over $5,000","11","3","2","-2.95","1.1","0.64","0.58","0","0","5","5","5","0","0"
"2006","Calgary, Alberta, municipal","48014","Shoplifting over $5,000","18","5","0","58.66","1.75","0.75","0.68","0","0","5","6","6","0","0"
"2007","Calgary, Alberta, municipal","48014","Shoplifting over $5,000","17","6","0","-7.82","1.61","0.48","0.44","0","0","6","4","4","0","0"
"2008","Calgary, Alberta, municipal","48014","Shoplifting over $5,000","14","4","0","-19.66","1.3","0.59","0.54","0","0","4","5","5","0","0"
"2009","Calgary, Alberta, municipal","48014","Shoplifting over $5,000","11","1","0","-23.4","0.99","0.11","0.1","0","0","1","1","1","0","0"
"2010","Calgary, Alberta, municipal","48014","Shoplifting over $5,000","8","2","3","-28.34","0.71","0.23","0.21","0","2.56","5","2","2","0","2"
"2011","Calgary, Alberta, municipal","48014","Shoplifting over $5,000","10","3","0","23.04","0.88","0.44","0.41","0","0","3","4","4","0","0"
"2012","Calgary, Alberta, municipal","48014","Shoplifting over $5,000","7","4","0","-32.09","0.59","0.43","0.4","0","0","4","4","4","0","0"
"2013","Calgary, Alberta, municipal","48014","Shoplifting over $5,000","6","1","0","-17.29","0.49","0.1","0.1","0","0","1","1","1","0","0"
"2014","Calgary, Alberta, municipal","48014","Shoplifting over $5,000","13","4","0","109.62","1.03","0.3","0.46","2.52","0","4","3","5","2","0"
"2015","Calgary, Alberta, municipal","48014","Shoplifting over $5,000","18","4","0","35.51","1.4","0.49","0.45","0","0","4","5","5","0","0"
"2016","Calgary, Alberta, municipal","48014","Shoplifting over $5,000","27","11","0","46.49","2.05","0.86","0.8","0","0","11","9","9","0","0"
"1998","Calgary, Alberta, municipal","48014","Total theft under $5,000 (non-motor vehicle)","25078","3675","1461","0","2983.09","0","0","0","0","5136","2781","3643","862","1133"
"1999","Calgary, Alberta, municipal","48014","Total theft under $5,000 (non-motor vehicle)","24750","3169","1513","-3.77","2870.53","0","0","0","0","4682","2496","3285","789","1199"
"2000","Calgary, Alberta, municipal","48014","Total theft under $5,000 (non-motor vehicle)","23330","3246","1516","-7.92","2643.18","0","0","0","0","4762","2471","3210","739","1115"
"2001","Calgary, Alberta, municipal","48014","Total theft under $5,000 (non-motor vehicle)","22751","3315","1414","-4.59","2521.88","0","0","0","0","4729","2622","3278","656","1118"
"2002","Calgary, Alberta, municipal","48014","Total theft under $5,000 (non-motor vehicle)","23348","3667","1618","0.25","2528.27","0","0","0","0","5285","2817","3674","857","1179"
"2003","Calgary, Alberta, municipal","48014","Total theft under $5,000 (non-motor vehicle)","24084","3557","1845","1.54","2567.21","0","0","0","0","5402","2856","3380","524","1410"
"2004","Calgary, Alberta, municipal","48014","Total theft under $5,000 (non-motor vehicle)","23304","3899","1672","-6.13","2409.89","419.09","438.44","630.46","1681.66","5571","3154","3632","478","1275"
"2005","Calgary, Alberta, municipal","48014","Total theft under $5,000 (non-motor vehicle)","23190","3712","1403","-3.43","2327.31","392.97","420.26","695.89","1554.06","5115","3057","3593","536","1197"
"2006","Calgary, Alberta, municipal","48014","Total theft under $5,000 (non-motor vehicle)","22734","3883","1110","-4.95","2212.12","396.28","422.97","699.13","1247.9","4993","3191","3735","544","971"
"2007","Calgary, Alberta, municipal","48014","Total theft under $5,000 (non-motor vehicle)","22323","3460","990","-4.16","2120","328.73","376.76","890.28","1119.94","4450","2724","3414","690","868"
"2008","Calgary, Alberta, municipal","48014","Total theft under $5,000 (non-motor vehicle)","21438","3677","995","-6.32","1986.12","340.66","391.13","948.28","1095.97","4672","2903","3635","732","846"
"2009","Calgary, Alberta, municipal","48014","Total theft under $5,000 (non-motor vehicle)","20228","3696","1012","-8.01","1826.96","349.2","392.02","875.54","1030.28","4708","3058","3737","679","799"
"2010","Calgary, Alberta, municipal","48014","Total theft under $5,000 (non-motor vehicle)","19117","3105","1006","-6.88","1701.26","296.98","316.99","544.99","854.03","4111","2638","3063","425","666"
"2011","Calgary, Alberta, municipal","48014","Total theft under $5,000 (non-motor vehicle)","19071","2781","1155","-1.8","1670.57","277.35","292.11","462.04","989.18","3936","2502","2864","362","775"
"2012","Calgary, Alberta, municipal","48014","Total theft under $5,000 (non-motor vehicle)","18575","2415","853","-5.51","1578.48","233.88","239.99","312.29","648.7","3268","2179","2425","246","511"
"2013","Calgary, Alberta, municipal","48014","Total theft under $5,000 (non-motor vehicle)","18835","2142","701","-2.15","1544.5","204.46","207.43","243.79","487.58","2843","1979","2172","193","386"
"2014","Calgary, Alberta, municipal","48014","Total theft under $5,000 (non-motor vehicle)","19032","2441","875","-2.24","1509.88","231.58","229.92","208.97","524.94","3316","2322","2488","166","417"
"2015","Calgary, Alberta, municipal","48014","Total theft under $5,000 (non-motor vehicle)","25800","2664","837","32.67","2003.11","249.59","248.93","240.51","606.89","3501","2556","2749","193","487"
"2016","Calgary, Alberta, municipal","48014","Total theft under $5,000 (non-motor vehicle)","26375","2527","722","-0.16","1999.9","228.94","223.92","159.81","491.63","3249","2398","2529","131","403"
"1998","Calgary, Alberta, municipal","48014","Theft $5,000 or under","8642","844","275","0","1027.99","0","0","0","0","1119","532","704","172","136"
"1999","Calgary, Alberta, municipal","48014","Theft $5,000 or under","8106","684","353","-8.55","940.14","0","0","0","0","1037","455","604","149","192"
"2000","Calgary, Alberta, municipal","48014","Theft $5,000 or under","8309","811","395","0.13","941.37","0","0","0","0","1206","523","660","137","167"
"2001","Calgary, Alberta, municipal","48014","Theft $5,000 or under","8347","786","405","-1.71","925.24","0","0","0","0","1191","509","650","141","191"
"2002","Calgary, Alberta, municipal","48014","Theft $5,000 or under","8961","823","444","4.88","970.35","0","0","0","0","1267","530","708","178","164"
"2003","Calgary, Alberta, municipal","48014","Theft $5,000 or under","9401","789","545","3.27","1002.09","0","0","0","0","1334","580","689","109","257"
"2004","Calgary, Alberta, municipal","48014","Theft $5,000 or under","9555","801","490","-1.4","988.09","75.21","81.72","146.4","274.34","1291","566","677","111","208"
"2005","Calgary, Alberta, municipal","48014","Theft $5,000 or under","8778","750","411","-10.84","880.94","69.16","75.91","144.11","275.24","1161","538","649","111","212"
"2006","Calgary, Alberta, municipal","48014","Theft $5,000 or under","7441","803","392","-17.81","724.04","72.53","78.37","138.8","268.6","1195","584","692","108","209"
"2007","Calgary, Alberta, municipal","48014","Theft $5,000 or under","7799","1218","384","2.3","740.67","115.73","129.01","270.95","286.44","1602","959","1169","210","222"
"2008","Calgary, Alberta, municipal","48014","Theft $5,000 or under","6879","1142","393","-13.96","637.3","95.64","107.49","238.37","336.82","1535","815","999","184","260"
"2009","Calgary, Alberta, municipal","48014","Theft $5,000 or under","5996","563","279","-15.02","541.55","39.62","47.1","131.52","154.73","842","347","449","102","120"
"2010","Calgary, Alberta, municipal","48014","Theft $5,000 or under","5718","497","262","-6.04","508.86","39.29","42.33","76.94","125.67","759","349","409","60","98"
"2011","Calgary, Alberta, municipal","48014","Theft $5,000 or under","5697","458","256","-1.93","499.04","39.24","41.31","65.09","146.78","714","354","405","51","115"
"2012","Calgary, Alberta, municipal","48014","Theft $5,000 or under","5472","453","200","-6.82","465","33.38","36.22","69.82","109.17","653","311","366","55","86"
"2013","Calgary, Alberta, municipal","48014","Theft $5,000 or under","6423","391","206","13.27","526.7","31.3","32.18","42.95","121.26","597","303","337","34","96"
"2014","Calgary, Alberta, municipal","48014","Theft $5,000 or under","6426","417","188","-3.21","509.8","35.6","35.76","37.77","69.24","605","357","387","30","55"
"2015","Calgary, Alberta, municipal","48014","Theft $5,000 or under","7413","405","153","12.9","575.55","31.25","31.24","31.15","62.31","558","320","345","25","50"
"2016","Calgary, Alberta, municipal","48014","Theft $5,000 or under","7179","408","138","-5.42","544.35","31.31","30.55","20.74","46.36","546","328","345","17","38"
"1998","Calgary, Alberta, municipal","48014","Theft $5,000 or under from a motor vehicle","12661","514","110","0","1506.06","0","0","0","0","624","361","455","94","39"
"1999","Calgary, Alberta, municipal","48014","Theft $5,000 or under from a motor vehicle","12897","232","76","-0.68","1495.81","0","0","0","0","308","137","222","85","41"
"2000","Calgary, Alberta, municipal","48014","Theft $5,000 or under from a motor vehicle","11415","243","101","-13.54","1293.26","0","0","0","0","344","123","182","59","30"
"2001","Calgary, Alberta, municipal","48014","Theft $5,000 or under from a motor vehicle","10710","218","80","-8.2","1187.17","0","0","0","0","298","132","155","23","43"
"2002","Calgary, Alberta, municipal","48014","Theft $5,000 or under from a motor vehicle","10106","226","118","-7.82","1094.34","0","0","0","0","344","122","169","47","26"
"2003","Calgary, Alberta, municipal","48014","Theft $5,000 or under from a motor vehicle","10411","303","120","1.41","1109.75","0","0","0","0","423","116","141","25","52"
"2004","Calgary, Alberta, municipal","48014","Theft $5,000 or under from a motor vehicle","9113","296","54","-15.08","942.38","5.71","5.92","7.91","7.91","350","43","49","6","6"
"2005","Calgary, Alberta, municipal","48014","Theft $5,000 or under from a motor vehicle","10069","209","35","7.23","1010.51","4.37","4.09","1.3","3.89","244","34","35","1","3"
"2006","Calgary, Alberta, municipal","48014","Theft $5,000 or under from a motor vehicle","11081","247","27","6.7","1078.23","4.22","4.3","5.14","10.28","274","34","38","4","8"
"2007","Calgary, Alberta, municipal","48014","Theft $5,000 or under from a motor vehicle","11382","165","39","0.25","1080.94","0.72","0.88","2.58","0","204","6","8","2","0"
"2008","Calgary, Alberta, municipal","48014","Theft $5,000 or under from a motor vehicle","10936","139","16","-6.27","1013.17","0.35","0.32","0","0","155","3","3","0","0"
"2009","Calgary, Alberta, municipal","48014","Theft $5,000 or under from a motor vehicle","9683","137","21","-13.68","874.55","0.34","0.42","1.29","0","158","3","4","1","0"
"2010","Calgary, Alberta, municipal","48014","Theft $5,000 or under from a motor vehicle","9452","113","16","-3.82","841.15","0","0","0","0","129","0","0","0","0"
"2011","Calgary, Alberta, municipal","48014","Theft $5,000 or under from a motor vehicle","9556","56","3","-0.48","837.08","0.55","0.71","2.55","3.83","59","5","7","2","3"
"2012","Calgary, Alberta, municipal","48014","Theft $5,000 or under from a motor vehicle","9690","3","2","-1.63","823.45","0.21","0.2","0","0","5","2","2","0","0"
"2013","Calgary, Alberta, municipal","48014","Theft $5,000 or under from a motor vehicle","9272","10","0","-7.67","760.32","0.21","0.19","0","0","10","2","2","0","0"
"2014","Calgary, Alberta, municipal","48014","Theft $5,000 or under from a motor vehicle","8891","4","0","-7.23","705.36","0","0","0","0","4","0","0","0","0"
"2015","Calgary, Alberta, municipal","48014","Theft $5,000 or under from a motor vehicle","13990","6","1","53.99","1086.19","0.39","0.36","0","1.25","7","4","4","0","1"
"2016","Calgary, Alberta, municipal","48014","Theft $5,000 or under from a motor vehicle","14675","22","6","2.44","1112.74","1.62","1.51","0","1.22","28","17","17","0","1"
"1998","Calgary, Alberta, municipal","48014","Shoplifting $5,000 or under","3775","2317","1076","0","449.04","0","0","0","0","3393","1888","2484","596","958"
"1999","Calgary, Alberta, municipal","48014","Shoplifting $5,000 or under","3747","2253","1084","-3.22","434.58","0","0","0","0","3337","1904","2459","555","966"
"2000","Calgary, Alberta, municipal","48014","Shoplifting $5,000 or under","3606","2192","1020","-5.99","408.54","0","0","0","0","3212","1825","2368","543","918"
"2001","Calgary, Alberta, municipal","48014","Shoplifting $5,000 or under","3694","2311","929","0.23","409.47","0","0","0","0","3240","1981","2473","492","884"
"2002","Calgary, Alberta, municipal","48014","Shoplifting $5,000 or under","4281","2618","1056","13.21","463.57","0","0","0","0","3674","2165","2797","632","989"
"2003","Calgary, Alberta, municipal","48014","Shoplifting $5,000 or under","4272","2465","1180","-1.77","455.37","0","0","0","0","3645","2160","2550","390","1101"
"2004","Calgary, Alberta, municipal","48014","Shoplifting $5,000 or under","4636","2802","1128","5.28","479.41","338.17","350.8","476.14","1399.4","3930","2545","2906","361","1061"
"2005","Calgary, Alberta, municipal","48014","Shoplifting $5,000 or under","4343","2753","957","-9.09","435.86","319.44","340.25","550.48","1274.93","3710","2485","2909","424","982"
"2006","Calgary, Alberta, municipal","48014","Shoplifting $5,000 or under","4212","2833","691","-5.97","409.85","319.54","340.3","555.19","969.01","3524","2573","3005","432","754"
"2007","Calgary, Alberta, municipal","48014","Shoplifting $5,000 or under","3142","2077","567","-27.19","298.39","212.28","246.87","616.74","833.51","2644","1759","2237","478","646"
"2008","Calgary, Alberta, municipal","48014","Shoplifting $5,000 or under","3623","2396","586","12.49","335.65","244.67","283.32","709.92","759.15","2982","2085","2633","548","586"
"2009","Calgary, Alberta, municipal","48014","Shoplifting $5,000 or under","4549","2996","712","22.41","410.86","309.23","344.5","742.73","875.54","3708","2708","3284","576","679"
"2010","Calgary, Alberta, municipal","48014","Shoplifting $5,000 or under","3947","2495","728","-14.51","351.25","257.69","274.67","468.05","728.36","3223","2289","2654","365","568"
"2011","Calgary, Alberta, municipal","48014","Shoplifting $5,000 or under","3818","2267","896","-4.78","334.45","237.55","250.09","394.39","838.57","3163","2143","2452","309","657"
"2012","Calgary, Alberta, municipal","48014","Shoplifting $5,000 or under","3413","1959","651","-13.28","290.03","200.28","203.57","242.47","539.52","2610","1866","2057","191","425"
"2013","Calgary, Alberta, municipal","48014","Shoplifting $5,000 or under","3140","1741","495","-11.22","257.49","172.95","175.06","200.84","366.31","2236","1674","1833","159","290"
"2014","Calgary, Alberta, municipal","48014","Shoplifting $5,000 or under","3715","2020","687","14.46","294.72","195.97","194.16","171.2","455.71","2707","1965","2101","136","362"
"2015","Calgary, Alberta, municipal","48014","Shoplifting $5,000 or under","4397","2253","683","15.83","341.38","217.95","217.33","209.36","543.34","2936","2232","2400","168","436"
"2016","Calgary, Alberta, municipal","48014","Shoplifting $5,000 or under","4521","2097","578","0.42","342.81","196","191.87","139.07","444.05","2675","2053","2167","114","364"
"1998","Calgary, Alberta, municipal","48014","Fraud","3725","1786","285","0","443.1","0","0","0","0","2071","991","1103","112","43"
"1999","Calgary, Alberta, municipal","48014","Fraud","3697","1767","384","-3.23","428.78","0","0","0","0","2151","1018","1133","115","62"
"2000","Calgary, Alberta, municipal","48014","Fraud","3496","1883","338","-7.63","396.08","0","0","0","0","2221","1014","1128","114","53"
"2001","Calgary, Alberta, municipal","48014","Fraud","3332","1942","368","-6.75","369.34","0","0","0","0","2310","1006","1105","99","61"
"2002","Calgary, Alberta, municipal","48014","Fraud","3886","1810","312","13.93","420.8","0","0","0","0","2122","1104","1198","94","48"
"2003","Calgary, Alberta, municipal","48014","Fraud","4102","2164","489","3.91","437.25","0","0","0","0","2653","1246","1322","76","76"
"2004","Calgary, Alberta, municipal","48014","Fraud","3851","1677","262","-8.92","398.24","159.05","149.45","54.08","59.35","1939","1197","1238","41","45"
"2005","Calgary, Alberta, municipal","48014","Fraud","4068","1772","194","2.52","408.26","164.54","156.15","71.41","68.81","1966","1280","1335","55","53"
"2006","Calgary, Alberta, municipal","48014","Fraud","3375","1521","194","-19.56","328.4","135.36","129.55","69.4","46.27","1715","1090","1144","54","36"
"2007","Calgary, Alberta, municipal","48014","Fraud","3003","1115","170","-13.16","285.19","97.39","95.46","74.83","32.26","1285","807","865","58","25"
"2008","Calgary, Alberta, municipal","48014","Fraud","2721","1124","141","-11.61","252.09","97.87","92.75","36.27","31.09","1265","834","862","28","24"
"2009","Calgary, Alberta, municipal","48014","Fraud","3149","1298","177","12.82","284.41","104.71","101.34","63.18","36.1","1475","917","966","49","28"
"2010","Calgary, Alberta, municipal","48014","Fraud","2752","1098","181","-13.89","244.91","90.74","85.17","21.8","30.78","1279","806","823","17","24"
"2011","Calgary, Alberta, municipal","48014","Fraud","2487","1052","144","-11.05","217.85","86.46","81.49","24.25","31.91","1196","780","799","19","25"
"2012","Calgary, Alberta, municipal","48014","Fraud","2409","915","136","-6.03","204.71","69.23","65.22","17.77","16.5","1051","645","659","14","13"
"2013","Calgary, Alberta, municipal","48014","Fraud","2551","947","116","2.18","209.19","74.08","69.43","12.63","11.37","1063","717","727","10","9"
"2014","Calgary, Alberta, municipal","48014","Fraud","2876","885","111","9.07","228.16","67.62","63.58","12.59","16.37","996","678","688","10","13"
"2015","Calgary, Alberta, municipal","48014","Fraud","3748","980","97","27.54","291","79.97","75.07","12.46","7.48","1077","819","829","10","6"
"2016","Calgary, Alberta, municipal","48014","Fraud","4157","1121","88","8.32","315.21","82.3","77.39","14.64","12.2","1209","862","874","12","10"
"2005","Calgary, Alberta, municipal","48014","Identity theft","0","0","0","0","0","0","0","0","0","0","0","0","0","0"
"2006","Calgary, Alberta, municipal","48014","Identity theft","0","0","0","0","0","0","0","0","0","0","0","0","0","0"
"2007","Calgary, Alberta, municipal","48014","Identity theft","0","0","0","0","0","0","0","0","0","0","0","0","0","0"
"2008","Calgary, Alberta, municipal","48014","Identity theft","0","0","0","0","0","0","0","0","0","0","0","0","0","0"
"2009","Calgary, Alberta, municipal","48014","Identity theft","0","0","0","0","0","0","0","0","0","0","0","0","0","0"
"2010","Calgary, Alberta, municipal","48014","Identity theft","24","8","2","0","2.14","0","0","0","0","10","0","0","0","0"
"2011","Calgary, Alberta, municipal","48014","Identity theft","44","28","0","80.46","3.85","0.11","0.1","0","0","28","1","1","0","0"
"2012","Calgary, Alberta, municipal","48014","Identity theft","47","22","0","3.62","3.99","0.32","0.3","0","0","22","3","3","0","0"
"2013","Calgary, Alberta, municipal","48014","Identity theft","19","17","1","-60.99","1.56","0.52","0.48","0","5.05","18","5","5","0","4"
"2014","Calgary, Alberta, municipal","48014","Identity theft","26","25","0","32.39","2.06","0.6","0.55","0","0","25","6","6","0","0"
"2015","Calgary, Alberta, municipal","48014","Identity theft","22","22","0","-17.19","1.71","0.98","1","1.25","0","22","10","11","1","0"
"2016","Calgary, Alberta, municipal","48014","Identity theft","55","51","0","144.16","4.17","2.77","2.57","0","0","51","29","29","0","0"
"2005","Calgary, Alberta, municipal","48014","Identity fraud","0","0","0","0","0","0","0","0","0","0","0","0","0","0"
"2006","Calgary, Alberta, municipal","48014","Identity fraud","0","0","0","0","0","0","0","0","0","0","0","0","0","0"
"2007","Calgary, Alberta, municipal","48014","Identity fraud","0","0","0","0","0","0","0","0","0","0","0","0","0","0"
"2008","Calgary, Alberta, municipal","48014","Identity fraud","21","13","1","0","1.95","0","0","0","0","14","0","0","0","0"
"2009","Calgary, Alberta, municipal","48014","Identity fraud","54","21","7","150.69","4.88","0","0","0","0","28","0","0","0","0"
"2010","Calgary, Alberta, municipal","48014","Identity fraud","222","112","6","305.07","19.76","5.18","5.17","5.13","0","118","46","50","4","0"
"2011","Calgary, Alberta, municipal","48014","Identity fraud","259","126","9","14.84","22.69","4.66","4.69","5.11","0","135","42","46","4","0"
"2012","Calgary, Alberta, municipal","48014","Identity fraud","250","127","5","-6.36","21.24","6.01","5.74","2.54","0","132","56","58","2","0"
"2013","Calgary, Alberta, municipal","48014","Identity fraud","230","80","7","-11.22","18.86","4.24","4.2","3.79","0","87","41","44","3","0"
"2014","Calgary, Alberta, municipal","48014","Identity fraud","270","104","5","13.57","21.42","3.99","3.88","2.52","0","109","40","42","2","0"
"2015","Calgary, Alberta, municipal","48014","Identity fraud","332","126","6","20.34","25.78","6.35","6.07","2.49","0","132","65","67","2","0"
"2016","Calgary, Alberta, municipal","48014","Identity fraud","626","138","3","84.15","47.47","7.64","7.17","1.22","0","141","80","81","1","0"
"1998","Calgary, Alberta, municipal","48014","Total mischief","8304","672","245","0","987.78","0","0","0","0","917","391","545","154","123"
"1999","Calgary, Alberta, municipal","48014","Total mischief","8006","648","299","-6","928.55","0","0","0","0","947","405","558","153","169"
"2000","Calgary, Alberta, municipal","48014","Total mischief","8143","762","409","-0.64","922.56","0","0","0","0","1171","444","605","161","269"
"2001","Calgary, Alberta, municipal","48014","Total mischief","8787","751","406","5.58","974.01","0","0","0","0","1157","477","644","167","245"
"2002","Calgary, Alberta, municipal","48014","Total mischief","8606","834","406","-4.32","931.91","0","0","0","0","1240","487","738","251","200"
"2003","Calgary, Alberta, municipal","48014","Total mischief","8515","678","498","-2.6","907.65","0","0","0","0","1176","495","628","133","372"
"2004","Calgary, Alberta, municipal","48014","Total mischief","7747","673","525","-11.74","801.13","63.25","77.14","214.99","416.79","1198","476","639","163","316"
"2005","Calgary, Alberta, municipal","48014","Total mischief","8408","757","463","5.33","843.81","62.35","76.26","216.82","353.14","1220","485","652","167","272"
"2006","Calgary, Alberta, municipal","48014","Total mischief","8975","817","440","3.5","873.31","69.3","81.42","206.91","291.73","1257","558","719","161","227"
"2007","Calgary, Alberta, municipal","48014","Total mischief","8564","741","327","-6.87","813.32","59.25","70.19","187.09","249.02","1068","491","636","145","193"
"2008","Calgary, Alberta, municipal","48014","Total mischief","8039","674","294","-8.43","744.77","58.56","67.04","160.64","207.28","968","499","623","124","160"
"2009","Calgary, Alberta, municipal","48014","Total mischief","7476","664","333","-9.34","675.22","52.41","58.75","130.24","196","997","459","560","101","152"
"2010","Calgary, Alberta, municipal","48014","Total mischief","6651","661","288","-12.34","591.88","47.62","53.4","119.26","146.19","949","423","516","93","114"
"2011","Calgary, Alberta, municipal","48014","Total mischief","6176","760","261","-8.6","541","46.67","51.1","102.11","103.38","1021","421","501","80","81"
"2012","Calgary, Alberta, municipal","48014","Total mischief","5847","772","235","-8.16","496.87","45.94","49.68","93.94","125.68","1007","428","502","74","99"
"2013","Calgary, Alberta, municipal","48014","Total mischief","5538","590","202","-8.6","454.13","36.57","38.77","65.68","104.84","792","354","406","52","83"
"2014","Calgary, Alberta, municipal","48014","Total mischief","5227","788","227","-8.69","414.68","38","39.27","55.39","86.86","1015","381","425","44","69"
"2015","Calgary, Alberta, municipal","48014","Total mischief","5651","438","221","5.8","438.74","34.67","35.95","52.34","64.8","659","355","397","42","52"
"2016","Calgary, Alberta, municipal","48014","Total mischief","4970","415","183","-14.11","376.85","30.36","31.26","42.7","52.46","598","318","353","35","43"
"1998","Calgary, Alberta, municipal","48014","Mischief","8304","672","245","0","987.78","0","0","0","0","917","391","545","154","123"
"1999","Calgary, Alberta, municipal","48014","Mischief","8006","648","299","-6","928.55","0","0","0","0","947","405","558","153","169"
"2000","Calgary, Alberta, municipal","48014","Mischief","8143","762","409","-0.64","922.56","0","0","0","0","1171","444","605","161","269"
"2001","Calgary, Alberta, municipal","48014","Mischief","8787","751","406","5.58","974.01","0","0","0","0","1157","477","644","167","245"
"2002","Calgary, Alberta, municipal","48014","Mischief","8606","834","406","-4.32","931.91","0","0","0","0","1240","487","738","251","200"
"2003","Calgary, Alberta, municipal","48014","Mischief","8515","678","498","-2.6","907.65","0","0","0","0","1176","495","628","133","372"
"2004","Calgary, Alberta, municipal","48014","Mischief","7747","673","525","-11.74","801.13","63.25","77.14","214.99","416.79","1198","476","639","163","316"
"2005","Calgary, Alberta, municipal","48014","Mischief","8408","757","463","5.33","843.81","62.35","76.26","216.82","353.14","1220","485","652","167","272"
"2006","Calgary, Alberta, municipal","48014","Mischief","8975","817","440","3.5","873.31","69.3","81.42","206.91","291.73","1257","558","719","161","227"
"2007","Calgary, Alberta, municipal","48014","Mischief","8564","741","327","-6.87","813.32","59.25","70.19","187.09","249.02","1068","491","636","145","193"
"2008","Calgary, Alberta, municipal","48014","Mischief","8039","674","294","-8.43","744.77","58.56","67.04","160.64","207.28","968","499","623","124","160"
"2009","Calgary, Alberta, municipal","48014","Mischief","7474","664","333","-9.36","675.04","52.41","58.75","130.24","196","997","459","560","101","152"
"2010","Calgary, Alberta, municipal","48014","Mischief","6651","659","288","-12.32","591.88","47.62","53.3","117.97","146.19","947","423","515","92","114"
"2011","Calgary, Alberta, municipal","48014","Mischief","6175","759","261","-8.61","540.91","46.45","50.89","102.11","103.38","1020","419","499","80","81"
"2012","Calgary, Alberta, municipal","48014","Mischief","5847","772","235","-8.14","496.87","45.94","49.68","93.94","125.68","1007","428","502","74","99"
"2013","Calgary, Alberta, municipal","48014","Mischief","5537","590","202","-8.62","454.04","36.57","38.77","65.68","104.84","792","354","406","52","83"
"2014","Calgary, Alberta, municipal","48014","Mischief","5224","788","227","-8.72","414.44","38","39.27","55.39","86.86","1015","381","425","44","69"
"2015","Calgary, Alberta, municipal","48014","Mischief","5648","438","221","5.81","438.51","34.67","35.95","52.34","64.8","659","355","397","42","52"
"2016","Calgary, Alberta, municipal","48014","Mischief","4967","415","183","-14.11","376.63","30.36","31.26","42.7","52.46","598","318","353","35","43"
"2001","Calgary, Alberta, municipal","48014","Counterfeiting","57","41","16","23.93","6.32","0","0","0","0","57","25","32","7","3"
"2002","Calgary, Alberta, municipal","48014","Counterfeiting","58","43","15","-0.6","6.28","0","0","0","0","58","38","44","6","5"
"2003","Calgary, Alberta, municipal","48014","Counterfeiting","80","55","25","35.78","8.53","0","0","0","0","80","34","41","7","10"
"2004","Calgary, Alberta, municipal","48014","Counterfeiting","115","95","20","39.46","11.89","10.5","10.14","6.59","9.23","115","79","84","5","7"
"2005","Calgary, Alberta, municipal","48014","Counterfeiting","33","19","14","-72.15","3.31","2.06","2.22","3.89","6.49","33","16","19","3","5"
"2006","Calgary, Alberta, municipal","48014","Counterfeiting","9","5","4","-73.56","0.88","0.62","0.57","0","3.86","9","5","5","0","3"
"2007","Calgary, Alberta, municipal","48014","Counterfeiting","23","19","4","149.42","2.18","0.97","0.88","0","2.58","23","8","8","0","2"
"2008","Calgary, Alberta, municipal","48014","Counterfeiting","70","54","16","196.9","6.49","3.52","3.44","2.59","2.59","70","30","32","2","2"
"2009","Calgary, Alberta, municipal","48014","Counterfeiting","41","29","12","-42.9","3.7","2.51","2.41","1.29","1.29","41","22","23","1","1"
"2010","Calgary, Alberta, municipal","48014","Counterfeiting","36","26","10","-13.48","3.2","2.25","2.07","0","0","36","20","20","0","0"
"2011","Calgary, Alberta, municipal","48014","Counterfeiting","19","12","7","-48.05","1.66","1","0.92","0","0","19","9","9","0","0"
"2012","Calgary, Alberta, municipal","48014","Counterfeiting","10","9","1","-48.94","0.85","0.86","0.79","0","2.54","10","8","8","0","2"
"2013","Calgary, Alberta, municipal","48014","Counterfeiting","3","3","0","-71.05","0.25","0.31","0.29","0","0","3","3","3","0","0"
"2014","Calgary, Alberta, municipal","48014","Counterfeiting","8","5","3","157.99","0.63","0.3","0.28","0","0","8","3","3","0","0"
"2015","Calgary, Alberta, municipal","48014","Counterfeiting","70","57","13","756.32","5.43","5.37","5.16","2.49","3.74","70","55","57","2","3"
"2016","Calgary, Alberta, municipal","48014","Counterfeiting","70","66","4","-2.34","5.31","5.82","5.76","4.88","1.22","70","61","65","4","1"
"1998","Calgary, Alberta, municipal","48014","Counterfeiting","8","3","5","0","0.95","0","0","0","0","8","3","3","0","1"
"1999","Calgary, Alberta, municipal","48014","Counterfeiting","38","24","14","363.14","4.41","0","0","0","0","38","25","29","4","13"
"2000","Calgary, Alberta, municipal","48014","Counterfeiting","45","29","16","15.68","5.1","0","0","0","0","45","24","29","5","8"
"2012","Calgary, Alberta, municipal","48014","Mischief in relation to cultural property","0","0","0","0","0","0","0","0","0","0","0","0","0","0"
"2013","Calgary, Alberta, municipal","48014","Mischief in relation to cultural property","0","0","0","0","0","0","0","0","0","0","0","0","0","0"
"2014","Calgary, Alberta, municipal","48014","Mischief in relation to cultural property","0","0","0","0","0","0","0","0","0","0","0","0","0","0"
"2015","Calgary, Alberta, municipal","48014","Mischief in relation to cultural property","0","0","0","0","0","0","0","0","0","0","0","0","0","0"
"2016","Calgary, Alberta, municipal","48014","Mischief in relation to cultural property","0","0","0","0","0","0","0","0","0","0","0","0","0","0"
"2005","Calgary, Alberta, municipal","48014","Mischief to religious property motivated by hate","0","0","0","0","0","0","0","0","0","0","0","0","0","0"
"2006","Calgary, Alberta, municipal","48014","Mischief to religious property motivated by hate","0","0","0","0","0","0","0","0","0","0","0","0","0","0"
"2007","Calgary, Alberta, municipal","48014","Mischief to religious property motivated by hate","0","0","0","0","0","0","0","0","0","0","0","0","0","0"
"2008","Calgary, Alberta, municipal","48014","Mischief to religious property motivated by hate","0","0","0","0","0","0","0","0","0","0","0","0","0","0"
"2009","Calgary, Alberta, municipal","48014","Mischief to religious property motivated by hate","2","0","0","0","0.18","0","0","0","0","0","0","0","0","0"
"2010","Calgary, Alberta, municipal","48014","Mischief to religious property motivated by hate","0","2","0","-100","0","0","0.1","1.28","0","2","0","1","1","0"
"2011","Calgary, Alberta, municipal","48014","Mischief to religious property motivated by hate","1","1","0","0","0.09","0.22","0.2","0","0","1","2","2","0","0"
"2012","Calgary, Alberta, municipal","48014","Mischief to religious property motivated by hate","0","0","0","-100","0","0","0","0","0","0","0","0","0","0"
"2013","Calgary, Alberta, municipal","48014","Mischief to religious property motivated by hate","1","0","0","0","0.08","0","0","0","0","0","0","0","0","0"
"2014","Calgary, Alberta, municipal","48014","Mischief to religious property motivated by hate","3","0","0","190.24","0.24","0","0","0","0","0","0","0","0","0"
"2015","Calgary, Alberta, municipal","48014","Mischief to religious property motivated by hate","3","0","0","-2.13","0.23","0","0","0","0","0","0","0","0","0"
"2016","Calgary, Alberta, municipal","48014","Mischief to religious property motivated by hate","3","0","0","-2.34","0.23","0","0","0","0","0","0","0","0","0"
"2012","Calgary, Alberta, municipal","48014","Mischief relating to war memorials","0","0","0","0","0","0","0","0","0","0","0","0","0","0"
"2013","Calgary, Alberta, municipal","48014","Mischief relating to war memorials","0","0","0","0","0","0","0","0","0","0","0","0","0","0"
"2014","Calgary, Alberta, municipal","48014","Mischief relating to war memorials","0","0","0","0","0","0","0","0","0","0","0","0","0","0"
"2015","Calgary, Alberta, municipal","48014","Mischief relating to war memorials","0","0","0","0","0","0","0","0","0","0","0","0","0","0"
"1998","Calgary, Alberta, municipal","48014","Total weapons violations","258","216","36","0","30.69","0","0","0","0","252","163","226","63","20"
"2016","Calgary, Alberta, municipal","48014","Mischief relating to war memorials","0","0","0","0","0","0","0","0","0","0","0","0","0","0"
"1999","Calgary, Alberta, municipal","48014","Total weapons violations","216","169","32","-18.37","25.05","0","0","0","0","201","113","169","56","19"
"2000","Calgary, Alberta, municipal","48014","Total weapons violations","263","220","38","18.94","29.8","0","0","0","0","258","139","220","81","31"
"2001","Calgary, Alberta, municipal","48014","Total weapons violations","279","220","54","3.79","30.93","0","0","0","0","274","157","234","77","34"
"2002","Calgary, Alberta, municipal","48014","Total weapons violations","327","281","41","14.5","35.41","0","0","0","0","322","215","285","70","30"
"2003","Calgary, Alberta, municipal","48014","Total weapons violations","362","298","67","8.97","38.59","0","0","0","0","365","219","300","81","67"
"1998","Calgary, Alberta, municipal","48014","Arson","154","28","8","0","18.32","0","0","0","0","36","14","23","9","10"
"2004","Calgary, Alberta, municipal","48014","Total weapons violations","394","336","54","5.59","40.74","38","43.7","100.24","55.4","390","286","362","76","42"
"1999","Calgary, Alberta, municipal","48014","Arson","176","15","11","11.43","20.41","0","0","0","0","26","8","21","13","9"
"2005","Calgary, Alberta, municipal","48014","Total weapons violations","475","408","64","17","47.67","44.09","51.46","125.93","66.21","472","343","440","97","51"
"2000","Calgary, Alberta, municipal","48014","Arson","161","23","19","-10.64","18.24","0","0","0","0","42","12","25","13","20"
"2006","Calgary, Alberta, municipal","48014","Total weapons violations","431","365","60","-12.02","41.94","38.13","44.05","105.38","44.98","425","307","389","82","35"
"2001","Calgary, Alberta, municipal","48014","Arson","235","20","33","42.81","26.05","0","0","0","0","53","8","25","17","30"
"2007","Calgary, Alberta, municipal","48014","Total weapons violations","350","295","48","-20.74","33.24","28.24","32.89","82.58","43.87","343","234","298","64","34"
"2002","Calgary, Alberta, municipal","48014","Arson","214","22","22","-11.04","23.17","0","0","0","0","44","14","26","12","12"
"2008","Calgary, Alberta, municipal","48014","Total weapons violations","271","228","40","-24.47","25.11","23.24","27.01","68.66","22.02","268","198","251","53","17"
"2003","Calgary, Alberta, municipal","48014","Arson","247","12","21","13.62","26.33","0","0","0","0","33","5","12","7","21"
"2009","Calgary, Alberta, municipal","48014","Total weapons violations","303","263","39","9","27.37","24.21","28.22","73.5","15.47","302","212","269","57","12"
"2004","Calgary, Alberta, municipal","48014","Arson","334","11","33","31.18","34.54","0.53","1.57","11.87","40.89","44","4","13","9","31"
"2010","Calgary, Alberta, municipal","48014","Total weapons violations","370","294","71","20.32","32.93","25.89","31.36","93.61","41.03","365","230","303","73","32"
"2005","Calgary, Alberta, municipal","48014","Arson","263","10","29","-23.58","26.39","0.77","1.75","11.68","38.95","39","6","15","9","30"
"2011","Calgary, Alberta, municipal","48014","Total weapons violations","293","247","46","-22.05","25.67","23.17","26.82","68.92","15.32","293","209","263","54","12"
"2006","Calgary, Alberta, municipal","48014","Arson","312","17","31","15.02","30.36","1.49","1.93","6.43","46.27","48","12","17","5","36"
"2012","Calgary, Alberta, municipal","48014","Total weapons violations","312","264","47","3.3","26.51","21.36","27.31","97.75","25.39","311","199","276","77","20"
"2007","Calgary, Alberta, municipal","48014","Arson","215","14","10","-32.74","20.42","1.33","1.77","6.45","16.77","24","11","16","5","13"
"2013","Calgary, Alberta, municipal","48014","Total weapons violations","302","252","46","-6.6","24.76","19.94","24.26","77.05","27.79","298","193","254","61","22"
"2008","Calgary, Alberta, municipal","48014","Arson","286","16","18","29.77","26.5","0.47","1.29","10.36","24.61","34","4","12","8","19"
"2014","Calgary, Alberta, municipal","48014","Total weapons violations","294","230","59","-5.82","23.32","18.45","22.36","71.75","40.28","289","185","242","57","32"
"2009","Calgary, Alberta, municipal","48014","Arson","216","9","9","-26.37","19.51","0.46","0.84","5.16","3.87","18","4","8","4","3"
"2015","Calgary, Alberta, municipal","48014","Total weapons violations","332","259","70","10.51","25.78","23.63","25.81","53.59","18.69","329","242","285","43","15"
"2010","Calgary, Alberta, municipal","48014","Arson","197","26","6","-10.14","17.53","1.69","2.07","6.41","5.13","32","15","20","5","4"
"2016","Calgary, Alberta, municipal","48014","Total weapons violations","315","241","73","-7.34","23.89","23.87","23.38","17.08","28.06","314","250","264","14","23"
"2011","Calgary, Alberta, municipal","48014","Arson","173","8","8","-13.56","15.15","0.67","0.71","1.28","5.11","16","6","7","1","4"
"2012","Calgary, Alberta, municipal","48014","Arson","183","14","6","2.62","15.55","0.43","1.29","11.43","10.16","20","4","13","9","8"
"2013","Calgary, Alberta, municipal","48014","Arson","164","17","3","-13.52","13.45","0.72","1.05","5.05","2.53","20","7","11","4","2"
"2014","Calgary, Alberta, municipal","48014","Arson","210","18","11","23.88","16.66","1.2","1.66","7.55","7.55","29","12","18","6","6"
"2015","Calgary, Alberta, municipal","48014","Arson","180","24","8","-16.12","13.98","1.37","1.27","0","2.49","32","14","14","0","2"
"2016","Calgary, Alberta, municipal","48014","Arson","137","7","3","-25.67","10.39","0.67","0.62","0","2.44","10","7","7","0","2"
"2005","Calgary, Alberta, municipal","48014","Altering, removing or destroying Vehicle Identification Number (VIN)","0","0","0","0","0","0","0","0","0","0","0","0","0","0"
"2006","Calgary, Alberta, municipal","48014","Altering, removing or destroying Vehicle Identification Number (VIN)","0","0","0","0","0","0","0","0","0","0","0","0","0","0"
"2007","Calgary, Alberta, municipal","48014","Altering, removing or destroying Vehicle Identification Number (VIN)","0","0","0","0","0","0","0","0","0","0","0","0","0","0"
"2008","Calgary, Alberta, municipal","48014","Altering, removing or destroying Vehicle Identification Number (VIN)","0","0","0","0","0","0","0","0","0","0","0","0","0","0"
"2009","Calgary, Alberta, municipal","48014","Altering, removing or destroying Vehicle Identification Number (VIN)","0","0","0","0","0","0","0","0","0","0","0","0","0","0"
"1998","Calgary, Alberta, municipal","48014","Offensive weapons, explosives","11","3","3","0","1.31","0","0","0","0","6","2","2","0","1"
"2010","Calgary, Alberta, municipal","48014","Altering, removing or destroying Vehicle Identification Number (VIN)","0","0","0","0","0","0","0","0","0","0","0","0","0","0"
"1999","Calgary, Alberta, municipal","48014","Offensive weapons, explosives","13","7","2","15.23","1.51","0","0","0","0","9","6","10","4","1"
"2011","Calgary, Alberta, municipal","48014","Altering, removing or destroying Vehicle Identification Number (VIN)","1","0","0","0","0.09","0","0","0","0","0","0","0","0","0"
"2000","Calgary, Alberta, municipal","48014","Offensive weapons, explosives","6","4","2","-54.92","0.68","0","0","0","0","6","3","8","5","3"
"2012","Calgary, Alberta, municipal","48014","Altering, removing or destroying Vehicle Identification Number (VIN)","2","1","0","94.02","0.17","0.11","0.1","0","0","1","1","1","0","0"
"2001","Calgary, Alberta, municipal","48014","Offensive weapons, explosives","2","1","0","-67.39","0.22","0","0","0","0","1","0","2","2","0"
"2013","Calgary, Alberta, municipal","48014","Altering, removing or destroying Vehicle Identification Number (VIN)","2","1","0","-3.5","0.16","0","0","0","0","1","0","0","0","0"
"2002","Calgary, Alberta, municipal","48014","Offensive weapons, explosives","5","2","1","144.23","0.54","0","0","0","0","3","0","0","0","2"
"2014","Calgary, Alberta, municipal","48014","Altering, removing or destroying Vehicle Identification Number (VIN)","2","1","0","-3.25","0.16","0","0","0","0","1","0","0","0","0"
"2003","Calgary, Alberta, municipal","48014","Offensive weapons, explosives","2","1","1","-60.63","0.21","0","0","0","0","2","2","2","0","1"
"2015","Calgary, Alberta, municipal","48014","Altering, removing or destroying Vehicle Identification Number (VIN)","2","0","0","-2.13","0.16","0","0","0","0","0","0","0","0","0"
"2004","Calgary, Alberta, municipal","48014","Offensive weapons, explosives","4","2","1","94.03","0.41","0.27","0.24","0","1.32","3","2","2","0","1"
"2016","Calgary, Alberta, municipal","48014","Altering, removing or destroying Vehicle Identification Number (VIN)","2","1","0","-2.34","0.15","0.1","0.09","0","0","1","1","1","0","0"
"2005","Calgary, Alberta, municipal","48014","Offensive weapons, explosives","6","3","0","45.57","0.6","0.51","0.47","0","0","3","4","4","0","0"
"2006","Calgary, Alberta, municipal","48014","Offensive weapons, explosives","2","0","2","-67.68","0.19","0","0","0","1.29","2","0","0","0","1"
"2007","Calgary, Alberta, municipal","48014","Offensive weapons, explosives","2","0","1","-2.4","0.19","0","0","0","6.45","1","0","0","0","5"
"2008","Calgary, Alberta, municipal","48014","Offensive weapons, explosives","4","4","0","95.1","0.37","1.06","0.97","0","0","4","9","9","0","0"
"1998","Calgary, Alberta, municipal","48014","Total other Criminal Code violations","4487","3859","303","0","533.74","0","0","0","0","4162","2909","3598","689","70"
"2009","Calgary, Alberta, municipal","48014","Offensive weapons, explosives","4","2","1","-2.51","0.36","0.34","0.31","0","1.29","3","3","3","0","1"
"1999","Calgary, Alberta, municipal","48014","Total other Criminal Code violations","3994","3612","163","-13.21","463.23","0","0","0","0","3775","2724","3418","694","60"
"2010","Calgary, Alberta, municipal","48014","Offensive weapons, explosives","2","2","0","-50.73","0.18","0.23","0.21","0","0","2","2","2","0","0"
"2000","Calgary, Alberta, municipal","48014","Total other Criminal Code violations","4300","3942","214","5.17","487.17","0","0","0","0","4156","3015","3693","678","73"
"2011","Calgary, Alberta, municipal","48014","Offensive weapons, explosives","2","0","2","-1.57","0.18","0","0","0","1.28","2","0","0","0","1"
"2001","Calgary, Alberta, municipal","48014","Total other Criminal Code violations","4640","4257","226","5.58","514.33","0","0","0","0","4483","3396","4041","645","78"
"2012","Calgary, Alberta, municipal","48014","Offensive weapons, explosives","1","1","0","-51.49","0.08","0","0","0","0","1","0","0","0","0"
"2002","Calgary, Alberta, municipal","48014","Total other Criminal Code violations","5161","4802","252","8.66","558.87","0","0","0","0","5054","3869","4580","711","89"
"2013","Calgary, Alberta, municipal","48014","Offensive weapons, explosives","2","1","1","92.99","0.16","0.21","0.19","0","0","2","2","2","0","0"
"2003","Calgary, Alberta, municipal","48014","Total other Criminal Code violations","4974","4533","295","-5.13","530.2","0","0","0","0","4828","3730","4322","592","144"
"2014","Calgary, Alberta, municipal","48014","Offensive weapons, explosives","0","0","0","-100","0","0","0","0","0","0","0","0","0","0"
"2004","Calgary, Alberta, municipal","48014","Total other Criminal Code violations","5437","4995","273","6.04","562.25","547.72","576.17","858.64","166.19","5268","4122","4773","651","126"
"2015","Calgary, Alberta, municipal","48014","Offensive weapons, explosives","3","0","0","0","0.23","0","0","0","0","0","0","0","0","0"
"2016","Calgary, Alberta, municipal","48014","Offensive weapons, explosives","3","3","0","-2.34","0.23","0.48","0.44","0","0","3","5","5","0","0"
"2005","Calgary, Alberta, municipal","48014","Total other Criminal Code violations","5388","4892","287","-3.83","540.73","528.33","554.3","816.63","144.11","5179","4110","4739","629","111"
"2006","Calgary, Alberta, municipal","48014","Total other Criminal Code violations","5507","5105","251","-0.9","535.86","519.48","547.43","836.64","105.38","5356","4183","4834","651","82"
"2007","Calgary, Alberta, municipal","48014","Total other Criminal Code violations","4627","4134","229","-18","439.42","407.9","431.94","689","100.64","4363","3380","3914","534","78"
"2008","Calgary, Alberta, municipal","48014","Total other Criminal Code violations","4151","3718","201","-12.48","384.57","368.48","381.88","529.85","77.73","3919","3140","3549","409","60"
"2009","Calgary, Alberta, municipal","48014","Total other Criminal Code violations","4673","4188","212","9.75","422.06","403.78","415.2","544.15","43.84","4400","3536","3958","422","34"
"2010","Calgary, Alberta, municipal","48014","Total other Criminal Code violations","4394","3918","263","-7.35","391.03","380.29","388.4","480.87","79.5","4181","3378","3753","375","62"
"2011","Calgary, Alberta, municipal","48014","Total other Criminal Code violations","4151","3790","213","-7.01","363.62","363.37","369.42","439.07","38.29","4003","3278","3622","344","30"
"2012","Calgary, Alberta, municipal","48014","Total other Criminal Code violations","3942","3692","151","-7.87","334.99","342.28","348.46","421.46","46.97","3843","3189","3521","332","37"
"2013","Calgary, Alberta, municipal","48014","Total other Criminal Code violations","3896","3570","172","-4.63","319.48","323.06","323.47","328.42","51.79","3742","3127","3387","260","41"
"2014","Calgary, Alberta, municipal","48014","Total other Criminal Code violations","3833","3459","199","-4.82","304.09","296","300.89","362.55","74.27","3658","2968","3256","288","59"
"2015","Calgary, Alberta, municipal","48014","Total other Criminal Code violations","3130","2791","195","-20.08","243.01","242.75","240.96","218.08","48.6","2986","2486","2661","175","39"
"2016","Calgary, Alberta, municipal","48014","Total other Criminal Code violations","4081","3655","199","27.34","309.44","323.94","314.95","200.07","43.92","3854","3393","3557","164","36"
"1998","Calgary, Alberta, municipal","48014","Offensive weapons, prohibited","56","48","9","0","6.66","0","0","0","0","57","39","49","10","1"
"1999","Calgary, Alberta, municipal","48014","Offensive weapons, prohibited","0","0","0","-100","0","0","0","0","0","0","0","0","0","0"
"2000","Calgary, Alberta, municipal","48014","Offensive weapons, prohibited","0","0","0","0","0","0","0","0","0","0","0","0","0","0"
"2001","Calgary, Alberta, municipal","48014","Offensive weapons, prohibited","0","0","0","0","0","0","0","0","0","0","0","0","0","0"
"2002","Calgary, Alberta, municipal","48014","Offensive weapons, prohibited","0","0","0","0","0","0","0","0","0","0","0","0","0","0"
"2003","Calgary, Alberta, municipal","48014","Offensive weapons, prohibited","0","0","0","0","0","0","0","0","0","0","0","0","0","0"
"2004","Calgary, Alberta, municipal","48014","Offensive weapons, prohibited","0","0","0","0","0","0","0","0","0","0","0","0","0","0"
"2005","Calgary, Alberta, municipal","48014","Offensive weapons, prohibited","0","0","0","0","0","0","0","0","0","0","0","0","0","0"
"2006","Calgary, Alberta, municipal","48014","Offensive weapons, prohibited","0","0","0","0","0","0","0","0","0","0","0","0","0","0"
"2007","Calgary, Alberta, municipal","48014","Offensive weapons, prohibited","0","0","0","0","0","0","0","0","0","0","0","0","0","0"
"2008","Calgary, Alberta, municipal","48014","Offensive weapons, prohibited","0","0","0","0","0","0","0","0","0","0","0","0","0","0"
"2009","Calgary, Alberta, municipal","48014","Offensive weapons, prohibited","0","0","0","0","0","0","0","0","0","0","0","0","0","0"
"2010","Calgary, Alberta, municipal","48014","Offensive weapons, prohibited","0","0","0","0","0","0","0","0","0","0","0","0","0","0"
"2011","Calgary, Alberta, municipal","48014","Offensive weapons, prohibited","0","0","0","0","0","0","0","0","0","0","0","0","0","0"
"2012","Calgary, Alberta, municipal","48014","Offensive weapons, prohibited","0","0","0","0","0","0","0","0","0","0","0","0","0","0"
"2013","Calgary, Alberta, municipal","48014","Offensive weapons, prohibited","0","0","0","0","0","0","0","0","0","0","0","0","0","0"
"2014","Calgary, Alberta, municipal","48014","Offensive weapons, prohibited","0","0","0","0","0","0","0","0","0","0","0","0","0","0"
"2015","Calgary, Alberta, municipal","48014","Offensive weapons, prohibited","0","0","0","0","0","0","0","0","0","0","0","0","0","0"
"2016","Calgary, Alberta, municipal","48014","Offensive weapons, prohibited","0","0","0","0","0","0","0","0","0","0","0","0","0","0"
"1998","Calgary, Alberta, municipal","48014","Offensive weapons, restricted","1","1","0","0","0.12","0","0","0","0","1","1","1","0","0"
"1999","Calgary, Alberta, municipal","48014","Offensive weapons, restricted","0","0","0","-100","0","0","0","0","0","0","0","0","0","0"
"2000","Calgary, Alberta, municipal","48014","Offensive weapons, restricted","0","0","0","0","0","0","0","0","0","0","0","0","0","0"
"2001","Calgary, Alberta, municipal","48014","Offensive weapons, restricted","0","0","0","0","0","0","0","0","0","0","0","0","0","0"
"2002","Calgary, Alberta, municipal","48014","Offensive weapons, restricted","0","0","0","0","0","0","0","0","0","0","0","0","0","0"
"2003","Calgary, Alberta, municipal","48014","Offensive weapons, restricted","0","0","0","0","0","0","0","0","0","0","0","0","0","0"
"2004","Calgary, Alberta, municipal","48014","Offensive weapons, restricted","0","0","0","0","0","0","0","0","0","0","0","0","0","0"
"2005","Calgary, Alberta, municipal","48014","Offensive weapons, restricted","0","0","0","0","0","0","0","0","0","0","0","0","0","0"
"2006","Calgary, Alberta, municipal","48014","Offensive weapons, restricted","0","0","0","0","0","0","0","0","0","0","0","0","0","0"
"2007","Calgary, Alberta, municipal","48014","Offensive weapons, restricted","0","0","0","0","0","0","0","0","0","0","0","0","0","0"
"2008","Calgary, Alberta, municipal","48014","Offensive weapons, restricted","0","0","0","0","0","0","0","0","0","0","0","0","0","0"
"2009","Calgary, Alberta, municipal","48014","Offensive weapons, restricted","0","0","0","0","0","0","0","0","0","0","0","0","0","0"
"2010","Calgary, Alberta, municipal","48014","Offensive weapons, restricted","0","0","0","0","0","0","0","0","0","0","0","0","0","0"
"2011","Calgary, Alberta, municipal","48014","Offensive weapons, restricted","0","0","0","0","0","0","0","0","0","0","0","0","0","0"
"2012","Calgary, Alberta, municipal","48014","Offensive weapons, restricted","0","0","0","0","0","0","0","0","0","0","0","0","0","0"
"2013","Calgary, Alberta, municipal","48014","Offensive weapons, restricted","0","0","0","0","0","0","0","0","0","0","0","0","0","0"
"2014","Calgary, Alberta, municipal","48014","Offensive weapons, restricted","0","0","0","0","0","0","0","0","0","0","0","0","0","0"
"2015","Calgary, Alberta, municipal","48014","Offensive weapons, restricted","0","0","0","0","0","0","0","0","0","0","0","0","0","0"
"2016","Calgary, Alberta, municipal","48014","Offensive weapons, restricted","0","0","0","0","0","0","0","0","0","0","0","0","0","0"
"1998","Calgary, Alberta, municipal","48014","Firearm transfers or serial numbers","6","4","2","0","0.71","0","0","0","0","6","5","5","0","0"
"1999","Calgary, Alberta, municipal","48014","Firearm transfers or serial numbers","0","0","0","-100","0","0","0","0","0","0","0","0","0","0"
"2000","Calgary, Alberta, municipal","48014","Firearm transfers or serial numbers","0","0","0","0","0","0","0","0","0","0","0","0","0","0"
"2001","Calgary, Alberta, municipal","48014","Firearm transfers or serial numbers","0","0","0","0","0","0","0","0","0","0","0","0","0","0"
"2002","Calgary, Alberta, municipal","48014","Firearm transfers or serial numbers","0","0","0","0","0","0","0","0","0","0","0","0","0","0"
"2003","Calgary, Alberta, municipal","48014","Firearm transfers or serial numbers","0","0","0","0","0","0","0","0","0","0","0","0","0","0"
"2004","Calgary, Alberta, municipal","48014","Firearm transfers or serial numbers","0","0","0","0","0","0","0","0","0","0","0","0","0","0"
"2005","Calgary, Alberta, municipal","48014","Firearm transfers or serial numbers","0","0","0","0","0","0","0","0","0","0","0","0","0","0"
"2006","Calgary, Alberta, municipal","48014","Firearm transfers or serial numbers","0","0","0","0","0","0","0","0","0","0","0","0","0","0"
"2007","Calgary, Alberta, municipal","48014","Firearm transfers or serial numbers","0","0","0","0","0","0","0","0","0","0","0","0","0","0"
"2008","Calgary, Alberta, municipal","48014","Firearm transfers or serial numbers","0","0","0","0","0","0","0","0","0","0","0","0","0","0"
"2009","Calgary, Alberta, municipal","48014","Firearm transfers or serial numbers","0","0","0","0","0","0","0","0","0","0","0","0","0","0"
"2010","Calgary, Alberta, municipal","48014","Firearm transfers or serial numbers","0","0","0","0","0","0","0","0","0","0","0","0","0","0"
"2011","Calgary, Alberta, municipal","48014","Firearm transfers or serial numbers","0","0","0","0","0","0","0","0","0","0","0","0","0","0"
"2012","Calgary, Alberta, municipal","48014","Firearm transfers or serial numbers","0","0","0","0","0","0","0","0","0","0","0","0","0","0"
"2013","Calgary, Alberta, municipal","48014","Firearm transfers or serial numbers","0","0","0","0","0","0","0","0","0","0","0","0","0","0"
"2014","Calgary, Alberta, municipal","48014","Firearm transfers or serial numbers","0","0","0","0","0","0","0","0","0","0","0","0","0","0"
"2015","Calgary, Alberta, municipal","48014","Firearm transfers or serial numbers","0","0","0","0","0","0","0","0","0","0","0","0","0","0"
"2016","Calgary, Alberta, municipal","48014","Firearm transfers or serial numbers","0","0","0","0","0","0","0","0","0","0","0","0","0","0"
"1998","Calgary, Alberta, municipal","48014","Other offensive weapons","112","100","10","0","13.32","0","0","0","0","110","71","111","40","15"
"1999","Calgary, Alberta, municipal","48014","Other offensive weapons","0","0","0","-100","0","0","0","0","0","0","0","0","0","0"
"2000","Calgary, Alberta, municipal","48014","Other offensive weapons","0","0","0","0","0","0","0","0","0","0","0","0","0","0"
"2001","Calgary, Alberta, municipal","48014","Other offensive weapons","0","0","0","0","0","0","0","0","0","0","0","0","0","0"
"2002","Calgary, Alberta, municipal","48014","Other offensive weapons","0","0","0","0","0","0","0","0","0","0","0","0","0","0"
"2003","Calgary, Alberta, municipal","48014","Other offensive weapons","0","0","0","0","0","0","0","0","0","0","0","0","0","0"
"2004","Calgary, Alberta, municipal","48014","Other offensive weapons","0","0","0","0","0","0","0","0","0","0","0","0","0","0"
"2005","Calgary, Alberta, municipal","48014","Other offensive weapons","0","0","0","0","0","0","0","0","0","0","0","0","0","0"
"2006","Calgary, Alberta, municipal","48014","Other offensive weapons","0","0","0","0","0","0","0","0","0","0","0","0","0","0"
"2007","Calgary, Alberta, municipal","48014","Other offensive weapons","0","0","0","0","0","0","0","0","0","0","0","0","0","0"
"2008","Calgary, Alberta, municipal","48014","Other offensive weapons","0","0","0","0","0","0","0","0","0","0","0","0","0","0"
"2009","Calgary, Alberta, municipal","48014","Other offensive weapons","0","0","0","0","0","0","0","0","0","0","0","0","0","0"
"2010","Calgary, Alberta, municipal","48014","Other offensive weapons","0","0","0","0","0","0","0","0","0","0","0","0","0","0"
"2011","Calgary, Alberta, municipal","48014","Other offensive weapons","0","0","0","0","0","0","0","0","0","0","0","0","0","0"
"2012","Calgary, Alberta, municipal","48014","Other offensive weapons","0","0","0","0","0","0","0","0","0","0","0","0","0","0"
"2013","Calgary, Alberta, municipal","48014","Other offensive weapons","0","0","0","0","0","0","0","0","0","0","0","0","0","0"
"2014","Calgary, Alberta, municipal","48014","Other offensive weapons","0","0","0","0","0","0","0","0","0","0","0","0","0","0"
"2015","Calgary, Alberta, municipal","48014","Other offensive weapons","0","0","0","0","0","0","0","0","0","0","0","0","0","0"
"2016","Calgary, Alberta, municipal","48014","Other offensive weapons","0","0","0","0","0","0","0","0","0","0","0","0","0","0"
"1998","Calgary, Alberta, municipal","48014","Weapons trafficking","2","2","0","0","0.24","0","0","0","0","2","2","3","1","0"
"1999","Calgary, Alberta, municipal","48014","Weapons trafficking","2","0","1","-2.5","0.23","0","0","0","0","1","0","0","0","0"
"2000","Calgary, Alberta, municipal","48014","Weapons trafficking","1","1","0","-51.16","0.11","0","0","0","0","1","0","1","1","0"
"2001","Calgary, Alberta, municipal","48014","Weapons trafficking","2","0","0","95.68","0.22","0","0","0","0","0","0","0","0","0"
"2002","Calgary, Alberta, municipal","48014","Weapons trafficking","2","2","0","-2.31","0.22","0","0","0","0","2","3","4","1","0"
"2003","Calgary, Alberta, municipal","48014","Weapons trafficking","2","2","0","-1.56","0.21","0","0","0","0","2","3","3","0","0"
"2004","Calgary, Alberta, municipal","48014","Weapons trafficking","1","1","0","-51.49","0.1","0.13","0.12","0","0","1","1","1","0","0"
"2005","Calgary, Alberta, municipal","48014","Weapons trafficking","0","0","0","-100","0","0","0","0","0","0","0","0","0","0"
"2006","Calgary, Alberta, municipal","48014","Weapons trafficking","1","0","0","0","0.1","0","0","0","0","0","0","0","0","0"
"2007","Calgary, Alberta, municipal","48014","Weapons trafficking","7","3","1","583.2","0.66","0.6","0.55","0","0","4","5","5","0","0"
"2008","Calgary, Alberta, municipal","48014","Weapons trafficking","3","6","0","-58.19","0.28","0.82","0.97","2.59","0","6","7","9","2","0"
"2009","Calgary, Alberta, municipal","48014","Weapons trafficking","5","4","0","62.48","0.45","0.57","0.52","0","0","4","5","5","0","0"
"2010","Calgary, Alberta, municipal","48014","Weapons trafficking","2","3","0","-60.59","0.18","0.68","0.62","0","0","3","6","6","0","0"
"2011","Calgary, Alberta, municipal","48014","Weapons trafficking","5","5","0","146.08","0.44","0.55","0.51","0","0","5","5","5","0","0"
"2012","Calgary, Alberta, municipal","48014","Weapons trafficking","1","1","0","-80.6","0.08","0","0.1","1.27","0","1","0","1","1","0"
"2013","Calgary, Alberta, municipal","48014","Weapons trafficking","1","1","0","-3.5","0.08","0","0","0","0","1","0","0","0","0"
"2014","Calgary, Alberta, municipal","48014","Weapons trafficking","0","0","0","-100","0","0","0","0","0","0","0","0","0","0"
"2015","Calgary, Alberta, municipal","48014","Weapons trafficking","1","1","0","0","0.08","0.2","0.18","0","0","1","2","2","0","0"
"2016","Calgary, Alberta, municipal","48014","Weapons trafficking","1","1","0","-2.34","0.08","0.1","0.09","0","0","1","1","1","0","0"
"1998","Calgary, Alberta, municipal","48014","Weapons possession contrary to order","0","0","0","0","0","0","0","0","0","0","0","0","0","0"
"1999","Calgary, Alberta, municipal","48014","Weapons possession contrary to order","4","4","0","0","0.46","0","0","0","0","4","4","4","0","0"
"2000","Calgary, Alberta, municipal","48014","Weapons possession contrary to order","6","6","0","46.53","0.68","0","0","0","0","6","4","6","2","0"
"2001","Calgary, Alberta, municipal","48014","Weapons possession contrary to order","5","5","0","-18.47","0.55","0","0","0","0","5","6","6","0","0"
"2002","Calgary, Alberta, municipal","48014","Weapons possession contrary to order","6","4","0","17.23","0.65","0","0","0","0","4","3","3","0","0"
"2003","Calgary, Alberta, municipal","48014","Weapons possession contrary to order","8","8","0","31.25","0.85","0","0","0","0","8","8","9","1","0"
"2004","Calgary, Alberta, municipal","48014","Weapons possession contrary to order","16","16","0","94.03","1.65","2.13","1.93","0","0","16","16","16","0","0"
"2005","Calgary, Alberta, municipal","48014","Weapons possession contrary to order","31","31","0","88.03","3.11","4.24","4.56","7.79","0","31","33","39","6","0"
"2006","Calgary, Alberta, municipal","48014","Weapons possession contrary to order","21","21","0","-34.32","2.04","2.98","2.72","0","0","21","24","24","0","0"
"2007","Calgary, Alberta, municipal","48014","Weapons possession contrary to order","26","24","2","20.84","2.47","2.9","3.09","5.16","0","26","24","28","4","0"
"2008","Calgary, Alberta, municipal","48014","Weapons possession contrary to order","13","13","0","-51.22","1.2","1.06","1.51","6.48","0","13","9","14","5","0"
"2009","Calgary, Alberta, municipal","48014","Weapons possession contrary to order","24","23","1","79.98","2.17","3.2","3.15","2.58","0","24","28","30","2","0"
"2010","Calgary, Alberta, municipal","48014","Weapons possession contrary to order","22","21","1","-9.68","1.96","2.14","2.28","3.85","0","22","19","22","3","0"
"2011","Calgary, Alberta, municipal","48014","Weapons possession contrary to order","25","24","0","11.86","2.19","3.21","3.06","1.28","0","24","29","30","1","0"
"2012","Calgary, Alberta, municipal","48014","Weapons possession contrary to order","31","31","0","20.29","2.63","3.01","2.87","1.27","0","31","28","29","1","0"
"2013","Calgary, Alberta, municipal","48014","Weapons possession contrary to order","29","28","1","-9.73","2.38","2.58","2.67","3.79","0","29","25","28","3","0"
"2014","Calgary, Alberta, municipal","48014","Weapons possession contrary to order","29","29","0","-3.25","2.3","2.69","2.5","0","0","29","27","27","0","0"
"2015","Calgary, Alberta, municipal","48014","Weapons possession contrary to order","41","40","1","38.36","3.18","4.88","4.71","2.49","0","41","50","52","2","0"
"2016","Calgary, Alberta, municipal","48014","Weapons possession contrary to order","38","38","1","-9.48","2.88","4.49","4.16","0","0","39","47","47","0","0"
"1998","Calgary, Alberta, municipal","48014","Possession of weapons","60","49","11","0","7.14","0","0","0","0","60","40","52","12","1"
"1999","Calgary, Alberta, municipal","48014","Possession of weapons","171","137","26","177.88","19.83","0","0","0","0","163","84","135","51","18"
"2000","Calgary, Alberta, municipal","48014","Possession of weapons","223","183","34","27.39","25.26","0","0","0","0","217","109","179","70","28"
"2001","Calgary, Alberta, municipal","48014","Possession of weapons","259","205","53","13.63","28.71","0","0","0","0","258","140","213","73","34"
"2002","Calgary, Alberta, municipal","48014","Possession of weapons","301","264","36","13.53","32.59","0","0","0","0","300","200","269","69","28"
"2003","Calgary, Alberta, municipal","48014","Possession of weapons","339","278","63","10.86","36.14","0","0","0","0","341","198","278","80","66"
"2004","Calgary, Alberta, municipal","48014","Possession of weapons","370","316","51","5.89","38.26","35.35","41.28","100.24","54.08","367","266","342","76","41"
"2005","Calgary, Alberta, municipal","48014","Possession of weapons","423","363","61","10.95","42.45","38.05","45.15","116.85","64.91","424","296","386","90","50"
"2006","Calgary, Alberta, municipal","48014","Possession of weapons","402","342","55","-7.86","39.12","35.02","41.22","105.38","43.7","397","282","364","82","34"
"2007","Calgary, Alberta, municipal","48014","Possession of weapons","305","260","42","-25.95","28.97","23.89","28.47","77.42","37.42","302","198","258","60","29"
"2008","Calgary, Alberta, municipal","48014","Possession of weapons","242","201","37","-22.6","22.42","19.83","23.13","59.59","22.02","238","169","215","46","17"
"2009","Calgary, Alberta, municipal","48014","Possession of weapons","261","230","32","5.14","23.57","19.76","23.92","70.92","14.18","262","173","228","55","11"
"2010","Calgary, Alberta, municipal","48014","Possession of weapons","332","260","68","25.33","29.55","21.95","27.43","89.76","41.03","328","195","265","70","32"
"2011","Calgary, Alberta, municipal","48014","Possession of weapons","256","214","43","-24.1","22.42","19.07","22.95","67.65","14.04","257","172","225","53","11"
"2012","Calgary, Alberta, municipal","48014","Possession of weapons","270","227","45","2.32","22.94","17.92","23.95","95.21","25.39","272","167","242","75","20"
"2013","Calgary, Alberta, municipal","48014","Possession of weapons","264","218","42","-5.65","21.65","16.74","21.01","73.26","27.79","260","162","220","58","22"
"2014","Calgary, Alberta, municipal","48014","Possession of weapons","248","194","55","-9.12","19.67","15.06","19.22","71.75","40.28","249","151","208","57","32"
"2015","Calgary, Alberta, municipal","48014","Possession of weapons","262","214","48","3.39","20.34","18.06","20.46","51.09","16.2","262","185","226","41","13"
"2016","Calgary, Alberta, municipal","48014","Possession of weapons","266","198","64","-0.85","20.17","18.71","18.59","17.08","28.06","262","196","210","14","23"
"1998","Calgary, Alberta, municipal","48014","Unauthorized importing or exporting of weapons","1","1","0","0","0.12","0","0","0","0","1","0","0","0","0"
"1999","Calgary, Alberta, municipal","48014","Unauthorized importing or exporting of weapons","0","0","0","-100","0","0","0","0","0","0","0","0","0","0"
"2000","Calgary, Alberta, municipal","48014","Unauthorized importing or exporting of weapons","1","1","0","0","0.11","0","0","0","0","1","1","1","0","0"
"2001","Calgary, Alberta, municipal","48014","Unauthorized importing or exporting of weapons","0","0","0","-100","0","0","0","0","0","0","0","0","0","0"
"2002","Calgary, Alberta, municipal","48014","Unauthorized importing or exporting of weapons","1","1","0","0","0.11","0","0","0","0","1","1","1","0","0"
"2003","Calgary, Alberta, municipal","48014","Unauthorized importing or exporting of weapons","0","0","0","-100","0","0","0","0","0","0","0","0","0","0"
"2004","Calgary, Alberta, municipal","48014","Unauthorized importing or exporting of weapons","0","0","0","0","0","0","0","0","0","0","0","0","0","0"
"2005","Calgary, Alberta, municipal","48014","Unauthorized importing or exporting of weapons","0","0","0","0","0","0","0","0","0","0","0","0","0","0"
"2006","Calgary, Alberta, municipal","48014","Unauthorized importing or exporting of weapons","0","0","0","0","0","0","0","0","0","0","0","0","0","0"
"2007","Calgary, Alberta, municipal","48014","Unauthorized importing or exporting of weapons","0","0","0","0","0","0","0","0","0","0","0","0","0","0"
"2008","Calgary, Alberta, municipal","48014","Unauthorized importing or exporting of weapons","2","0","0","0","0.19","0","0","0","0","0","0","0","0","0"
"2009","Calgary, Alberta, municipal","48014","Unauthorized importing or exporting of weapons","1","0","1","-51.26","0.09","0","0","0","0","1","0","0","0","0"
"2010","Calgary, Alberta, municipal","48014","Unauthorized importing or exporting of weapons","4","0","2","294.12","0.36","0","0","0","0","2","0","0","0","0"
"2011","Calgary, Alberta, municipal","48014","Unauthorized importing or exporting of weapons","1","0","0","-75.39","0.09","0","0","0","0","0","0","0","0","0"
"2012","Calgary, Alberta, municipal","48014","Unauthorized importing or exporting of weapons","3","0","0","191.03","0.25","0","0","0","0","0","0","0","0","0"
"2013","Calgary, Alberta, municipal","48014","Unauthorized importing or exporting of weapons","2","0","2","-35.67","0.16","0","0","0","0","2","0","0","0","0"
"2014","Calgary, Alberta, municipal","48014","Unauthorized importing or exporting of weapons","9","0","3","335.36","0.71","0","0","0","0","3","0","0","0","0"
"2015","Calgary, Alberta, municipal","48014","Unauthorized importing or exporting of weapons","17","0","18","84.86","1.32","0","0","0","2.49","18","0","0","0","2"
"2016","Calgary, Alberta, municipal","48014","Unauthorized importing or exporting of weapons","4","0","6","-77.02","0.3","0","0","0","0","6","0","0","0","0"
"1998","Calgary, Alberta, municipal","48014","Firearms documentation or administration","0","0","0","0","0","0","0","0","0","0","0","0","0","0"
"1999","Calgary, Alberta, municipal","48014","Firearms documentation or administration","0","0","0","0","0","0","0","0","0","0","0","0","0","0"
"2000","Calgary, Alberta, municipal","48014","Firearms documentation or administration","0","0","0","0","0","0","0","0","0","0","0","0","0","0"
"2001","Calgary, Alberta, municipal","48014","Firearms documentation or administration","0","0","0","0","0","0","0","0","0","0","0","0","0","0"
"2002","Calgary, Alberta, municipal","48014","Firearms documentation or administration","0","0","0","0","0","0","0","0","0","0","0","0","0","0"
"2003","Calgary, Alberta, municipal","48014","Firearms documentation or administration","0","0","0","0","0","0","0","0","0","0","0","0","0","0"
"2004","Calgary, Alberta, municipal","48014","Firearms documentation or administration","0","0","0","0","0","0","0","0","0","0","0","0","0","0"
"2005","Calgary, Alberta, municipal","48014","Firearms documentation or administration","0","0","0","0","0","0","0","0","0","0","0","0","0","0"
"2006","Calgary, Alberta, municipal","48014","Firearms documentation or administration","0","0","0","0","0","0","0","0","0","0","0","0","0","0"
"2007","Calgary, Alberta, municipal","48014","Firearms documentation or administration","0","0","0","0","0","0","0","0","0","0","0","0","0","0"
"2008","Calgary, Alberta, municipal","48014","Firearms documentation or administration","1","1","0","0","0.09","0.12","0.11","0","0","1","1","1","0","0"
"2009","Calgary, Alberta, municipal","48014","Firearms documentation or administration","1","1","0","-2.51","0.09","0.11","0.1","0","0","1","1","1","0","0"
"2010","Calgary, Alberta, municipal","48014","Firearms documentation or administration","2","2","0","97.06","0.18","0.23","0.21","0","0","2","2","2","0","0"
"2011","Calgary, Alberta, municipal","48014","Firearms documentation or administration","0","1","0","-100","0","0","0","0","0","1","0","0","0","0"
"2012","Calgary, Alberta, municipal","48014","Firearms documentation or administration","1","0","1","0","0.08","0","0","0","0","1","0","0","0","0"
"2013","Calgary, Alberta, municipal","48014","Firearms documentation or administration","0","0","0","-100","0","0","0","0","0","0","0","0","0","0"
"2014","Calgary, Alberta, municipal","48014","Firearms documentation or administration","1","1","0","0","0.08","0.1","0.09","0","0","1","1","1","0","0"
"2015","Calgary, Alberta, municipal","48014","Firearms documentation or administration","0","0","0","-100","0","0","0","0","0","0","0","0","0","0"
"2016","Calgary, Alberta, municipal","48014","Firearms documentation or administration","0","0","0","0","0","0","0","0","0","0","0","0","0","0"
"1998","Calgary, Alberta, municipal","48014","Unsafe storage of firearms","9","8","1","0","1.07","0","0","0","0","9","3","3","0","2"
"1999","Calgary, Alberta, municipal","48014","Unsafe storage of firearms","26","21","3","181.67","3.02","0","0","0","0","24","19","20","1","0"
"2000","Calgary, Alberta, municipal","48014","Unsafe storage of firearms","26","25","2","-2.32","2.95","0","0","0","0","27","22","25","3","0"
"2001","Calgary, Alberta, municipal","48014","Unsafe storage of firearms","11","9","1","-58.61","1.22","0","0","0","0","10","11","13","2","0"
"2002","Calgary, Alberta, municipal","48014","Unsafe storage of firearms","12","8","4","6.57","1.3","0","0","0","0","12","8","8","0","0"
"2003","Calgary, Alberta, municipal","48014","Unsafe storage of firearms","11","9","3","-9.77","1.17","0","0","0","0","12","8","8","0","0"
"2004","Calgary, Alberta, municipal","48014","Unsafe storage of firearms","3","1","2","-73.54","0.31","0.13","0.12","0","0","3","1","1","0","0"
"2005","Calgary, Alberta, municipal","48014","Unsafe storage of firearms","15","11","3","385.24","1.51","1.29","1.29","1.3","1.3","14","10","11","1","1"
"2006","Calgary, Alberta, municipal","48014","Unsafe storage of firearms","5","2","3","-67.68","0.49","0.12","0.11","0","0","5","1","1","0","0"
"2007","Calgary, Alberta, municipal","48014","Unsafe storage of firearms","10","8","2","95.2","0.95","0.84","0.77","0","0","10","7","7","0","0"
"2008","Calgary, Alberta, municipal","48014","Unsafe storage of firearms","6","3","3","-41.47","0.56","0.35","0.32","0","0","6","3","3","0","0"
"2009","Calgary, Alberta, municipal","48014","Unsafe storage of firearms","7","3","4","13.74","0.63","0.23","0.21","0","0","7","2","2","0","0"
"2010","Calgary, Alberta, municipal","48014","Unsafe storage of firearms","6","6","0","-15.54","0.53","0.68","0.62","0","0","6","6","6","0","0"
"2011","Calgary, Alberta, municipal","48014","Unsafe storage of firearms","4","3","1","-34.38","0.35","0.33","0.31","0","0","4","3","3","0","0"
"2012","Calgary, Alberta, municipal","48014","Unsafe storage of firearms","5","4","1","21.26","0.42","0.43","0.4","0","0","5","4","4","0","0"
"2013","Calgary, Alberta, municipal","48014","Unsafe storage of firearms","4","4","0","-22.8","0.33","0.41","0.38","0","0","4","4","4","0","0"
"2014","Calgary, Alberta, municipal","48014","Unsafe storage of firearms","7","6","1","69.31","0.56","0.6","0.55","0","0","7","6","6","0","0"
"2015","Calgary, Alberta, municipal","48014","Unsafe storage of firearms","8","4","3","11.85","0.62","0.49","0.45","0","0","7","5","5","0","0"
"2016","Calgary, Alberta, municipal","48014","Unsafe storage of firearms","3","1","2","-63.38","0.23","0.1","0.09","0","0","3","1","1","0","0"
"1998","Calgary, Alberta, municipal","48014","Child pornography","0","0","0","0","0","0","0","0","0","0","0","0","0","0"
"1999","Calgary, Alberta, municipal","48014","Child pornography","1","1","0","0","0.12","0","0","0","0","1","1","1","0","0"
"2000","Calgary, Alberta, municipal","48014","Child pornography","2","1","0","95.37","0.23","0","0","0","0","1","1","1","0","0"
"2001","Calgary, Alberta, municipal","48014","Child pornography","6","6","0","193.52","0.67","0","0","0","0","6","4","5","1","0"
"2002","Calgary, Alberta, municipal","48014","Child pornography","10","7","3","62.82","1.08","0","0","0","0","10","7","7","0","0"
"2003","Calgary, Alberta, municipal","48014","Child pornography","5","4","0","-50.78","0.53","0","0","0","0","4","4","4","0","0"
"2004","Calgary, Alberta, municipal","48014","Child pornography","15","12","3","191.04","1.55","1.33","1.21","0","0","15","10","10","0","0"
"2005","Calgary, Alberta, municipal","48014","Child pornography","23","15","4","48.81","2.31","1.93","1.75","0","1.3","19","15","15","0","1"
"2006","Calgary, Alberta, municipal","48014","Child pornography","27","11","6","13.82","2.63","1.37","1.25","0","2.57","17","11","11","0","2"
"2007","Calgary, Alberta, municipal","48014","Child pornography","44","7","5","59.05","4.18","0.84","0.77","0","5.16","12","7","7","0","4"
"2008","Calgary, Alberta, municipal","48014","Child pornography","16","8","1","-64.53","1.48","0.94","0.86","0","0","9","8","8","0","0"
"2009","Calgary, Alberta, municipal","48014","Child pornography","28","18","5","70.61","2.53","1.71","1.78","2.58","1.29","23","15","17","2","1"
"2010","Calgary, Alberta, municipal","48014","Child pornography","29","16","6","2.05","2.58","1.91","1.76","0","1.28","22","17","17","0","1"
"2011","Calgary, Alberta, municipal","48014","Child pornography","37","21","9","25.59","3.24","1.77","1.73","1.28","3.83","30","16","17","1","3"
"2012","Calgary, Alberta, municipal","48014","Child pornography","30","30","4","-21.34","2.55","2.58","2.38","0","1.27","34","24","24","0","1"
"2013","Calgary, Alberta, municipal","48014","Child pornography","22","20","3","-29.24","1.8","2.07","1.91","0","3.79","23","20","20","0","3"
"2014","Calgary, Alberta, municipal","48014","Child pornography","51","22","11","124.28","4.05","2.09","1.94","0","7.55","33","21","21","0","6"
"2015","Calgary, Alberta, municipal","48014","Child pornography","36","10","8","-30.92","2.8","0.98","0.91","0","7.48","18","10","10","0","6"
"2016","Calgary, Alberta, municipal","48014","Child pornography","42","17","9","13.94","3.18","1.62","1.51","0","3.66","26","17","17","0","3"
"2012","Calgary, Alberta, municipal","48014","Making, or distribution of child pornography","0","0","0","0","0","0","0","0","0","0","0","0","0","0"
"2013","Calgary, Alberta, municipal","48014","Making, or distribution of child pornography","0","0","0","0","0","0","0","0","0","0","0","0","0","0"
"2014","Calgary, Alberta, municipal","48014","Making, or distribution of child pornography","0","0","0","0","0","0","0","0","0","0","0","0","0","0"
"2015","Calgary, Alberta, municipal","48014","Making, or distribution of child pornography","0","0","0","0","0","0","0","0","0","0","0","0","0","0"
"2016","Calgary, Alberta, municipal","48014","Making, or distribution of child pornography","53","0","0","0","4.02","0","0","0","0","0","0","0","0","0"
"1998","Calgary, Alberta, municipal","48014","Total prostitution","175","170","0","0","20.82","0","0","0","0","170","184","203","19","0"
"1999","Calgary, Alberta, municipal","48014","Total prostitution","144","133","4","-19.77","16.7","0","0","0","0","137","132","133","1","2"
"2000","Calgary, Alberta, municipal","48014","Total prostitution","81","80","0","-45.05","9.18","0","0","0","0","80","60","64","4","0"
"2001","Calgary, Alberta, municipal","48014","Total prostitution","290","285","5","250.29","32.15","0","0","0","0","290","275","276","1","0"
"2002","Calgary, Alberta, municipal","48014","Total prostitution","229","218","16","-22.86","24.8","0","0","0","0","234","246","249","3","1"
"2003","Calgary, Alberta, municipal","48014","Total prostitution","254","245","8","9.18","27.07","0","0","0","0","253","284","286","2","0"
"2004","Calgary, Alberta, municipal","48014","Total prostitution","183","182","1","-30.1","18.92","24.98","22.82","1.32","1.32","183","188","189","1","1"
"2005","Calgary, Alberta, municipal","48014","Total prostitution","245","204","39","29.93","24.59","25.58","23.39","1.3","0","243","199","200","1","0"
"2006","Calgary, Alberta, municipal","48014","Total prostitution","171","164","5","-32.33","16.64","20.99","19.25","1.29","0","169","169","170","1","0"
"2007","Calgary, Alberta, municipal","48014","Total prostitution","142","130","12","-18.95","13.49","16.41","15.12","1.29","0","142","136","137","1","0"
"2008","Calgary, Alberta, municipal","48014","Total prostitution","186","183","3","27.78","17.23","22.53","20.66","0","0","186","192","192","0","0"
"2009","Calgary, Alberta, municipal","48014","Total prostitution","149","148","0","-21.9","13.46","18.61","17.1","0","0","148","163","163","0","0"
"2010","Calgary, Alberta, municipal","48014","Total prostitution","182","177","5","20.35","16.2","21.39","19.66","0","0","182","190","190","0","0"
"2011","Calgary, Alberta, municipal","48014","Total prostitution","113","107","3","-38.88","9.9","12.86","11.83","0","0","110","116","116","0","0"
"2012","Calgary, Alberta, municipal","48014","Total prostitution","63","58","3","-45.91","5.35","6.33","5.84","0","0","61","59","59","0","0"
"2013","Calgary, Alberta, municipal","48014","Total prostitution","141","135","1","115.97","11.56","14.26","13.27","1.26","0","136","138","139","1","0"
"2014","Calgary, Alberta, municipal","48014","Total prostitution","55","58","1","-62.26","4.36","5.78","5.36","0","0","59","58","58","0","0"
"2015","Calgary, Alberta, municipal","48014","Total prostitution","3","4","0","-94.66","0.23","0.39","0.36","0","0","4","4","4","0","0"
"2016","Calgary, Alberta, municipal","48014","Total prostitution","4","6","0","30.22","0.3","0.57","0.53","0","0","6","6","6","0","0"
"1998","Calgary, Alberta, municipal","48014","Bawdy house","14","14","0","0","1.67","0","0","0","0","14","42","42","0","0"
"1999","Calgary, Alberta, municipal","48014","Bawdy house","2","1","0","-86.07","0.23","0","0","0","0","1","1","1","0","0"
"2000","Calgary, Alberta, municipal","48014","Bawdy house","1","2","0","-51.16","0.11","0","0","0","0","2","3","3","0","0"
"2001","Calgary, Alberta, municipal","48014","Bawdy house","2","5","0","95.68","0.22","0","0","0","0","5","12","12","0","0"
"2002","Calgary, Alberta, municipal","48014","Bawdy house","7","6","0","241.92","0.76","0","0","0","0","6","34","34","0","0"
"2003","Calgary, Alberta, municipal","48014","Bawdy house","17","17","0","139.06","1.81","0","0","0","0","17","41","41","0","0"
"2004","Calgary, Alberta, municipal","48014","Bawdy house","2","2","0","-88.59","0.21","0.66","0.6","0","0","2","5","5","0","0"
"2005","Calgary, Alberta, municipal","48014","Bawdy house","0","0","0","-100","0","0","0","0","0","0","0","0","0","0"
"2006","Calgary, Alberta, municipal","48014","Bawdy house","0","0","0","0","0","0","0","0","0","0","0","0","0","0"
"2007","Calgary, Alberta, municipal","48014","Bawdy house","2","2","0","0","0.19","0.97","0.88","0","0","2","8","8","0","0"
"2008","Calgary, Alberta, municipal","48014","Bawdy house","3","3","0","46.33","0.28","0.7","0.65","0","0","3","6","6","0","0"
"2009","Calgary, Alberta, municipal","48014","Bawdy house","5","5","0","62.48","0.45","1.14","1.05","0","0","5","10","10","0","0"
"2010","Calgary, Alberta, municipal","48014","Bawdy house","7","4","3","37.94","0.62","0.9","0.83","0","0","7","8","8","0","0"
"2011","Calgary, Alberta, municipal","48014","Bawdy house","4","3","0","-43.75","0.35","0.78","0.71","0","0","3","7","7","0","0"
"2012","Calgary, Alberta, municipal","48014","Bawdy house","2","0","1","-51.49","0.17","0","0","0","0","1","0","0","0","0"
"2013","Calgary, Alberta, municipal","48014","Bawdy house","4","5","0","92.99","0.33","0.93","0.86","0","0","5","9","9","0","0"
"2014","Calgary, Alberta, municipal","48014","Bawdy house","1","0","1","-75.81","0.08","0","0","0","0","1","0","0","0","0"
"2015","Calgary, Alberta, municipal","48014","Bawdy house","0","0","0","-100","0","0","0","0","0","0","0","0","0","0"
"2016","Calgary, Alberta, municipal","48014","Bawdy house","0","0","0","0","0","0","0","0","0","0","0","0","0","0"
"1998","Calgary, Alberta, municipal","48014","Living off the avails of prostitution of a person under age 18","4","3","0","0","0.48","0","0","0","0","3","2","2","0","0"
"1999","Calgary, Alberta, municipal","48014","Living off the avails of prostitution of a person under age 18","13","6","2","216.88","1.51","0","0","0","0","8","6","6","0","2"
"2000","Calgary, Alberta, municipal","48014","Living off the avails of prostitution of a person under age 18","2","4","0","-84.97","0.23","0","0","0","0","4","2","5","3","0"
"2001","Calgary, Alberta, municipal","48014","Living off the avails of prostitution of a person under age 18","0","0","0","-100","0","0","0","0","0","0","0","0","0","0"
"2002","Calgary, Alberta, municipal","48014","Living off the avails of prostitution of a person under age 18","1","1","0","0","0.11","0","0","0","0","1","1","1","0","0"
"2003","Calgary, Alberta, municipal","48014","Living off the avails of prostitution of a person under age 18","2","2","0","96.87","0.21","0","0","0","0","2","3","4","1","0"
"2004","Calgary, Alberta, municipal","48014","Living off the avails of prostitution of a person under age 18","0","0","0","-100","0","0","0","0","0","0","0","0","0","0"
"2005","Calgary, Alberta, municipal","48014","Living off the avails of prostitution of a person under age 18","1","1","0","0","0.1","0.13","0.12","0","0","1","1","1","0","0"
"2006","Calgary, Alberta, municipal","48014","Living off the avails of prostitution of a person under age 18","0","0","0","-100","0","0","0","0","0","0","0","0","0","0"
"2007","Calgary, Alberta, municipal","48014","Living off the avails of prostitution of a person under age 18","0","0","0","0","0","0","0","0","0","0","0","0","0","0"
"2008","Calgary, Alberta, municipal","48014","Living off the avails of prostitution of a person under age 18","0","0","0","0","0","0","0","0","0","0","0","0","0","0"
"2009","Calgary, Alberta, municipal","48014","Living off the avails of prostitution of a person under age 18","0","0","0","0","0","0","0","0","0","0","0","0","0","0"
"2010","Calgary, Alberta, municipal","48014","Living off the avails of prostitution of a person under age 18","0","0","0","0","0","0","0","0","0","0","0","0","0","0"
"2011","Calgary, Alberta, municipal","48014","Living off the avails of prostitution of a person under age 18","3","3","0","0","0.26","0.55","0.51","0","0","3","5","5","0","0"
"2012","Calgary, Alberta, municipal","48014","Living off the avails of prostitution of a person under age 18","2","1","0","-35.33","0.17","0.11","0.1","0","0","1","1","1","0","0"
"2013","Calgary, Alberta, municipal","48014","Living off the avails of prostitution of a person under age 18","0","0","0","-100","0","0","0","0","0","0","0","0","0","0"
"2014","Calgary, Alberta, municipal","48014","Living off the avails of prostitution of a person under age 18","0","0","0","0","0","0","0","0","0","0","0","0","0","0"
"2015","Calgary, Alberta, municipal","48014","Living off the avails of prostitution of a person under age 18","0","0","0","0","0","0","0","0","0","0","0","0","0","0"
"2016","Calgary, Alberta, municipal","48014","Living off the avails of prostitution of a person under age 18","0","0","0","0","0","0","0","0","0","0","0","0","0","0"
"1998","Calgary, Alberta, municipal","48014","Procuring","12","9","0","0","1.43","0","0","0","0","9","5","5","0","0"
"1999","Calgary, Alberta, municipal","48014","Procuring","5","4","1","-59.37","0.58","0","0","0","0","5","5","5","0","0"
"2000","Calgary, Alberta, municipal","48014","Procuring","5","4","0","-2.32","0.57","0","0","0","0","4","4","5","1","0"
"2001","Calgary, Alberta, municipal","48014","Procuring","9","8","3","76.11","1","0","0","0","0","11","9","9","0","0"
"2002","Calgary, Alberta, municipal","48014","Procuring","6","4","1","-34.87","0.65","0","0","0","0","5","7","7","0","0"
"2003","Calgary, Alberta, municipal","48014","Procuring","7","7","0","14.84","0.75","0","0","0","0","7","14","14","0","0"
"2004","Calgary, Alberta, municipal","48014","Procuring","2","2","0","-72.28","0.21","0.53","0.48","0","0","2","4","4","0","0"
"2005","Calgary, Alberta, municipal","48014","Procuring","1","1","0","-51.48","0.1","0.13","0.12","0","0","1","1","1","0","0"
"2006","Calgary, Alberta, municipal","48014","Procuring","3","2","0","190.87","0.29","0.37","0.34","0","0","2","3","3","0","0"
"2007","Calgary, Alberta, municipal","48014","Procuring","0","0","0","-100","0","0","0","0","0","0","0","0","0","0"
"2008","Calgary, Alberta, municipal","48014","Procuring","3","3","0","0","0.28","0.35","0.32","0","0","3","3","3","0","0"
"2009","Calgary, Alberta, municipal","48014","Procuring","2","1","0","-35.01","0.18","0.11","0.1","0","0","1","1","1","0","0"
"2010","Calgary, Alberta, municipal","48014","Procuring","6","7","0","195.59","0.53","0.79","0.72","0","0","7","7","7","0","0"
"2011","Calgary, Alberta, municipal","48014","Procuring","3","1","0","-50.78","0.26","0.33","0.31","0","0","1","3","3","0","0"
"1998","Calgary, Alberta, municipal","48014","Obtains or communicates with a person under age 18 for purpose of sex","2","2","0","0","0.24","0","0","0","0","2","2","2","0","0"
"1999","Calgary, Alberta, municipal","48014","Obtains or communicates with a person under age 18 for purpose of sex","4","3","0","95","0.46","0","0","0","0","3","3","3","0","0"
"2000","Calgary, Alberta, municipal","48014","Obtains or communicates with a person under age 18 for purpose of sex","1","1","0","-75.58","0.11","0","0","0","0","1","1","1","0","0"
"2001","Calgary, Alberta, municipal","48014","Obtains or communicates with a person under age 18 for purpose of sex","1","0","1","-2.16","0.11","0","0","0","0","1","0","0","0","0"
"2002","Calgary, Alberta, municipal","48014","Obtains or communicates with a person under age 18 for purpose of sex","2","2","0","95.38","0.22","0","0","0","0","2","2","2","0","0"
"2003","Calgary, Alberta, municipal","48014","Obtains or communicates with a person under age 18 for purpose of sex","5","3","1","146.09","0.53","0","0","0","0","4","4","4","0","0"
"2004","Calgary, Alberta, municipal","48014","Obtains or communicates with a person under age 18 for purpose of sex","1","1","0","-80.6","0.1","0.13","0.12","0","0","1","1","1","0","0"
"2005","Calgary, Alberta, municipal","48014","Obtains or communicates with a person under age 18 for purpose of sex","2","1","0","94.1","0.2","0.13","0.12","0","0","1","1","1","0","0"
"2006","Calgary, Alberta, municipal","48014","Obtains or communicates with a person under age 18 for purpose of sex","1","0","0","-51.52","0.1","0","0","0","0","0","0","0","0","0"
"2007","Calgary, Alberta, municipal","48014","Obtains or communicates with a person under age 18 for purpose of sex","0","0","0","-100","0","0","0","0","0","0","0","0","0","0"
"2008","Calgary, Alberta, municipal","48014","Obtains or communicates with a person under age 18 for purpose of sex","0","0","0","0","0","0","0","0","0","0","0","0","0","0"
"2009","Calgary, Alberta, municipal","48014","Obtains or communicates with a person under age 18 for purpose of sex","0","0","0","0","0","0","0","0","0","0","0","0","0","0"
"2010","Calgary, Alberta, municipal","48014","Obtains or communicates with a person under age 18 for purpose of sex","1","0","0","0","0.09","0","0","0","0","0","0","0","0","0"
"2011","Calgary, Alberta, municipal","48014","Obtains or communicates with a person under age 18 for purpose of sex","4","4","0","293.73","0.35","0.44","0.41","0","0","4","4","4","0","0"
"2012","Calgary, Alberta, municipal","48014","Obtains or communicates with a person under age 18 for purpose of sex","0","0","0","-100","0","0","0","0","0","0","0","0","0","0"
"2013","Calgary, Alberta, municipal","48014","Obtains or communicates with a person under age 18 for purpose of sex","0","0","0","0","0","0","0","0","0","0","0","0","0","0"
"2014","Calgary, Alberta, municipal","48014","Obtains or communicates with a person under age 18 for purpose of sex","1","0","0","0","0.08","0","0","0","0","0","0","0","0","0"
"2015","Calgary, Alberta, municipal","48014","Obtains or communicates with a person under age 18 for purpose of sex","0","1","0","-100","0","0.1","0.09","0","0","1","1","1","0","0"
"2016","Calgary, Alberta, municipal","48014","Obtains or communicates with a person under age 18 for purpose of sex","0","0","0","0","0","0","0","0","0","0","0","0","0","0"
"1998","Calgary, Alberta, municipal","48014","Other prostitution","143","142","0","0","17.01","0","0","0","0","142","133","152","19","0"
"1999","Calgary, Alberta, municipal","48014","Other prostitution","120","119","1","-18.18","13.92","0","0","0","0","120","117","118","1","0"
"2000","Calgary, Alberta, municipal","48014","Other prostitution","72","69","0","-41.39","8.16","0","0","0","0","69","50","50","0","0"
"2001","Calgary, Alberta, municipal","48014","Other prostitution","278","272","1","277.77","30.82","0","0","0","0","273","254","255","1","0"
"2002","Calgary, Alberta, municipal","48014","Other prostitution","213","205","15","-25.15","23.06","0","0","0","0","220","202","205","3","1"
"2003","Calgary, Alberta, municipal","48014","Other prostitution","223","216","7","3.06","23.77","0","0","0","0","223","222","223","1","0"
"2004","Calgary, Alberta, municipal","48014","Other prostitution","178","177","1","-22.56","18.41","23.65","21.61","1.32","1.32","178","178","179","1","1"
"2005","Calgary, Alberta, municipal","48014","Other prostitution","241","201","39","31.4","24.19","25.2","23.04","1.3","0","240","196","197","1","0"
"2006","Calgary, Alberta, municipal","48014","Other prostitution","167","162","5","-32.81","16.25","20.62","18.91","1.29","0","167","166","167","1","0"
"2007","Calgary, Alberta, municipal","48014","Other prostitution","140","128","12","-18.18","13.3","15.45","14.24","1.29","0","140","128","129","1","0"
"2008","Calgary, Alberta, municipal","48014","Other prostitution","180","177","3","25.42","16.68","21.47","19.69","0","0","180","183","183","0","0"
"2009","Calgary, Alberta, municipal","48014","Other prostitution","142","142","0","-23.09","12.83","17.36","15.95","0","0","142","152","152","0","0"
"2010","Calgary, Alberta, municipal","48014","Other prostitution","168","166","2","16.57","14.95","19.7","18.11","0","0","168","175","175","0","0"
"2011","Calgary, Alberta, municipal","48014","Other prostitution","99","96","3","-41.99","8.67","10.75","9.89","0","0","99","97","97","0","0"
"2012","Calgary, Alberta, municipal","48014","Other prostitution","56","54","2","-45.13","4.76","5.9","5.44","0","0","56","55","55","0","0"
"2013","Calgary, Alberta, municipal","48014","Other prostitution","91","90","1","56.81","7.46","9.19","8.6","1.26","0","91","89","90","1","0"
"2014","Calgary, Alberta, municipal","48014","Other prostitution","46","46","0","-51.1","3.65","4.59","4.25","0","0","46","46","46","0","0"
"2015","Calgary, Alberta, municipal","48014","Other prostitution","0","0","0","-100","0","0","0","0","0","0","0","0","0","0"
"2016","Calgary, Alberta, municipal","48014","Other prostitution","0","0","0","0","0","0","0","0","0","0","0","0","0","0"
"2012","Calgary, Alberta, municipal","48014","Communicating to provide sexual services for consideration","0","0","0","0","0","0","0","0","0","0","0","0","0","0"
"2013","Calgary, Alberta, municipal","48014","Communicating to provide sexual services for consideration","0","0","0","0","0","0","0","0","0","0","0","0","0","0"
"2014","Calgary, Alberta, municipal","48014","Communicating to provide sexual services for consideration","0","0","0","0","0","0","0","0","0","0","0","0","0","0"
"2015","Calgary, Alberta, municipal","48014","Communicating to provide sexual services for consideration","0","0","0","0","0","0","0","0","0","0","0","0","0","0"
"2016","Calgary, Alberta, municipal","48014","Communicating to provide sexual services for consideration","0","0","0","0","0","0","0","0","0","0","0","0","0","0"
"2012","Calgary, Alberta, municipal","48014","Stopping or impeding traffic for the purpose of offering, providing or obtaining sexual services for consideration","0","0","0","0","0","0","0","0","0","0","0","0","0","0"
"2013","Calgary, Alberta, municipal","48014","Stopping or impeding traffic for the purpose of offering, providing or obtaining sexual services for consideration","0","0","0","0","0","0","0","0","0","0","0","0","0","0"
"2014","Calgary, Alberta, municipal","48014","Stopping or impeding traffic for the purpose of offering, providing or obtaining sexual services for consideration","0","0","0","0","0","0","0","0","0","0","0","0","0","0"
"2015","Calgary, Alberta, municipal","48014","Stopping or impeding traffic for the purpose of offering, providing or obtaining sexual services for consideration","0","0","0","0","0","0","0","0","0","0","0","0","0","0"
"2016","Calgary, Alberta, municipal","48014","Stopping or impeding traffic for the purpose of offering, providing or obtaining sexual services for consideration","0","0","0","0","0","0","0","0","0","0","0","0","0","0"
"1998","Calgary, Alberta, municipal","48014","Disturb the peace","118","108","6","0","14.04","0","0","0","0","114","103","119","16","1"
"1999","Calgary, Alberta, municipal","48014","Disturb the peace","84","72","8","-30.59","9.74","0","0","0","0","80","69","83","14","4"
"2000","Calgary, Alberta, municipal","48014","Disturb the peace","72","60","7","-16.27","8.16","0","0","0","0","67","54","60","6","5"
"2001","Calgary, Alberta, municipal","48014","Disturb the peace","73","65","6","-0.8","8.09","0","0","0","0","71","55","66","11","2"
"2002","Calgary, Alberta, municipal","48014","Disturb the peace","65","52","10","-13.02","7.04","0","0","0","0","62","47","57","10","5"
"2003","Calgary, Alberta, municipal","48014","Disturb the peace","97","70","19","46.9","10.34","0","0","0","0","89","63","71","8","19"
"2004","Calgary, Alberta, municipal","48014","Disturb the peace","80","60","20","-19.99","8.27","6.25","7.24","17.15","23.74","80","47","60","13","18"
"2005","Calgary, Alberta, municipal","48014","Disturb the peace","71","52","14","-13.87","7.13","6.43","6.9","11.68","14.28","66","50","59","9","11"
"2006","Calgary, Alberta, municipal","48014","Disturb the peace","54","39","15","-26.26","5.25","4.47","4.42","3.86","3.86","54","36","39","3","3"
"2007","Calgary, Alberta, municipal","48014","Disturb the peace","43","37","4","-22.28","4.08","4.1","4.41","7.74","1.29","41","34","40","6","1"
"2008","Calgary, Alberta, municipal","48014","Disturb the peace","46","33","9","4.36","4.26","3.99","3.66","0","7.77","42","34","34","0","6"
"2009","Calgary, Alberta, municipal","48014","Disturb the peace","43","34","4","-8.87","3.88","3.65","4.3","11.61","0","38","32","41","9","0"
"2010","Calgary, Alberta, municipal","48014","Disturb the peace","35","28","4","-19.8","3.11","3.26","3.21","2.56","1.28","32","29","31","2","1"
"2011","Calgary, Alberta, municipal","48014","Disturb the peace","35","27","2","-1.57","3.07","2.55","2.86","6.38","0","29","23","28","5","0"
"2012","Calgary, Alberta, municipal","48014","Disturb the peace","32","30","2","-11.3","2.72","2.47","2.67","5.08","1.27","32","23","27","4","1"
"2013","Calgary, Alberta, municipal","48014","Disturb the peace","32","17","6","-3.5","2.62","1.65","1.62","1.26","1.26","23","16","17","1","1"
"2014","Calgary, Alberta, municipal","48014","Disturb the peace","31","22","6","-6.28","2.46","2.19","2.03","0","1.26","28","22","22","0","1"
"2015","Calgary, Alberta, municipal","48014","Disturb the peace","28","20","4","-11.61","2.17","1.66","1.54","0","3.74","24","17","17","0","3"
"2016","Calgary, Alberta, municipal","48014","Disturb the peace","24","8","3","-16.29","1.82","0.76","0.8","1.22","0","11","8","9","1","0"
"1998","Calgary, Alberta, municipal","48014","Total administration of justice violations","2584","2496","57","0","307.37","0","0","0","0","2553","1857","2356","499","13"
"1999","Calgary, Alberta, municipal","48014","Total administration of justice violations","2688","2592","64","1.43","311.76","0","0","0","0","2656","1910","2463","553","11"
"2000","Calgary, Alberta, municipal","48014","Total administration of justice violations","3063","2958","104","11.31","347.02","0","0","0","0","3062","2256","2772","516","16"
"2001","Calgary, Alberta, municipal","48014","Total administration of justice violations","3163","3038","100","1.03","350.61","0","0","0","0","3138","2400","2889","489","18"
"2002","Calgary, Alberta, municipal","48014","Total administration of justice violations","3534","3421","99","9.15","382.68","0","0","0","0","3520","2730","3288","558","24"
"2003","Calgary, Alberta, municipal","48014","Total administration of justice violations","3197","3073","112","-10.95","340.78","0","0","0","0","3185","2541","2951","410","24"
"2004","Calgary, Alberta, municipal","48014","Total administration of justice violations","3678","3561","102","11.61","380.35","387.33","411.28","648.92","38.25","3663","2915","3407","492","29"
"2005","Calgary, Alberta, municipal","48014","Total administration of justice violations","3541","3427","88","-6.57","355.37","365.59","386.8","601.11","33.76","3515","2844","3307","463","26"
"2006","Calgary, Alberta, municipal","48014","Total administration of justice violations","3883","3769","111","6.32","377.83","379.64","404.28","659.29","35.98","3880","3057","3570","513","28"
"2007","Calgary, Alberta, municipal","48014","Total administration of justice violations","3155","3064","89","-20.7","299.63","298.56","319.05","538.04","18.06","3153","2474","2891","417","14"
"2008","Calgary, Alberta, municipal","48014","Total administration of justice violations","2864","2760","91","-11.45","265.34","271.55","282.67","405.48","33.68","2851","2314","2627","313","26"
"2009","Calgary, Alberta, municipal","48014","Total administration of justice violations","3322","3209","108","13.08","300.04","307.18","315.34","407.47","18.05","3317","2690","3006","316","14"
"2010","Calgary, Alberta, municipal","48014","Total administration of justice violations","3132","3014","109","-7.1","278.72","291.12","296.71","360.33","19.23","3123","2586","2867","281","15"
"2011","Calgary, Alberta, municipal","48014","Total administration of justice violations","3175","3052","102","-0.22","278.12","292.43","294.35","316.54","12.76","3154","2638","2886","248","10"
"2012","Calgary, Alberta, municipal","48014","Total administration of justice violations","3075","3020","57","-6.04","261.31","281.86","283.04","297.06","15.23","3077","2626","2860","234","12"
"2013","Calgary, Alberta, municipal","48014","Total administration of justice violations","2954","2858","80","-7.3","242.23","259.21","256.81","227.37","8.84","2938","2509","2689","180","7"
"2014","Calgary, Alberta, municipal","48014","Total administration of justice violations","2951","2859","78","-3.35","234.11","244.94","246.83","270.65","16.37","2937","2456","2671","215","13"
"2015","Calgary, Alberta, municipal","48014","Total administration of justice violations","2184","2141","64","-27.57","169.57","183.19","181.02","153.28","8.72","2205","1876","1999","123","7"
"2016","Calgary, Alberta, municipal","48014","Total administration of justice violations","3096","3017","76","38.45","234.76","263.31","255.98","162.25","4.88","3093","2758","2891","133","4"
"1998","Calgary, Alberta, municipal","48014","Fail to comply with order","2030","1994","19","0","241.47","0","0","0","0","2013","1453","1914","461","3"
"1999","Calgary, Alberta, municipal","48014","Fail to comply with order","2178","2117","42","4.61","252.61","0","0","0","0","2159","1507","2021","514","4"
"2000","Calgary, Alberta, municipal","48014","Fail to comply with order","2447","2383","69","9.75","277.23","0","0","0","0","2452","1728","2218","490","12"
"2001","Calgary, Alberta, municipal","48014","Fail to comply with order","2503","2425","69","0.08","277.45","0","0","0","0","2494","1879","2312","433","9"
"2002","Calgary, Alberta, municipal","48014","Fail to comply with order","2738","2670","60","6.86","296.49","0","0","0","0","2730","2079","2587","508","9"
"2003","Calgary, Alberta, municipal","48014","Fail to comply with order","2552","2465","78","-8.25","272.03","0","0","0","0","2543","1991","2363","372","16"
"2004","Calgary, Alberta, municipal","48014","Fail to comply with order","2986","2902","73","13.51","308.79","307.48","335.71","615.95","23.74","2975","2314","2781","467","18"
"2005","Calgary, Alberta, municipal","48014","Fail to comply with order","2760","2688","57","-10.3","276.99","275.99","301.54","559.57","20.77","2745","2147","2578","431","16"
"2006","Calgary, Alberta, municipal","48014","Fail to comply with order","3051","2972","78","7.18","296.88","293.08","319.58","593.75","24.42","3050","2360","2822","462","19"
"2007","Calgary, Alberta, municipal","48014","Fail to comply with order","2519","2452","67","-19.42","239.23","234","255.92","490.3","15.48","2519","1939","2319","380","12"
"2008","Calgary, Alberta, municipal","48014","Fail to comply with order","2268","2202","61","-12.17","210.12","211.58","225.64","380.87","20.73","2263","1803","2097","294","16"
"2009","Calgary, Alberta, municipal","48014","Fail to comply with order","2590","2518","78","11.33","233.93","236.38","247.99","379.1","11.61","2596","2070","2364","294","9"
"2010","Calgary, Alberta, municipal","48014","Fail to comply with order","2420","2348","76","-7.94","215.36","222.45","231.61","335.97","11.54","2424","1976","2238","262","9"
"2011","Calgary, Alberta, municipal","48014","Fail to comply with order","2486","2404","72","1.12","217.77","226.91","232.44","296.11","8.93","2476","2047","2279","232","7"
"2012","Calgary, Alberta, municipal","48014","Fail to comply with order","2430","2396","38","-5.17","206.5","221.43","225.74","276.74","6.35","2434","2063","2281","218","5"
"2013","Calgary, Alberta, municipal","48014","Fail to comply with order","2430","2364","55","-3.5","199.26","215.2","213.35","190.74","7.58","2419","2083","2234","151","6"
"2014","Calgary, Alberta, municipal","48014","Fail to comply with order","2507","2448","57","-0.19","198.89","208.34","211.99","258.07","10.07","2505","2089","2294","205","8"
"2015","Calgary, Alberta, municipal","48014","Fail to comply with order","1689","1651","55","-34.07","131.13","140.03","139.99","139.57","7.48","1706","1434","1546","112","6"
"2016","Calgary, Alberta, municipal","48014","Fail to comply with order","2535","2477","59","46.58","192.22","214.81","210.29","152.49","1.22","2536","2250","2375","125","1"
"1998","Calgary, Alberta, municipal","48014","Escape or helps to escape from lawful custody","75","72","2","0","8.92","0","0","0","0","74","56","66","10","1"
"1999","Calgary, Alberta, municipal","48014","Escape or helps to escape from lawful custody","47","46","2","-38.9","5.45","0","0","0","0","48","34","46","12","1"
"2000","Calgary, Alberta, municipal","48014","Escape or helps to escape from lawful custody","26","24","1","-45.96","2.95","0","0","0","0","25","15","23","8","1"
"2001","Calgary, Alberta, municipal","48014","Escape or helps to escape from lawful custody","50","50","0","88.15","5.54","0","0","0","0","50","28","41","13","0"
"2002","Calgary, Alberta, municipal","48014","Escape or helps to escape from lawful custody","68","65","1","32.86","7.36","0","0","0","0","66","45","66","21","1"
"2003","Calgary, Alberta, municipal","48014","Escape or helps to escape from lawful custody","31","31","0","-55.12","3.3","0","0","0","0","31","26","36","10","0"
"2004","Calgary, Alberta, municipal","48014","Escape or helps to escape from lawful custody","36","35","2","12.66","3.72","3.19","4.1","13.19","0","37","24","34","10","0"
"2005","Calgary, Alberta, municipal","48014","Escape or helps to escape from lawful custody","63","63","0","69.83","6.32","5.78","6.78","16.88","0","63","45","58","13","0"
"2006","Calgary, Alberta, municipal","48014","Escape or helps to escape from lawful custody","69","68","1","6.19","6.71","6.46","7.7","20.56","0","69","52","68","16","0"
"2007","Calgary, Alberta, municipal","48014","Escape or helps to escape from lawful custody","48","48","0","-32.1","4.56","3.38","5.41","27.1","0","48","28","49","21","0"
"2008","Calgary, Alberta, municipal","48014","Escape or helps to escape from lawful custody","35","35","0","-28.87","3.24","3.29","3.66","7.77","0","35","28","34","6","0"
"2009","Calgary, Alberta, municipal","48014","Escape or helps to escape from lawful custody","55","54","0","53.2","4.97","4.68","5.14","10.32","0","54","41","49","8","0"
"2010","Calgary, Alberta, municipal","48014","Escape or helps to escape from lawful custody","39","39","0","-30.13","3.47","3.6","4.04","8.98","0","39","32","39","7","0"
"2011","Calgary, Alberta, municipal","48014","Escape or helps to escape from lawful custody","29","30","0","-26.81","2.54","2.88","3.16","6.38","0","30","26","31","5","0"
"2012","Calgary, Alberta, municipal","48014","Escape or helps to escape from lawful custody","27","27","0","-9.68","2.29","2.15","2.28","3.81","0","27","20","23","3","0"
"2013","Calgary, Alberta, municipal","48014","Escape or helps to escape from lawful custody","24","24","0","-14.23","1.97","1.55","2.29","11.37","0","24","15","24","9","0"
"2014","Calgary, Alberta, municipal","48014","Escape or helps to escape from lawful custody","18","18","0","-27.44","1.43","1.4","1.57","3.78","0","18","14","17","3","0"
"2015","Calgary, Alberta, municipal","48014","Escape or helps to escape from lawful custody","24","24","0","30.49","1.86","2.05","2.08","2.49","0","24","21","23","2","0"
"2016","Calgary, Alberta, municipal","48014","Escape or helps to escape from lawful custody","29","29","0","18.01","2.2","2.67","2.57","1.22","0","29","28","29","1","0"
"1998","Calgary, Alberta, municipal","48014","Prisoner unlawfully at large","169","163","4","0","20.1","0","0","0","0","167","146","163","17","0"
"1999","Calgary, Alberta, municipal","48014","Prisoner unlawfully at large","195","192","5","12.5","22.62","0","0","0","0","197","168","190","22","1"
"2000","Calgary, Alberta, municipal","48014","Prisoner unlawfully at large","223","219","4","11.71","25.26","0","0","0","0","223","206","215","9","0"
"2001","Calgary, Alberta, municipal","48014","Prisoner unlawfully at large","197","194","2","-13.57","21.84","0","0","0","0","196","176","196","20","1"
"2002","Calgary, Alberta, municipal","48014","Prisoner unlawfully at large","195","194","1","-3.3","21.12","0","0","0","0","195","177","194","17","1"
"2003","Calgary, Alberta, municipal","48014","Prisoner unlawfully at large","211","209","0","6.51","22.49","0","0","0","0","209","197","209","12","0"
"2004","Calgary, Alberta, municipal","48014","Prisoner unlawfully at large","191","189","1","-12.18","19.75","23.92","22.69","10.55","0","190","180","188","8","0"
"2005","Calgary, Alberta, municipal","48014","Prisoner unlawfully at large","256","256","0","30.07","25.69","31.49","29.36","7.79","0","256","245","251","6","0"
"2006","Calgary, Alberta, municipal","48014","Prisoner unlawfully at large","283","281","0","7.18","27.54","32.79","31.71","20.56","0","281","264","280","16","0"
"2007","Calgary, Alberta, municipal","48014","Prisoner unlawfully at large","245","245","1","-15.51","23.27","28.12","26.6","10.32","0","246","233","241","8","0"
"2008","Calgary, Alberta, municipal","48014","Prisoner unlawfully at large","177","177","1","-29.52","16.4","19.83","19.05","10.36","0","178","169","177","8","0"
"2009","Calgary, Alberta, municipal","48014","Prisoner unlawfully at large","126","125","0","-30.6","11.38","13.02","12.9","11.61","0","125","114","123","9","0"
"2010","Calgary, Alberta, municipal","48014","Prisoner unlawfully at large","143","144","0","11.82","12.73","14.86","14.59","11.54","0","144","132","141","9","0"
"2011","Calgary, Alberta, municipal","48014","Prisoner unlawfully at large","129","130","0","-11.2","11.3","13.97","13.16","3.83","0","130","126","129","3","0"
"2012","Calgary, Alberta, municipal","48014","Prisoner unlawfully at large","170","170","0","27.84","14.45","17.28","16.92","12.69","0","170","161","171","10","0"
"2013","Calgary, Alberta, municipal","48014","Prisoner unlawfully at large","152","151","0","-13.72","12.46","13.84","14.13","17.68","0","151","134","148","14","0"
"2014","Calgary, Alberta, municipal","48014","Prisoner unlawfully at large","100","101","0","-36.35","7.93","9.67","9.24","3.78","0","101","97","100","3","0"
"2015","Calgary, Alberta, municipal","48014","Prisoner unlawfully at large","130","129","1","27.22","10.09","12.3","11.68","3.74","0","130","126","129","3","0"
"2016","Calgary, Alberta, municipal","48014","Prisoner unlawfully at large","175","175","0","31.47","13.27","16.52","15.49","2.44","0","175","173","175","2","0"
"1998","Calgary, Alberta, municipal","48014","Fail to appear","0","0","0","0","0","0","0","0","0","0","0","0","0","0"
"1999","Calgary, Alberta, municipal","48014","Fail to appear","0","0","0","0","0","0","0","0","0","0","0","0","0","0"
"2000","Calgary, Alberta, municipal","48014","Fail to appear","0","0","0","0","0","0","0","0","0","0","0","0","0","0"
"2001","Calgary, Alberta, municipal","48014","Fail to appear","0","0","0","0","0","0","0","0","0","0","0","0","0","0"
"2002","Calgary, Alberta, municipal","48014","Fail to appear","1","1","0","0","0.11","0","0","0","0","1","0","1","1","0"
"2003","Calgary, Alberta, municipal","48014","Fail to appear","0","0","0","-100","0","0","0","0","0","0","0","0","0","0"
"2004","Calgary, Alberta, municipal","48014","Fail to appear","0","0","0","0","0","0","0","0","0","0","0","0","0","0"
"2005","Calgary, Alberta, municipal","48014","Fail to appear","3","3","0","0","0.3","0.51","0.47","0","0","3","4","4","0","0"
"2006","Calgary, Alberta, municipal","48014","Fail to appear","0","0","0","-100","0","0","0","0","0","0","0","0","0","0"
"2007","Calgary, Alberta, municipal","48014","Fail to appear","0","0","0","0","0","0","0","0","0","0","0","0","0","0"
"2008","Calgary, Alberta, municipal","48014","Fail to appear","0","0","0","0","0","0","0","0","0","0","0","0","0","0"
"2009","Calgary, Alberta, municipal","48014","Fail to appear","1","1","0","0","0.09","0.11","0.1","0","0","1","1","1","0","0"
"2010","Calgary, Alberta, municipal","48014","Fail to appear","3","3","0","195.59","0.27","0.34","0.31","0","0","3","3","3","0","0"
"2011","Calgary, Alberta, municipal","48014","Fail to appear","2","2","0","-34.38","0.18","0.22","0.2","0","0","2","2","2","0","0"
"2012","Calgary, Alberta, municipal","48014","Fail to appear","1","1","0","-51.49","0.08","0.11","0.1","0","0","1","1","1","0","0"
"2013","Calgary, Alberta, municipal","48014","Fail to appear","2","2","0","92.99","0.16","0.21","0.19","0","0","2","2","2","0","0"
"2014","Calgary, Alberta, municipal","48014","Fail to appear","3","3","0","45.12","0.24","0.3","0.28","0","0","3","3","3","0","0"
"2015","Calgary, Alberta, municipal","48014","Fail to appear","2","2","0","-34.76","0.16","0.2","0.18","0","0","2","2","2","0","0"
"2016","Calgary, Alberta, municipal","48014","Fail to appear","3","3","0","46.49","0.23","0.29","0.27","0","0","3","3","3","0","0"
"1998","Calgary, Alberta, municipal","48014","Breach of probation","185","177","6","0","22.01","0","0","0","0","183","140","141","1","1"
"1999","Calgary, Alberta, municipal","48014","Breach of probation","182","175","1","-4.08","21.11","0","0","0","0","176","150","152","2","0"
"2000","Calgary, Alberta, municipal","48014","Breach of probation","267","257","5","43.31","30.25","0","0","0","0","262","243","244","1","0"
"2001","Calgary, Alberta, municipal","48014","Breach of probation","298","283","6","9.2","33.03","0","0","0","0","289","251","260","9","1"
"2002","Calgary, Alberta, municipal","48014","Breach of probation","409","400","9","34.08","44.29","0","0","0","0","409","359","360","1","2"
"2003","Calgary, Alberta, municipal","48014","Breach of probation","293","286","7","-29.48","31.23","0","0","0","0","293","260","269","9","2"
"2004","Calgary, Alberta, municipal","48014","Breach of probation","369","367","2","22.18","38.16","45.31","41.65","5.28","0","369","341","345","4","0"
"2005","Calgary, Alberta, municipal","48014","Breach of probation","343","339","2","-9.79","34.42","43.58","40.12","5.19","0","341","339","343","4","0"
"2006","Calgary, Alberta, municipal","48014","Breach of probation","383","375","8","8.26","37.27","41.35","39.18","16.71","1.29","383","333","346","13","1"
"2007","Calgary, Alberta, municipal","48014","Breach of probation","266","262","6","-32.22","25.26","27.52","25.71","6.45","0","268","228","233","5","0"
"2008","Calgary, Alberta, municipal","48014","Breach of probation","286","279","6","4.89","26.5","30.16","27.76","1.3","0","285","257","258","1","0"
"2009","Calgary, Alberta, municipal","48014","Breach of probation","437","432","6","48.96","39.47","44.53","41.33","5.16","1.29","438","390","394","4","1"
"2010","Calgary, Alberta, municipal","48014","Breach of probation","411","397","9","-7.33","36.58","42.55","39.22","1.28","1.28","406","378","379","1","1"
"2011","Calgary, Alberta, municipal","48014","Breach of probation","380","377","8","-8.99","33.29","38.8","36.31","7.66","0","385","350","356","6","0"
"2012","Calgary, Alberta, municipal","48014","Breach of probation","370","360","5","-5.54","31.44","35.42","32.86","2.54","0","365","330","332","2","0"
"2013","Calgary, Alberta, municipal","48014","Breach of probation","278","273","9","-27.5","22.8","24.49","23.21","7.58","1.26","282","237","243","6","1"
"2014","Calgary, Alberta, municipal","48014","Breach of probation","256","239","6","-10.91","20.31","21.04","19.78","3.78","2.52","245","211","214","3","2"
"2015","Calgary, Alberta, municipal","48014","Breach of probation","280","285","4","7.04","21.74","24.22","22.82","4.98","0","289","248","252","4","0"
"2016","Calgary, Alberta, municipal","48014","Breach of probation","299","290","5","4.29","22.67","25.59","24","3.66","1.22","295","268","271","3","1"
"1998","Calgary, Alberta, municipal","48014","Other violations against the administration of law and justice (Part IV Criminal Code)","125","90","26","0","14.87","0","0","0","0","116","62","72","10","8"
"1999","Calgary, Alberta, municipal","48014","Other violations against the administration of law and justice (Part IV Criminal Code)","86","62","14","-32.92","9.97","0","0","0","0","76","51","54","3","5"
"2000","Calgary, Alberta, municipal","48014","Other violations against the administration of law and justice (Part IV Criminal Code)","100","75","25","13.59","11.33","0","0","0","0","100","64","72","8","3"
"2001","Calgary, Alberta, municipal","48014","Other violations against the administration of law and justice (Part IV Criminal Code)","115","86","23","12.51","12.75","0","0","0","0","109","66","80","14","7"
"2002","Calgary, Alberta, municipal","48014","Other violations against the administration of law and justice (Part IV Criminal Code)","123","91","28","4.49","13.32","0","0","0","0","119","70","80","10","11"
"2003","Calgary, Alberta, municipal","48014","Other violations against the administration of law and justice (Part IV Criminal Code)","110","82","27","-11.97","11.73","0","0","0","0","109","67","74","7","6"
"2004","Calgary, Alberta, municipal","48014","Other violations against the administration of law and justice (Part IV Criminal Code)","96","68","24","-15.33","9.93","7.44","7.12","3.96","14.51","92","56","59","3","11"
"2005","Calgary, Alberta, municipal","48014","Other violations against the administration of law and justice (Part IV Criminal Code)","116","78","29","17.27","11.64","8.23","8.54","11.68","12.98","107","64","73","9","10"
"2006","Calgary, Alberta, municipal","48014","Other violations against the administration of law and justice (Part IV Criminal Code)","97","73","24","-18.92","9.44","5.96","6.12","7.71","10.28","97","48","54","6","8"
"2007","Calgary, Alberta, municipal","48014","Other violations against the administration of law and justice (Part IV Criminal Code)","77","57","15","-22.52","7.31","5.55","5.41","3.87","2.58","72","46","49","3","2"
"2008","Calgary, Alberta, municipal","48014","Other violations against the administration of law and justice (Part IV Criminal Code)","98","67","23","24.16","9.08","6.69","6.56","5.18","12.95","90","57","61","4","10"
"2009","Calgary, Alberta, municipal","48014","Other violations against the administration of law and justice (Part IV Criminal Code)","113","79","24","12.41","10.21","8.45","7.87","1.29","5.16","103","74","75","1","4"
"2010","Calgary, Alberta, municipal","48014","Other violations against the administration of law and justice (Part IV Criminal Code)","116","83","24","1.15","10.32","7.32","6.93","2.56","6.41","107","65","67","2","5"
"2011","Calgary, Alberta, municipal","48014","Other violations against the administration of law and justice (Part IV Criminal Code)","149","109","22","26.44","13.05","9.64","9.08","2.55","3.83","131","87","89","2","3"
"2012","Calgary, Alberta, municipal","48014","Other violations against the administration of law and justice (Part IV Criminal Code)","77","66","14","-49.87","6.54","5.47","5.15","1.27","8.89","80","51","52","1","7"
"2013","Calgary, Alberta, municipal","48014","Other violations against the administration of law and justice (Part IV Criminal Code)","68","44","16","-14.78","5.58","3.93","3.63","0","0","60","38","38","0","0"
"2014","Calgary, Alberta, municipal","48014","Other violations against the administration of law and justice (Part IV Criminal Code)","67","50","15","-4.68","5.32","4.19","3.97","1.26","3.78","65","42","43","1","3"
"2015","Calgary, Alberta, municipal","48014","Other violations against the administration of law and justice (Part IV Criminal Code)","59","50","4","-13.82","4.58","4.39","4.26","2.49","1.25","54","45","47","2","1"
"2016","Calgary, Alberta, municipal","48014","Other violations against the administration of law and justice (Part IV Criminal Code)","55","43","12","-8.96","4.17","3.44","3.36","2.44","2.44","55","36","38","2","2"
"1998","Calgary, Alberta, municipal","48014","Total other violations","1344","866","199","0","159.87","0","0","0","0","1065","599","691","92","35"
"1999","Calgary, Alberta, municipal","48014","Total other violations","823","621","41","-40.29","95.45","0","0","0","0","662","474","540","66","11"
"2000","Calgary, Alberta, municipal","48014","Total other violations","774","594","49","-8.13","87.69","0","0","0","0","643","481","547","66","13"
"2001","Calgary, Alberta, municipal","48014","Total other violations","772","602","45","-2.41","85.57","0","0","0","0","647","480","539","59","21"
"2002","Calgary, Alberta, municipal","48014","Total other violations","938","780","68","18.7","101.57","0","0","0","0","848","586","650","64","24"
"2003","Calgary, Alberta, municipal","48014","Total other violations","979","788","64","2.74","104.36","0","0","0","0","852","585","669","84","24"
"2004","Calgary, Alberta, municipal","48014","Total other violations","972","749","73","-3.68","100.52","79.33","79.79","84.41","38.25","822","597","661","64","29"
"2005","Calgary, Alberta, municipal","48014","Total other violations","1000","767","64","-0.16","100.36","82.66","81.76","72.7","22.07","831","643","699","56","17"
"2006","Calgary, Alberta, municipal","48014","Total other violations","932","752","50","-9.64","90.69","74.26","73.61","66.83","14.14","802","598","650","52","11"
"2007","Calgary, Alberta, municipal","48014","Total other violations","870","582","67","-8.89","82.62","58.77","58.82","59.35","29.68","649","487","533","46","23"
"2008","Calgary, Alberta, municipal","48014","Total other violations","698","452","41","-21.73","64.67","42.72","43.58","53.11","11.66","493","364","405","41","9"
"2009","Calgary, Alberta, municipal","48014","Total other violations","787","487","44","9.92","71.08","45.91","46.05","47.71","7.74","531","402","439","37","6"
"2010","Calgary, Alberta, municipal","48014","Total other violations","610","363","58","-23.63","54.28","34.45","33.63","24.36","16.67","421","306","325","19","13"
"2011","Calgary, Alberta, municipal","48014","Total other violations","479","324","44","-22.71","41.96","29.6","30.9","45.95","6.38","368","267","303","36","5"
"2012","Calgary, Alberta, municipal","48014","Total other violations","420","281","37","-14.94","35.69","26.83","26.42","21.58","1.27","318","250","267","17","1"
"2013","Calgary, Alberta, municipal","48014","Total other violations","442","285","36","1.55","36.24","25.62","25.31","21.47","10.11","321","248","265","17","8"
"2014","Calgary, Alberta, municipal","48014","Total other violations","443","263","41","-3.03","35.14","22.24","22.09","20.14","8.81","304","223","239","16","7"
"2015","Calgary, Alberta, municipal","48014","Total other violations","477","300","36","5.38","37.03","27.54","26.17","8.72","6.23","336","282","289","7","5"
"2016","Calgary, Alberta, municipal","48014","Total other violations","477","300","34","-2.34","36.17","27.97","27.01","14.64","6.1","334","293","305","12","5"
"1998","Calgary, Alberta, municipal","48014","Betting house","0","0","0","0","0","0","0","0","0","0","0","0","0","0"
"1999","Calgary, Alberta, municipal","48014","Betting house","0","0","0","0","0","0","0","0","0","0","0","0","0","0"
"2000","Calgary, Alberta, municipal","48014","Betting house","1","1","0","0","0.11","0","0","0","0","1","21","21","0","0"
"2001","Calgary, Alberta, municipal","48014","Betting house","0","0","0","-100","0","0","0","0","0","0","0","0","0","0"
"2002","Calgary, Alberta, municipal","48014","Betting house","0","0","0","0","0","0","0","0","0","0","0","0","0","0"
"2003","Calgary, Alberta, municipal","48014","Betting house","0","0","0","0","0","0","0","0","0","0","0","0","0","0"
"2004","Calgary, Alberta, municipal","48014","Betting house","0","0","0","0","0","0","0","0","0","0","0","0","0","0"
"2005","Calgary, Alberta, municipal","48014","Betting house","0","0","0","0","0","0","0","0","0","0","0","0","0","0"
"2006","Calgary, Alberta, municipal","48014","Betting house","0","0","0","0","0","0","0","0","0","0","0","0","0","0"
"2007","Calgary, Alberta, municipal","48014","Betting house","0","0","0","0","0","0","0","0","0","0","0","0","0","0"
"2008","Calgary, Alberta, municipal","48014","Betting house","0","0","0","0","0","0","0","0","0","0","0","0","0","0"
"2009","Calgary, Alberta, municipal","48014","Betting house","0","0","0","0","0","0","0","0","0","0","0","0","0","0"
"2010","Calgary, Alberta, municipal","48014","Betting house","0","0","0","0","0","0","0","0","0","0","0","0","0","0"
"2011","Calgary, Alberta, municipal","48014","Betting house","0","0","0","0","0","0","0","0","0","0","0","0","0","0"
"2012","Calgary, Alberta, municipal","48014","Betting house","0","0","0","0","0","0","0","0","0","0","0","0","0","0"
"2013","Calgary, Alberta, municipal","48014","Betting house","0","0","0","0","0","0","0","0","0","0","0","0","0","0"
"2014","Calgary, Alberta, municipal","48014","Betting house","0","0","0","0","0","0","0","0","0","0","0","0","0","0"
"2015","Calgary, Alberta, municipal","48014","Betting house","1","1","0","0","0.08","0.2","0.18","0","0","1","2","2","0","0"
"2016","Calgary, Alberta, municipal","48014","Betting house","0","0","0","-100","0","0","0","0","0","0","0","0","0","0"
"1998","Calgary, Alberta, municipal","48014","Gaming house","0","0","0","0","0","0","0","0","0","0","0","0","0","0"
"1999","Calgary, Alberta, municipal","48014","Gaming house","0","0","0","0","0","0","0","0","0","0","0","0","0","0"
"2000","Calgary, Alberta, municipal","48014","Gaming house","2","2","0","0","0.23","0","0","0","0","2","18","18","0","0"
"2001","Calgary, Alberta, municipal","48014","Gaming house","4","4","0","95.68","0.44","0","0","0","0","4","7","7","0","0"
"2002","Calgary, Alberta, municipal","48014","Gaming house","0","0","0","-100","0","0","0","0","0","0","0","0","0","0"
"2003","Calgary, Alberta, municipal","48014","Gaming house","0","0","0","0","0","0","0","0","0","0","0","0","0","0"
"2004","Calgary, Alberta, municipal","48014","Gaming house","0","0","0","0","0","0","0","0","0","0","0","0","0","0"
"2005","Calgary, Alberta, municipal","48014","Gaming house","0","0","0","0","0","0","0","0","0","0","0","0","0","0"
"2006","Calgary, Alberta, municipal","48014","Gaming house","0","0","0","0","0","0","0","0","0","0","0","0","0","0"
"2007","Calgary, Alberta, municipal","48014","Gaming house","1","1","0","0","0.09","0.24","0.22","0","0","1","2","2","0","0"
"2008","Calgary, Alberta, municipal","48014","Gaming house","0","0","0","-100","0","0","0","0","0","0","0","0","0","0"
"2009","Calgary, Alberta, municipal","48014","Gaming house","0","0","0","0","0","0","0","0","0","0","0","0","0","0"
"2010","Calgary, Alberta, municipal","48014","Gaming house","0","0","0","0","0","0","0","0","0","0","0","0","0","0"
"2011","Calgary, Alberta, municipal","48014","Gaming house","0","0","0","0","0","0","0","0","0","0","0","0","0","0"
"2012","Calgary, Alberta, municipal","48014","Gaming house","0","0","0","0","0","0","0","0","0","0","0","0","0","0"
"2013","Calgary, Alberta, municipal","48014","Gaming house","1","1","0","0","0.08","0.1","0.1","0","0","1","1","1","0","0"
"2014","Calgary, Alberta, municipal","48014","Gaming house","0","0","0","-100","0","0","0","0","0","0","0","0","0","0"
"2015","Calgary, Alberta, municipal","48014","Gaming house","0","0","0","0","0","0","0","0","0","0","0","0","0","0"
"2016","Calgary, Alberta, municipal","48014","Gaming house","1","0","0","0","0.08","0","0","0","0","0","0","0","0","0"
"1998","Calgary, Alberta, municipal","48014","Other violations related to gaming and betting","33","7","1","0","3.93","0","0","0","0","8","7","7","0","0"
"1999","Calgary, Alberta, municipal","48014","Other violations related to gaming and betting","27","7","0","-20.23","3.13","0","0","0","0","7","21","21","0","0"
"2000","Calgary, Alberta, municipal","48014","Other violations related to gaming and betting","3","3","0","-89.15","0.34","0","0","0","0","3","4","4","0","0"
"2001","Calgary, Alberta, municipal","48014","Other violations related to gaming and betting","5","4","0","63.06","0.55","0","0","0","0","4","6","6","0","0"
"2002","Calgary, Alberta, municipal","48014","Other violations related to gaming and betting","3","3","0","-41.39","0.32","0","0","0","0","3","3","3","0","0"
"2003","Calgary, Alberta, municipal","48014","Other violations related to gaming and betting","3","3","0","-1.56","0.32","0","0","0","0","3","10","10","0","0"
"2004","Calgary, Alberta, municipal","48014","Other violations related to gaming and betting","6","6","0","94.03","0.62","0.8","0.72","0","0","6","6","6","0","0"
"2005","Calgary, Alberta, municipal","48014","Other violations related to gaming and betting","2","2","0","-67.65","0.2","0.26","0.23","0","0","2","2","2","0","0"
"2006","Calgary, Alberta, municipal","48014","Other violations related to gaming and betting","6","6","0","190.87","0.58","0.75","0.68","0","0","6","6","6","0","0"
"2007","Calgary, Alberta, municipal","48014","Other violations related to gaming and betting","7","4","1","13.87","0.66","0.36","0.33","0","0","5","3","3","0","0"
"2008","Calgary, Alberta, municipal","48014","Other violations related to gaming and betting","7","6","1","-2.45","0.65","0.7","0.65","0","0","7","6","6","0","0"
"2009","Calgary, Alberta, municipal","48014","Other violations related to gaming and betting","4","4","0","-44.29","0.36","0.46","0.42","0","0","4","4","4","0","0"
"2010","Calgary, Alberta, municipal","48014","Other violations related to gaming and betting","6","6","0","47.8","0.53","0.68","0.62","0","0","6","6","6","0","0"
"2011","Calgary, Alberta, municipal","48014","Other violations related to gaming and betting","0","0","0","-100","0","0","0","0","0","0","0","0","0","0"
"2012","Calgary, Alberta, municipal","48014","Other violations related to gaming and betting","2","1","0","0","0.17","0.11","0.1","0","0","1","1","1","0","0"
"2013","Calgary, Alberta, municipal","48014","Other violations related to gaming and betting","0","1","0","-100","0","0.1","0.1","0","0","1","1","1","0","0"
"2014","Calgary, Alberta, municipal","48014","Other violations related to gaming and betting","1","1","0","0","0.08","0.1","0.09","0","0","1","1","1","0","0"
"2015","Calgary, Alberta, municipal","48014","Other violations related to gaming and betting","0","0","0","-100","0","0","0","0","0","0","0","0","0","0"
"2016","Calgary, Alberta, municipal","48014","Other violations related to gaming and betting","0","0","0","0","0","0","0","0","0","0","0","0","0","0"
"2012","Calgary, Alberta, municipal","48014","Common Bawdy House","0","0","0","0","0","0","0","0","0","0","0","0","0","0"
"2013","Calgary, Alberta, municipal","48014","Common Bawdy House","0","0","0","0","0","0","0","0","0","0","0","0","0","0"
"2014","Calgary, Alberta, municipal","48014","Common Bawdy House","0","0","0","0","0","0","0","0","0","0","0","0","0","0"
"2015","Calgary, Alberta, municipal","48014","Common Bawdy House","0","0","0","0","0","0","0","0","0","0","0","0","0","0"
"2016","Calgary, Alberta, municipal","48014","Common Bawdy House","0","0","0","0","0","0","0","0","0","0","0","0","0","0"
"1998","Calgary, Alberta, municipal","48014","Indecent acts","123","40","13","0","14.63","0","0","0","0","53","34","38","4","4"
"1999","Calgary, Alberta, municipal","48014","Indecent acts","184","65","12","45.86","21.34","0","0","0","0","77","55","55","0","1"
"2000","Calgary, Alberta, municipal","48014","Indecent acts","158","44","21","-16.12","17.9","0","0","0","0","65","34","39","5","6"
"2001","Calgary, Alberta, municipal","48014","Indecent acts","110","26","12","-31.88","12.19","0","0","0","0","38","27","27","0","4"
"2002","Calgary, Alberta, municipal","48014","Indecent acts","136","52","25","20.78","14.73","0","0","0","0","77","37","41","4","2"
"2003","Calgary, Alberta, municipal","48014","Indecent acts","148","27","22","7.12","15.78","0","0","0","0","49","22","25","3","8"
"2004","Calgary, Alberta, municipal","48014","Indecent acts","190","46","31","24.55","19.65","4.78","4.59","2.64","5.28","77","36","38","2","4"
"2005","Calgary, Alberta, municipal","48014","Indecent acts","196","37","30","0.11","19.67","4.11","3.98","2.6","2.6","67","32","34","2","2"
"2006","Calgary, Alberta, municipal","48014","Indecent acts","128","31","15","-36.68","12.45","3.48","3.4","2.57","1.29","46","28","30","2","1"
"2007","Calgary, Alberta, municipal","48014","Indecent acts","108","27","24","-17.65","10.26","3.02","2.98","2.58","16.77","51","25","27","2","13"
"2008","Calgary, Alberta, municipal","48014","Indecent acts","90","20","11","-18.71","8.34","2.11","2.15","2.59","1.3","31","18","20","2","1"
"2009","Calgary, Alberta, municipal","48014","Indecent acts","135","40","8","46.23","12.19","3.77","3.67","2.58","2.58","48","33","35","2","2"
"2010","Calgary, Alberta, municipal","48014","Indecent acts","186","41","22","35.75","16.55","3.04","2.9","1.28","2.56","63","27","28","1","2"
"2011","Calgary, Alberta, municipal","48014","Indecent acts","109","25","9","-42.32","9.55","2.44","2.75","6.38","0","34","22","27","5","0"
"2012","Calgary, Alberta, municipal","48014","Indecent acts","99","27","11","-11.89","8.41","2.58","2.47","1.27","0","38","24","25","1","0"
"2013","Calgary, Alberta, municipal","48014","Indecent acts","112","28","12","9.17","9.18","3","2.87","1.26","5.05","40","29","30","1","4"
"2014","Calgary, Alberta, municipal","48014","Indecent acts","109","26","9","-5.84","8.65","2.19","2.13","1.26","2.52","35","22","23","1","2"
"2015","Calgary, Alberta, municipal","48014","Indecent acts","114","35","6","2.35","8.85","3.03","2.81","0","0","41","31","31","0","0"
"2016","Calgary, Alberta, municipal","48014","Indecent acts","122","35","8","4.52","9.25","2.86","2.83","2.44","2.44","43","30","32","2","2"
"1998","Calgary, Alberta, municipal","48014","Corrupting morals","3","3","0","0","0.36","0","0","0","0","3","3","3","0","0"
"1999","Calgary, Alberta, municipal","48014","Corrupting morals","1","1","0","-67.5","0.12","0","0","0","0","1","1","1","0","0"
"2000","Calgary, Alberta, municipal","48014","Corrupting morals","4","0","1","290.74","0.45","0","0","0","0","1","0","0","0","0"
"2001","Calgary, Alberta, municipal","48014","Corrupting morals","3","3","0","-26.62","0.33","0","0","0","0","3","1","1","0","0"
"2002","Calgary, Alberta, municipal","48014","Corrupting morals","4","3","1","30.25","0.43","0","0","0","0","4","2","2","0","0"
"2003","Calgary, Alberta, municipal","48014","Corrupting morals","1","0","1","-75.39","0.11","0","0","0","0","1","0","0","0","0"
"2004","Calgary, Alberta, municipal","48014","Corrupting morals","2","1","0","94.03","0.21","0.13","0.12","0","0","1","1","1","0","0"
"2005","Calgary, Alberta, municipal","48014","Corrupting morals","1","0","0","-51.48","0.1","0","0","0","0","0","0","0","0","0"
"2006","Calgary, Alberta, municipal","48014","Corrupting morals","0","0","0","-100","0","0","0","0","0","0","0","0","0","0"
"2007","Calgary, Alberta, municipal","48014","Corrupting morals","0","0","0","0","0","0","0","0","0","0","0","0","0","0"
"2008","Calgary, Alberta, municipal","48014","Corrupting morals","0","0","0","0","0","0","0","0","0","0","0","0","0","0"
"2009","Calgary, Alberta, municipal","48014","Corrupting morals","1","0","1","0","0.09","0","0","0","0","1","0","0","0","0"
"2010","Calgary, Alberta, municipal","48014","Corrupting morals","1","0","0","-1.47","0.09","0","0","0","0","0","0","0","0","0"
"2011","Calgary, Alberta, municipal","48014","Corrupting morals","0","0","0","-100","0","0","0","0","0","0","0","0","0","0"
"2012","Calgary, Alberta, municipal","48014","Corrupting morals","2","0","1","0","0.17","0","0","0","0","1","0","0","0","0"
"2013","Calgary, Alberta, municipal","48014","Corrupting morals","3","0","2","44.74","0.25","0","0","0","0","2","0","0","0","0"
"2014","Calgary, Alberta, municipal","48014","Corrupting morals","2","0","0","-35.5","0.16","0","0","0","0","0","0","0","0","0"
"2015","Calgary, Alberta, municipal","48014","Corrupting morals","0","0","0","-100","0","0","0","0","0","0","0","0","0","0"
"2016","Calgary, Alberta, municipal","48014","Corrupting morals","1","0","1","0","0.08","0","0","0","0","1","0","0","0","0"
"1998","Calgary, Alberta, municipal","48014","Obstruct public or peace officer","437","426","1","0","51.98","0","0","0","0","427","327","372","45","0"
"1999","Calgary, Alberta, municipal","48014","Obstruct public or peace officer","356","353","4","-20.57","41.29","0","0","0","0","357","278","303","25","0"
"2000","Calgary, Alberta, municipal","48014","Obstruct public or peace officer","409","403","4","12.23","46.34","0","0","0","0","407","318","344","26","3"
"2001","Calgary, Alberta, municipal","48014","Obstruct public or peace officer","440","426","8","5.25","48.77","0","0","0","0","434","339","368","29","1"
"2002","Calgary, Alberta, municipal","48014","Obstruct public or peace officer","572","558","9","27","61.94","0","0","0","0","567","426","456","30","1"
"2003","Calgary, Alberta, municipal","48014","Obstruct public or peace officer","620","600","13","6.7","66.09","0","0","0","0","613","448","496","48","2"
"2004","Calgary, Alberta, municipal","48014","Obstruct public or peace officer","588","565","16","-7.99","60.81","59.4","58.67","51.44","5.28","581","447","486","39","4"
"2005","Calgary, Alberta, municipal","48014","Obstruct public or peace officer","599","576","16","-1.14","60.11","60.29","58.48","40.25","2.6","592","469","500","31","2"
"2006","Calgary, Alberta, municipal","48014","Obstruct public or peace officer","586","575","15","-5.15","57.02","57.5","55.38","33.41","3.86","590","463","489","26","3"
"2007","Calgary, Alberta, municipal","48014","Obstruct public or peace officer","408","384","15","-32.05","38.75","38.62","37.63","27.1","2.58","399","320","341","21","2"
"2008","Calgary, Alberta, municipal","48014","Obstruct public or peace officer","321","300","17","-23.25","29.74","27.22","27.87","34.98","7.77","317","232","259","27","6"
"2009","Calgary, Alberta, municipal","48014","Obstruct public or peace officer","354","336","15","7.51","31.97","31.17","31.16","30.95","3.87","351","273","297","24","3"
"2010","Calgary, Alberta, municipal","48014","Obstruct public or peace officer","242","225","15","-32.64","21.54","22.07","21.53","15.39","6.41","240","196","208","12","5"
"2011","Calgary, Alberta, municipal","48014","Obstruct public or peace officer","217","198","17","-11.74","19.01","18.18","18.66","24.25","2.55","215","164","183","19","2"
"2012","Calgary, Alberta, municipal","48014","Obstruct public or peace officer","182","171","11","-18.64","15.47","16.85","16.23","8.89","0","182","157","164","7","0"
"2013","Calgary, Alberta, municipal","48014","Obstruct public or peace officer","177","160","14","-6.15","14.51","14.15","14.04","12.63","2.53","174","137","147","10","2"
"2014","Calgary, Alberta, municipal","48014","Obstruct public or peace officer","148","133","12","-19.1","11.74","11.27","11.09","8.81","0","145","113","120","7","0"
"2015","Calgary, Alberta, municipal","48014","Obstruct public or peace officer","169","157","11","11.75","13.12","13.77","13.22","6.23","0","168","141","146","5","0"
"2016","Calgary, Alberta, municipal","48014","Obstruct public or peace officer","137","122","12","-20.83","10.39","10.88","10.63","7.32","0","134","114","120","6","0"
"1998","Calgary, Alberta, municipal","48014","Trespass at night","23","17","2","0","2.74","0","0","0","0","19","11","11","0","0"
"1999","Calgary, Alberta, municipal","48014","Trespass at night","14","10","4","-40.65","1.62","0","0","0","0","14","7","7","0","0"
"2000","Calgary, Alberta, municipal","48014","Trespass at night","22","16","3","53.5","2.49","0","0","0","0","19","15","15","0","0"
"2001","Calgary, Alberta, municipal","48014","Trespass at night","23","12","3","2.29","2.55","0","0","0","0","15","8","10","2","0"
"2002","Calgary, Alberta, municipal","48014","Trespass at night","25","17","5","6.18","2.71","0","0","0","0","22","10","13","3","3"
"2003","Calgary, Alberta, municipal","48014","Trespass at night","14","7","2","-44.88","1.49","0","0","0","0","9","7","7","0","2"
"2004","Calgary, Alberta, municipal","48014","Trespass at night","20","8","3","38.59","2.07","0.8","0.72","0","2.64","11","6","6","0","2"
"2005","Calgary, Alberta, municipal","48014","Trespass at night","12","5","2","-41.77","1.2","0.64","0.58","0","1.3","7","5","5","0","1"
"2006","Calgary, Alberta, municipal","48014","Trespass at night","18","10","1","45.44","1.75","0.99","1.02","1.29","0","11","8","9","1","0"
"2007","Calgary, Alberta, municipal","48014","Trespass at night","9","0","3","-51.2","0.85","0","0","0","2.58","3","0","0","0","2"
"2008","Calgary, Alberta, municipal","48014","Trespass at night","8","5","0","-13.29","0.74","0.47","0.43","0","0","5","4","4","0","0"
"2009","Calgary, Alberta, municipal","48014","Trespass at night","15","10","2","82.79","1.35","0.8","0.94","2.58","0","12","7","9","2","0"
"2010","Calgary, Alberta, municipal","48014","Trespass at night","10","8","1","-34.31","0.89","0.56","0.83","3.85","2.56","9","5","8","3","2"
"2011","Calgary, Alberta, municipal","48014","Trespass at night","7","4","0","-31.1","0.61","0.44","0.41","0","0","4","4","4","0","0"
"2012","Calgary, Alberta, municipal","48014","Trespass at night","11","8","0","52.45","0.93","0.54","0.69","2.54","0","8","5","7","2","0"
"2013","Calgary, Alberta, municipal","48014","Trespass at night","12","11","0","5.27","0.98","0.83","0.76","0","0","11","8","8","0","0"
"2014","Calgary, Alberta, municipal","48014","Trespass at night","16","13","0","29","1.27","0.5","0.74","3.78","0","13","5","8","3","0"
"2015","Calgary, Alberta, municipal","48014","Trespass at night","10","7","0","-38.83","0.78","0.59","0.54","0","0","7","6","6","0","0"
"2016","Calgary, Alberta, municipal","48014","Trespass at night","5","4","0","-51.17","0.38","0.1","0.09","0","0","4","1","1","0","0"
"2005","Calgary, Alberta, municipal","48014","Utter threats to property or animal","2","0","0","0","0.2","0","0","0","0","0","0","0","0","0"
"2006","Calgary, Alberta, municipal","48014","Utter threats to property or animal","1","1","0","-51.52","0.1","0.12","0.23","1.29","0","1","1","2","1","0"
"2007","Calgary, Alberta, municipal","48014","Utter threats to property or animal","5","2","1","388","0.47","0.24","0.22","0","0","3","2","2","0","0"
"2008","Calgary, Alberta, municipal","48014","Utter threats to property or animal","21","6","4","309.72","1.95","0.47","0.54","1.3","1.3","10","4","5","1","1"
"2009","Calgary, Alberta, municipal","48014","Utter threats to property or animal","19","5","5","-11.8","1.72","0.46","0.42","0","0","10","4","4","0","0"
"2010","Calgary, Alberta, municipal","48014","Utter threats to property or animal","27","2","13","40.02","2.4","0.11","0.21","1.28","1.28","15","1","2","1","1"
"2011","Calgary, Alberta, municipal","48014","Utter threats to property or animal","20","2","7","-27.09","1.75","0.11","0.1","0","0","9","1","1","0","0"
"2012","Calgary, Alberta, municipal","48014","Utter threats to property or animal","27","1","9","30.96","2.29","0.11","0.1","0","1.27","10","1","1","0","1"
"2013","Calgary, Alberta, municipal","48014","Utter threats to property or animal","26","3","4","-7.08","2.13","0.31","0.29","0","2.53","7","3","3","0","2"
"2014","Calgary, Alberta, municipal","48014","Utter threats to property or animal","37","2","10","37.68","2.94","0.2","0.18","0","1.26","12","2","2","0","1"
"2015","Calgary, Alberta, municipal","48014","Utter threats to property or animal","44","3","9","16.38","3.42","0.29","0.27","0","1.25","12","3","3","0","1"
"2016","Calgary, Alberta, municipal","48014","Utter threats to property or animal","40","3","10","-11.22","3.03","0.1","0.09","0","3.66","13","1","1","0","3"
"2005","Calgary, Alberta, municipal","48014","Advocating genocide","0","0","0","0","0","0","0","0","0","0","0","0","0","0"
"2006","Calgary, Alberta, municipal","48014","Advocating genocide","0","0","0","0","0","0","0","0","0","0","0","0","0","0"
"2007","Calgary, Alberta, municipal","48014","Advocating genocide","0","0","0","0","0","0","0","0","0","0","0","0","0","0"
"2008","Calgary, Alberta, municipal","48014","Advocating genocide","0","0","0","0","0","0","0","0","0","0","0","0","0","0"
"2009","Calgary, Alberta, municipal","48014","Advocating genocide","0","0","0","0","0","0","0","0","0","0","0","0","0","0"
"2010","Calgary, Alberta, municipal","48014","Advocating genocide","0","0","0","0","0","0","0","0","0","0","0","0","0","0"
"2011","Calgary, Alberta, municipal","48014","Advocating genocide","0","0","0","0","0","0","0","0","0","0","0","0","0","0"
"2012","Calgary, Alberta, municipal","48014","Advocating genocide","1","0","0","0","0.08","0","0","0","0","0","0","0","0","0"
"2013","Calgary, Alberta, municipal","48014","Advocating genocide","0","0","0","-100","0","0","0","0","0","0","0","0","0","0"
"2014","Calgary, Alberta, municipal","48014","Advocating genocide","0","0","0","0","0","0","0","0","0","0","0","0","0","0"
"2015","Calgary, Alberta, municipal","48014","Advocating genocide","0","0","0","0","0","0","0","0","0","0","0","0","0","0"
"2016","Calgary, Alberta, municipal","48014","Advocating genocide","0","0","0","0","0","0","0","0","0","0","0","0","0","0"
"2005","Calgary, Alberta, municipal","48014","Public incitement of hatred","0","0","0","0","0","0","0","0","0","0","0","0","0","0"
"2006","Calgary, Alberta, municipal","48014","Public incitement of hatred","1","1","0","0","0.1","0.12","0.11","0","0","1","1","1","0","0"
"2007","Calgary, Alberta, municipal","48014","Public incitement of hatred","0","0","0","-100","0","0","0","0","0","0","0","0","0","0"
"2008","Calgary, Alberta, municipal","48014","Public incitement of hatred","1","1","0","0","0.09","0.12","0.11","0","0","1","1","1","0","0"
"2009","Calgary, Alberta, municipal","48014","Public incitement of hatred","2","0","0","94.98","0.18","0","0","0","0","0","0","0","0","0"
"2010","Calgary, Alberta, municipal","48014","Public incitement of hatred","0","0","0","-100","0","0","0","0","0","0","0","0","0","0"
"2011","Calgary, Alberta, municipal","48014","Public incitement of hatred","0","0","0","0","0","0","0","0","0","0","0","0","0","0"
"2012","Calgary, Alberta, municipal","48014","Public incitement of hatred","2","0","0","0","0.17","0","0","0","0","0","0","0","0","0"
"2013","Calgary, Alberta, municipal","48014","Public incitement of hatred","0","0","0","-100","0","0","0","0","0","0","0","0","0","0"
"2014","Calgary, Alberta, municipal","48014","Public incitement of hatred","6","6","0","0","0.48","0.4","0.37","0","0","6","4","4","0","0"
"2015","Calgary, Alberta, municipal","48014","Public incitement of hatred","2","0","0","-67.38","0.16","0","0","0","0","0","0","0","0","0"
"2016","Calgary, Alberta, municipal","48014","Public incitement of hatred","0","0","0","-100","0","0","0","0","0","0","0","0","0","0"
"2005","Calgary, Alberta, municipal","48014","Unauthorized recording of a movie","0","0","0","0","0","0","0","0","0","0","0","0","0","0"
"2006","Calgary, Alberta, municipal","48014","Unauthorized recording of a movie","0","0","0","0","0","0","0","0","0","0","0","0","0","0"
"2007","Calgary, Alberta, municipal","48014","Unauthorized recording of a movie","1","1","0","0","0.09","0.12","0.11","0","0","1","1","1","0","0"
"2008","Calgary, Alberta, municipal","48014","Unauthorized recording of a movie","0","0","0","-100","0","0","0","0","0","0","0","0","0","0"
"2009","Calgary, Alberta, municipal","48014","Unauthorized recording of a movie","0","0","0","0","0","0","0","0","0","0","0","0","0","0"
"2010","Calgary, Alberta, municipal","48014","Unauthorized recording of a movie","0","0","0","0","0","0","0","0","0","0","0","0","0","0"
"2011","Calgary, Alberta, municipal","48014","Unauthorized recording of a movie","0","0","0","0","0","0","0","0","0","0","0","0","0","0"
"2012","Calgary, Alberta, municipal","48014","Unauthorized recording of a movie","0","0","0","0","0","0","0","0","0","0","0","0","0","0"
"2013","Calgary, Alberta, municipal","48014","Unauthorized recording of a movie","0","0","0","0","0","0","0","0","0","0","0","0","0","0"
"2014","Calgary, Alberta, municipal","48014","Unauthorized recording of a movie","1","1","0","0","0.08","0.1","0.09","0","0","1","1","1","0","0"
"2015","Calgary, Alberta, municipal","48014","Unauthorized recording of a movie","0","0","0","-100","0","0","0","0","0","0","0","0","0","0"
"2016","Calgary, Alberta, municipal","48014","Unauthorized recording of a movie","0","0","0","0","0","0","0","0","0","0","0","0","0","0"
"1998","Calgary, Alberta, municipal","48014","Offences against public order (Part II Criminal Code)","12","10","1","0","1.43","0","0","0","0","11","11","11","0","1"
"1999","Calgary, Alberta, municipal","48014","Offences against public order (Part II Criminal Code)","13","11","2","5.63","1.51","0","0","0","0","13","7","9","2","0"
"2000","Calgary, Alberta, municipal","48014","Offences against public order (Part II Criminal Code)","10","8","2","-24.86","1.13","0","0","0","0","10","8","8","0","0"
"2001","Calgary, Alberta, municipal","48014","Offences against public order (Part II Criminal Code)","6","3","0","-41.3","0.67","0","0","0","0","3","3","4","1","0"
"2002","Calgary, Alberta, municipal","48014","Offences against public order (Part II Criminal Code)","12","11","0","95.38","1.3","0","0","0","0","11","11","11","0","0"
"2003","Calgary, Alberta, municipal","48014","Offences against public order (Part II Criminal Code)","5","5","0","-58.98","0.53","0","0","0","0","5","3","5","2","0"
"2004","Calgary, Alberta, municipal","48014","Offences against public order (Part II Criminal Code)","7","4","1","35.82","0.72","0.4","0.36","0","0","5","3","3","0","0"
"2005","Calgary, Alberta, municipal","48014","Offences against public order (Part II Criminal Code)","10","10","0","38.64","1","1.29","1.29","1.3","0","10","10","11","1","0"
"2006","Calgary, Alberta, municipal","48014","Offences against public order (Part II Criminal Code)","9","5","1","-12.74","0.88","0.37","0.45","1.29","0","6","3","4","1","0"
"2007","Calgary, Alberta, municipal","48014","Offences against public order (Part II Criminal Code)","8","6","2","-13.24","0.76","0.72","0.77","1.29","0","8","6","7","1","0"
"2008","Calgary, Alberta, municipal","48014","Offences against public order (Part II Criminal Code)","13","11","0","58.52","1.2","1.29","1.18","0","0","11","11","11","0","0"
"2009","Calgary, Alberta, municipal","48014","Offences against public order (Part II Criminal Code)","21","18","1","57.48","1.9","1.94","1.99","2.58","0","19","17","19","2","0"
"2010","Calgary, Alberta, municipal","48014","Offences against public order (Part II Criminal Code)","20","16","2","-6.16","1.78","1.8","1.76","1.28","0","18","16","17","1","0"
"2011","Calgary, Alberta, municipal","48014","Offences against public order (Part II Criminal Code)","19","18","1","-6.49","1.66","1.66","2.04","6.38","0","19","15","20","5","0"
"2012","Calgary, Alberta, municipal","48014","Offences against public order (Part II Criminal Code)","21","19","1","7.22","1.78","1.82","1.78","1.27","0","20","17","18","1","0"
"2013","Calgary, Alberta, municipal","48014","Offences against public order (Part II Criminal Code)","17","14","2","-21.88","1.39","1.45","1.43","1.26","0","16","14","15","1","0"
"2014","Calgary, Alberta, municipal","48014","Offences against public order (Part II Criminal Code)","15","12","1","-14.64","1.19","1.1","1.02","0","1.26","13","11","11","0","1"
"2015","Calgary, Alberta, municipal","48014","Offences against public order (Part II Criminal Code)","13","11","0","-15.18","1.01","1.07","1","0","0","11","11","11","0","0"
"2016","Calgary, Alberta, municipal","48014","Offences against public order (Part II Criminal Code)","13","12","0","-2.34","0.99","0.95","1.15","3.66","0","12","10","13","3","0"
"2002","Calgary, Alberta, municipal","48014","Property or service for terrorist activity","0","0","0","0","0","0","0","0","0","0","0","0","0","0"
"2003","Calgary, Alberta, municipal","48014","Property or service for terrorist activity","0","0","0","0","0","0","0","0","0","0","0","0","0","0"
"2004","Calgary, Alberta, municipal","48014","Property or service for terrorist activity","0","0","0","0","0","0","0","0","0","0","0","0","0","0"
"2005","Calgary, Alberta, municipal","48014","Property or service for terrorist activity","0","0","0","0","0","0","0","0","0","0","0","0","0","0"
"2006","Calgary, Alberta, municipal","48014","Property or service for terrorist activity","0","0","0","0","0","0","0","0","0","0","0","0","0","0"
"2007","Calgary, Alberta, municipal","48014","Property or service for terrorist activity","0","0","0","0","0","0","0","0","0","0","0","0","0","0"
"2008","Calgary, Alberta, municipal","48014","Property or service for terrorist activity","2","0","0","0","0.19","0","0","0","0","0","0","0","0","0"
"2009","Calgary, Alberta, municipal","48014","Property or service for terrorist activity","1","0","0","-51.26","0.09","0","0","0","0","0","0","0","0","0"
"2010","Calgary, Alberta, municipal","48014","Property or service for terrorist activity","0","0","0","-100","0","0","0","0","0","0","0","0","0","0"
"2011","Calgary, Alberta, municipal","48014","Property or service for terrorist activity","3","0","0","0","0.26","0","0","0","0","0","0","0","0","0"
"2012","Calgary, Alberta, municipal","48014","Property or service for terrorist activity","2","1","0","-35.33","0.17","0.11","0.1","0","0","1","1","1","0","0"
"2013","Calgary, Alberta, municipal","48014","Property or service for terrorist activity","3","0","0","44.74","0.25","0","0","0","0","0","0","0","0","0"
"2014","Calgary, Alberta, municipal","48014","Property or service for terrorist activity","0","0","0","-100","0","0","0","0","0","0","0","0","0","0"
"2015","Calgary, Alberta, municipal","48014","Property or service for terrorist activity","1","0","0","0","0.08","0","0","0","0","0","0","0","0","0"
"2016","Calgary, Alberta, municipal","48014","Property or service for terrorist activity","0","0","0","-100","0","0","0","0","0","0","0","0","0","0"
"2002","Calgary, Alberta, municipal","48014","Freezing of property, disclosure or audit","0","0","0","0","0","0","0","0","0","0","0","0","0","0"
"2003","Calgary, Alberta, municipal","48014","Freezing of property, disclosure or audit","0","0","0","0","0","0","0","0","0","0","0","0","0","0"
"2004","Calgary, Alberta, municipal","48014","Freezing of property, disclosure or audit","0","0","0","0","0","0","0","0","0","0","0","0","0","0"
"2005","Calgary, Alberta, municipal","48014","Freezing of property, disclosure or audit","0","0","0","0","0","0","0","0","0","0","0","0","0","0"
"2006","Calgary, Alberta, municipal","48014","Freezing of property, disclosure or audit","0","0","0","0","0","0","0","0","0","0","0","0","0","0"
"2007","Calgary, Alberta, municipal","48014","Freezing of property, disclosure or audit","0","0","0","0","0","0","0","0","0","0","0","0","0","0"
"2008","Calgary, Alberta, municipal","48014","Freezing of property, disclosure or audit","0","0","0","0","0","0","0","0","0","0","0","0","0","0"
"2009","Calgary, Alberta, municipal","48014","Freezing of property, disclosure or audit","0","0","0","0","0","0","0","0","0","0","0","0","0","0"
"2010","Calgary, Alberta, municipal","48014","Freezing of property, disclosure or audit","0","0","0","0","0","0","0","0","0","0","0","0","0","0"
"2011","Calgary, Alberta, municipal","48014","Freezing of property, disclosure or audit","0","0","0","0","0","0","0","0","0","0","0","0","0","0"
"2012","Calgary, Alberta, municipal","48014","Freezing of property, disclosure or audit","0","0","0","0","0","0","0","0","0","0","0","0","0","0"
"2013","Calgary, Alberta, municipal","48014","Freezing of property, disclosure or audit","0","0","0","0","0","0","0","0","0","0","0","0","0","0"
"2014","Calgary, Alberta, municipal","48014","Freezing of property, disclosure or audit","0","0","0","0","0","0","0","0","0","0","0","0","0","0"
"2015","Calgary, Alberta, municipal","48014","Freezing of property, disclosure or audit","0","0","0","0","0","0","0","0","0","0","0","0","0","0"
"2016","Calgary, Alberta, municipal","48014","Freezing of property, disclosure or audit","0","0","0","0","0","0","0","0","0","0","0","0","0","0"
"2002","Calgary, Alberta, municipal","48014","Participate in activity of terrorist group","0","0","0","0","0","0","0","0","0","0","0","0","0","0"
"2003","Calgary, Alberta, municipal","48014","Participate in activity of terrorist group","0","0","0","0","0","0","0","0","0","0","0","0","0","0"
"2004","Calgary, Alberta, municipal","48014","Participate in activity of terrorist group","0","0","0","0","0","0","0","0","0","0","0","0","0","0"
"2005","Calgary, Alberta, municipal","48014","Participate in activity of terrorist group","0","0","0","0","0","0","0","0","0","0","0","0","0","0"
"2006","Calgary, Alberta, municipal","48014","Participate in activity of terrorist group","0","0","0","0","0","0","0","0","0","0","0","0","0","0"
"2007","Calgary, Alberta, municipal","48014","Participate in activity of terrorist group","1","0","0","0","0.09","0","0","0","0","0","0","0","0","0"
"2008","Calgary, Alberta, municipal","48014","Participate in activity of terrorist group","1","0","0","-2.45","0.09","0","0","0","0","0","0","0","0","0"
"2009","Calgary, Alberta, municipal","48014","Participate in activity of terrorist group","2","0","0","94.98","0.18","0","0","0","0","0","0","0","0","0"
"2010","Calgary, Alberta, municipal","48014","Participate in activity of terrorist group","4","0","0","97.06","0.36","0","0","0","0","0","0","0","0","0"
"2011","Calgary, Alberta, municipal","48014","Participate in activity of terrorist group","1","0","0","-75.39","0.09","0","0","0","0","0","0","0","0","0"
"2012","Calgary, Alberta, municipal","48014","Participate in activity of terrorist group","2","0","0","94.02","0.17","0","0","0","0","0","0","0","0","0"
"2013","Calgary, Alberta, municipal","48014","Participate in activity of terrorist group","4","0","0","92.99","0.33","0","0","0","0","0","0","0","0","0"
"2014","Calgary, Alberta, municipal","48014","Participate in activity of terrorist group","1","0","0","-75.81","0.08","0","0","0","0","0","0","0","0","0"
"2015","Calgary, Alberta, municipal","48014","Participate in activity of terrorist group","1","0","0","-2.13","0.08","0","0","0","0","0","0","0","0","0"
"2016","Calgary, Alberta, municipal","48014","Participate in activity of terrorist group","0","0","0","-100","0","0","0","0","0","0","0","0","0","0"
"2002","Calgary, Alberta, municipal","48014","Facilitate terrorist activity","0","0","0","0","0","0","0","0","0","0","0","0","0","0"
"2003","Calgary, Alberta, municipal","48014","Facilitate terrorist activity","0","0","0","0","0","0","0","0","0","0","0","0","0","0"
"2004","Calgary, Alberta, municipal","48014","Facilitate terrorist activity","0","0","0","0","0","0","0","0","0","0","0","0","0","0"
"2005","Calgary, Alberta, municipal","48014","Facilitate terrorist activity","0","0","0","0","0","0","0","0","0","0","0","0","0","0"
"2006","Calgary, Alberta, municipal","48014","Facilitate terrorist activity","0","0","0","0","0","0","0","0","0","0","0","0","0","0"
"2007","Calgary, Alberta, municipal","48014","Facilitate terrorist activity","0","0","0","0","0","0","0","0","0","0","0","0","0","0"
"2008","Calgary, Alberta, municipal","48014","Facilitate terrorist activity","1","0","0","0","0.09","0","0","0","0","0","0","0","0","0"
"2009","Calgary, Alberta, municipal","48014","Facilitate terrorist activity","0","0","0","-100","0","0","0","0","0","0","0","0","0","0"
"2010","Calgary, Alberta, municipal","48014","Facilitate terrorist activity","0","0","0","0","0","0","0","0","0","0","0","0","0","0"
"2011","Calgary, Alberta, municipal","48014","Facilitate terrorist activity","1","0","0","0","0.09","0","0","0","0","0","0","0","0","0"
"2012","Calgary, Alberta, municipal","48014","Facilitate terrorist activity","1","0","0","-2.99","0.08","0","0","0","0","0","0","0","0","0"
"2013","Calgary, Alberta, municipal","48014","Facilitate terrorist activity","0","0","0","-100","0","0","0","0","0","0","0","0","0","0"
"2014","Calgary, Alberta, municipal","48014","Facilitate terrorist activity","0","0","0","0","0","0","0","0","0","0","0","0","0","0"
"2015","Calgary, Alberta, municipal","48014","Facilitate terrorist activity","2","0","0","0","0.16","0","0","0","0","0","0","0","0","0"
"2016","Calgary, Alberta, municipal","48014","Facilitate terrorist activity","0","0","0","-100","0","0","0","0","0","0","0","0","0","0"
"2002","Calgary, Alberta, municipal","48014","Commission or instructing to carry out terrorist activity","0","0","0","0","0","0","0","0","0","0","0","0","0","0"
"2003","Calgary, Alberta, municipal","48014","Commission or instructing to carry out terrorist activity","0","0","0","0","0","0","0","0","0","0","0","0","0","0"
"2004","Calgary, Alberta, municipal","48014","Commission or instructing to carry out terrorist activity","0","0","0","0","0","0","0","0","0","0","0","0","0","0"
"2005","Calgary, Alberta, municipal","48014","Commission or instructing to carry out terrorist activity","0","0","0","0","0","0","0","0","0","0","0","0","0","0"
"2006","Calgary, Alberta, municipal","48014","Commission or instructing to carry out terrorist activity","0","0","0","0","0","0","0","0","0","0","0","0","0","0"
"2007","Calgary, Alberta, municipal","48014","Commission or instructing to carry out terrorist activity","0","0","0","0","0","0","0","0","0","0","0","0","0","0"
"2008","Calgary, Alberta, municipal","48014","Commission or instructing to carry out terrorist activity","0","0","0","0","0","0","0","0","0","0","0","0","0","0"
"2009","Calgary, Alberta, municipal","48014","Commission or instructing to carry out terrorist activity","1","0","0","0","0.09","0","0","0","0","0","0","0","0","0"
"2010","Calgary, Alberta, municipal","48014","Commission or instructing to carry out terrorist activity","0","0","0","-100","0","0","0","0","0","0","0","0","0","0"
"2011","Calgary, Alberta, municipal","48014","Commission or instructing to carry out terrorist activity","0","0","0","0","0","0","0","0","0","0","0","0","0","0"
"2012","Calgary, Alberta, municipal","48014","Commission or instructing to carry out terrorist activity","0","0","0","0","0","0","0","0","0","0","0","0","0","0"
"2013","Calgary, Alberta, municipal","48014","Commission or instructing to carry out terrorist activity","0","0","0","0","0","0","0","0","0","0","0","0","0","0"
"2014","Calgary, Alberta, municipal","48014","Commission or instructing to carry out terrorist activity","1","0","0","0","0.08","0","0","0","0","0","0","0","0","0"
"2015","Calgary, Alberta, municipal","48014","Commission or instructing to carry out terrorist activity","0","1","0","-100","0","0.1","0.09","0","0","1","1","1","0","0"
"2016","Calgary, Alberta, municipal","48014","Commission or instructing to carry out terrorist activity","0","0","0","0","0","0","0","0","0","0","0","0","0","0"
"2002","Calgary, Alberta, municipal","48014","Harbour or conceal terrorist","0","0","0","0","0","0","0","0","0","0","0","0","0","0"
"2003","Calgary, Alberta, municipal","48014","Harbour or conceal terrorist","0","0","0","0","0","0","0","0","0","0","0","0","0","0"
"2004","Calgary, Alberta, municipal","48014","Harbour or conceal terrorist","0","0","0","0","0","0","0","0","0","0","0","0","0","0"
"2005","Calgary, Alberta, municipal","48014","Harbour or conceal terrorist","0","0","0","0","0","0","0","0","0","0","0","0","0","0"
"2006","Calgary, Alberta, municipal","48014","Harbour or conceal terrorist","0","0","0","0","0","0","0","0","0","0","0","0","0","0"
"2007","Calgary, Alberta, municipal","48014","Harbour or conceal terrorist","0","0","0","0","0","0","0","0","0","0","0","0","0","0"
"2008","Calgary, Alberta, municipal","48014","Harbour or conceal terrorist","0","0","0","0","0","0","0","0","0","0","0","0","0","0"
"2009","Calgary, Alberta, municipal","48014","Harbour or conceal terrorist","0","0","0","0","0","0","0","0","0","0","0","0","0","0"
"2010","Calgary, Alberta, municipal","48014","Harbour or conceal terrorist","0","0","0","0","0","0","0","0","0","0","0","0","0","0"
"2011","Calgary, Alberta, municipal","48014","Harbour or conceal terrorist","0","0","0","0","0","0","0","0","0","0","0","0","0","0"
"2012","Calgary, Alberta, municipal","48014","Harbour or conceal terrorist","0","0","0","0","0","0","0","0","0","0","0","0","0","0"
"2013","Calgary, Alberta, municipal","48014","Harbour or conceal terrorist","0","0","0","0","0","0","0","0","0","0","0","0","0","0"
"2014","Calgary, Alberta, municipal","48014","Harbour or conceal terrorist","0","0","0","0","0","0","0","0","0","0","0","0","0","0"
"2015","Calgary, Alberta, municipal","48014","Harbour or conceal terrorist","0","0","0","0","0","0","0","0","0","0","0","0","0","0"
"2016","Calgary, Alberta, municipal","48014","Harbour or conceal terrorist","0","0","0","0","0","0","0","0","0","0","0","0","0","0"
"2005","Calgary, Alberta, municipal","48014","Hoax terrorism","0","0","0","0","0","0","0","0","0","0","0","0","0","0"
"2006","Calgary, Alberta, municipal","48014","Hoax terrorism","0","0","0","0","0","0","0","0","0","0","0","0","0","0"
"2007","Calgary, Alberta, municipal","48014","Hoax terrorism","0","0","0","0","0","0","0","0","0","0","0","0","0","0"
"2008","Calgary, Alberta, municipal","48014","Hoax terrorism","1","0","0","0","0.09","0","0","0","0","0","0","0","0","0"
"2009","Calgary, Alberta, municipal","48014","Hoax terrorism","2","0","0","94.98","0.18","0","0","0","0","0","0","0","0","0"
"2010","Calgary, Alberta, municipal","48014","Hoax terrorism","0","0","0","-100","0","0","0","0","0","0","0","0","0","0"
"2011","Calgary, Alberta, municipal","48014","Hoax terrorism","0","0","0","0","0","0","0","0","0","0","0","0","0","0"
"2012","Calgary, Alberta, municipal","48014","Hoax terrorism","0","0","0","0","0","0","0","0","0","0","0","0","0","0"
"2013","Calgary, Alberta, municipal","48014","Hoax terrorism","0","0","0","0","0","0","0","0","0","0","0","0","0","0"
"2014","Calgary, Alberta, municipal","48014","Hoax terrorism","0","0","0","0","0","0","0","0","0","0","0","0","0","0"
"2015","Calgary, Alberta, municipal","48014","Hoax terrorism","0","0","0","0","0","0","0","0","0","0","0","0","0","0"
"2016","Calgary, Alberta, municipal","48014","Hoax terrorism","0","0","0","0","0","0","0","0","0","0","0","0","0","0"
"2012","Calgary, Alberta, municipal","48014","Advocating/Promoting terrorism offence","0","0","0","0","0","0","0","0","0","0","0","0","0","0"
"2013","Calgary, Alberta, municipal","48014","Advocating/Promoting terrorism offence","0","0","0","0","0","0","0","0","0","0","0","0","0","0"
"2014","Calgary, Alberta, municipal","48014","Advocating/Promoting terrorism offence","0","0","0","0","0","0","0","0","0","0","0","0","0","0"
"2015","Calgary, Alberta, municipal","48014","Advocating/Promoting terrorism offence","0","0","0","0","0","0","0","0","0","0","0","0","0","0"
"2016","Calgary, Alberta, municipal","48014","Advocating/Promoting terrorism offence","0","0","0","0","0","0","0","0","0","0","0","0","0","0"
"1998","Calgary, Alberta, municipal","48014","Firearms and other offensive weapons (Part III Criminal Code)","0","0","0","0","0","0","0","0","0","0","0","0","0","0"
"1999","Calgary, Alberta, municipal","48014","Firearms and other offensive weapons (Part III Criminal Code)","1","1","0","0","0.12","0","0","0","0","1","0","0","0","0"
"2000","Calgary, Alberta, municipal","48014","Firearms and other offensive weapons (Part III Criminal Code)","1","1","0","-2.32","0.11","0","0","0","0","1","0","1","1","0"
"2001","Calgary, Alberta, municipal","48014","Firearms and other offensive weapons (Part III Criminal Code)","6","4","1","487.03","0.67","0","0","0","0","5","5","5","0","1"
"2002","Calgary, Alberta, municipal","48014","Firearms and other offensive weapons (Part III Criminal Code)","18","18","0","193.07","1.95","0","0","0","0","18","19","21","2","0"
"2003","Calgary, Alberta, municipal","48014","Firearms and other offensive weapons (Part III Criminal Code)","5","5","0","-72.66","0.53","0","0","0","0","5","5","5","0","0"
"2004","Calgary, Alberta, municipal","48014","Firearms and other offensive weapons (Part III Criminal Code)","2","2","0","-61.19","0.21","0.27","0.24","0","0","2","2","2","0","0"
"2005","Calgary, Alberta, municipal","48014","Firearms and other offensive weapons (Part III Criminal Code)","1","1","0","-51.48","0.1","0.13","0.12","0","0","1","1","1","0","0"
"2006","Calgary, Alberta, municipal","48014","Firearms and other offensive weapons (Part III Criminal Code)","4","2","2","287.83","0.39","0.12","0.11","0","0","4","1","1","0","0"
"2007","Calgary, Alberta, municipal","48014","Firearms and other offensive weapons (Part III Criminal Code)","3","1","1","-26.8","0.28","0.12","0.11","0","0","2","1","1","0","0"
"2008","Calgary, Alberta, municipal","48014","Firearms and other offensive weapons (Part III Criminal Code)","3","1","2","-2.45","0.28","0.12","0.11","0","0","3","1","1","0","0"
"2009","Calgary, Alberta, municipal","48014","Firearms and other offensive weapons (Part III Criminal Code)","2","1","1","-35.01","0.18","0.11","0.1","0","0","2","1","1","0","0"
"2010","Calgary, Alberta, municipal","48014","Firearms and other offensive weapons (Part III Criminal Code)","1","0","1","-50.73","0.09","0","0","0","0","1","0","0","0","0"
"2011","Calgary, Alberta, municipal","48014","Firearms and other offensive weapons (Part III Criminal Code)","2","2","0","96.87","0.18","0.22","0.2","0","0","2","2","2","0","0"
"2012","Calgary, Alberta, municipal","48014","Firearms and other offensive weapons (Part III Criminal Code)","2","1","0","-2.99","0.17","0.11","0.1","0","0","1","1","1","0","0"
"2013","Calgary, Alberta, municipal","48014","Firearms and other offensive weapons (Part III Criminal Code)","4","3","1","92.99","0.33","0.31","0.29","0","0","4","3","3","0","0"
"2014","Calgary, Alberta, municipal","48014","Firearms and other offensive weapons (Part III Criminal Code)","0","0","0","-100","0","0","0","0","0","0","0","0","0","0"
"2015","Calgary, Alberta, municipal","48014","Firearms and other offensive weapons (Part III Criminal Code)","0","0","0","0","0","0","0","0","0","0","0","0","0","0"
"2016","Calgary, Alberta, municipal","48014","Firearms and other offensive weapons (Part III Criminal Code)","4","3","1","0","0.3","0.29","0.27","0","0","4","3","3","0","0"
"2012","Calgary, Alberta, municipal","48014","Leaving Canada to participate in activity of terrorist group","0","0","0","0","0","0","0","0","0","0","0","0","0","0"
"2013","Calgary, Alberta, municipal","48014","Leaving Canada to participate in activity of terrorist group","0","0","0","0","0","0","0","0","0","0","0","0","0","0"
"2014","Calgary, Alberta, municipal","48014","Leaving Canada to participate in activity of terrorist group","0","0","0","0","0","0","0","0","0","0","0","0","0","0"
"2015","Calgary, Alberta, municipal","48014","Leaving Canada to participate in activity of terrorist group","3","0","1","0","0.23","0","0","0","0","1","0","0","0","0"
"2016","Calgary, Alberta, municipal","48014","Leaving Canada to participate in activity of terrorist group","0","0","0","-100","0","0","0","0","0","0","0","0","0","0"
"2012","Calgary, Alberta, municipal","48014","Leaving Canada to facilitate terrorist activity","0","0","0","0","0","0","0","0","0","0","0","0","0","0"
"2013","Calgary, Alberta, municipal","48014","Leaving Canada to facilitate terrorist activity","0","0","0","0","0","0","0","0","0","0","0","0","0","0"
"2014","Calgary, Alberta, municipal","48014","Leaving Canada to facilitate terrorist activity","0","0","0","0","0","0","0","0","0","0","0","0","0","0"
"2015","Calgary, Alberta, municipal","48014","Leaving Canada to facilitate terrorist activity","0","0","0","0","0","0","0","0","0","0","0","0","0","0"
"2016","Calgary, Alberta, municipal","48014","Leaving Canada to facilitate terrorist activity","0","0","0","0","0","0","0","0","0","0","0","0","0","0"
"2012","Calgary, Alberta, municipal","48014","Leaving Canada to commit offence for terrorist group","0","0","0","0","0","0","0","0","0","0","0","0","0","0"
"2013","Calgary, Alberta, municipal","48014","Leaving Canada to commit offence for terrorist group","0","0","0","0","0","0","0","0","0","0","0","0","0","0"
"2014","Calgary, Alberta, municipal","48014","Leaving Canada to commit offence for terrorist group","0","0","0","0","0","0","0","0","0","0","0","0","0","0"
"2015","Calgary, Alberta, municipal","48014","Leaving Canada to commit offence for terrorist group","0","0","0","0","0","0","0","0","0","0","0","0","0","0"
"2016","Calgary, Alberta, municipal","48014","Leaving Canada to commit offence for terrorist group","0","0","0","0","0","0","0","0","0","0","0","0","0","0"
"2012","Calgary, Alberta, municipal","48014","Leaving Canada to commit offence that is terrorist activity","0","0","0","0","0","0","0","0","0","0","0","0","0","0"
"2013","Calgary, Alberta, municipal","48014","Leaving Canada to commit offence that is terrorist activity","0","0","0","0","0","0","0","0","0","0","0","0","0","0"
"2014","Calgary, Alberta, municipal","48014","Leaving Canada to commit offence that is terrorist activity","0","0","0","0","0","0","0","0","0","0","0","0","0","0"
"2015","Calgary, Alberta, municipal","48014","Leaving Canada to commit offence that is terrorist activity","0","0","0","0","0","0","0","0","0","0","0","0","0","0"
"2016","Calgary, Alberta, municipal","48014","Leaving Canada to commit offence that is terrorist activity","0","0","0","0","0","0","0","0","0","0","0","0","0","0"
"2012","Calgary, Alberta, municipal","48014","Concealing person who carried out terrorist activity that is a terrorism offence for which that person is liable to imprisonment for life","0","0","0","0","0","0","0","0","0","0","0","0","0","0"
"2013","Calgary, Alberta, municipal","48014","Concealing person who carried out terrorist activity that is a terrorism offence for which that person is liable to imprisonment for life","0","0","0","0","0","0","0","0","0","0","0","0","0","0"
"2014","Calgary, Alberta, municipal","48014","Concealing person who carried out terrorist activity that is a terrorism offence for which that person is liable to imprisonment for life","0","0","0","0","0","0","0","0","0","0","0","0","0","0"
"2015","Calgary, Alberta, municipal","48014","Concealing person who carried out terrorist activity that is a terrorism offence for which that person is liable to imprisonment for life","0","0","0","0","0","0","0","0","0","0","0","0","0","0"
"2016","Calgary, Alberta, municipal","48014","Concealing person who carried out terrorist activity that is a terrorism offence for which that person is liable to imprisonment for life","0","0","0","0","0","0","0","0","0","0","0","0","0","0"
"2012","Calgary, Alberta, municipal","48014","Concealing person who carried out terrorist activity that is a terrorism offence for which that person is liable to any punishment other than life","0","0","0","0","0","0","0","0","0","0","0","0","0","0"
"2013","Calgary, Alberta, municipal","48014","Concealing person who carried out terrorist activity that is a terrorism offence for which that person is liable to any punishment other than life","0","0","0","0","0","0","0","0","0","0","0","0","0","0"
"2014","Calgary, Alberta, municipal","48014","Concealing person who carried out terrorist activity that is a terrorism offence for which that person is liable to any punishment other than life","0","0","0","0","0","0","0","0","0","0","0","0","0","0"
"2015","Calgary, Alberta, municipal","48014","Concealing person who carried out terrorist activity that is a terrorism offence for which that person is liable to any punishment other than life","0","0","0","0","0","0","0","0","0","0","0","0","0","0"
"2016","Calgary, Alberta, municipal","48014","Concealing person who carried out terrorist activity that is a terrorism offence for which that person is liable to any punishment other than life","0","0","0","0","0","0","0","0","0","0","0","0","0","0"
"2012","Calgary, Alberta, municipal","48014","Concealing person who is likely to carry out terrorist activity","0","0","0","0","0","0","0","0","0","0","0","0","0","0"
"2013","Calgary, Alberta, municipal","48014","Concealing person who is likely to carry out terrorist activity","0","0","0","0","0","0","0","0","0","0","0","0","0","0"
"2014","Calgary, Alberta, municipal","48014","Concealing person who is likely to carry out terrorist activity","0","0","0","0","0","0","0","0","0","0","0","0","0","0"
"2015","Calgary, Alberta, municipal","48014","Concealing person who is likely to carry out terrorist activity","0","0","0","0","0","0","0","0","0","0","0","0","0","0"
"2016","Calgary, Alberta, municipal","48014","Concealing person who is likely to carry out terrorist activity","0","0","0","0","0","0","0","0","0","0","0","0","0","0"
"1998","Calgary, Alberta, municipal","48014","Sexual offences, public morals and disorderly conduct (Part V Criminal Code)","0","0","0","0","0","0","0","0","0","0","0","0","0","0"
"1999","Calgary, Alberta, municipal","48014","Sexual offences, public morals and disorderly conduct (Part V Criminal Code)","4","3","0","0","0.46","0","0","0","0","3","3","3","0","0"
"2000","Calgary, Alberta, municipal","48014","Sexual offences, public morals and disorderly conduct (Part V Criminal Code)","0","0","0","-100","0","0","0","0","0","0","0","0","0","0"
"2001","Calgary, Alberta, municipal","48014","Sexual offences, public morals and disorderly conduct (Part V Criminal Code)","0","0","0","0","0","0","0","0","0","0","0","0","0","0"
"2002","Calgary, Alberta, municipal","48014","Sexual offences, public morals and disorderly conduct (Part V Criminal Code)","2","0","0","0","0.22","0","0","0","0","0","0","0","0","0"
"2003","Calgary, Alberta, municipal","48014","Sexual offences, public morals and disorderly conduct (Part V Criminal Code)","1","0","1","-50.78","0.11","0","0","0","0","1","0","0","0","1"
"2004","Calgary, Alberta, municipal","48014","Sexual offences, public morals and disorderly conduct (Part V Criminal Code)","7","6","1","579.1","0.72","0.93","0.85","0","3.96","7","7","7","0","3"
"2005","Calgary, Alberta, municipal","48014","Sexual offences, public morals and disorderly conduct (Part V Criminal Code)","3","2","0","-58.41","0.3","0.13","0.23","1.3","0","2","1","2","1","0"
"2006","Calgary, Alberta, municipal","48014","Sexual offences, public morals and disorderly conduct (Part V Criminal Code)","3","1","1","-3.04","0.29","0.12","0.11","0","2.57","2","1","1","0","2"
"2007","Calgary, Alberta, municipal","48014","Sexual offences, public morals and disorderly conduct (Part V Criminal Code)","4","4","0","30.13","0.38","0.24","0.44","2.58","0","4","2","4","2","0"
"2008","Calgary, Alberta, municipal","48014","Sexual offences, public morals and disorderly conduct (Part V Criminal Code)","4","3","0","-2.45","0.37","0.47","0.43","0","0","3","4","4","0","0"
"2009","Calgary, Alberta, municipal","48014","Sexual offences, public morals and disorderly conduct (Part V Criminal Code)","0","0","0","-100","0","0","0","0","0","0","0","0","0","0"
"2010","Calgary, Alberta, municipal","48014","Sexual offences, public morals and disorderly conduct (Part V Criminal Code)","6","4","2","0","0.53","0.45","0.41","0","3.85","6","4","4","0","3"
"2011","Calgary, Alberta, municipal","48014","Sexual offences, public morals and disorderly conduct (Part V Criminal Code)","3","3","0","-50.78","0.26","0.11","0.2","1.28","0","3","1","2","1","0"
"2012","Calgary, Alberta, municipal","48014","Sexual offences, public morals and disorderly conduct (Part V Criminal Code)","1","1","0","-67.66","0.08","0.11","0.1","0","0","1","1","1","0","0"
"2013","Calgary, Alberta, municipal","48014","Sexual offences, public morals and disorderly conduct (Part V Criminal Code)","1","1","0","-3.5","0.08","0.1","0.1","0","0","1","1","1","0","0"
"2014","Calgary, Alberta, municipal","48014","Sexual offences, public morals and disorderly conduct (Part V Criminal Code)","1","0","0","-3.25","0.08","0","0","0","0","0","0","0","0","0"
"2015","Calgary, Alberta, municipal","48014","Sexual offences, public morals and disorderly conduct (Part V Criminal Code)","0","0","0","-100","0","0","0","0","0","0","0","0","0","0"
"2016","Calgary, Alberta, municipal","48014","Sexual offences, public morals and disorderly conduct (Part V Criminal Code)","1","1","0","0","0.08","0.1","0.09","0","0","1","1","1","0","0"
"1998","Calgary, Alberta, municipal","48014","Invasion of privacy (Part VI Criminal Code)","3","1","1","0","0.36","0","0","0","0","2","1","1","0","0"
"1999","Calgary, Alberta, municipal","48014","Invasion of privacy (Part VI Criminal Code)","0","0","0","-100","0","0","0","0","0","0","0","0","0","0"
"2000","Calgary, Alberta, municipal","48014","Invasion of privacy (Part VI Criminal Code)","2","0","1","0","0.23","0","0","0","0","1","0","0","0","1"
"2001","Calgary, Alberta, municipal","48014","Invasion of privacy (Part VI Criminal Code)","0","0","0","-100","0","0","0","0","0","0","0","0","0","0"
"2002","Calgary, Alberta, municipal","48014","Invasion of privacy (Part VI Criminal Code)","1","1","0","0","0.11","0","0","0","0","1","0","0","0","0"
"2003","Calgary, Alberta, municipal","48014","Invasion of privacy (Part VI Criminal Code)","1","0","0","-1.56","0.11","0","0","0","0","0","0","0","0","0"
"2004","Calgary, Alberta, municipal","48014","Invasion of privacy (Part VI Criminal Code)","0","0","0","-100","0","0","0","0","0","0","0","0","0","0"
"2005","Calgary, Alberta, municipal","48014","Invasion of privacy (Part VI Criminal Code)","0","0","0","0","0","0","0","0","0","0","0","0","0","0"
"2006","Calgary, Alberta, municipal","48014","Invasion of privacy (Part VI Criminal Code)","0","0","0","0","0","0","0","0","0","0","0","0","0","0"
"2007","Calgary, Alberta, municipal","48014","Invasion of privacy (Part VI Criminal Code)","0","0","0","0","0","0","0","0","0","0","0","0","0","0"
"2008","Calgary, Alberta, municipal","48014","Invasion of privacy (Part VI Criminal Code)","0","0","0","0","0","0","0","0","0","0","0","0","0","0"
"2009","Calgary, Alberta, municipal","48014","Invasion of privacy (Part VI Criminal Code)","0","0","0","0","0","0","0","0","0","0","0","0","0","0"
"2010","Calgary, Alberta, municipal","48014","Invasion of privacy (Part VI Criminal Code)","0","0","0","0","0","0","0","0","0","0","0","0","0","0"
"2011","Calgary, Alberta, municipal","48014","Invasion of privacy (Part VI Criminal Code)","0","0","0","0","0","0","0","0","0","0","0","0","0","0"
"2012","Calgary, Alberta, municipal","48014","Invasion of privacy (Part VI Criminal Code)","0","0","0","0","0","0","0","0","0","0","0","0","0","0"
"2013","Calgary, Alberta, municipal","48014","Invasion of privacy (Part VI Criminal Code)","0","0","0","0","0","0","0","0","0","0","0","0","0","0"
"2014","Calgary, Alberta, municipal","48014","Invasion of privacy (Part VI Criminal Code)","0","0","0","0","0","0","0","0","0","0","0","0","0","0"
"2015","Calgary, Alberta, municipal","48014","Invasion of privacy (Part VI Criminal Code)","1","0","0","0","0.08","0","0","0","0","0","0","0","0","0"
"2016","Calgary, Alberta, municipal","48014","Invasion of privacy (Part VI Criminal Code)","0","0","0","-100","0","0","0","0","0","0","0","0","0","0"
"1998","Calgary, Alberta, municipal","48014","Disorderly houses, gaming and betting","0","0","0","0","0","0","0","0","0","0","0","0","0","0"
"1999","Calgary, Alberta, municipal","48014","Disorderly houses, gaming and betting","0","0","0","0","0","0","0","0","0","0","0","0","0","0"
"2000","Calgary, Alberta, municipal","48014","Disorderly houses, gaming and betting","0","0","0","0","0","0","0","0","0","0","0","0","0","0"
"2001","Calgary, Alberta, municipal","48014","Disorderly houses, gaming and betting","0","0","0","0","0","0","0","0","0","0","0","0","0","0"
"2002","Calgary, Alberta, municipal","48014","Disorderly houses, gaming and betting","0","0","0","0","0","0","0","0","0","0","0","0","0","0"
"2003","Calgary, Alberta, municipal","48014","Disorderly houses, gaming and betting","0","0","0","0","0","0","0","0","0","0","0","0","0","0"
"2004","Calgary, Alberta, municipal","48014","Disorderly houses, gaming and betting","0","0","0","0","0","0","0","0","0","0","0","0","0","0"
"2005","Calgary, Alberta, municipal","48014","Disorderly houses, gaming and betting","0","0","0","0","0","0","0","0","0","0","0","0","0","0"
"2006","Calgary, Alberta, municipal","48014","Disorderly houses, gaming and betting","0","0","0","0","0","0","0","0","0","0","0","0","0","0"
"2007","Calgary, Alberta, municipal","48014","Disorderly houses, gaming and betting","0","0","0","0","0","0","0","0","0","0","0","0","0","0"
"2008","Calgary, Alberta, municipal","48014","Disorderly houses, gaming and betting","0","0","0","0","0","0","0","0","0","0","0","0","0","0"
"2009","Calgary, Alberta, municipal","48014","Disorderly houses, gaming and betting","0","0","0","0","0","0","0","0","0","0","0","0","0","0"
"2010","Calgary, Alberta, municipal","48014","Disorderly houses, gaming and betting","0","0","0","0","0","0","0","0","0","0","0","0","0","0"
"2011","Calgary, Alberta, municipal","48014","Disorderly houses, gaming and betting","0","0","0","0","0","0","0","0","0","0","0","0","0","0"
"2012","Calgary, Alberta, municipal","48014","Disorderly houses, gaming and betting","0","0","0","0","0","0","0","0","0","0","0","0","0","0"
"2013","Calgary, Alberta, municipal","48014","Disorderly houses, gaming and betting","0","0","0","0","0","0","0","0","0","0","0","0","0","0"
"2014","Calgary, Alberta, municipal","48014","Disorderly houses, gaming and betting","0","0","0","0","0","0","0","0","0","0","0","0","0","0"
"2015","Calgary, Alberta, municipal","48014","Disorderly houses, gaming and betting","0","0","0","0","0","0","0","0","0","0","0","0","0","0"
"2016","Calgary, Alberta, municipal","48014","Disorderly houses, gaming and betting","0","0","0","0","0","0","0","0","0","0","0","0","0","0"
"1998","Calgary, Alberta, municipal","48014","Offences against the person and reputation (Part VIII Criminal Code)","570","241","162","0","67.8","0","0","0","0","403","137","153","16","17"
"1999","Calgary, Alberta, municipal","48014","Offences against the person and reputation (Part VIII Criminal Code)","36","12","7","-93.84","4.18","0","0","0","0","19","7","9","2","3"
"2000","Calgary, Alberta, municipal","48014","Offences against the person and reputation (Part VIII Criminal Code)","40","9","11","8.54","4.53","0","0","0","0","20","6","7","1","1"
"2001","Calgary, Alberta, municipal","48014","Offences against the person and reputation (Part VIII Criminal Code)","44","9","10","7.62","4.88","0","0","0","0","19","8","9","1","2"
"2002","Calgary, Alberta, municipal","48014","Offences against the person and reputation (Part VIII Criminal Code)","29","2","11","-35.61","3.14","0","0","0","0","13","0","1","1","2"
"2003","Calgary, Alberta, municipal","48014","Offences against the person and reputation (Part VIII Criminal Code)","20","5","4","-32.11","2.13","0","0","0","0","9","2","4","2","1"
"2004","Calgary, Alberta, municipal","48014","Offences against the person and reputation (Part VIII Criminal Code)","27","4","11","30.97","2.79","0.4","0.6","2.64","7.91","15","3","5","2","6"
"2005","Calgary, Alberta, municipal","48014","Offences against the person and reputation (Part VIII Criminal Code)","36","11","11","29.4","3.61","1.03","1.05","1.3","9.09","22","8","9","1","7"
"2006","Calgary, Alberta, municipal","48014","Offences against the person and reputation (Part VIII Criminal Code)","26","7","6","-29.98","2.53","0.75","0.68","0","1.29","13","6","6","0","1"
"2007","Calgary, Alberta, municipal","48014","Offences against the person and reputation (Part VIII Criminal Code)","24","3","12","-9.91","2.28","0.24","0.22","0","5.16","15","2","2","0","4"
"2008","Calgary, Alberta, municipal","48014","Offences against the person and reputation (Part VIII Criminal Code)","6","1","0","-75.61","0.56","0","0","0","0","1","0","0","0","0"
"2009","Calgary, Alberta, municipal","48014","Offences against the person and reputation (Part VIII Criminal Code)","7","2","4","13.74","0.63","0.23","0.21","0","0","6","2","2","0","0"
"2010","Calgary, Alberta, municipal","48014","Offences against the person and reputation (Part VIII Criminal Code)","2","0","1","-71.85","0.18","0","0","0","0","1","0","0","0","0"
"2011","Calgary, Alberta, municipal","48014","Offences against the person and reputation (Part VIII Criminal Code)","2","0","0","-1.57","0.18","0","0","0","0","0","0","0","0","0"
"2012","Calgary, Alberta, municipal","48014","Offences against the person and reputation (Part VIII Criminal Code)","2","1","2","-2.99","0.17","0.11","0.1","0","0","3","1","1","0","0"
"2013","Calgary, Alberta, municipal","48014","Offences against the person and reputation (Part VIII Criminal Code)","1","1","0","-51.75","0.08","0.1","0.1","0","0","1","1","1","0","0"
"2014","Calgary, Alberta, municipal","48014","Offences against the person and reputation (Part VIII Criminal Code)","4","1","1","286.99","0.32","0","0","0","0","2","0","0","0","0"
"2015","Calgary, Alberta, municipal","48014","Offences against the person and reputation (Part VIII Criminal Code)","4","0","2","-2.13","0.31","0","0","0","1.25","2","0","0","0","1"
"2016","Calgary, Alberta, municipal","48014","Offences against the person and reputation (Part VIII Criminal Code)","6","1","0","46.49","0.45","0.1","0.09","0","0","1","1","1","0","0"
"2012","Calgary, Alberta, municipal","48014","Failure to comply with the regulations/obligations for medical assistance in dying","0","0","0","0","0","0","0","0","0","0","0","0","0","0"
"2013","Calgary, Alberta, municipal","48014","Failure to comply with the regulations/obligations for medical assistance in dying","0","0","0","0","0","0","0","0","0","0","0","0","0","0"
"2014","Calgary, Alberta, municipal","48014","Failure to comply with the regulations/obligations for medical assistance in dying","0","0","0","0","0","0","0","0","0","0","0","0","0","0"
"2015","Calgary, Alberta, municipal","48014","Failure to comply with the regulations/obligations for medical assistance in dying","0","0","0","0","0","0","0","0","0","0","0","0","0","0"
"2016","Calgary, Alberta, municipal","48014","Failure to comply with the regulations/obligations for medical assistance in dying","0","0","0","0","0","0","0","0","0","0","0","0","0","0"
"1998","Calgary, Alberta, municipal","48014","Offences against rights of property (Part IX Criminal Code)","84","78","6","0","9.99","0","0","0","0","84","41","59","18","4"
"1999","Calgary, Alberta, municipal","48014","Offences against rights of property (Part IX Criminal Code)","116","109","4","34.65","13.45","0","0","0","0","113","65","89","24","2"
"2000","Calgary, Alberta, municipal","48014","Offences against rights of property (Part IX Criminal Code)","81","77","1","-31.79","9.18","0","0","0","0","78","41","69","28","1"
"2001","Calgary, Alberta, municipal","48014","Offences against rights of property (Part IX Criminal Code)","68","64","2","-17.86","7.54","0","0","0","0","66","48","68","20","5"
"2002","Calgary, Alberta, municipal","48014","Offences against rights of property (Part IX Criminal Code)","90","87","3","29.3","9.75","0","0","0","0","90","58","78","20","2"
"2003","Calgary, Alberta, municipal","48014","Offences against rights of property (Part IX Criminal Code)","113","108","3","23.59","12.05","0","0","0","0","111","70","94","24","0"
"2004","Calgary, Alberta, municipal","48014","Offences against rights of property (Part IX Criminal Code)","82","78","2","-29.6","8.48","8.37","9.3","18.47","3.96","80","63","77","14","3"
"2005","Calgary, Alberta, municipal","48014","Offences against rights of property (Part IX Criminal Code)","89","87","1","5.33","8.93","11.31","11.7","15.58","1.3","88","88","100","12","1"
"2006","Calgary, Alberta, municipal","48014","Offences against rights of property (Part IX Criminal Code)","87","87","0","-5.22","8.47","7.82","8.95","20.56","0","87","63","79","16","0"
"2007","Calgary, Alberta, municipal","48014","Offences against rights of property (Part IX Criminal Code)","115","114","1","29.01","10.92","11.46","12.14","19.35","1.29","115","95","110","15","1"
"2008","Calgary, Alberta, municipal","48014","Offences against rights of property (Part IX Criminal Code)","73","72","1","-38.08","6.76","7.98","8.29","11.66","0","73","68","77","9","0"
"2009","Calgary, Alberta, municipal","48014","Offences against rights of property (Part IX Criminal Code)","54","51","1","-27.88","4.88","4.91","4.93","5.16","0","52","43","47","4","0"
"2010","Calgary, Alberta, municipal","48014","Offences against rights of property (Part IX Criminal Code)","34","35","0","-37.96","3.03","3.6","3.31","0","0","35","32","32","0","0"
"2011","Calgary, Alberta, municipal","48014","Offences against rights of property (Part IX Criminal Code)","50","48","2","44.75","4.38","4.32","4.49","6.38","0","50","39","44","5","0"
"2012","Calgary, Alberta, municipal","48014","Offences against rights of property (Part IX Criminal Code)","30","30","0","-41.79","2.55","2.15","2.57","7.62","0","30","20","26","6","0"
"2013","Calgary, Alberta, municipal","48014","Offences against rights of property (Part IX Criminal Code)","43","43","0","38.31","3.53","3.93","4.01","5.05","0","43","38","42","4","0"
"2014","Calgary, Alberta, municipal","48014","Offences against rights of property (Part IX Criminal Code)","52","51","1","17","4.13","4.79","4.71","3.78","0","52","48","51","3","0"
"2015","Calgary, Alberta, municipal","48014","Offences against rights of property (Part IX Criminal Code)","67","63","4","26.1","5.2","6.25","5.98","2.49","2.49","67","64","66","2","2"
"2016","Calgary, Alberta, municipal","48014","Offences against rights of property (Part IX Criminal Code)","82","81","1","19.53","6.22","8.21","7.61","0","0","82","86","86","0","0"
"1998","Calgary, Alberta, municipal","48014","Fraudulent transactions relating to contracts and trade (Part X Criminal Code)","3","2","1","0","0.36","0","0","0","0","3","2","2","0","0"
"1999","Calgary, Alberta, municipal","48014","Fraudulent transactions relating to contracts and trade (Part X Criminal Code)","8","3","0","160.01","0.93","0","0","0","0","3","3","3","0","0"
"2000","Calgary, Alberta, municipal","48014","Fraudulent transactions relating to contracts and trade (Part X Criminal Code)","5","3","0","-38.95","0.57","0","0","0","0","3","3","3","0","0"
"2001","Calgary, Alberta, municipal","48014","Fraudulent transactions relating to contracts and trade (Part X Criminal Code)","4","2","2","-21.73","0.44","0","0","0","0","4","1","1","0","2"
"2002","Calgary, Alberta, municipal","48014","Fraudulent transactions relating to contracts and trade (Part X Criminal Code)","4","2","0","-2.31","0.43","0","0","0","0","2","1","2","1","0"
"2003","Calgary, Alberta, municipal","48014","Fraudulent transactions relating to contracts and trade (Part X Criminal Code)","3","1","2","-26.17","0.32","0","0","0","0","3","1","1","0","1"
"2004","Calgary, Alberta, municipal","48014","Fraudulent transactions relating to contracts and trade (Part X Criminal Code)","4","3","1","29.35","0.41","0.27","0.24","0","1.32","4","2","2","0","1"
"2005","Calgary, Alberta, municipal","48014","Fraudulent transactions relating to contracts and trade (Part X Criminal Code)","5","2","0","21.31","0.5","0.26","0.23","0","0","2","2","2","0","0"
"2006","Calgary, Alberta, municipal","48014","Fraudulent transactions relating to contracts and trade (Part X Criminal Code)","2","2","0","-61.22","0.19","0","0.23","2.57","0","2","0","2","2","0"
"2007","Calgary, Alberta, municipal","48014","Fraudulent transactions relating to contracts and trade (Part X Criminal Code)","5","0","3","144","0.47","0","0","0","1.29","3","0","0","0","1"
"2008","Calgary, Alberta, municipal","48014","Fraudulent transactions relating to contracts and trade (Part X Criminal Code)","5","4","0","-2.45","0.46","0.35","0.32","0","0","4","3","3","0","0"
"2009","Calgary, Alberta, municipal","48014","Fraudulent transactions relating to contracts and trade (Part X Criminal Code)","6","2","1","16.99","0.54","0.11","0.21","1.29","0","3","1","2","1","0"
"2010","Calgary, Alberta, municipal","48014","Fraudulent transactions relating to contracts and trade (Part X Criminal Code)","5","4","0","-17.89","0.44","0.45","0.41","0","0","4","4","4","0","0"
"2011","Calgary, Alberta, municipal","48014","Fraudulent transactions relating to contracts and trade (Part X Criminal Code)","6","3","1","18.12","0.53","0.22","0.31","1.28","0","4","2","3","1","0"
"2012","Calgary, Alberta, municipal","48014","Fraudulent transactions relating to contracts and trade (Part X Criminal Code)","4","3","0","-35.33","0.34","0.32","0.3","0","0","3","3","3","0","0"
"2013","Calgary, Alberta, municipal","48014","Fraudulent transactions relating to contracts and trade (Part X Criminal Code)","7","3","0","68.87","0.57","0.31","0.29","0","0","3","3","3","0","0"
"2014","Calgary, Alberta, municipal","48014","Fraudulent transactions relating to contracts and trade (Part X Criminal Code)","10","4","2","38.21","0.79","0.4","0.37","0","0","6","4","4","0","0"
"2015","Calgary, Alberta, municipal","48014","Fraudulent transactions relating to contracts and trade (Part X Criminal Code)","4","2","0","-60.85","0.31","0.2","0.18","0","0","2","2","2","0","0"
"2016","Calgary, Alberta, municipal","48014","Fraudulent transactions relating to contracts and trade (Part X Criminal Code)","5","4","0","22.08","0.38","0.19","0.27","1.22","0","4","2","3","1","0"
"1998","Calgary, Alberta, municipal","48014","Willful and forbidden acts in respect of certain property (Part XI Criminal Code)","12","9","3","0","1.43","0","0","0","0","12","9","10","1","2"
"1999","Calgary, Alberta, municipal","48014","Willful and forbidden acts in respect of certain property (Part XI Criminal Code)","18","10","4","46.25","2.09","0","0","0","0","14","7","11","4","0"
"2000","Calgary, Alberta, municipal","48014","Willful and forbidden acts in respect of certain property (Part XI Criminal Code)","13","6","3","-29.45","1.47","0","0","0","0","9","5","6","1","0"
"2001","Calgary, Alberta, municipal","48014","Willful and forbidden acts in respect of certain property (Part XI Criminal Code)","11","7","1","-17.21","1.22","0","0","0","0","8","6","8","2","0"
"2002","Calgary, Alberta, municipal","48014","Willful and forbidden acts in respect of certain property (Part XI Criminal Code)","14","7","5","24.33","1.52","0","0","0","0","12","6","8","2","5"
"2003","Calgary, Alberta, municipal","48014","Willful and forbidden acts in respect of certain property (Part XI Criminal Code)","7","3","3","-50.78","0.75","0","0","0","0","6","3","4","1","2"
"2004","Calgary, Alberta, municipal","48014","Willful and forbidden acts in respect of certain property (Part XI Criminal Code)","10","5","2","38.59","1.03","0.4","0.48","1.32","2.64","7","3","4","1","2"
"2005","Calgary, Alberta, municipal","48014","Willful and forbidden acts in respect of certain property (Part XI Criminal Code)","11","9","2","6.75","1.1","1.03","1.4","5.19","1.3","11","8","12","4","1"
"2006","Calgary, Alberta, municipal","48014","Willful and forbidden acts in respect of certain property (Part XI Criminal Code)","16","10","4","41.03","1.56","0.99","1.13","2.57","0","14","8","10","2","0"
"2007","Calgary, Alberta, municipal","48014","Willful and forbidden acts in respect of certain property (Part XI Criminal Code)","7","7","1","-57.3","0.66","0.48","0.77","3.87","0","8","4","7","3","0"
"2008","Calgary, Alberta, municipal","48014","Willful and forbidden acts in respect of certain property (Part XI Criminal Code)","7","4","0","-2.45","0.65","0.35","0.32","0","0","4","3","3","0","0"
"2009","Calgary, Alberta, municipal","48014","Willful and forbidden acts in respect of certain property (Part XI Criminal Code)","6","4","1","-16.44","0.54","0.34","0.42","1.29","0","5","3","4","1","0"
"2010","Calgary, Alberta, municipal","48014","Willful and forbidden acts in respect of certain property (Part XI Criminal Code)","8","8","0","31.37","0.71","0.68","0.72","1.28","0","8","6","7","1","0"
"2011","Calgary, Alberta, municipal","48014","Willful and forbidden acts in respect of certain property (Part XI Criminal Code)","14","9","4","72.26","1.23","0.89","0.82","0","0","13","8","8","0","0"
"2012","Calgary, Alberta, municipal","48014","Willful and forbidden acts in respect of certain property (Part XI Criminal Code)","17","13","2","17.8","1.44","1.5","1.39","0","0","15","14","14","0","0"
"2013","Calgary, Alberta, municipal","48014","Willful and forbidden acts in respect of certain property (Part XI Criminal Code)","14","12","1","-20.53","1.15","0.72","0.76","1.26","0","13","7","8","1","0"
"2014","Calgary, Alberta, municipal","48014","Willful and forbidden acts in respect of certain property (Part XI Criminal Code)","18","7","5","24.39","1.43","0.6","0.74","2.52","3.78","12","6","8","2","3"
"2015","Calgary, Alberta, municipal","48014","Willful and forbidden acts in respect of certain property (Part XI Criminal Code)","22","13","3","19.61","1.71","1.27","1.18","0","1.25","16","13","13","0","1"
"2016","Calgary, Alberta, municipal","48014","Willful and forbidden acts in respect of certain property (Part XI Criminal Code)","21","16","0","-6.78","1.59","1.43","1.33","0","0","16","15","15","0","0"
"1998","Calgary, Alberta, municipal","48014","Offences relating to currency (Part XII Criminal Code)","0","0","0","0","0","0","0","0","0","0","0","0","0","0"
"1999","Calgary, Alberta, municipal","48014","Offences relating to currency (Part XII Criminal Code)","0","0","0","0","0","0","0","0","0","0","0","0","0","0"
"2000","Calgary, Alberta, municipal","48014","Offences relating to currency (Part XII Criminal Code)","0","0","0","0","0","0","0","0","0","0","0","0","0","0"
"2001","Calgary, Alberta, municipal","48014","Offences relating to currency (Part XII Criminal Code)","0","0","0","0","0","0","0","0","0","0","0","0","0","0"
"2002","Calgary, Alberta, municipal","48014","Offences relating to currency (Part XII Criminal Code)","1","1","0","0","0.11","0","0","0","0","1","1","1","0","0"
"2003","Calgary, Alberta, municipal","48014","Offences relating to currency (Part XII Criminal Code)","0","0","0","-100","0","0","0","0","0","0","0","0","0","0"
"2004","Calgary, Alberta, municipal","48014","Offences relating to currency (Part XII Criminal Code)","0","0","0","0","0","0","0","0","0","0","0","0","0","0"
"2005","Calgary, Alberta, municipal","48014","Offences relating to currency (Part XII Criminal Code)","2","1","0","0","0.2","0","0","0","0","1","0","0","0","0"
"2006","Calgary, Alberta, municipal","48014","Offences relating to currency (Part XII Criminal Code)","1","1","0","-51.52","0.1","0.12","0.11","0","0","1","1","1","0","0"
"2007","Calgary, Alberta, municipal","48014","Offences relating to currency (Part XII Criminal Code)","1","0","0","-2.4","0.09","0","0","0","0","0","0","0","0","0"
"2008","Calgary, Alberta, municipal","48014","Offences relating to currency (Part XII Criminal Code)","1","1","1","-2.45","0.09","0","0","0","0","2","0","0","0","0"
"2009","Calgary, Alberta, municipal","48014","Offences relating to currency (Part XII Criminal Code)","1","0","0","-2.51","0.09","0","0","0","0","0","0","0","0","0"
"2010","Calgary, Alberta, municipal","48014","Offences relating to currency (Part XII Criminal Code)","1","0","0","-1.47","0.09","0","0","0","0","0","0","0","0","0"
"2011","Calgary, Alberta, municipal","48014","Offences relating to currency (Part XII Criminal Code)","0","0","0","-100","0","0","0","0","0","0","0","0","0","0"
"2012","Calgary, Alberta, municipal","48014","Offences relating to currency (Part XII Criminal Code)","0","0","0","0","0","0","0","0","0","0","0","0","0","0"
"2013","Calgary, Alberta, municipal","48014","Offences relating to currency (Part XII Criminal Code)","1","0","0","0","0.08","0","0","0","0","0","0","0","0","0"
"2014","Calgary, Alberta, municipal","48014","Offences relating to currency (Part XII Criminal Code)","0","0","0","-100","0","0","0","0","0","0","0","0","0","0"
"2015","Calgary, Alberta, municipal","48014","Offences relating to currency (Part XII Criminal Code)","0","0","0","0","0","0","0","0","0","0","0","0","0","0"
"2016","Calgary, Alberta, municipal","48014","Offences relating to currency (Part XII Criminal Code)","1","0","0","0","0.08","0","0","0","0","0","0","0","0","0"
"1998","Calgary, Alberta, municipal","48014","Proceeds of crime (Part XII.2 Criminal Code)","0","0","0","0","0","0","0","0","0","0","0","0","0","0"
"1999","Calgary, Alberta, municipal","48014","Proceeds of crime (Part XII.2 Criminal Code)","0","0","0","0","0","0","0","0","0","0","0","0","0","0"
"2000","Calgary, Alberta, municipal","48014","Proceeds of crime (Part XII.2 Criminal Code)","0","0","0","0","0","0","0","0","0","0","0","0","0","0"
"2001","Calgary, Alberta, municipal","48014","Proceeds of crime (Part XII.2 Criminal Code)","1","0","0","0","0.11","0","0","0","0","0","0","0","0","0"
"2002","Calgary, Alberta, municipal","48014","Proceeds of crime (Part XII.2 Criminal Code)","0","0","0","-100","0","0","0","0","0","0","0","0","0","0"
"2003","Calgary, Alberta, municipal","48014","Proceeds of crime (Part XII.2 Criminal Code)","0","0","0","0","0","0","0","0","0","0","0","0","0","0"
"2004","Calgary, Alberta, municipal","48014","Proceeds of crime (Part XII.2 Criminal Code)","0","0","0","0","0","0","0","0","0","0","0","0","0","0"
"2005","Calgary, Alberta, municipal","48014","Proceeds of crime (Part XII.2 Criminal Code)","4","1","0","0","0.4","0.26","0.23","0","0","1","2","2","0","0"
"2006","Calgary, Alberta, municipal","48014","Proceeds of crime (Part XII.2 Criminal Code)","26","0","1","530.22","2.53","0","0","0","0","1","0","0","0","0"
"2007","Calgary, Alberta, municipal","48014","Proceeds of crime (Part XII.2 Criminal Code)","135","0","2","406.77","12.82","0","0","0","0","2","0","0","0","0"
"2008","Calgary, Alberta, municipal","48014","Proceeds of crime (Part XII.2 Criminal Code)","115","0","3","-16.9","10.65","0","0","0","0","3","0","0","0","0"
"2009","Calgary, Alberta, municipal","48014","Proceeds of crime (Part XII.2 Criminal Code)","135","0","1","14.44","12.19","0","0","0","0","1","0","0","0","0"
"2010","Calgary, Alberta, municipal","48014","Proceeds of crime (Part XII.2 Criminal Code)","42","0","0","-69.35","3.74","0","0","0","0","0","0","0","0","0"
"2011","Calgary, Alberta, municipal","48014","Proceeds of crime (Part XII.2 Criminal Code)","11","1","0","-74.22","0.96","0.11","0.1","0","0","1","1","1","0","0"
"2012","Calgary, Alberta, municipal","48014","Proceeds of crime (Part XII.2 Criminal Code)","8","0","0","-29.45","0.68","0","0","0","0","0","0","0","0","0"
"2013","Calgary, Alberta, municipal","48014","Proceeds of crime (Part XII.2 Criminal Code)","9","0","0","8.56","0.74","0","0","0","0","0","0","0","0","0"
"2014","Calgary, Alberta, municipal","48014","Proceeds of crime (Part XII.2 Criminal Code)","12","1","0","29","0.95","0.2","0.18","0","0","1","2","2","0","0"
"2015","Calgary, Alberta, municipal","48014","Proceeds of crime (Part XII.2 Criminal Code)","16","3","0","30.49","1.24","0","0","0","0","3","0","0","0","0"
"2016","Calgary, Alberta, municipal","48014","Proceeds of crime (Part XII.2 Criminal Code)","20","1","0","22.08","1.52","0.1","0.09","0","0","1","1","1","0","0"
"1998","Calgary, Alberta, municipal","48014","Attempts, conspiracies, accessories (Part XIII Criminal Code)","41","32","8","0","4.88","0","0","0","0","40","16","24","8","7"
"1999","Calgary, Alberta, municipal","48014","Attempts, conspiracies, accessories (Part XIII Criminal Code)","42","36","4","-0.12","4.87","0","0","0","0","40","20","29","9","5"
"2000","Calgary, Alberta, municipal","48014","Attempts, conspiracies, accessories (Part XIII Criminal Code)","23","21","2","-46.51","2.61","0","0","0","0","23","8","12","4","1"
"2001","Calgary, Alberta, municipal","48014","Attempts, conspiracies, accessories (Part XIII Criminal Code)","47","38","6","99.93","5.21","0","0","0","0","44","21","25","4","6"
"2002","Calgary, Alberta, municipal","48014","Attempts, conspiracies, accessories (Part XIII Criminal Code)","24","15","9","-50.12","2.6","0","0","0","0","24","9","10","1","9"
"2003","Calgary, Alberta, municipal","48014","Attempts, conspiracies, accessories (Part XIII Criminal Code)","36","23","12","47.66","3.84","0","0","0","0","35","13","17","4","7"
"2004","Calgary, Alberta, municipal","48014","Attempts, conspiracies, accessories (Part XIII Criminal Code)","26","21","4","-29.93","2.69","2.39","2.9","7.91","5.28","25","18","24","6","4"
"2005","Calgary, Alberta, municipal","48014","Attempts, conspiracies, accessories (Part XIII Criminal Code)","27","23","2","0.78","2.71","1.93","2.22","5.19","3.89","25","15","19","4","3"
"2006","Calgary, Alberta, municipal","48014","Attempts, conspiracies, accessories (Part XIII Criminal Code)","18","13","4","-35.36","1.75","0.99","1.02","1.29","5.14","17","8","9","1","4"
"2007","Calgary, Alberta, municipal","48014","Attempts, conspiracies, accessories (Part XIII Criminal Code)","15","15","1","-18.67","1.42","1.21","1.32","2.58","0","16","10","12","2","0"
"2008","Calgary, Alberta, municipal","48014","Attempts, conspiracies, accessories (Part XIII Criminal Code)","18","17","1","17.06","1.67","1.06","1.18","2.59","1.3","18","9","11","2","1"
"2009","Calgary, Alberta, municipal","48014","Attempts, conspiracies, accessories (Part XIII Criminal Code)","19","13","3","2.9","1.72","0.57","0.63","1.29","1.29","16","5","6","1","1"
"2010","Calgary, Alberta, municipal","48014","Attempts, conspiracies, accessories (Part XIII Criminal Code)","14","13","1","-27.4","1.25","0.9","0.83","0","0","14","8","8","0","0"
"2011","Calgary, Alberta, municipal","48014","Attempts, conspiracies, accessories (Part XIII Criminal Code)","13","10","3","-8.6","1.14","0.78","0.71","0","3.83","13","7","7","0","3"
"2012","Calgary, Alberta, municipal","48014","Attempts, conspiracies, accessories (Part XIII Criminal Code)","4","4","0","-70.15","0.34","0.43","0.4","0","0","4","4","4","0","0"
"2013","Calgary, Alberta, municipal","48014","Attempts, conspiracies, accessories (Part XIII Criminal Code)","5","4","0","20.62","0.41","0.21","0.19","0","0","4","2","2","0","0"
"2014","Calgary, Alberta, municipal","48014","Attempts, conspiracies, accessories (Part XIII Criminal Code)","7","5","0","35.45","0.56","0.4","0.37","0","0","5","4","4","0","0"
"2015","Calgary, Alberta, municipal","48014","Attempts, conspiracies, accessories (Part XIII Criminal Code)","2","3","0","-72.04","0.16","0.2","0.18","0","0","3","2","2","0","0"
"2016","Calgary, Alberta, municipal","48014","Attempts, conspiracies, accessories (Part XIII Criminal Code)","3","3","0","46.49","0.23","0.38","0.35","0","0","3","4","4","0","0"
"2002","Calgary, Alberta, municipal","48014","Instruct offence for criminal organization","0","0","0","0","0","0","0","0","0","0","0","0","0","0"
"2003","Calgary, Alberta, municipal","48014","Instruct offence for criminal organization","0","0","0","0","0","0","0","0","0","0","0","0","0","0"
"2004","Calgary, Alberta, municipal","48014","Instruct offence for criminal organization","0","0","0","0","0","0","0","0","0","0","0","0","0","0"
"2005","Calgary, Alberta, municipal","48014","Instruct offence for criminal organization","0","0","0","0","0","0","0","0","0","0","0","0","0","0"
"2006","Calgary, Alberta, municipal","48014","Instruct offence for criminal organization","0","0","0","0","0","0","0","0","0","0","0","0","0","0"
"2007","Calgary, Alberta, municipal","48014","Instruct offence for criminal organization","0","0","0","0","0","0","0","0","0","0","0","0","0","0"
"2008","Calgary, Alberta, municipal","48014","Instruct offence for criminal organization","0","0","0","0","0","0","0","0","0","0","0","0","0","0"
"2009","Calgary, Alberta, municipal","48014","Instruct offence for criminal organization","0","0","0","0","0","0","0","0","0","0","0","0","0","0"
"2010","Calgary, Alberta, municipal","48014","Instruct offence for criminal organization","0","0","0","0","0","0","0","0","0","0","0","0","0","0"
"2011","Calgary, Alberta, municipal","48014","Instruct offence for criminal organization","0","0","0","0","0","0","0","0","0","0","0","0","0","0"
"2012","Calgary, Alberta, municipal","48014","Instruct offence for criminal organization","0","0","0","0","0","0","0","0","0","0","0","0","0","0"
"2013","Calgary, Alberta, municipal","48014","Instruct offence for criminal organization","0","0","0","0","0","0","0","0","0","0","0","0","0","0"
"2014","Calgary, Alberta, municipal","48014","Instruct offence for criminal organization","1","0","0","0","0.08","0","0","0","0","0","0","0","0","0"
"2015","Calgary, Alberta, municipal","48014","Instruct offence for criminal organization","1","1","0","-2.13","0.08","0.59","0.54","0","0","1","6","6","0","0"
"2016","Calgary, Alberta, municipal","48014","Instruct offence for criminal organization","2","3","0","95.33","0.15","1.24","1.15","0","0","3","13","13","0","0"
"2002","Calgary, Alberta, municipal","48014","Commit offence for criminal organization","0","0","0","0","0","0","0","0","0","0","0","0","0","0"
"2003","Calgary, Alberta, municipal","48014","Commit offence for criminal organization","0","0","0","0","0","0","0","0","0","0","0","0","0","0"
"2004","Calgary, Alberta, municipal","48014","Commit offence for criminal organization","0","0","0","0","0","0","0","0","0","0","0","0","0","0"
"2005","Calgary, Alberta, municipal","48014","Commit offence for criminal organization","0","0","0","0","0","0","0","0","0","0","0","0","0","0"
"2006","Calgary, Alberta, municipal","48014","Commit offence for criminal organization","0","0","0","0","0","0","0","0","0","0","0","0","0","0"
"2007","Calgary, Alberta, municipal","48014","Commit offence for criminal organization","0","0","0","0","0","0","0","0","0","0","0","0","0","0"
"2008","Calgary, Alberta, municipal","48014","Commit offence for criminal organization","0","0","0","0","0","0","0","0","0","0","0","0","0","0"
"2009","Calgary, Alberta, municipal","48014","Commit offence for criminal organization","0","1","0","0","0","1.03","0.94","0","0","1","9","9","0","0"
"2010","Calgary, Alberta, municipal","48014","Commit offence for criminal organization","0","0","0","0","0","0","0","0","0","0","0","0","0","0"
"2011","Calgary, Alberta, municipal","48014","Commit offence for criminal organization","0","0","0","0","0","0","0","0","0","0","0","0","0","0"
"2012","Calgary, Alberta, municipal","48014","Commit offence for criminal organization","0","0","0","0","0","0","0","0","0","0","0","0","0","0"
"2013","Calgary, Alberta, municipal","48014","Commit offence for criminal organization","0","0","0","0","0","0","0","0","0","0","0","0","0","0"
"2014","Calgary, Alberta, municipal","48014","Commit offence for criminal organization","0","0","0","0","0","0","0","0","0","0","0","0","0","0"
"2015","Calgary, Alberta, municipal","48014","Commit offence for criminal organization","0","0","0","0","0","0","0","0","0","0","0","0","0","0"
"2016","Calgary, Alberta, municipal","48014","Commit offence for criminal organization","0","0","0","0","0","0","0","0","0","0","0","0","0","0"
"2002","Calgary, Alberta, municipal","48014","Participate in activities of criminal organization","0","0","0","0","0","0","0","0","0","0","0","0","0","0"
"2003","Calgary, Alberta, municipal","48014","Participate in activities of criminal organization","0","0","0","0","0","0","0","0","0","0","0","0","0","0"
"2004","Calgary, Alberta, municipal","48014","Participate in activities of criminal organization","0","0","0","0","0","0","0","0","0","0","0","0","0","0"
"2005","Calgary, Alberta, municipal","48014","Participate in activities of criminal organization","0","0","0","0","0","0","0","0","0","0","0","0","0","0"
"2006","Calgary, Alberta, municipal","48014","Participate in activities of criminal organization","0","0","0","0","0","0","0","0","0","0","0","0","0","0"
"2007","Calgary, Alberta, municipal","48014","Participate in activities of criminal organization","0","0","0","0","0","0","0","0","0","0","0","0","0","0"
"2008","Calgary, Alberta, municipal","48014","Participate in activities of criminal organization","0","0","0","0","0","0","0","0","0","0","0","0","0","0"
"2009","Calgary, Alberta, municipal","48014","Participate in activities of criminal organization","0","0","0","0","0","0","0","0","0","0","0","0","0","0"
"2010","Calgary, Alberta, municipal","48014","Participate in activities of criminal organization","0","0","0","0","0","0","0","0","0","0","0","0","0","0"
"2011","Calgary, Alberta, municipal","48014","Participate in activities of criminal organization","0","0","0","0","0","0","0","0","0","0","0","0","0","0"
"2012","Calgary, Alberta, municipal","48014","Participate in activities of criminal organization","0","0","0","0","0","0","0","0","0","0","0","0","0","0"
"2013","Calgary, Alberta, municipal","48014","Participate in activities of criminal organization","1","0","0","0","0.08","0","0","0","0","0","0","0","0","0"
"2014","Calgary, Alberta, municipal","48014","Participate in activities of criminal organization","1","0","0","-3.25","0.08","0","0","0","0","0","0","0","0","0"
"2015","Calgary, Alberta, municipal","48014","Participate in activities of criminal organization","0","0","0","-100","0","0","0","0","0","0","0","0","0","0"
"2016","Calgary, Alberta, municipal","48014","Participate in activities of criminal organization","0","0","0","0","0","0","0","0","0","0","0","0","0","0"
"2012","Calgary, Alberta, municipal","48014","Recruitment of members by a criminal organization","0","0","0","0","0","0","0","0","0","0","0","0","0","0"
"2013","Calgary, Alberta, municipal","48014","Recruitment of members by a criminal organization","0","0","0","0","0","0","0","0","0","0","0","0","0","0"
"2014","Calgary, Alberta, municipal","48014","Recruitment of members by a criminal organization","0","0","0","0","0","0","0","0","0","0","0","0","0","0"
"2015","Calgary, Alberta, municipal","48014","Recruitment of members by a criminal organization","0","0","0","0","0","0","0","0","0","0","0","0","0","0"
"2016","Calgary, Alberta, municipal","48014","Recruitment of members by a criminal organization","0","0","0","0","0","0","0","0","0","0","0","0","0","0"
"1998","Calgary, Alberta, municipal","48014","All other Criminal Code (includes Part XII.1 Criminal Code)","0","0","0","0","0","0","0","0","0","0","0","0","0","0"
"1999","Calgary, Alberta, municipal","48014","All other Criminal Code (includes Part XII.1 Criminal Code)","3","0","0","0","0.35","0","0","0","0","0","0","0","0","0"
"2000","Calgary, Alberta, municipal","48014","All other Criminal Code (includes Part XII.1 Criminal Code)","0","0","0","-100","0","0","0","0","0","0","0","0","0","0"
"2001","Calgary, Alberta, municipal","48014","All other Criminal Code (includes Part XII.1 Criminal Code)","0","0","0","0","0","0","0","0","0","0","0","0","0","0"
"2002","Calgary, Alberta, municipal","48014","All other Criminal Code (includes Part XII.1 Criminal Code)","3","3","0","0","0.32","0","0","0","0","3","3","3","0","0"
"2003","Calgary, Alberta, municipal","48014","All other Criminal Code (includes Part XII.1 Criminal Code)","2","1","1","-34.38","0.21","0","0","0","0","2","1","1","0","0"
"2004","Calgary, Alberta, municipal","48014","All other Criminal Code (includes Part XII.1 Criminal Code)","1","0","1","-51.49","0.1","0","0","0","0","1","0","0","0","0"
"2005","Calgary, Alberta, municipal","48014","All other Criminal Code (includes Part XII.1 Criminal Code)","0","0","0","-100","0","0","0","0","0","0","0","0","0","0"
"2006","Calgary, Alberta, municipal","48014","All other Criminal Code (includes Part XII.1 Criminal Code)","0","0","0","0","0","0","0","0","0","0","0","0","0","0"
"2007","Calgary, Alberta, municipal","48014","All other Criminal Code (includes Part XII.1 Criminal Code)","13","13","0","0","1.23","1.69","1.55","0","0","13","14","14","0","0"
"2008","Calgary, Alberta, municipal","48014","All other Criminal Code (includes Part XII.1 Criminal Code)","0","0","0","-100","0","0","0","0","0","0","0","0","0","0"
"2009","Calgary, Alberta, municipal","48014","All other Criminal Code (includes Part XII.1 Criminal Code)","0","0","0","0","0","0","0","0","0","0","0","0","0","0"
"2010","Calgary, Alberta, municipal","48014","All other Criminal Code (includes Part XII.1 Criminal Code)","1","1","0","0","0.09","0.11","0.1","0","0","1","1","1","0","0"
"2011","Calgary, Alberta, municipal","48014","All other Criminal Code (includes Part XII.1 Criminal Code)","1","1","0","-1.57","0.09","0.11","0.1","0","0","1","1","1","0","0"
"2012","Calgary, Alberta, municipal","48014","All other Criminal Code (includes Part XII.1 Criminal Code)","0","0","0","-100","0","0","0","0","0","0","0","0","0","0"
"2013","Calgary, Alberta, municipal","48014","All other Criminal Code (includes Part XII.1 Criminal Code)","1","0","0","0","0.08","0","0","0","0","0","0","0","0","0"
"2014","Calgary, Alberta, municipal","48014","All other Criminal Code (includes Part XII.1 Criminal Code)","0","0","0","-100","0","0","0","0","0","0","0","0","0","0"
"2015","Calgary, Alberta, municipal","48014","All other Criminal Code (includes Part XII.1 Criminal Code)","0","0","0","0","0","0","0","0","0","0","0","0","0","0"
"2016","Calgary, Alberta, municipal","48014","All other Criminal Code (includes Part XII.1 Criminal Code)","13","11","1","0","0.99","1.05","0.97","0","0","12","11","11","0","0"
"1998","Calgary, Alberta, municipal","48014","Total Criminal Code traffic violations","2255","2225","7","0","268.24","0","0","0","0","2232","2217","2217","0","0"
"1999","Calgary, Alberta, municipal","48014","Total Criminal Code traffic violations","2235","2212","16","-3.36","259.22","0","0","0","0","2228","2199","2199","0","0"
"2000","Calgary, Alberta, municipal","48014","Total Criminal Code traffic violations","2304","2239","38","0.7","261.03","0","0","0","0","2277","2232","2232","0","0"
"2001","Calgary, Alberta, municipal","48014","Total Criminal Code traffic violations","2391","2343","25","1.53","265.03","0","0","0","0","2368","2340","2340","0","0"
"2002","Calgary, Alberta, municipal","48014","Total Criminal Code traffic violations","2521","2502","18","3","272.99","0","0","0","0","2520","2488","2488","0","0"
"2003","Calgary, Alberta, municipal","48014","Total Criminal Code traffic violations","2290","2281","14","-10.58","244.1","0","0","0","0","2295","2258","2258","0","0"
"2004","Calgary, Alberta, municipal","48014","Total Criminal Code traffic violations","2352","2303","19","-0.36","243.22","304.29","276.44","0","0","2322","2290","2290","0","0"
"2005","Calgary, Alberta, municipal","48014","Total Criminal Code traffic violations","2231","2159","69","-7.94","223.9","276.63","251.71","0","0","2228","2152","2152","0","0"
"2006","Calgary, Alberta, municipal","48014","Total Criminal Code traffic violations","2131","2059","50","-7.39","207.36","253.96","231.59","0","0","2109","2045","2045","0","0"
"2007","Calgary, Alberta, municipal","48014","Total Criminal Code traffic violations","2036","1934","83","-6.75","193.36","229.66","212.77","32.26","1.29","2017","1903","1928","25","1"
"2008","Calgary, Alberta, municipal","48014","Total Criminal Code traffic violations","2065","1994","65","-1.06","191.31","230","213.37","29.8","0","2059","1960","1983","23","0"
"2009","Calgary, Alberta, municipal","48014","Total Criminal Code traffic violations","2161","2076","59","2.02","195.18","231.12","215.26","36.1","0","2135","2024","2052","28","0"
"2010","Calgary, Alberta, municipal","48014","Total Criminal Code traffic violations","2099","2043","49","-4.3","186.79","225.15","210.4","42.32","1.28","2092","2000","2033","33","1"
"2011","Calgary, Alberta, municipal","48014","Total Criminal Code traffic violations","2161","2126","29","1.34","189.3","230.35","213.88","24.25","1.28","2155","2078","2097","19","1"
"2012","Calgary, Alberta, municipal","48014","Total Criminal Code traffic violations","2109","2076","31","-5.32","179.22","219.28","204.36","27.93","0","2107","2043","2065","22","0"
"2013","Calgary, Alberta, municipal","48014","Total Criminal Code traffic violations","1836","1796","22","-15.99","150.55","181.21","169.61","27.79","1.26","1818","1754","1776","22","1"
"2014","Calgary, Alberta, municipal","48014","Total Criminal Code traffic violations","1785","1765","16","-5.94","141.61","173.53","162.64","25.18","0","1781","1740","1760","20","0"
"2015","Calgary, Alberta, municipal","48014","Total Criminal Code traffic violations","1667","1629","10","-8.6","129.43","156.53","146.51","18.69","0","1639","1603","1618","15","0"
"2016","Calgary, Alberta, municipal","48014","Total Criminal Code traffic violations","1459","1449","12","-14.52","110.63","137.19","127.94","9.76","0","1461","1437","1445","8","0"
"1998","Calgary, Alberta, municipal","48014","Total impaired driving","1785","1775","6","0","212.33","0","0","0","0","1781","1772","1772","0","0"
"1999","Calgary, Alberta, municipal","48014","Total impaired driving","1781","1773","11","-2.72","206.56","0","0","0","0","1784","1774","1774","0","0"
"2000","Calgary, Alberta, municipal","48014","Total impaired driving","1865","1825","30","2.29","211.3","0","0","0","0","1855","1827","1827","0","0"
"2001","Calgary, Alberta, municipal","48014","Total impaired driving","1932","1914","19","1.35","214.16","0","0","0","0","1933","1914","1914","0","0"
"2002","Calgary, Alberta, municipal","48014","Total impaired driving","2007","2004","9","1.48","217.33","0","0","0","0","2013","2001","2001","0","0"
"2003","Calgary, Alberta, municipal","48014","Total impaired driving","1850","1848","9","-9.26","197.2","0","0","0","0","1857","1846","1846","0","0"
"2004","Calgary, Alberta, municipal","48014","Total impaired driving","1917","1897","9","0.53","198.24","252.33","229.24","0","0","1906","1899","1899","0","0"
"2005","Calgary, Alberta, municipal","48014","Total impaired driving","1851","1790","64","-6.29","185.76","230.1","209.37","0","0","1854","1790","1790","0","0"
"2006","Calgary, Alberta, municipal","48014","Total impaired driving","1708","1669","40","-10.53","166.2","207.15","188.89","0","0","1709","1668","1668","0","0"
"2007","Calgary, Alberta, municipal","48014","Total impaired driving","1675","1594","77","-4.29","159.07","191.04","175.69","11.61","1.29","1671","1583","1592","9","1"
"2008","Calgary, Alberta, municipal","48014","Total impaired driving","1678","1626","61","-2.27","155.46","189.52","174.75","11.66","0","1687","1615","1624","9","0"
"2009","Calgary, Alberta, municipal","48014","Total impaired driving","1711","1647","51","-0.59","154.54","185.79","172.25","19.34","0","1698","1627","1642","15","0"
"2010","Calgary, Alberta, municipal","48014","Total impaired driving","1713","1667","45","-1.35","152.44","185.87","172.42","19.23","1.28","1712","1651","1666","15","1"
"2011","Calgary, Alberta, municipal","48014","Total impaired driving","1779","1765","22","2.23","155.84","194.54","179.92","11.49","1.28","1787","1755","1764","9","1"
"2012","Calgary, Alberta, municipal","48014","Total impaired driving","1761","1745","25","-3.97","149.65","186.12","172.6","12.69","0","1770","1734","1744","10","0"
"2013","Calgary, Alberta, municipal","48014","Total impaired driving","1487","1457","18","-18.52","121.94","149.19","138.86","12.63","0","1475","1444","1454","10","0"
"2014","Calgary, Alberta, municipal","48014","Total impaired driving","1335","1328","11","-13.14","105.91","131.55","122.63","10.07","0","1339","1319","1327","8","0"
"2015","Calgary, Alberta, municipal","48014","Total impaired driving","1122","1115","6","-17.75","87.11","108.39","101.06","7.48","0","1121","1110","1116","6","0"
"2016","Calgary, Alberta, municipal","48014","Total impaired driving","943","943","5","-17.92","71.5","90.03","83.67","2.44","0","948","943","945","2","0"
"1998","Calgary, Alberta, municipal","48014","Impaired operation, causing death","0","0","0","0","0","0","0","0","0","0","0","0","0","0"
"1999","Calgary, Alberta, municipal","48014","Impaired operation, causing death","1","1","0","0","0.12","0","0","0","0","1","1","1","0","0"
"2000","Calgary, Alberta, municipal","48014","Impaired operation, causing death","6","6","0","486.1","0.68","0","0","0","0","6","6","6","0","0"
"2001","Calgary, Alberta, municipal","48014","Impaired operation, causing death","2","1","0","-67.39","0.22","0","0","0","0","1","1","1","0","0"
"2002","Calgary, Alberta, municipal","48014","Impaired operation, causing death","7","8","0","241.92","0.76","0","0","0","0","8","8","8","0","0"
"2003","Calgary, Alberta, municipal","48014","Impaired operation, causing death","6","5","0","-15.63","0.64","0","0","0","0","5","5","5","0","0"
"2004","Calgary, Alberta, municipal","48014","Impaired operation, causing death","3","3","0","-51.49","0.31","0.4","0.36","0","0","3","3","3","0","0"
"2005","Calgary, Alberta, municipal","48014","Impaired operation, causing death","4","5","0","29.4","0.4","0.64","0.58","0","0","5","5","5","0","0"
"2006","Calgary, Alberta, municipal","48014","Impaired operation, causing death","6","5","0","45.44","0.58","0.62","0.57","0","0","5","5","5","0","0"
"2007","Calgary, Alberta, municipal","48014","Impaired operation, causing death","2","3","0","-67.47","0.19","0.36","0.33","0","0","3","3","3","0","0"
"2008","Calgary, Alberta, municipal","48014","Impaired operation, causing death","2","2","0","-2.45","0.19","0.23","0.22","0","0","2","2","2","0","0"
"2009","Calgary, Alberta, municipal","48014","Impaired operation, causing death","3","3","0","46.23","0.27","0.34","0.31","0","0","3","3","3","0","0"
"2010","Calgary, Alberta, municipal","48014","Impaired operation, causing death","0","0","0","-100","0","0","0","0","0","0","0","0","0","0"
"2011","Calgary, Alberta, municipal","48014","Impaired operation, causing death","3","2","0","0","0.26","0.22","0.2","0","0","2","2","2","0","0"
"2012","Calgary, Alberta, municipal","48014","Impaired operation, causing death","4","5","0","29.35","0.34","0.43","0.4","0","0","5","4","4","0","0"
"2013","Calgary, Alberta, municipal","48014","Impaired operation, causing death","3","1","0","-27.63","0.25","0.1","0.1","0","0","1","1","1","0","0"
"2014","Calgary, Alberta, municipal","48014","Impaired operation, causing death","1","3","0","-67.75","0.08","0.3","0.28","0","0","3","3","3","0","0"
"2015","Calgary, Alberta, municipal","48014","Impaired operation, causing death","5","5","0","389.33","0.39","0.49","0.45","0","0","5","5","5","0","0"
"2016","Calgary, Alberta, municipal","48014","Impaired operation, causing death","1","1","0","-80.47","0.08","0.1","0.09","0","0","1","1","1","0","0"
"2005","Calgary, Alberta, municipal","48014","Impaired operation (drugs), causing death","0","0","0","0","0","0","0","0","0","0","0","0","0","0"
"2006","Calgary, Alberta, municipal","48014","Impaired operation (drugs), causing death","0","0","0","0","0","0","0","0","0","0","0","0","0","0"
"2007","Calgary, Alberta, municipal","48014","Impaired operation (drugs), causing death","0","0","0","0","0","0","0","0","0","0","0","0","0","0"
"2008","Calgary, Alberta, municipal","48014","Impaired operation (drugs), causing death","0","0","0","0","0","0","0","0","0","0","0","0","0","0"
"2009","Calgary, Alberta, municipal","48014","Impaired operation (drugs), causing death","1","1","0","0","0.09","0.11","0.1","0","0","1","1","1","0","0"
"2010","Calgary, Alberta, municipal","48014","Impaired operation (drugs), causing death","0","0","0","-100","0","0","0","0","0","0","0","0","0","0"
"2011","Calgary, Alberta, municipal","48014","Impaired operation (drugs), causing death","0","0","0","0","0","0","0","0","0","0","0","0","0","0"
"2012","Calgary, Alberta, municipal","48014","Impaired operation (drugs), causing death","0","0","0","0","0","0","0","0","0","0","0","0","0","0"
"2013","Calgary, Alberta, municipal","48014","Impaired operation (drugs), causing death","0","0","0","0","0","0","0","0","0","0","0","0","0","0"
"2014","Calgary, Alberta, municipal","48014","Impaired operation (drugs), causing death","0","0","0","0","0","0","0","0","0","0","0","0","0","0"
"2015","Calgary, Alberta, municipal","48014","Impaired operation (drugs), causing death","0","0","0","0","0","0","0","0","0","0","0","0","0","0"
"2016","Calgary, Alberta, municipal","48014","Impaired operation (drugs), causing death","0","0","0","0","0","0","0","0","0","0","0","0","0","0"
"1998","Calgary, Alberta, municipal","48014","Impaired operation, causing bodily harm","12","12","0","0","1.43","0","0","0","0","12","12","12","0","0"
"1999","Calgary, Alberta, municipal","48014","Impaired operation, causing bodily harm","18","17","0","46.25","2.09","0","0","0","0","17","17","17","0","0"
"2000","Calgary, Alberta, municipal","48014","Impaired operation, causing bodily harm","10","8","0","-45.73","1.13","0","0","0","0","8","8","8","0","0"
"2001","Calgary, Alberta, municipal","48014","Impaired operation, causing bodily harm","21","21","0","105.46","2.33","0","0","0","0","21","21","21","0","0"
"2002","Calgary, Alberta, municipal","48014","Impaired operation, causing bodily harm","16","17","1","-25.57","1.73","0","0","0","0","18","17","17","0","0"
"2003","Calgary, Alberta, municipal","48014","Impaired operation, causing bodily harm","11","11","0","-32.32","1.17","0","0","0","0","11","11","11","0","0"
"2004","Calgary, Alberta, municipal","48014","Impaired operation, causing bodily harm","12","11","1","5.83","1.24","1.46","1.33","0","0","12","11","11","0","0"
"2005","Calgary, Alberta, municipal","48014","Impaired operation, causing bodily harm","9","9","0","-27.21","0.9","1.16","1.05","0","0","9","9","9","0","0"
"2006","Calgary, Alberta, municipal","48014","Impaired operation, causing bodily harm","12","11","1","29.28","1.17","1.37","1.25","0","0","12","11","11","0","0"
"2007","Calgary, Alberta, municipal","48014","Impaired operation, causing bodily harm","19","15","3","54.53","1.8","1.69","1.55","0","0","18","14","14","0","0"
"2008","Calgary, Alberta, municipal","48014","Impaired operation, causing bodily harm","13","13","0","-33.25","1.2","1.29","1.29","1.3","0","13","11","12","1","0"
"2009","Calgary, Alberta, municipal","48014","Impaired operation, causing bodily harm","14","14","0","4.99","1.26","1.14","1.05","0","0","14","10","10","0","0"
"2010","Calgary, Alberta, municipal","48014","Impaired operation, causing bodily harm","10","9","0","-29.62","0.89","1.01","0.93","0","0","9","9","9","0","0"
"2011","Calgary, Alberta, municipal","48014","Impaired operation, causing bodily harm","8","10","0","-21.25","0.7","1","0.92","0","0","10","9","9","0","0"
"2012","Calgary, Alberta, municipal","48014","Impaired operation, causing bodily harm","9","9","0","9.14","0.76","0.97","0.89","0","0","9","9","9","0","0"
"2013","Calgary, Alberta, municipal","48014","Impaired operation, causing bodily harm","1","1","0","-89.28","0.08","0.1","0.1","0","0","1","1","1","0","0"
"2014","Calgary, Alberta, municipal","48014","Impaired operation, causing bodily harm","3","3","0","190.24","0.24","0.3","0.28","0","0","3","3","3","0","0"
"2015","Calgary, Alberta, municipal","48014","Impaired operation, causing bodily harm","3","3","0","-2.13","0.23","0.29","0.27","0","0","3","3","3","0","0"
"2016","Calgary, Alberta, municipal","48014","Impaired operation, causing bodily harm","3","3","0","-2.34","0.23","0.29","0.27","0","0","3","3","3","0","0"
"2005","Calgary, Alberta, municipal","48014","Impaired operation (drugs), causing bodily harm","0","0","0","0","0","0","0","0","0","0","0","0","0","0"
"2006","Calgary, Alberta, municipal","48014","Impaired operation (drugs), causing bodily harm","0","0","0","0","0","0","0","0","0","0","0","0","0","0"
"2007","Calgary, Alberta, municipal","48014","Impaired operation (drugs), causing bodily harm","0","0","0","0","0","0","0","0","0","0","0","0","0","0"
"2008","Calgary, Alberta, municipal","48014","Impaired operation (drugs), causing bodily harm","0","0","0","0","0","0","0","0","0","0","0","0","0","0"
"2009","Calgary, Alberta, municipal","48014","Impaired operation (drugs), causing bodily harm","0","0","0","0","0","0","0","0","0","0","0","0","0","0"
"2010","Calgary, Alberta, municipal","48014","Impaired operation (drugs), causing bodily harm","0","0","0","0","0","0","0","0","0","0","0","0","0","0"
"2011","Calgary, Alberta, municipal","48014","Impaired operation (drugs), causing bodily harm","1","1","0","0","0.09","0","0","0","0","1","0","0","0","0"
"2012","Calgary, Alberta, municipal","48014","Impaired operation (drugs), causing bodily harm","0","0","0","-100","0","0","0","0","0","0","0","0","0","0"
"2013","Calgary, Alberta, municipal","48014","Impaired operation (drugs), causing bodily harm","0","0","0","0","0","0","0","0","0","0","0","0","0","0"
"2014","Calgary, Alberta, municipal","48014","Impaired operation (drugs), causing bodily harm","0","0","0","0","0","0","0","0","0","0","0","0","0","0"
"2015","Calgary, Alberta, municipal","48014","Impaired operation (drugs), causing bodily harm","0","0","0","0","0","0","0","0","0","0","0","0","0","0"
"2016","Calgary, Alberta, municipal","48014","Impaired operation (drugs), causing bodily harm","0","0","0","0","0","0","0","0","0","0","0","0","0","0"
"1998","Calgary, Alberta, municipal","48014","Impaired operation of motor vehicle, vessel or aircraft","1768","1758","6","0","210.31","0","0","0","0","1764","1755","1755","0","0"
"1999","Calgary, Alberta, municipal","48014","Impaired operation of motor vehicle, vessel or aircraft","1755","1748","11","-3.21","203.55","0","0","0","0","1759","1750","1750","0","0"
"2000","Calgary, Alberta, municipal","48014","Impaired operation of motor vehicle, vessel or aircraft","1843","1805","30","2.58","208.8","0","0","0","0","1835","1807","1807","0","0"
"2001","Calgary, Alberta, municipal","48014","Impaired operation of motor vehicle, vessel or aircraft","1896","1880","19","0.65","210.17","0","0","0","0","1899","1880","1880","0","0"
"2002","Calgary, Alberta, municipal","48014","Impaired operation of motor vehicle, vessel or aircraft","1959","1953","8","0.94","212.13","0","0","0","0","1961","1950","1950","0","0"
"2003","Calgary, Alberta, municipal","48014","Impaired operation of motor vehicle, vessel or aircraft","1797","1796","9","-9.7","191.55","0","0","0","0","1805","1794","1794","0","0"
"2004","Calgary, Alberta, municipal","48014","Impaired operation of motor vehicle, vessel or aircraft","1842","1823","8","-0.56","190.48","242.5","220.3","0","0","1831","1825","1825","0","0"
"2005","Calgary, Alberta, municipal","48014","Impaired operation of motor vehicle, vessel or aircraft","1747","1685","64","-7.96","175.33","216.6","197.09","0","0","1749","1685","1685","0","0"
"2006","Calgary, Alberta, municipal","48014","Impaired operation of motor vehicle, vessel or aircraft","1622","1586","38","-9.98","157.83","196.84","179.49","0","0","1624","1585","1585","0","0"
"2007","Calgary, Alberta, municipal","48014","Impaired operation of motor vehicle, vessel or aircraft","1583","1507","72","-4.75","150.34","180.66","166.2","11.61","1.29","1579","1497","1506","9","1"
"2008","Calgary, Alberta, municipal","48014","Impaired operation of motor vehicle, vessel or aircraft","1567","1515","61","-3.43","145.17","176.73","162.91","10.36","0","1576","1506","1514","8","0"
"2009","Calgary, Alberta, municipal","48014","Impaired operation of motor vehicle, vessel or aircraft","1586","1523","50","-1.33","143.25","172.2","159.66","18.05","0","1573","1508","1522","14","0"
"2010","Calgary, Alberta, municipal","48014","Impaired operation of motor vehicle, vessel or aircraft","1606","1562","44","-0.23","142.92","174.04","161.55","19.23","1.28","1606","1546","1561","15","1"
"2011","Calgary, Alberta, municipal","48014","Impaired operation of motor vehicle, vessel or aircraft","1626","1612","21","-0.34","142.43","177.81","164.51","11.49","1.28","1633","1604","1613","9","1"
"2012","Calgary, Alberta, municipal","48014","Impaired operation of motor vehicle, vessel or aircraft","1599","1583","24","-4.6","135.88","168.83","156.66","12.69","0","1607","1573","1583","10","0"
"2013","Calgary, Alberta, municipal","48014","Impaired operation of motor vehicle, vessel or aircraft","1357","1331","16","-18.11","111.28","136.37","126.92","11.37","0","1347","1320","1329","9","0"
"2014","Calgary, Alberta, municipal","48014","Impaired operation of motor vehicle, vessel or aircraft","1204","1197","9","-14.16","95.52","118.48","110.52","10.07","0","1206","1188","1196","8","0"
"2015","Calgary, Alberta, municipal","48014","Impaired operation of motor vehicle, vessel or aircraft","999","991","6","-18.8","77.56","96.38","89.83","6.23","0","997","987","992","5","0"
"2016","Calgary, Alberta, municipal","48014","Impaired operation of motor vehicle, vessel or aircraft","824","827","4","-19.45","62.48","78.96","73.4","2.44","0","831","827","829","2","0"
"2005","Calgary, Alberta, municipal","48014","Impaired operation (drugs) vehicle, vessel, aircraft","0","0","0","0","0","0","0","0","0","0","0","0","0","0"
"2006","Calgary, Alberta, municipal","48014","Impaired operation (drugs) vehicle, vessel, aircraft","0","0","0","0","0","0","0","0","0","0","0","0","0","0"
"2007","Calgary, Alberta, municipal","48014","Impaired operation (drugs) vehicle, vessel, aircraft","0","0","0","0","0","0","0","0","0","0","0","0","0","0"
"2008","Calgary, Alberta, municipal","48014","Impaired operation (drugs) vehicle, vessel, aircraft","0","0","0","0","0","0","0","0","0","0","0","0","0","0"
"2009","Calgary, Alberta, municipal","48014","Impaired operation (drugs) vehicle, vessel, aircraft","1","0","1","0","0.09","0","0","0","0","1","0","0","0","0"
"2010","Calgary, Alberta, municipal","48014","Impaired operation (drugs) vehicle, vessel, aircraft","1","0","1","-1.47","0.09","0","0","0","0","1","0","0","0","0"
"2011","Calgary, Alberta, municipal","48014","Impaired operation (drugs) vehicle, vessel, aircraft","1","1","0","-1.57","0.09","0.11","0.1","0","0","1","1","1","0","0"
"2012","Calgary, Alberta, municipal","48014","Impaired operation (drugs) vehicle, vessel, aircraft","0","0","0","-100","0","0","0","0","0","0","0","0","0","0"
"2013","Calgary, Alberta, municipal","48014","Impaired operation (drugs) vehicle, vessel, aircraft","0","0","0","0","0","0","0","0","0","0","0","0","0","0"
"2014","Calgary, Alberta, municipal","48014","Impaired operation (drugs) vehicle, vessel, aircraft","0","0","0","0","0","0","0","0","0","0","0","0","0","0"
"2015","Calgary, Alberta, municipal","48014","Impaired operation (drugs) vehicle, vessel, aircraft","0","0","0","0","0","0","0","0","0","0","0","0","0","0"
"2016","Calgary, Alberta, municipal","48014","Impaired operation (drugs) vehicle, vessel, aircraft","5","3","0","0","0.38","0.29","0.27","0","0","3","3","3","0","0"
"1998","Calgary, Alberta, municipal","48014","Impaired operation, failure to provide breath sample","5","5","0","0","0.59","0","0","0","0","5","5","5","0","0"
"1999","Calgary, Alberta, municipal","48014","Impaired operation, failure to provide breath sample","7","7","0","36.5","0.81","0","0","0","0","7","6","6","0","0"
"2000","Calgary, Alberta, municipal","48014","Impaired operation, failure to provide breath sample","6","6","0","-16.27","0.68","0","0","0","0","6","6","6","0","0"
"2001","Calgary, Alberta, municipal","48014","Impaired operation, failure to provide breath sample","12","11","0","95.68","1.33","0","0","0","0","11","11","11","0","0"
"2002","Calgary, Alberta, municipal","48014","Impaired operation, failure to provide breath sample","25","26","0","103.52","2.71","0","0","0","0","26","26","26","0","0"
"2003","Calgary, Alberta, municipal","48014","Impaired operation, failure to provide breath sample","36","36","0","41.75","3.84","0","0","0","0","36","36","36","0","0"
"2004","Calgary, Alberta, municipal","48014","Impaired operation, failure to provide breath sample","59","59","0","59","6.1","7.84","7.12","0","0","59","59","59","0","0"
"2005","Calgary, Alberta, municipal","48014","Impaired operation, failure to provide breath sample","91","91","0","49.68","9.13","11.7","10.64","0","0","91","91","91","0","0"
"2006","Calgary, Alberta, municipal","48014","Impaired operation, failure to provide breath sample","68","67","1","-27.55","6.62","8.32","7.59","0","0","68","67","67","0","0"
"2007","Calgary, Alberta, municipal","48014","Impaired operation, failure to provide breath sample","70","68","2","0.47","6.65","8.21","7.5","0","0","70","68","68","0","0"
"2008","Calgary, Alberta, municipal","48014","Impaired operation, failure to provide breath sample","95","95","0","32.39","8.8","11.15","10.22","0","0","95","95","95","0","0"
"2009","Calgary, Alberta, municipal","48014","Impaired operation, failure to provide breath sample","105","105","0","7.75","9.48","11.88","11.01","1.29","0","105","104","105","1","0"
"2010","Calgary, Alberta, municipal","48014","Impaired operation, failure to provide breath sample","95","95","0","-10.85","8.45","10.69","9.83","0","0","95","95","95","0","0"
"2011","Calgary, Alberta, municipal","48014","Impaired operation, failure to provide breath sample","137","136","1","41.95","12","15.08","13.87","0","0","137","136","136","0","0"
"2012","Calgary, Alberta, municipal","48014","Impaired operation, failure to provide breath sample","149","148","1","5.51","12.66","15.89","14.65","0","0","149","148","148","0","0"
"2013","Calgary, Alberta, municipal","48014","Impaired operation, failure to provide breath sample","126","124","2","-18.4","10.33","12.6","11.75","1.26","0","126","122","123","1","0"
"2014","Calgary, Alberta, municipal","48014","Impaired operation, failure to provide breath sample","127","125","2","-2.49","10.08","12.47","11.55","0","0","127","125","125","0","0"
"2015","Calgary, Alberta, municipal","48014","Impaired operation, failure to provide breath sample","115","116","0","-11.38","8.93","11.23","10.5","1.25","0","116","115","116","1","0"
"2016","Calgary, Alberta, municipal","48014","Impaired operation, failure to provide breath sample","110","109","1","-6.58","8.34","10.41","9.65","0","0","110","109","109","0","0"
"2005","Calgary, Alberta, municipal","48014","Failure to comply or refusal (drugs)","0","0","0","0","0","0","0","0","0","0","0","0","0","0"
"2006","Calgary, Alberta, municipal","48014","Failure to comply or refusal (drugs)","0","0","0","0","0","0","0","0","0","0","0","0","0","0"
"2007","Calgary, Alberta, municipal","48014","Failure to comply or refusal (drugs)","0","0","0","0","0","0","0","0","0","0","0","0","0","0"
"2008","Calgary, Alberta, municipal","48014","Failure to comply or refusal (drugs)","0","0","0","0","0","0","0","0","0","0","0","0","0","0"
"2009","Calgary, Alberta, municipal","48014","Failure to comply or refusal (drugs)","1","1","0","0","0.09","0.11","0.1","0","0","1","1","1","0","0"
"2010","Calgary, Alberta, municipal","48014","Failure to comply or refusal (drugs)","1","1","0","-1.47","0.09","0.11","0.1","0","0","1","1","1","0","0"
"2011","Calgary, Alberta, municipal","48014","Failure to comply or refusal (drugs)","3","3","0","195.3","0.26","0.33","0.31","0","0","3","3","3","0","0"
"2012","Calgary, Alberta, municipal","48014","Failure to comply or refusal (drugs)","0","0","0","-100","0","0","0","0","0","0","0","0","0","0"
"2013","Calgary, Alberta, municipal","48014","Failure to comply or refusal (drugs)","0","0","0","0","0","0","0","0","0","0","0","0","0","0"
"2014","Calgary, Alberta, municipal","48014","Failure to comply or refusal (drugs)","0","0","0","0","0","0","0","0","0","0","0","0","0","0"
"2015","Calgary, Alberta, municipal","48014","Failure to comply or refusal (drugs)","0","0","0","0","0","0","0","0","0","0","0","0","0","0"
"2016","Calgary, Alberta, municipal","48014","Failure to comply or refusal (drugs)","0","0","0","0","0","0","0","0","0","0","0","0","0","0"
"1998","Calgary, Alberta, municipal","48014","Impaired operation, failure to provide blood sample","0","0","0","0","0","0","0","0","0","0","0","0","0","0"
"1999","Calgary, Alberta, municipal","48014","Impaired operation, failure to provide blood sample","0","0","0","0","0","0","0","0","0","0","0","0","0","0"
"2000","Calgary, Alberta, municipal","48014","Impaired operation, failure to provide blood sample","0","0","0","0","0","0","0","0","0","0","0","0","0","0"
"2001","Calgary, Alberta, municipal","48014","Impaired operation, failure to provide blood sample","1","1","0","0","0.11","0","0","0","0","1","1","1","0","0"
"2002","Calgary, Alberta, municipal","48014","Impaired operation, failure to provide blood sample","0","0","0","-100","0","0","0","0","0","0","0","0","0","0"
"2003","Calgary, Alberta, municipal","48014","Impaired operation, failure to provide blood sample","0","0","0","0","0","0","0","0","0","0","0","0","0","0"
"2004","Calgary, Alberta, municipal","48014","Impaired operation, failure to provide blood sample","1","1","0","0","0.1","0.13","0.12","0","0","1","1","1","0","0"
"2005","Calgary, Alberta, municipal","48014","Impaired operation, failure to provide blood sample","0","0","0","-100","0","0","0","0","0","0","0","0","0","0"
"2006","Calgary, Alberta, municipal","48014","Impaired operation, failure to provide blood sample","0","0","0","0","0","0","0","0","0","0","0","0","0","0"
"2007","Calgary, Alberta, municipal","48014","Impaired operation, failure to provide blood sample","1","1","0","0","0.09","0.12","0.11","0","0","1","1","1","0","0"
"2008","Calgary, Alberta, municipal","48014","Impaired operation, failure to provide blood sample","1","1","0","-2.45","0.09","0.12","0.11","0","0","1","1","1","0","0"
"2009","Calgary, Alberta, municipal","48014","Impaired operation, failure to provide blood sample","0","0","0","-100","0","0","0","0","0","0","0","0","0","0"
"2010","Calgary, Alberta, municipal","48014","Impaired operation, failure to provide blood sample","0","0","0","0","0","0","0","0","0","0","0","0","0","0"
"2011","Calgary, Alberta, municipal","48014","Impaired operation, failure to provide blood sample","0","0","0","0","0","0","0","0","0","0","0","0","0","0"
"2012","Calgary, Alberta, municipal","48014","Impaired operation, failure to provide blood sample","0","0","0","0","0","0","0","0","0","0","0","0","0","0"
"2013","Calgary, Alberta, municipal","48014","Impaired operation, failure to provide blood sample","0","0","0","0","0","0","0","0","0","0","0","0","0","0"
"2014","Calgary, Alberta, municipal","48014","Impaired operation, failure to provide blood sample","0","0","0","0","0","0","0","0","0","0","0","0","0","0"
"2015","Calgary, Alberta, municipal","48014","Impaired operation, failure to provide blood sample","0","0","0","0","0","0","0","0","0","0","0","0","0","0"
"2016","Calgary, Alberta, municipal","48014","Impaired operation, failure to provide blood sample","0","0","0","0","0","0","0","0","0","0","0","0","0","0"
"2005","Calgary, Alberta, municipal","48014","Failure to provide blood sample (drugs)","0","0","0","0","0","0","0","0","0","0","0","0","0","0"
"2006","Calgary, Alberta, municipal","48014","Failure to provide blood sample (drugs)","0","0","0","0","0","0","0","0","0","0","0","0","0","0"
"2007","Calgary, Alberta, municipal","48014","Failure to provide blood sample (drugs)","0","0","0","0","0","0","0","0","0","0","0","0","0","0"
"2008","Calgary, Alberta, municipal","48014","Failure to provide blood sample (drugs)","0","0","0","0","0","0","0","0","0","0","0","0","0","0"
"2009","Calgary, Alberta, municipal","48014","Failure to provide blood sample (drugs)","0","0","0","0","0","0","0","0","0","0","0","0","0","0"
"2010","Calgary, Alberta, municipal","48014","Failure to provide blood sample (drugs)","0","0","0","0","0","0","0","0","0","0","0","0","0","0"
"2011","Calgary, Alberta, municipal","48014","Failure to provide blood sample (drugs)","0","0","0","0","0","0","0","0","0","0","0","0","0","0"
"2012","Calgary, Alberta, municipal","48014","Failure to provide blood sample (drugs)","0","0","0","0","0","0","0","0","0","0","0","0","0","0"
"2013","Calgary, Alberta, municipal","48014","Failure to provide blood sample (drugs)","0","0","0","0","0","0","0","0","0","0","0","0","0","0"
"2014","Calgary, Alberta, municipal","48014","Failure to provide blood sample (drugs)","0","0","0","0","0","0","0","0","0","0","0","0","0","0"
"2015","Calgary, Alberta, municipal","48014","Failure to provide blood sample (drugs)","0","0","0","0","0","0","0","0","0","0","0","0","0","0"
"2016","Calgary, Alberta, municipal","48014","Failure to provide blood sample (drugs)","0","0","0","0","0","0","0","0","0","0","0","0","0","0"
"1998","Calgary, Alberta, municipal","48014","Total other Criminal Code traffic violations","470","450","1","0","55.91","0","0","0","0","451","445","445","0","0"
"1999","Calgary, Alberta, municipal","48014","Total other Criminal Code traffic violations","454","439","5","-5.82","52.66","0","0","0","0","444","425","425","0","0"
"2000","Calgary, Alberta, municipal","48014","Total other Criminal Code traffic violations","439","414","8","-5.54","49.74","0","0","0","0","422","405","405","0","0"
"2001","Calgary, Alberta, municipal","48014","Total other Criminal Code traffic violations","459","429","6","2.3","50.88","0","0","0","0","435","426","426","0","0"
"2002","Calgary, Alberta, municipal","48014","Total other Criminal Code traffic violations","514","498","9","9.4","55.66","0","0","0","0","507","487","487","0","0"
"2003","Calgary, Alberta, municipal","48014","Total other Criminal Code traffic violations","440","433","5","-15.73","46.9","0","0","0","0","438","412","412","0","0"
"2004","Calgary, Alberta, municipal","48014","Total other Criminal Code traffic violations","435","406","10","-4.09","44.98","51.95","47.2","0","0","416","391","391","0","0"
"2005","Calgary, Alberta, municipal","48014","Total other Criminal Code traffic violations","380","369","5","-15.22","38.14","46.53","42.34","0","0","374","362","362","0","0"
"2006","Calgary, Alberta, municipal","48014","Total other Criminal Code traffic violations","423","390","10","7.93","41.16","46.82","42.69","0","0","400","377","377","0","0"
"2007","Calgary, Alberta, municipal","48014","Total other Criminal Code traffic violations","361","340","6","-16.71","34.28","38.62","37.08","20.64","0","346","320","336","16","0"
"2008","Calgary, Alberta, municipal","48014","Total other Criminal Code traffic violations","387","368","4","4.58","35.85","40.49","38.63","18.14","0","372","345","359","14","0"
"2009","Calgary, Alberta, municipal","48014","Total other Criminal Code traffic violations","450","429","8","13.36","40.64","45.33","43.01","16.76","0","437","397","410","13","0"
"2010","Calgary, Alberta, municipal","48014","Total other Criminal Code traffic violations","386","376","4","-15.48","34.35","39.29","37.98","23.08","0","380","349","367","18","0"
"2011","Calgary, Alberta, municipal","48014","Total other Criminal Code traffic violations","382","361","7","-2.59","33.46","35.8","33.96","12.76","0","368","323","333","10","0"
"2012","Calgary, Alberta, municipal","48014","Total other Criminal Code traffic violations","348","331","6","-11.62","29.57","33.17","31.77","15.23","0","337","309","321","12","0"
"2013","Calgary, Alberta, municipal","48014","Total other Criminal Code traffic violations","349","339","4","-3.23","28.62","32.03","30.75","15.16","1.26","343","310","322","12","1"
"2014","Calgary, Alberta, municipal","48014","Total other Criminal Code traffic violations","450","437","5","24.74","35.7","41.99","40.01","15.11","0","442","421","433","12","0"
"2015","Calgary, Alberta, municipal","48014","Total other Criminal Code traffic violations","545","514","4","18.53","42.31","48.14","45.46","11.22","0","518","493","502","9","0"
"2016","Calgary, Alberta, municipal","48014","Total other Criminal Code traffic violations","516","506","7","-7.53","39.13","47.16","44.27","7.32","0","513","494","500","6","0"
"1998","Calgary, Alberta, municipal","48014","Dangerous operation, causing death","6","5","0","0","0.71","0","0","0","0","5","5","5","0","0"
"1999","Calgary, Alberta, municipal","48014","Dangerous operation, causing death","4","5","0","-35","0.46","0","0","0","0","5","5","5","0","0"
"2000","Calgary, Alberta, municipal","48014","Dangerous operation, causing death","1","1","0","-75.58","0.11","0","0","0","0","1","1","1","0","0"
"2001","Calgary, Alberta, municipal","48014","Dangerous operation, causing death","2","2","0","95.68","0.22","0","0","0","0","2","2","2","0","0"
"2002","Calgary, Alberta, municipal","48014","Dangerous operation, causing death","2","2","0","-2.31","0.22","0","0","0","0","2","2","2","0","0"
"2003","Calgary, Alberta, municipal","48014","Dangerous operation, causing death","0","0","0","-100","0","0","0","0","0","0","0","0","0","0"
"2004","Calgary, Alberta, municipal","48014","Dangerous operation, causing death","0","0","0","0","0","0","0","0","0","0","0","0","0","0"
"2005","Calgary, Alberta, municipal","48014","Dangerous operation, causing death","1","1","0","0","0.1","0.13","0.12","0","0","1","1","1","0","0"
"2006","Calgary, Alberta, municipal","48014","Dangerous operation, causing death","6","3","1","481.74","0.58","0.25","0.23","0","0","4","2","2","0","0"
"2007","Calgary, Alberta, municipal","48014","Dangerous operation, causing death","3","3","1","-51.2","0.28","0.24","0.22","0","0","4","2","2","0","0"
"2008","Calgary, Alberta, municipal","48014","Dangerous operation, causing death","1","1","0","-67.48","0.09","0.12","0.11","0","0","1","1","1","0","0"
"2009","Calgary, Alberta, municipal","48014","Dangerous operation, causing death","0","1","0","-100","0","0","0.1","1.29","0","1","0","1","1","0"
"2010","Calgary, Alberta, municipal","48014","Dangerous operation, causing death","0","0","0","0","0","0","0","0","0","0","0","0","0","0"
"2011","Calgary, Alberta, municipal","48014","Dangerous operation, causing death","2","2","0","0","0.18","0.11","0.2","1.28","0","2","1","2","1","0"
"2012","Calgary, Alberta, municipal","48014","Dangerous operation, causing death","3","3","0","45.52","0.25","0.32","0.3","0","0","3","3","3","0","0"
"2013","Calgary, Alberta, municipal","48014","Dangerous operation, causing death","0","0","0","-100","0","0","0","0","0","0","0","0","0","0"
"2014","Calgary, Alberta, municipal","48014","Dangerous operation, causing death","0","0","0","0","0","0","0","0","0","0","0","0","0","0"
"2015","Calgary, Alberta, municipal","48014","Dangerous operation, causing death","0","0","0","0","0","0","0","0","0","0","0","0","0","0"
"2016","Calgary, Alberta, municipal","48014","Dangerous operation, causing death","0","0","0","0","0","0","0","0","0","0","0","0","0","0"
"1998","Calgary, Alberta, municipal","48014","Dangerous operation, causing bodily harm","14","13","0","0","1.67","0","0","0","0","13","14","14","0","0"
"1999","Calgary, Alberta, municipal","48014","Dangerous operation, causing bodily harm","21","22","0","46.25","2.44","0","0","0","0","22","21","21","0","0"
"2000","Calgary, Alberta, municipal","48014","Dangerous operation, causing bodily harm","16","15","0","-25.57","1.81","0","0","0","0","15","15","15","0","0"
"2001","Calgary, Alberta, municipal","48014","Dangerous operation, causing bodily harm","13","11","0","-20.51","1.44","0","0","0","0","11","11","11","0","0"
"2002","Calgary, Alberta, municipal","48014","Dangerous operation, causing bodily harm","16","15","0","20.23","1.73","0","0","0","0","15","15","15","0","0"
"2003","Calgary, Alberta, municipal","48014","Dangerous operation, causing bodily harm","19","20","0","16.89","2.03","0","0","0","0","20","20","20","0","0"
"2004","Calgary, Alberta, municipal","48014","Dangerous operation, causing bodily harm","13","12","1","-33.62","1.34","1.33","1.21","0","0","13","10","10","0","0"
"2005","Calgary, Alberta, municipal","48014","Dangerous operation, causing bodily harm","5","5","0","-62.67","0.5","0.51","0.47","0","0","5","4","4","0","0"
"2006","Calgary, Alberta, municipal","48014","Dangerous operation, causing bodily harm","11","9","0","113.31","1.07","0.99","0.91","0","0","9","8","8","0","0"
"2007","Calgary, Alberta, municipal","48014","Dangerous operation, causing bodily harm","16","10","1","41.96","1.52","0.97","0.99","1.29","0","11","8","9","1","0"
"2008","Calgary, Alberta, municipal","48014","Dangerous operation, causing bodily harm","19","20","0","15.84","1.76","1.99","2.04","2.59","0","20","17","19","2","0"
"2009","Calgary, Alberta, municipal","48014","Dangerous operation, causing bodily harm","12","11","1","-38.43","1.08","1.03","1.05","1.29","0","12","9","10","1","0"
"2010","Calgary, Alberta, municipal","48014","Dangerous operation, causing bodily harm","11","10","0","-9.68","0.98","0.9","0.93","1.28","0","10","8","9","1","0"
"2011","Calgary, Alberta, municipal","48014","Dangerous operation, causing bodily harm","14","12","2","25.28","1.23","0.55","0.51","0","0","14","5","5","0","0"
"2012","Calgary, Alberta, municipal","48014","Dangerous operation, causing bodily harm","6","8","0","-58.42","0.51","0.54","0.49","0","0","8","5","5","0","0"
"2013","Calgary, Alberta, municipal","48014","Dangerous operation, causing bodily harm","6","6","0","-3.5","0.49","0.62","0.57","0","0","6","6","6","0","0"
"2014","Calgary, Alberta, municipal","48014","Dangerous operation, causing bodily harm","3","3","0","-51.63","0.24","0.3","0.28","0","0","3","3","3","0","0"
"2015","Calgary, Alberta, municipal","48014","Dangerous operation, causing bodily harm","6","5","0","95.73","0.47","0.39","0.45","1.25","0","5","4","5","1","0"
"2016","Calgary, Alberta, municipal","48014","Dangerous operation, causing bodily harm","5","5","0","-18.61","0.38","0.48","0.44","0","0","5","5","5","0","0"
"1998","Calgary, Alberta, municipal","48014","Dangerous operation of motor vehicle, vessel or aircraft","211","203","1","0","25.1","0","0","0","0","204","205","205","0","0"
"1999","Calgary, Alberta, municipal","48014","Dangerous operation of motor vehicle, vessel or aircraft","215","210","3","-0.65","24.94","0","0","0","0","213","208","208","0","0"
"2000","Calgary, Alberta, municipal","48014","Dangerous operation of motor vehicle, vessel or aircraft","152","146","3","-30.94","17.22","0","0","0","0","149","148","148","0","0"
"2001","Calgary, Alberta, municipal","48014","Dangerous operation of motor vehicle, vessel or aircraft","177","167","3","13.93","19.62","0","0","0","0","170","177","177","0","0"
"2002","Calgary, Alberta, municipal","48014","Dangerous operation of motor vehicle, vessel or aircraft","186","181","5","2.66","20.14","0","0","0","0","186","187","187","0","0"
"2003","Calgary, Alberta, municipal","48014","Dangerous operation of motor vehicle, vessel or aircraft","166","164","1","-12.15","17.69","0","0","0","0","165","163","163","0","0"
"2004","Calgary, Alberta, municipal","48014","Dangerous operation of motor vehicle, vessel or aircraft","165","155","4","-3.57","17.06","20.46","18.59","0","0","159","154","154","0","0"
"2005","Calgary, Alberta, municipal","48014","Dangerous operation of motor vehicle, vessel or aircraft","148","144","2","-12.95","14.85","18.77","17.08","0","0","146","146","146","0","0"
"2006","Calgary, Alberta, municipal","48014","Dangerous operation of motor vehicle, vessel or aircraft","162","152","8","6.13","15.76","18.63","16.99","0","0","160","150","150","0","0"
"2007","Calgary, Alberta, municipal","48014","Dangerous operation of motor vehicle, vessel or aircraft","146","139","4","-12.04","13.87","15.81","15.45","11.61","0","143","131","140","9","0"
"2008","Calgary, Alberta, municipal","48014","Dangerous operation of motor vehicle, vessel or aircraft","158","157","1","5.57","14.64","17.37","16.89","11.66","0","158","148","157","9","0"
"2009","Calgary, Alberta, municipal","48014","Dangerous operation of motor vehicle, vessel or aircraft","179","170","6","10.45","16.17","18.16","17.41","9.03","0","176","159","166","7","0"
"2010","Calgary, Alberta, municipal","48014","Dangerous operation of motor vehicle, vessel or aircraft","155","150","2","-14.68","13.79","15.99","15.42","8.98","0","152","142","149","7","0"
"2011","Calgary, Alberta, municipal","48014","Dangerous operation of motor vehicle, vessel or aircraft","141","137","2","-10.46","12.35","14.52","13.97","7.66","0","139","131","137","6","0"
"2012","Calgary, Alberta, municipal","48014","Dangerous operation of motor vehicle, vessel or aircraft","123","121","3","-15.37","10.45","12.02","11.88","10.16","0","124","112","120","8","0"
"2013","Calgary, Alberta, municipal","48014","Dangerous operation of motor vehicle, vessel or aircraft","130","125","3","1.99","10.66","11.98","11.84","10.11","0","128","116","124","8","0"
"2014","Calgary, Alberta, municipal","48014","Dangerous operation of motor vehicle, vessel or aircraft","154","149","2","14.61","12.22","13.86","13.68","11.33","0","151","139","148","9","0"
"2015","Calgary, Alberta, municipal","48014","Dangerous operation of motor vehicle, vessel or aircraft","148","146","0","-5.95","11.49","14.06","13.4","4.98","0","146","144","148","4","0"
"2016","Calgary, Alberta, municipal","48014","Dangerous operation of motor vehicle, vessel or aircraft","182","184","2","20.1","13.8","17.19","16.2","3.66","0","186","180","183","3","0"
"2000","Calgary, Alberta, municipal","48014","Dangerous operation evading police, causing death","0","0","0","0","0","0","0","0","0","0","0","0","0","0"
"2001","Calgary, Alberta, municipal","48014","Dangerous operation evading police, causing death","0","0","0","0","0","0","0","0","0","0","0","0","0","0"
"2002","Calgary, Alberta, municipal","48014","Dangerous operation evading police, causing death","0","0","0","0","0","0","0","0","0","0","0","0","0","0"
"2003","Calgary, Alberta, municipal","48014","Dangerous operation evading police, causing death","0","0","0","0","0","0","0","0","0","0","0","0","0","0"
"2004","Calgary, Alberta, municipal","48014","Dangerous operation evading police, causing death","0","0","0","0","0","0","0","0","0","0","0","0","0","0"
"2005","Calgary, Alberta, municipal","48014","Dangerous operation evading police, causing death","0","0","0","0","0","0","0","0","0","0","0","0","0","0"
"2006","Calgary, Alberta, municipal","48014","Dangerous operation evading police, causing death","0","0","0","0","0","0","0","0","0","0","0","0","0","0"
"2007","Calgary, Alberta, municipal","48014","Dangerous operation evading police, causing death","0","0","0","0","0","0","0","0","0","0","0","0","0","0"
"2008","Calgary, Alberta, municipal","48014","Dangerous operation evading police, causing death","0","0","0","0","0","0","0","0","0","0","0","0","0","0"
"2009","Calgary, Alberta, municipal","48014","Dangerous operation evading police, causing death","0","0","0","0","0","0","0","0","0","0","0","0","0","0"
"2010","Calgary, Alberta, municipal","48014","Dangerous operation evading police, causing death","0","0","0","0","0","0","0","0","0","0","0","0","0","0"
"2011","Calgary, Alberta, municipal","48014","Dangerous operation evading police, causing death","0","0","0","0","0","0","0","0","0","0","0","0","0","0"
"2012","Calgary, Alberta, municipal","48014","Dangerous operation evading police, causing death","0","0","0","0","0","0","0","0","0","0","0","0","0","0"
"2013","Calgary, Alberta, municipal","48014","Dangerous operation evading police, causing death","0","0","0","0","0","0","0","0","0","0","0","0","0","0"
"2014","Calgary, Alberta, municipal","48014","Dangerous operation evading police, causing death","0","0","0","0","0","0","0","0","0","0","0","0","0","0"
"2015","Calgary, Alberta, municipal","48014","Dangerous operation evading police, causing death","0","0","0","0","0","0","0","0","0","0","0","0","0","0"
"2016","Calgary, Alberta, municipal","48014","Dangerous operation evading police, causing death","0","0","0","0","0","0","0","0","0","0","0","0","0","0"
"2000","Calgary, Alberta, municipal","48014","Dangerous operation evading police, causing bodily harm","0","0","0","0","0","0","0","0","0","0","0","0","0","0"
"2001","Calgary, Alberta, municipal","48014","Dangerous operation evading police, causing bodily harm","1","1","0","0","0.11","0","0","0","0","1","1","1","0","0"
"2002","Calgary, Alberta, municipal","48014","Dangerous operation evading police, causing bodily harm","0","0","0","-100","0","0","0","0","0","0","0","0","0","0"
"2003","Calgary, Alberta, municipal","48014","Dangerous operation evading police, causing bodily harm","0","0","0","0","0","0","0","0","0","0","0","0","0","0"
"2004","Calgary, Alberta, municipal","48014","Dangerous operation evading police, causing bodily harm","0","0","0","0","0","0","0","0","0","0","0","0","0","0"
"2005","Calgary, Alberta, municipal","48014","Dangerous operation evading police, causing bodily harm","1","1","0","0","0.1","0.13","0.12","0","0","1","1","1","0","0"
"2006","Calgary, Alberta, municipal","48014","Dangerous operation evading police, causing bodily harm","1","1","0","-3.04","0.1","0.12","0.11","0","0","1","1","1","0","0"
"2007","Calgary, Alberta, municipal","48014","Dangerous operation evading police, causing bodily harm","0","0","0","-100","0","0","0","0","0","0","0","0","0","0"
"2008","Calgary, Alberta, municipal","48014","Dangerous operation evading police, causing bodily harm","2","2","0","0","0.19","0.12","0.11","0","0","2","1","1","0","0"
"2009","Calgary, Alberta, municipal","48014","Dangerous operation evading police, causing bodily harm","1","1","0","-51.26","0.09","0","0","0","0","1","0","0","0","0"
"2010","Calgary, Alberta, municipal","48014","Dangerous operation evading police, causing bodily harm","0","0","0","-100","0","0","0","0","0","0","0","0","0","0"
"2011","Calgary, Alberta, municipal","48014","Dangerous operation evading police, causing bodily harm","2","2","0","0","0.18","0","0","0","0","2","0","0","0","0"
"2012","Calgary, Alberta, municipal","48014","Dangerous operation evading police, causing bodily harm","0","0","0","-100","0","0","0","0","0","0","0","0","0","0"
"2013","Calgary, Alberta, municipal","48014","Dangerous operation evading police, causing bodily harm","0","0","0","0","0","0","0","0","0","0","0","0","0","0"
"2014","Calgary, Alberta, municipal","48014","Dangerous operation evading police, causing bodily harm","0","0","0","0","0","0","0","0","0","0","0","0","0","0"
"2015","Calgary, Alberta, municipal","48014","Dangerous operation evading police, causing bodily harm","0","0","0","0","0","0","0","0","0","0","0","0","0","0"
"2016","Calgary, Alberta, municipal","48014","Dangerous operation evading police, causing bodily harm","1","1","0","0","0.08","0.1","0.09","0","0","1","1","1","0","0"
"2000","Calgary, Alberta, municipal","48014","Dangerous operation of motor vehicle evading police","5","5","0","0","0.57","0","0","0","0","5","4","4","0","0"
"2001","Calgary, Alberta, municipal","48014","Dangerous operation of motor vehicle evading police","15","15","0","193.52","1.66","0","0","0","0","15","11","11","0","0"
"2002","Calgary, Alberta, municipal","48014","Dangerous operation of motor vehicle evading police","7","6","1","-54.41","0.76","0","0","0","0","7","4","4","0","0"
"2003","Calgary, Alberta, municipal","48014","Dangerous operation of motor vehicle evading police","11","10","1","54.69","1.17","0","0","0","0","11","10","10","0","0"
"2004","Calgary, Alberta, municipal","48014","Dangerous operation of motor vehicle evading police","7","5","0","-38.26","0.72","0.66","0.6","0","0","5","5","5","0","0"
"2005","Calgary, Alberta, municipal","48014","Dangerous operation of motor vehicle evading police","9","9","0","24.78","0.9","1.16","1.05","0","0","9","9","9","0","0"
"2006","Calgary, Alberta, municipal","48014","Dangerous operation of motor vehicle evading police","5","5","0","-46.13","0.49","0.37","0.34","0","0","5","3","3","0","0"
"2007","Calgary, Alberta, municipal","48014","Dangerous operation of motor vehicle evading police","10","10","0","95.2","0.95","0.97","1.1","2.58","0","10","8","10","2","0"
"2008","Calgary, Alberta, municipal","48014","Dangerous operation of motor vehicle evading police","8","5","2","-21.96","0.74","0.47","0.54","1.3","0","7","4","5","1","0"
"2009","Calgary, Alberta, municipal","48014","Dangerous operation of motor vehicle evading police","17","15","0","107.16","1.54","1.48","1.57","2.58","0","15","13","15","2","0"
"2010","Calgary, Alberta, municipal","48014","Dangerous operation of motor vehicle evading police","12","13","1","-30.45","1.07","1.13","1.14","1.28","0","14","10","11","1","0"
"2011","Calgary, Alberta, municipal","48014","Dangerous operation of motor vehicle evading police","16","15","0","31.24","1.4","1.55","1.43","0","0","15","14","14","0","0"
"2012","Calgary, Alberta, municipal","48014","Dangerous operation of motor vehicle evading police","14","13","0","-15.12","1.19","1.4","1.39","1.27","0","13","13","14","1","0"
"2013","Calgary, Alberta, municipal","48014","Dangerous operation of motor vehicle evading police","6","5","0","-58.64","0.49","0.41","0.48","1.26","0","5","4","5","1","0"
"2014","Calgary, Alberta, municipal","48014","Dangerous operation of motor vehicle evading police","6","6","0","-3.25","0.48","0.4","0.46","1.26","0","6","4","5","1","0"
"2015","Calgary, Alberta, municipal","48014","Dangerous operation of motor vehicle evading police","12","12","1","95.73","0.93","1.17","1.09","0","0","13","12","12","0","0"
"2016","Calgary, Alberta, municipal","48014","Dangerous operation of motor vehicle evading police","6","6","0","-51.17","0.45","0.48","0.44","0","0","6","5","5","0","0"
"1998","Calgary, Alberta, municipal","48014","Total fail to stop or remain","89","79","0","0","10.59","0","0","0","0","79","72","72","0","0"
"1999","Calgary, Alberta, municipal","48014","Total fail to stop or remain","66","55","2","-27.69","7.65","0","0","0","0","57","44","44","0","0"
"2000","Calgary, Alberta, municipal","48014","Total fail to stop or remain","91","72","5","34.69","10.31","0","0","0","0","77","64","64","0","0"
"2001","Calgary, Alberta, municipal","48014","Total fail to stop or remain","70","53","1","-24.74","7.76","0","0","0","0","54","44","44","0","0"
"2002","Calgary, Alberta, municipal","48014","Total fail to stop or remain","74","69","3","3.27","8.01","0","0","0","0","72","57","57","0","0"
"2003","Calgary, Alberta, municipal","48014","Total fail to stop or remain","52","50","1","-30.83","5.54","0","0","0","0","51","33","33","0","0"
"2004","Calgary, Alberta, municipal","48014","Total fail to stop or remain","67","54","3","25","6.93","5.85","5.31","0","0","57","44","44","0","0"
"2005","Calgary, Alberta, municipal","48014","Total fail to stop or remain","40","28","2","-42.06","4.01","3.09","2.81","0","0","30","24","24","0","0"
"2006","Calgary, Alberta, municipal","48014","Total fail to stop or remain","51","34","0","23.62","4.96","3.73","3.4","0","0","34","30","30","0","0"
"2007","Calgary, Alberta, municipal","48014","Total fail to stop or remain","31","22","0","-40.67","2.94","2.17","2.21","2.58","0","22","18","20","2","0"
"2008","Calgary, Alberta, municipal","48014","Total fail to stop or remain","37","25","0","16.43","3.43","2.11","2.15","2.59","0","25","18","20","2","0"
"2009","Calgary, Alberta, municipal","48014","Total fail to stop or remain","36","26","1","-5.15","3.25","2.28","2.2","1.29","0","27","20","21","1","0"
"2010","Calgary, Alberta, municipal","48014","Total fail to stop or remain","40","34","0","9.48","3.56","3.04","3.52","8.98","0","34","27","34","7","0"
"2011","Calgary, Alberta, municipal","48014","Total fail to stop or remain","43","29","3","5.82","3.77","2.66","2.55","1.28","0","32","24","25","1","0"
"2012","Calgary, Alberta, municipal","48014","Total fail to stop or remain","34","22","1","-23.29","2.89","1.72","1.88","3.81","0","23","16","19","3","0"
"2013","Calgary, Alberta, municipal","48014","Total fail to stop or remain","35","32","1","-0.67","2.87","2.79","2.87","3.79","1.26","33","27","30","3","1"
"2014","Calgary, Alberta, municipal","48014","Total fail to stop or remain","31","23","2","-14.31","2.46","2.29","2.13","0","0","25","23","23","0","0"
"2015","Calgary, Alberta, municipal","48014","Total fail to stop or remain","65","41","2","105.2","5.05","3.22","3.17","2.49","0","43","33","35","2","0"
"2016","Calgary, Alberta, municipal","48014","Total fail to stop or remain","45","30","1","-32.39","3.41","2.77","2.74","2.44","0","31","29","31","2","0"
"1998","Calgary, Alberta, municipal","48014","Driving while prohibited","150","150","0","0","17.84","0","0","0","0","150","149","149","0","0"
"1999","Calgary, Alberta, municipal","48014","Driving while prohibited","148","147","0","-3.8","17.17","0","0","0","0","147","147","147","0","0"
"2000","Calgary, Alberta, municipal","48014","Driving while prohibited","174","175","0","14.84","19.71","0","0","0","0","175","173","173","0","0"
"2001","Calgary, Alberta, municipal","48014","Driving while prohibited","181","180","2","1.77","20.06","0","0","0","0","182","180","180","0","0"
"2002","Calgary, Alberta, municipal","48014","Driving while prohibited","229","225","0","23.6","24.8","0","0","0","0","225","222","222","0","0"
"2003","Calgary, Alberta, municipal","48014","Driving while prohibited","192","189","2","-17.47","20.47","0","0","0","0","191","186","186","0","0"
"2004","Calgary, Alberta, municipal","48014","Driving while prohibited","183","180","2","-7.53","18.92","23.65","21.49","0","0","182","178","178","0","0"
"2005","Calgary, Alberta, municipal","48014","Driving while prohibited","176","181","1","-6.66","17.66","22.75","20.7","0","0","182","177","177","0","0"
"2006","Calgary, Alberta, municipal","48014","Driving while prohibited","187","186","1","3.02","18.2","22.73","20.72","0","0","187","183","183","0","0"
"2007","Calgary, Alberta, municipal","48014","Driving while prohibited","155","156","0","-19.1","14.72","18.46","17.11","2.58","0","156","153","155","2","0"
"2008","Calgary, Alberta, municipal","48014","Driving while prohibited","162","158","1","1.96","15.01","18.31","16.79","0","0","159","156","156","0","0"
"2009","Calgary, Alberta, municipal","48014","Driving while prohibited","205","205","0","23.37","18.52","22.38","20.67","1.29","0","205","196","197","1","0"
"2010","Calgary, Alberta, municipal","48014","Driving while prohibited","168","169","1","-19.25","14.95","18.24","16.97","2.56","0","170","162","164","2","0"
"2011","Calgary, Alberta, municipal","48014","Driving while prohibited","164","164","0","-3.91","14.37","16.41","15.3","2.55","0","164","148","150","2","0"
"2012","Calgary, Alberta, municipal","48014","Driving while prohibited","168","164","2","-0.62","14.28","17.17","15.83","0","0","166","160","160","0","0"
"2013","Calgary, Alberta, municipal","48014","Driving while prohibited","171","170","0","-1.78","14.02","16.12","14.9","0","0","170","156","156","0","0"
"2014","Calgary, Alberta, municipal","48014","Driving while prohibited","256","256","1","44.84","20.31","25.13","23.47","2.52","0","257","252","254","2","0"
"2015","Calgary, Alberta, municipal","48014","Driving while prohibited","313","310","1","19.66","24.3","29.29","27.35","2.49","0","311","300","302","2","0"
"2016","Calgary, Alberta, municipal","48014","Driving while prohibited","277","279","4","-13.57","21","26.06","24.26","1.22","0","283","273","274","1","0"
"1998","Calgary, Alberta, municipal","48014","Other Criminal Code traffic violations","0","0","0","0","0","0","0","0","0","0","0","0","0","0"
"1999","Calgary, Alberta, municipal","48014","Other Criminal Code traffic violations","0","0","0","0","0","0","0","0","0","0","0","0","0","0"
"2000","Calgary, Alberta, municipal","48014","Other Criminal Code traffic violations","0","0","0","0","0","0","0","0","0","0","0","0","0","0"
"2001","Calgary, Alberta, municipal","48014","Other Criminal Code traffic violations","0","0","0","0","0","0","0","0","0","0","0","0","0","0"
"2002","Calgary, Alberta, municipal","48014","Other Criminal Code traffic violations","0","0","0","0","0","0","0","0","0","0","0","0","0","0"
"2003","Calgary, Alberta, municipal","48014","Other Criminal Code traffic violations","0","0","0","0","0","0","0","0","0","0","0","0","0","0"
"2004","Calgary, Alberta, municipal","48014","Other Criminal Code traffic violations","0","0","0","0","0","0","0","0","0","0","0","0","0","0"
"2005","Calgary, Alberta, municipal","48014","Other Criminal Code traffic violations","0","0","0","0","0","0","0","0","0","0","0","0","0","0"
"2006","Calgary, Alberta, municipal","48014","Other Criminal Code traffic violations","0","0","0","0","0","0","0","0","0","0","0","0","0","0"
"2007","Calgary, Alberta, municipal","48014","Other Criminal Code traffic violations","0","0","0","0","0","0","0","0","0","0","0","0","0","0"
"2008","Calgary, Alberta, municipal","48014","Other Criminal Code traffic violations","0","0","0","0","0","0","0","0","0","0","0","0","0","0"
"2009","Calgary, Alberta, municipal","48014","Other Criminal Code traffic violations","0","0","0","0","0","0","0","0","0","0","0","0","0","0"
"2010","Calgary, Alberta, municipal","48014","Other Criminal Code traffic violations","0","0","0","0","0","0","0","0","0","0","0","0","0","0"
"2011","Calgary, Alberta, municipal","48014","Other Criminal Code traffic violations","0","0","0","0","0","0","0","0","0","0","0","0","0","0"
"2012","Calgary, Alberta, municipal","48014","Other Criminal Code traffic violations","0","0","0","0","0","0","0","0","0","0","0","0","0","0"
"2013","Calgary, Alberta, municipal","48014","Other Criminal Code traffic violations","0","0","0","0","0","0","0","0","0","0","0","0","0","0"
"2014","Calgary, Alberta, municipal","48014","Other Criminal Code traffic violations","0","0","0","0","0","0","0","0","0","0","0","0","0","0"
"2015","Calgary, Alberta, municipal","48014","Other Criminal Code traffic violations","0","0","0","0","0","0","0","0","0","0","0","0","0","0"
"2016","Calgary, Alberta, municipal","48014","Other Criminal Code traffic violations","0","0","0","0","0","0","0","0","0","0","0","0","0","0"
"2005","Calgary, Alberta, municipal","48014","Causing death by criminal negligence while street racing","0","0","0","0","0","0","0","0","0","0","0","0","0","0"
"2006","Calgary, Alberta, municipal","48014","Causing death by criminal negligence while street racing","0","0","0","0","0","0","0","0","0","0","0","0","0","0"
"2007","Calgary, Alberta, municipal","48014","Causing death by criminal negligence while street racing","0","0","0","0","0","0","0","0","0","0","0","0","0","0"
"2008","Calgary, Alberta, municipal","48014","Causing death by criminal negligence while street racing","0","0","0","0","0","0","0","0","0","0","0","0","0","0"
"2009","Calgary, Alberta, municipal","48014","Causing death by criminal negligence while street racing","0","0","0","0","0","0","0","0","0","0","0","0","0","0"
"2010","Calgary, Alberta, municipal","48014","Causing death by criminal negligence while street racing","0","0","0","0","0","0","0","0","0","0","0","0","0","0"
"2011","Calgary, Alberta, municipal","48014","Causing death by criminal negligence while street racing","0","0","0","0","0","0","0","0","0","0","0","0","0","0"
"2012","Calgary, Alberta, municipal","48014","Causing death by criminal negligence while street racing","0","0","0","0","0","0","0","0","0","0","0","0","0","0"
"2013","Calgary, Alberta, municipal","48014","Causing death by criminal negligence while street racing","0","0","0","0","0","0","0","0","0","0","0","0","0","0"
"2014","Calgary, Alberta, municipal","48014","Causing death by criminal negligence while street racing","0","0","0","0","0","0","0","0","0","0","0","0","0","0"
"2015","Calgary, Alberta, municipal","48014","Causing death by criminal negligence while street racing","0","0","0","0","0","0","0","0","0","0","0","0","0","0"
"2016","Calgary, Alberta, municipal","48014","Causing death by criminal negligence while street racing","0","0","0","0","0","0","0","0","0","0","0","0","0","0"
"2005","Calgary, Alberta, municipal","48014","Causing bodily harm by criminal negligence while street racing","0","0","0","0","0","0","0","0","0","0","0","0","0","0"
"2006","Calgary, Alberta, municipal","48014","Causing bodily harm by criminal negligence while street racing","0","0","0","0","0","0","0","0","0","0","0","0","0","0"
"2007","Calgary, Alberta, municipal","48014","Causing bodily harm by criminal negligence while street racing","0","0","0","0","0","0","0","0","0","0","0","0","0","0"
"2008","Calgary, Alberta, municipal","48014","Causing bodily harm by criminal negligence while street racing","0","0","0","0","0","0","0","0","0","0","0","0","0","0"
"2009","Calgary, Alberta, municipal","48014","Causing bodily harm by criminal negligence while street racing","0","0","0","0","0","0","0","0","0","0","0","0","0","0"
"2010","Calgary, Alberta, municipal","48014","Causing bodily harm by criminal negligence while street racing","0","0","0","0","0","0","0","0","0","0","0","0","0","0"
"2011","Calgary, Alberta, municipal","48014","Causing bodily harm by criminal negligence while street racing","0","0","0","0","0","0","0","0","0","0","0","0","0","0"
"2012","Calgary, Alberta, municipal","48014","Causing bodily harm by criminal negligence while street racing","0","0","0","0","0","0","0","0","0","0","0","0","0","0"
"2013","Calgary, Alberta, municipal","48014","Causing bodily harm by criminal negligence while street racing","0","0","0","0","0","0","0","0","0","0","0","0","0","0"
"2014","Calgary, Alberta, municipal","48014","Causing bodily harm by criminal negligence while street racing","0","0","0","0","0","0","0","0","0","0","0","0","0","0"
"2015","Calgary, Alberta, municipal","48014","Causing bodily harm by criminal negligence while street racing","1","0","0","0","0.08","0","0","0","0","0","0","0","0","0"
"2016","Calgary, Alberta, municipal","48014","Causing bodily harm by criminal negligence while street racing","0","1","0","-100","0","0.1","0.09","0","0","1","1","1","0","0"
"2005","Calgary, Alberta, municipal","48014","Dangerous operation causing death while street racing","0","0","0","0","0","0","0","0","0","0","0","0","0","0"
"2006","Calgary, Alberta, municipal","48014","Dangerous operation causing death while street racing","0","0","0","0","0","0","0","0","0","0","0","0","0","0"
"2007","Calgary, Alberta, municipal","48014","Dangerous operation causing death while street racing","0","0","0","0","0","0","0","0","0","0","0","0","0","0"
"2008","Calgary, Alberta, municipal","48014","Dangerous operation causing death while street racing","0","0","0","0","0","0","0","0","0","0","0","0","0","0"
"2009","Calgary, Alberta, municipal","48014","Dangerous operation causing death while street racing","0","0","0","0","0","0","0","0","0","0","0","0","0","0"
"2010","Calgary, Alberta, municipal","48014","Dangerous operation causing death while street racing","0","0","0","0","0","0","0","0","0","0","0","0","0","0"
"2011","Calgary, Alberta, municipal","48014","Dangerous operation causing death while street racing","0","0","0","0","0","0","0","0","0","0","0","0","0","0"
"2012","Calgary, Alberta, municipal","48014","Dangerous operation causing death while street racing","0","0","0","0","0","0","0","0","0","0","0","0","0","0"
"2013","Calgary, Alberta, municipal","48014","Dangerous operation causing death while street racing","0","0","0","0","0","0","0","0","0","0","0","0","0","0"
"2014","Calgary, Alberta, municipal","48014","Dangerous operation causing death while street racing","0","0","0","0","0","0","0","0","0","0","0","0","0","0"
"2015","Calgary, Alberta, municipal","48014","Dangerous operation causing death while street racing","0","0","0","0","0","0","0","0","0","0","0","0","0","0"
"2016","Calgary, Alberta, municipal","48014","Dangerous operation causing death while street racing","0","0","0","0","0","0","0","0","0","0","0","0","0","0"
"2005","Calgary, Alberta, municipal","48014","Dangerous operation causing bodily harm while street racing","0","0","0","0","0","0","0","0","0","0","0","0","0","0"
"2006","Calgary, Alberta, municipal","48014","Dangerous operation causing bodily harm while street racing","0","0","0","0","0","0","0","0","0","0","0","0","0","0"
"2007","Calgary, Alberta, municipal","48014","Dangerous operation causing bodily harm while street racing","0","0","0","0","0","0","0","0","0","0","0","0","0","0"
"2008","Calgary, Alberta, municipal","48014","Dangerous operation causing bodily harm while street racing","0","0","0","0","0","0","0","0","0","0","0","0","0","0"
"2009","Calgary, Alberta, municipal","48014","Dangerous operation causing bodily harm while street racing","0","0","0","0","0","0","0","0","0","0","0","0","0","0"
"2010","Calgary, Alberta, municipal","48014","Dangerous operation causing bodily harm while street racing","0","0","0","0","0","0","0","0","0","0","0","0","0","0"
"2011","Calgary, Alberta, municipal","48014","Dangerous operation causing bodily harm while street racing","0","0","0","0","0","0","0","0","0","0","0","0","0","0"
"2012","Calgary, Alberta, municipal","48014","Dangerous operation causing bodily harm while street racing","0","0","0","0","0","0","0","0","0","0","0","0","0","0"
"2013","Calgary, Alberta, municipal","48014","Dangerous operation causing bodily harm while street racing","1","1","0","0","0.08","0.1","0.1","0","0","1","1","1","0","0"
"2014","Calgary, Alberta, municipal","48014","Dangerous operation causing bodily harm while street racing","0","0","0","-100","0","0","0","0","0","0","0","0","0","0"
"2015","Calgary, Alberta, municipal","48014","Dangerous operation causing bodily harm while street racing","0","0","0","0","0","0","0","0","0","0","0","0","0","0"
"2016","Calgary, Alberta, municipal","48014","Dangerous operation causing bodily harm while street racing","0","0","0","0","0","0","0","0","0","0","0","0","0","0"
"2005","Calgary, Alberta, municipal","48014","Dangerous operation of motor vehicle while street racing","0","0","0","0","0","0","0","0","0","0","0","0","0","0"
"2006","Calgary, Alberta, municipal","48014","Dangerous operation of motor vehicle while street racing","0","0","0","0","0","0","0","0","0","0","0","0","0","0"
"2007","Calgary, Alberta, municipal","48014","Dangerous operation of motor vehicle while street racing","0","0","0","0","0","0","0","0","0","0","0","0","0","0"
"2008","Calgary, Alberta, municipal","48014","Dangerous operation of motor vehicle while street racing","0","0","0","0","0","0","0","0","0","0","0","0","0","0"
"2009","Calgary, Alberta, municipal","48014","Dangerous operation of motor vehicle while street racing","0","0","0","0","0","0","0","0","0","0","0","0","0","0"
"2010","Calgary, Alberta, municipal","48014","Dangerous operation of motor vehicle while street racing","0","0","0","0","0","0","0","0","0","0","0","0","0","0"
"2011","Calgary, Alberta, municipal","48014","Dangerous operation of motor vehicle while street racing","0","0","0","0","0","0","0","0","0","0","0","0","0","0"
"2012","Calgary, Alberta, municipal","48014","Dangerous operation of motor vehicle while street racing","0","0","0","0","0","0","0","0","0","0","0","0","0","0"
"2013","Calgary, Alberta, municipal","48014","Dangerous operation of motor vehicle while street racing","0","0","0","0","0","0","0","0","0","0","0","0","0","0"
"2014","Calgary, Alberta, municipal","48014","Dangerous operation of motor vehicle while street racing","0","0","0","0","0","0","0","0","0","0","0","0","0","0"
"2015","Calgary, Alberta, municipal","48014","Dangerous operation of motor vehicle while street racing","0","0","0","0","0","0","0","0","0","0","0","0","0","0"
"2016","Calgary, Alberta, municipal","48014","Dangerous operation of motor vehicle while street racing","0","0","0","0","0","0","0","0","0","0","0","0","0","0"
"1998","Calgary, Alberta, municipal","48014","Total Federal Statute violations","1835","1227","351","0","218.28","0","0","0","0","1578","845","1275","430","30"
"1999","Calgary, Alberta, municipal","48014","Total Federal Statute violations","1781","1317","366","-5.37","206.56","0","0","0","0","1683","848","1229","381","57"
"2000","Calgary, Alberta, municipal","48014","Total Federal Statute violations","1976","1319","317","8.38","223.87","0","0","0","0","1636","969","1337","368","138"
"2001","Calgary, Alberta, municipal","48014","Total Federal Statute violations","2244","1634","234","11.11","248.74","0","0","0","0","1868","1189","1615","426","142"
"2002","Calgary, Alberta, municipal","48014","Total Federal Statute violations","2398","1870","211","4.39","259.67","0","0","0","0","2081","1403","1888","485","137"
"2003","Calgary, Alberta, municipal","48014","Total Federal Statute violations","1726","1412","192","-29.15","183.98","0","0","0","0","1604","1178","1392","214","108"
"2004","Calgary, Alberta, municipal","48014","Total Federal Statute violations","2062","1669","237","15.9","213.23","193.87","213.91","412.83","212.35","1906","1459","1772","313","161"
"2005","Calgary, Alberta, municipal","48014","Total Federal Statute violations","2231","1822","236","5","223.9","206.83","223.52","392.09","224.61","2058","1609","1911","302","173"
"2006","Calgary, Alberta, municipal","48014","Total Federal Statute violations","2251","1819","290","-2.17","219.03","185.04","205.65","418.96","191.49","2109","1490","1816","326","149"
"2007","Calgary, Alberta, municipal","48014","Total Federal Statute violations","1925","1560","257","-16.53","182.82","154.83","169.84","330.31","139.35","1817","1283","1539","256","108"
"2008","Calgary, Alberta, municipal","48014","Total Federal Statute violations","1580","1299","214","-19.93","146.38","121.69","139.45","335.53","112.71","1513","1037","1296","259","87"
"2009","Calgary, Alberta, municipal","48014","Total Federal Statute violations","2260","1848","312","39.45","204.12","158.5","172.25","327.52","153.45","2160","1388","1642","254","119"
"2010","Calgary, Alberta, municipal","48014","Total Federal Statute violations","2197","1755","420","-4.22","195.51","159.3","175.94","365.46","183.37","2175","1415","1700","285","143"
"2011","Calgary, Alberta, municipal","48014","Total Federal Statute violations","1823","1357","403","-18.32","159.69","121.38","132.9","265.48","149.33","1760","1095","1303","208","117"
"2012","Calgary, Alberta, municipal","48014","Total Federal Statute violations","1762","1389","384","-6.24","149.73","116.99","126.77","242.47","200.58","1773","1090","1281","191","158"
"2013","Calgary, Alberta, municipal","48014","Total Federal Statute violations","1610","1221","345","-11.83","132.02","110.55","119.66","231.16","157.89","1566","1070","1253","183","125"
"2014","Calgary, Alberta, municipal","48014","Total Federal Statute violations","1701","1343","342","2.21","134.95","113.59","123.28","245.48","133.44","1685","1139","1334","195","106"
"2015","Calgary, Alberta, municipal","48014","Total Federal Statute violations","1339","1145","186","-22.96","103.96","108","113.37","181.94","59.82","1331","1106","1252","146","48"
"2016","Calgary, Alberta, municipal","48014","Total Federal Statute violations","1303","1078","211","-4.96","98.8","103.3","104.21","115.89","68.32","1289","1082","1177","95","56"
"1998","Calgary, Alberta, municipal","48014","Total Drug violations","965","769","177","0","114.79","0","0","0","0","946","780","867","87","25"
"1999","Calgary, Alberta, municipal","48014","Total Drug violations","1109","842","263","12.05","128.62","0","0","0","0","1105","771","869","98","55"
"2000","Calgary, Alberta, municipal","48014","Total Drug violations","1481","964","278","30.45","167.79","0","0","0","0","1242","897","1022","125","136"
"2001","Calgary, Alberta, municipal","48014","Total Drug violations","1736","1249","210","14.68","192.43","0","0","0","0","1459","1137","1315","178","140"
"2002","Calgary, Alberta, municipal","48014","Total Drug violations","1913","1507","198","7.65","207.15","0","0","0","0","1705","1354","1554","200","133"
"2003","Calgary, Alberta, municipal","48014","Total Drug violations","1545","1270","173","-20.5","164.69","0","0","0","0","1443","1152","1269","117","101"
"2004","Calgary, Alberta, municipal","48014","Total Drug violations","1774","1475","224","11.39","183.45","189.08","195.32","257.19","205.76","1699","1423","1618","195","156"
"2005","Calgary, Alberta, municipal","48014","Total Drug violations","1905","1629","212","4.21","191.18","200.28","203.99","241.48","215.52","1841","1558","1744","186","166"
"2006","Calgary, Alberta, municipal","48014","Total Drug violations","1996","1665","223","1.59","194.22","181.56","189.68","273.74","182.49","1888","1462","1675","213","142"
"2007","Calgary, Alberta, municipal","48014","Total Drug violations","1687","1381","218","-17.51","160.21","151.09","152.96","172.89","131.61","1599","1252","1386","134","102"
"2008","Calgary, Alberta, municipal","48014","Total Drug violations","1331","1128","181","-23.03","123.31","117.58","122.77","180.07","110.12","1309","1002","1141","139","85"
"2009","Calgary, Alberta, municipal","48014","Total Drug violations","1986","1663","274","45.46","179.37","154.5","154.73","157.31","148.29","1937","1353","1475","122","115"
"2010","Calgary, Alberta, municipal","48014","Total Drug violations","1870","1526","356","-7.22","166.41","153.67","155.24","173.11","180.81","1882","1365","1500","135","141"
"2011","Calgary, Alberta, municipal","48014","Total Drug violations","1515","1116","335","-20.25","132.71","116.84","117.09","119.98","145.5","1451","1054","1148","94","114"
"2012","Calgary, Alberta, municipal","48014","Total Drug violations","1515","1177","362","-2.99","128.74","111.73","111.14","104.1","195.5","1539","1041","1123","82","154"
"2013","Calgary, Alberta, municipal","48014","Total Drug violations","1428","1058","339","-9.04","117.1","106.41","106.2","103.58","156.63","1397","1030","1112","82","124"
"2014","Calgary, Alberta, municipal","48014","Total Drug violations","1516","1178","321","2.71","120.27","110.5","110.06","104.49","122.11","1499","1108","1191","83","97"
"2015","Calgary, Alberta, municipal","48014","Total Drug violations","1180","1019","169","-23.83","91.62","104.58","102.6","77.26","54.83","1188","1071","1133","62","44"
"2016","Calgary, Alberta, municipal","48014","Total Drug violations","1198","990","201","-0.85","90.84","101.01","96.78","42.7","68.32","1191","1058","1093","35","56"
"1998","Calgary, Alberta, municipal","48014","Possession, cannabis","407","304","99","0","48.41","0","0","0","0","403","264","316","52","21"
"1999","Calgary, Alberta, municipal","48014","Possession, cannabis","537","367","168","28.65","62.28","0","0","0","0","535","304","368","64","50"
"2000","Calgary, Alberta, municipal","48014","Possession, cannabis","724","412","156","31.7","82.03","0","0","0","0","568","350","429","79","116"
"2001","Calgary, Alberta, municipal","48014","Possession, cannabis","771","423","125","4.19","85.46","0","0","0","0","548","325","424","99","116"
"2002","Calgary, Alberta, municipal","48014","Possession, cannabis","747","475","119","-5.35","80.89","0","0","0","0","594","390","494","104","112"
"2003","Calgary, Alberta, municipal","48014","Possession, cannabis","546","343","100","-28.05","58.2","0","0","0","0","443","292","342","50","76"
"2004","Calgary, Alberta, municipal","48014","Possession, cannabis","559","399","145","-0.68","57.81","45.44","49.49","89.69","185.97","544","342","410","68","141"
"2005","Calgary, Alberta, municipal","48014","Possession, cannabis","569","356","146","-1.22","57.1","37.02","43.63","110.36","176.57","502","288","373","85","136"
"2006","Calgary, Alberta, municipal","48014","Possession, cannabis","541","354","150","-7.81","52.64","33.78","41.45","120.81","150.36","504","272","366","94","117"
"2007","Calgary, Alberta, municipal","48014","Possession, cannabis","425","257","139","-23.33","40.36","23.17","29.36","95.48","110.96","396","192","266","74","86"
"2008","Calgary, Alberta, municipal","48014","Possession, cannabis","415","292","117","-4.74","38.45","26.05","32.6","104.93","89.39","409","222","303","81","69"
"2009","Calgary, Alberta, municipal","48014","Possession, cannabis","533","375","154","25.21","48.14","36.88","42.59","107.02","128.95","529","323","406","83","100"
"2010","Calgary, Alberta, municipal","48014","Possession, cannabis","665","425","232","22.93","59.18","41.99","46.88","102.59","166.7","657","373","453","80","130"
"2011","Calgary, Alberta, municipal","48014","Possession, cannabis","628","439","193","-7.04","55.01","42.68","45.69","80.41","131.46","632","385","448","63","103"
"2012","Calgary, Alberta, municipal","48014","Possession, cannabis","645","399","244","-0.36","54.81","38.96","40.97","64.74","179","643","363","414","51","141"
"2013","Calgary, Alberta, municipal","48014","Possession, cannabis","629","376","254","-5.9","51.58","37.3","39.16","61.89","138.95","630","361","410","49","110"
"2014","Calgary, Alberta, municipal","48014","Possession, cannabis","592","362","231","-8.94","46.97","33.61","34.93","51.61","117.07","593","337","378","41","93"
"2015","Calgary, Alberta, municipal","48014","Possession, cannabis","384","285","98","-36.52","29.81","26.95","27.8","38.63","43.62","383","276","307","31","35"
"2016","Calgary, Alberta, municipal","48014","Possession, cannabis","315","192","122","-19.89","23.89","17.76","17.97","20.74","61","314","186","203","17","50"
"1998","Calgary, Alberta, municipal","48014","Possession, cocaine","55","46","10","0","6.54","0","0","0","0","56","48","51","3","0"
"1999","Calgary, Alberta, municipal","48014","Possession, cocaine","52","45","6","-7.82","6.03","0","0","0","0","51","44","47","3","1"
"2000","Calgary, Alberta, municipal","48014","Possession, cocaine","69","62","7","29.62","7.82","0","0","0","0","69","60","62","2","0"
"2001","Calgary, Alberta, municipal","48014","Possession, cocaine","163","144","13","131.13","18.07","0","0","0","0","157","154","158","4","0"
"2002","Calgary, Alberta, municipal","48014","Possession, cocaine","257","253","5","54.03","27.83","0","0","0","0","258","270","270","0","0"
"2003","Calgary, Alberta, municipal","48014","Possession, cocaine","181","163","17","-30.67","19.29","0","0","0","0","180","150","153","3","0"
"2004","Calgary, Alberta, municipal","48014","Possession, cocaine","271","246","24","45.25","28.02","31.49","29.58","10.55","3.96","270","237","245","8","3"
"2005","Calgary, Alberta, municipal","48014","Possession, cocaine","291","271","21","4.21","29.2","35.48","33.22","10.39","7.79","292","276","284","8","6"
"2006","Calgary, Alberta, municipal","48014","Possession, cocaine","359","328","30","19.61","34.93","40.24","37.37","7.71","3.86","358","324","330","6","3"
"2007","Calgary, Alberta, municipal","48014","Possession, cocaine","285","260","25","-22.52","27.07","30.89","29.47","14.19","3.87","285","256","267","11","3"
"2008","Calgary, Alberta, municipal","48014","Possession, cocaine","204","182","20","-30.17","18.9","20.18","19.26","9.07","1.3","202","172","179","7","1"
"2009","Calgary, Alberta, municipal","48014","Possession, cocaine","167","149","15","-20.19","15.08","17.13","16.05","3.87","2.58","164","150","153","3","2"
"2010","Calgary, Alberta, municipal","48014","Possession, cocaine","149","131","17","-12.09","13.26","14.18","13.35","3.85","0","148","126","129","3","0"
"2011","Calgary, Alberta, municipal","48014","Possession, cocaine","105","89","16","-30.63","9.2","9.87","9.18","1.28","1.28","105","89","90","1","1"
"2012","Calgary, Alberta, municipal","48014","Possession, cocaine","159","135","24","46.9","13.51","14.38","13.56","3.81","0","159","134","137","3","0"
"2013","Calgary, Alberta, municipal","48014","Possession, cocaine","154","134","19","-6.54","12.63","14.67","13.85","3.79","3.79","153","142","145","3","3"
"2014","Calgary, Alberta, municipal","48014","Possession, cocaine","165","140","25","3.66","13.09","14.06","13.58","7.55","0","165","141","147","6","0"
"2015","Calgary, Alberta, municipal","48014","Possession, cocaine","148","132","16","-12.22","11.49","13.18","12.5","3.74","0","148","135","138","3","0"
"2016","Calgary, Alberta, municipal","48014","Possession, cocaine","132","124","7","-12.9","10.01","12.7","11.86","1.22","1.22","131","133","134","1","1"
"1998","Calgary, Alberta, municipal","48014","Total, possession, other Controlled Drugs and Substances Act drugs","12","11","0","0","1.43","0","0","0","0","11","5","5","0","0"
"1999","Calgary, Alberta, municipal","48014","Total, possession, other Controlled Drugs and Substances Act drugs","5","2","3","-59.37","0.58","0","0","0","0","5","2","2","0","0"
"2000","Calgary, Alberta, municipal","48014","Total, possession, other Controlled Drugs and Substances Act drugs","16","5","2","212.59","1.81","0","0","0","0","7","4","4","0","0"
"2001","Calgary, Alberta, municipal","48014","Total, possession, other Controlled Drugs and Substances Act drugs","15","7","2","-8.28","1.66","0","0","0","0","9","6","6","0","0"
"2002","Calgary, Alberta, municipal","48014","Total, possession, other Controlled Drugs and Substances Act drugs","6","4","1","-60.92","0.65","0","0","0","0","5","3","3","0","0"
"2003","Calgary, Alberta, municipal","48014","Total, possession, other Controlled Drugs and Substances Act drugs","6","1","0","-1.56","0.64","0","0","0","0","1","1","1","0","0"
"2004","Calgary, Alberta, municipal","48014","Total, possession, other Controlled Drugs and Substances Act drugs","9","7","0","45.52","0.93","0.66","0.6","0","0","7","5","5","0","0"
"2005","Calgary, Alberta, municipal","48014","Total, possession, other Controlled Drugs and Substances Act drugs","11","7","3","18.61","1.1","1.03","0.94","0","1.3","10","8","8","0","1"
"2006","Calgary, Alberta, municipal","48014","Total, possession, other Controlled Drugs and Substances Act drugs","17","17","0","49.84","1.65","1.74","1.7","1.29","0","17","14","15","1","0"
"2007","Calgary, Alberta, municipal","48014","Total, possession, other Controlled Drugs and Substances Act drugs","4","2","1","-77.04","0.38","0.36","0.33","0","0","3","3","3","0","0"
"2008","Calgary, Alberta, municipal","48014","Total, possession, other Controlled Drugs and Substances Act drugs","19","13","4","363.37","1.76","1.29","1.29","1.3","1.3","17","11","12","1","1"
"2009","Calgary, Alberta, municipal","48014","Total, possession, other Controlled Drugs and Substances Act drugs","43","35","6","120.63","3.88","3.65","3.57","2.58","2.58","41","32","34","2","2"
"2010","Calgary, Alberta, municipal","48014","Total, possession, other Controlled Drugs and Substances Act drugs","29","26","4","-33.55","2.58","2.59","2.48","1.28","2.56","30","23","24","1","2"
"2011","Calgary, Alberta, municipal","48014","Total, possession, other Controlled Drugs and Substances Act drugs","35","26","7","18.8","3.07","2.77","2.65","1.28","0","33","25","26","1","0"
"2012","Calgary, Alberta, municipal","48014","Total, possession, other Controlled Drugs and Substances Act drugs","45","40","7","24.73","3.82","3.33","3.27","2.54","0","47","31","33","2","0"
"2013","Calgary, Alberta, municipal","48014","Total, possession, other Controlled Drugs and Substances Act drugs","64","48","11","37.24","5.25","4.65","4.3","0","2.53","59","45","45","0","2"
"2014","Calgary, Alberta, municipal","48014","Total, possession, other Controlled Drugs and Substances Act drugs","142","130","15","114.66","11.27","12.77","11.92","1.26","1.26","145","128","129","1","1"
"2015","Calgary, Alberta, municipal","48014","Total, possession, other Controlled Drugs and Substances Act drugs","195","178","18","34.39","15.14","15.92","15.39","8.72","1.25","196","163","170","7","1"
"2016","Calgary, Alberta, municipal","48014","Total, possession, other Controlled Drugs and Substances Act drugs","311","285","25","55.76","23.58","26.64","25.06","4.88","2.44","310","279","283","4","2"
"1998","Calgary, Alberta, municipal","48014","Heroin, possession","1","1","0","0","0.12","0","0","0","0","1","1","1","0","0"
"1999","Calgary, Alberta, municipal","48014","Heroin, possession","2","1","1","95","0.23","0","0","0","0","2","1","1","0","0"
"2000","Calgary, Alberta, municipal","48014","Heroin, possession","4","3","0","95.37","0.45","0","0","0","0","3","2","2","0","0"
"2001","Calgary, Alberta, municipal","48014","Heroin, possession","3","0","0","-26.62","0.33","0","0","0","0","0","0","0","0","0"
"2002","Calgary, Alberta, municipal","48014","Heroin, possession","1","1","0","-67.44","0.11","0","0","0","0","1","1","1","0","0"
"2003","Calgary, Alberta, municipal","48014","Heroin, possession","0","0","0","-100","0","0","0","0","0","0","0","0","0","0"
"2004","Calgary, Alberta, municipal","48014","Heroin, possession","1","1","0","0","0.1","0.13","0.12","0","0","1","1","1","0","0"
"2005","Calgary, Alberta, municipal","48014","Heroin, possession","1","1","0","-2.95","0.1","0.13","0.12","0","0","1","1","1","0","0"
"2006","Calgary, Alberta, municipal","48014","Heroin, possession","4","4","0","287.83","0.39","0.5","0.45","0","0","4","4","4","0","0"
"2007","Calgary, Alberta, municipal","48014","Heroin, possession","1","0","0","-75.6","0.09","0","0","0","0","0","0","0","0","0"
"2008","Calgary, Alberta, municipal","48014","Heroin, possession","0","0","0","-100","0","0","0","0","0","0","0","0","0","0"
"2009","Calgary, Alberta, municipal","48014","Heroin, possession","2","1","1","0","0.18","0.11","0.1","0","0","2","1","1","0","0"
"2010","Calgary, Alberta, municipal","48014","Heroin, possession","2","2","0","-1.47","0.18","0.23","0.21","0","0","2","2","2","0","0"
"2011","Calgary, Alberta, municipal","48014","Heroin, possession","8","4","3","293.73","0.7","0.33","0.31","0","0","7","3","3","0","0"
"2012","Calgary, Alberta, municipal","48014","Heroin, possession","8","8","1","-2.99","0.68","0.75","0.69","0","0","9","7","7","0","0"
"2013","Calgary, Alberta, municipal","48014","Heroin, possession","12","9","3","44.74","0.98","0.52","0.48","0","0","12","5","5","0","0"
"2014","Calgary, Alberta, municipal","48014","Heroin, possession","20","19","1","61.24","1.59","2.29","2.13","0","0","20","23","23","0","0"
"2015","Calgary, Alberta, municipal","48014","Heroin, possession","17","13","4","-16.81","1.32","1.27","1.18","0","0","17","13","13","0","0"
"2016","Calgary, Alberta, municipal","48014","Heroin, possession","35","30","5","101.07","2.65","2.86","2.66","0","1.22","35","30","30","0","1"
"1998","Calgary, Alberta, municipal","48014","Other Controlled Drugs and Substances Act, possession","11","10","0","0","1.31","0","0","0","0","10","4","4","0","0"
"1999","Calgary, Alberta, municipal","48014","Other Controlled Drugs and Substances Act, possession","3","1","2","-73.41","0.35","0","0","0","0","3","1","1","0","0"
"2000","Calgary, Alberta, municipal","48014","Other Controlled Drugs and Substances Act, possession","12","2","2","290.74","1.36","0","0","0","0","4","2","2","0","0"
"2001","Calgary, Alberta, municipal","48014","Other Controlled Drugs and Substances Act, possession","12","7","2","-2.16","1.33","0","0","0","0","9","6","6","0","0"
"2002","Calgary, Alberta, municipal","48014","Other Controlled Drugs and Substances Act, possession","5","3","1","-59.3","0.54","0","0","0","0","4","2","2","0","0"
"2003","Calgary, Alberta, municipal","48014","Other Controlled Drugs and Substances Act, possession","6","1","0","18.12","0.64","0","0","0","0","1","1","1","0","0"
"2004","Calgary, Alberta, municipal","48014","Other Controlled Drugs and Substances Act, possession","8","6","0","29.35","0.83","0.53","0.48","0","0","6","4","4","0","0"
"2005","Calgary, Alberta, municipal","48014","Other Controlled Drugs and Substances Act, possession","10","6","3","21.31","1","0.9","0.82","0","1.3","9","7","7","0","1"
"2006","Calgary, Alberta, municipal","48014","Other Controlled Drugs and Substances Act, possession","13","13","0","26.04","1.26","1.24","1.25","1.29","0","13","10","11","1","0"
"2007","Calgary, Alberta, municipal","48014","Other Controlled Drugs and Substances Act, possession","3","2","1","-77.48","0.28","0.36","0.33","0","0","3","3","3","0","0"
"2008","Calgary, Alberta, municipal","48014","Other Controlled Drugs and Substances Act, possession","5","1","2","62.59","0.46","0","0","0","0","3","0","0","0","0"
"2009","Calgary, Alberta, municipal","48014","Other Controlled Drugs and Substances Act, possession","10","10","0","94.98","0.9","1.14","1.05","0","0","10","10","10","0","0"
"2010","Calgary, Alberta, municipal","48014","Other Controlled Drugs and Substances Act, possession","10","8","2","-1.47","0.89","1.01","0.93","0","0","10","9","9","0","0"
"2011","Calgary, Alberta, municipal","48014","Other Controlled Drugs and Substances Act, possession","8","6","1","-21.25","0.7","0.78","0.71","0","0","7","7","7","0","0"
"2012","Calgary, Alberta, municipal","48014","Other Controlled Drugs and Substances Act, possession","8","9","0","-2.99","0.68","0.86","0.89","1.27","0","9","8","9","1","0"
"2013","Calgary, Alberta, municipal","48014","Other Controlled Drugs and Substances Act, possession","14","11","2","68.87","1.15","1.03","0.96","0","1.26","13","10","10","0","1"
"2014","Calgary, Alberta, municipal","48014","Other Controlled Drugs and Substances Act, possession","18","13","4","24.39","1.43","1.1","1.11","1.26","0","17","11","12","1","0"
"2015","Calgary, Alberta, municipal","48014","Other Controlled Drugs and Substances Act, possession","28","28","2","52.23","2.17","2.64","2.44","0","0","30","27","27","0","0"
"2016","Calgary, Alberta, municipal","48014","Other Controlled Drugs and Substances Act, possession","56","47","8","95.33","4.25","4.77","4.43","0","0","55","50","50","0","0"
"2005","Calgary, Alberta, municipal","48014","Methamphetamines (crystal meth), possession","0","0","0","0","0","0","0","0","0","0","0","0","0","0"
"2006","Calgary, Alberta, municipal","48014","Methamphetamines (crystal meth), possession","0","0","0","0","0","0","0","0","0","0","0","0","0","0"
"2007","Calgary, Alberta, municipal","48014","Methamphetamines (crystal meth), possession","0","0","0","0","0","0","0","0","0","0","0","0","0","0"
"2008","Calgary, Alberta, municipal","48014","Methamphetamines (crystal meth), possession","6","5","1","0","0.56","0.59","0.54","0","0","6","5","5","0","0"
"2009","Calgary, Alberta, municipal","48014","Methamphetamines (crystal meth), possession","9","8","1","46.23","0.81","0.91","0.84","0","0","9","8","8","0","0"
"2010","Calgary, Alberta, municipal","48014","Methamphetamines (crystal meth), possession","11","10","0","20.43","0.98","0.9","0.83","0","0","10","8","8","0","0"
"2011","Calgary, Alberta, municipal","48014","Methamphetamines (crystal meth), possession","10","8","2","-10.52","0.88","0.89","0.82","0","0","10","8","8","0","0"
"2012","Calgary, Alberta, municipal","48014","Methamphetamines (crystal meth), possession","22","18","4","113.42","1.87","1.4","1.29","0","0","22","13","13","0","0"
"2013","Calgary, Alberta, municipal","48014","Methamphetamines (crystal meth), possession","35","27","4","53.52","2.87","3","2.77","0","0","31","29","29","0","0"
"2014","Calgary, Alberta, municipal","48014","Methamphetamines (crystal meth), possession","102","97","9","181.95","8.09","9.28","8.59","0","1.26","106","93","93","0","1"
"2015","Calgary, Alberta, municipal","48014","Methamphetamines (crystal meth), possession","147","134","12","41.04","11.41","11.91","11.59","7.48","1.25","146","122","128","6","1"
"2016","Calgary, Alberta, municipal","48014","Methamphetamines (crystal meth), possession","216","205","11","43.5","16.38","18.71","17.71","4.88","1.22","216","196","200","4","1"
"2005","Calgary, Alberta, municipal","48014","Methylenedioxyamphetamine (ecstasy), possession","0","0","0","0","0","0","0","0","0","0","0","0","0","0"
"2006","Calgary, Alberta, municipal","48014","Methylenedioxyamphetamine (ecstasy), possession","0","0","0","0","0","0","0","0","0","0","0","0","0","0"
"2007","Calgary, Alberta, municipal","48014","Methylenedioxyamphetamine (ecstasy), possession","0","0","0","0","0","0","0","0","0","0","0","0","0","0"
"2008","Calgary, Alberta, municipal","48014","Methylenedioxyamphetamine (ecstasy), possession","8","7","1","0","0.74","0.7","0.75","1.3","1.3","8","6","7","1","1"
"2009","Calgary, Alberta, municipal","48014","Methylenedioxyamphetamine (ecstasy), possession","22","16","4","168.09","1.99","1.48","1.57","2.58","2.58","20","13","15","2","2"
"2010","Calgary, Alberta, municipal","48014","Methylenedioxyamphetamine (ecstasy), possession","6","6","2","-73.13","0.53","0.45","0.52","1.28","2.56","8","4","5","1","2"
"2011","Calgary, Alberta, municipal","48014","Methylenedioxyamphetamine (ecstasy), possession","9","8","1","47.65","0.79","0.78","0.82","1.28","0","9","7","8","1","0"
"2012","Calgary, Alberta, municipal","48014","Methylenedioxyamphetamine (ecstasy), possession","7","5","2","-24.55","0.59","0.32","0.4","1.27","0","7","3","4","1","0"
"2013","Calgary, Alberta, municipal","48014","Methylenedioxyamphetamine (ecstasy), possession","3","1","2","-58.64","0.25","0.1","0.1","0","1.26","3","1","1","0","1"
"2014","Calgary, Alberta, municipal","48014","Methylenedioxyamphetamine (ecstasy), possession","2","1","1","-35.5","0.16","0.1","0.09","0","0","2","1","1","0","0"
"2015","Calgary, Alberta, municipal","48014","Methylenedioxyamphetamine (ecstasy), possession","3","3","0","46.8","0.23","0.1","0.18","1.25","0","3","1","2","1","0"
"2016","Calgary, Alberta, municipal","48014","Methylenedioxyamphetamine (ecstasy), possession","4","3","1","30.22","0.3","0.29","0.27","0","0","4","3","3","0","0"
"1998","Calgary, Alberta, municipal","48014","Total cannabis, trafficking, production or distribution","250","226","22","0","29.74","0","0","0","0","248","311","328","17","2"
"1999","Calgary, Alberta, municipal","48014","Total cannabis, trafficking, production or distribution","221","180","42","-13.81","25.63","0","0","0","0","222","226","245","19","4"
"2000","Calgary, Alberta, municipal","48014","Total cannabis, trafficking, production or distribution","292","206","48","29.07","33.08","0","0","0","0","254","243","270","27","17"
"2001","Calgary, Alberta, municipal","48014","Total cannabis, trafficking, production or distribution","371","302","30","24.31","41.12","0","0","0","0","332","323","376","53","22"
"2002","Calgary, Alberta, municipal","48014","Total cannabis, trafficking, production or distribution","381","332","34","0.32","41.26","0","0","0","0","366","354","419","65","17"
"2003","Calgary, Alberta, municipal","48014","Total cannabis, trafficking, production or distribution","361","305","35","-6.73","38.48","0","0","0","0","340","330","375","45","23"
"2004","Calgary, Alberta, municipal","48014","Total cannabis, trafficking, production or distribution","372","333","24","-0.03","38.47","47.57","54.56","123.98","13.19","357","358","452","94","10"
"2005","Calgary, Alberta, municipal","48014","Total cannabis, trafficking, production or distribution","313","291","25","-18.34","31.41","36.89","39.42","64.91","25.97","316","287","337","50","20"
"2006","Calgary, Alberta, municipal","48014","Total cannabis, trafficking, production or distribution","278","230","17","-13.88","27.05","25.58","29.56","70.68","10.28","247","206","261","55","8"
"2007","Calgary, Alberta, municipal","48014","Total cannabis, trafficking, production or distribution","229","156","29","-19.6","21.75","22.21","23.06","32.26","12.9","185","184","209","25","10"
"2008","Calgary, Alberta, municipal","48014","Total cannabis, trafficking, production or distribution","167","150","15","-28.86","15.47","16.19","18.18","40.16","14.25","165","138","169","31","11"
"2009","Calgary, Alberta, municipal","48014","Total cannabis, trafficking, production or distribution","220","169","46","28.43","19.87","19.64","20.14","25.79","10.32","215","172","192","20","8"
"2010","Calgary, Alberta, municipal","48014","Total cannabis, trafficking, production or distribution","332","277","50","48.69","29.55","29.04","30.74","50.01","11.54","327","258","297","39","9"
"2011","Calgary, Alberta, municipal","48014","Total cannabis, trafficking, production or distribution","265","193","67","-21.43","23.21","23.06","23.56","29.36","10.21","260","208","231","23","8"
"2012","Calgary, Alberta, municipal","48014","Total cannabis, trafficking, production or distribution","193","156","36","-29.35","16.4","15.99","16.63","24.12","15.23","192","149","168","19","12"
"2013","Calgary, Alberta, municipal","48014","Total cannabis, trafficking, production or distribution","184","148","26","-8","15.09","15.08","16.33","31.58","11.37","174","146","171","25","9"
"2014","Calgary, Alberta, municipal","48014","Total cannabis, trafficking, production or distribution","178","158","23","-6.41","14.12","13.96","15.34","32.73","1.26","181","140","166","26","1"
"2015","Calgary, Alberta, municipal","48014","Total cannabis, trafficking, production or distribution","88","80","13","-51.62","6.83","8.01","8.15","9.97","9.97","93","82","90","8","8"
"2016","Calgary, Alberta, municipal","48014","Total cannabis, trafficking, production or distribution","66","58","7","-26.75","5","5.44","5.67","8.54","2.44","65","57","64","7","2"
"1998","Calgary, Alberta, municipal","48014","Cannabis, trafficking","212","199","16","0","25.22","0","0","0","0","215","269","286","17","2"
"1999","Calgary, Alberta, municipal","48014","Cannabis, trafficking","213","173","36","-2.04","24.7","0","0","0","0","209","218","237","19","4"
"2000","Calgary, Alberta, municipal","48014","Cannabis, trafficking","280","202","42","28.41","31.72","0","0","0","0","244","238","265","27","17"
"2001","Calgary, Alberta, municipal","48014","Cannabis, trafficking","366","300","29","27.89","40.57","0","0","0","0","329","319","372","53","21"
"2002","Calgary, Alberta, municipal","48014","Cannabis, trafficking","367","325","29","-2.04","39.74","0","0","0","0","354","349","414","65","17"
"2003","Calgary, Alberta, municipal","48014","Cannabis, trafficking","338","295","28","-9.34","36.03","0","0","0","0","323","318","363","45","23"
"2004","Calgary, Alberta, municipal","48014","Cannabis, trafficking","360","331","17","3.33","37.23","47.3","54.08","121.34","13.19","348","356","448","92","10"
"2005","Calgary, Alberta, municipal","48014","Cannabis, trafficking","309","290","23","-16.7","31.01","36.51","39.07","64.91","25.97","313","284","334","50","20"
"2006","Calgary, Alberta, municipal","48014","Cannabis, trafficking","275","229","15","-13.71","26.76","25.46","29.44","70.68","10.28","244","205","260","55","8"
"2007","Calgary, Alberta, municipal","48014","Cannabis, trafficking","224","156","26","-20.5","21.27","22.21","23.06","32.26","12.9","182","184","209","25","10"
"2008","Calgary, Alberta, municipal","48014","Cannabis, trafficking","165","149","15","-28.14","15.29","16.19","18.18","40.16","14.25","164","138","169","31","11"
"2009","Calgary, Alberta, municipal","48014","Cannabis, trafficking","208","166","38","22.9","18.79","19.3","19.83","25.79","10.32","204","169","189","20","8"
"2010","Calgary, Alberta, municipal","48014","Cannabis, trafficking","314","273","35","48.74","27.94","28.48","30.22","50.01","11.54","308","253","292","39","9"
"2011","Calgary, Alberta, municipal","48014","Cannabis, trafficking","257","193","59","-19.44","22.51","23.06","23.56","29.36","10.21","252","208","231","23","8"
"2012","Calgary, Alberta, municipal","48014","Cannabis, trafficking","185","154","30","-30.17","15.72","15.78","16.43","24.12","15.23","184","147","166","19","12"
"2013","Calgary, Alberta, municipal","48014","Cannabis, trafficking","177","145","22","-7.68","14.51","14.67","15.95","31.58","11.37","167","142","167","25","9"
"2014","Calgary, Alberta, municipal","48014","Cannabis, trafficking","170","155","18","-7.08","13.49","13.56","14.97","32.73","1.26","173","136","162","26","1"
"2015","Calgary, Alberta, municipal","48014","Cannabis, trafficking","83","76","13","-52.22","6.44","7.52","7.7","9.97","9.97","89","77","85","8","8"
"2016","Calgary, Alberta, municipal","48014","Cannabis, trafficking","62","57","5","-27.05","4.7","5.35","5.58","8.54","2.44","62","56","63","7","2"
"1998","Calgary, Alberta, municipal","48014","Cannabis, importation and exportation","1","1","0","0","0.12","0","0","0","0","1","1","1","0","0"
"1999","Calgary, Alberta, municipal","48014","Cannabis, importation and exportation","0","0","0","-100","0","0","0","0","0","0","0","0","0","0"
"2000","Calgary, Alberta, municipal","48014","Cannabis, importation and exportation","2","0","0","0","0.23","0","0","0","0","0","0","0","0","0"
"2001","Calgary, Alberta, municipal","48014","Cannabis, importation and exportation","1","0","0","-51.08","0.11","0","0","0","0","0","0","0","0","0"
"2002","Calgary, Alberta, municipal","48014","Cannabis, importation and exportation","1","0","0","-2.31","0.11","0","0","0","0","0","0","0","0","0"
"2003","Calgary, Alberta, municipal","48014","Cannabis, importation and exportation","0","0","0","-100","0","0","0","0","0","0","0","0","0","0"
"2004","Calgary, Alberta, municipal","48014","Cannabis, importation and exportation","0","0","0","0","0","0","0","0","0","0","0","0","0","0"
"2005","Calgary, Alberta, municipal","48014","Cannabis, importation and exportation","0","0","0","0","0","0","0","0","0","0","0","0","0","0"
"2006","Calgary, Alberta, municipal","48014","Cannabis, importation and exportation","0","0","0","0","0","0","0","0","0","0","0","0","0","0"
"2007","Calgary, Alberta, municipal","48014","Cannabis, importation and exportation","0","0","0","0","0","0","0","0","0","0","0","0","0","0"
"2008","Calgary, Alberta, municipal","48014","Cannabis, importation and exportation","0","0","0","0","0","0","0","0","0","0","0","0","0","0"
"2009","Calgary, Alberta, municipal","48014","Cannabis, importation and exportation","0","0","0","0","0","0","0","0","0","0","0","0","0","0"
"2010","Calgary, Alberta, municipal","48014","Cannabis, importation and exportation","0","0","0","0","0","0","0","0","0","0","0","0","0","0"
"2011","Calgary, Alberta, municipal","48014","Cannabis, importation and exportation","0","0","0","0","0","0","0","0","0","0","0","0","0","0"
"2012","Calgary, Alberta, municipal","48014","Cannabis, importation and exportation","0","0","0","0","0","0","0","0","0","0","0","0","0","0"
"2013","Calgary, Alberta, municipal","48014","Cannabis, importation and exportation","1","0","1","0","0.08","0","0","0","0","1","0","0","0","0"
"2014","Calgary, Alberta, municipal","48014","Cannabis, importation and exportation","0","0","0","-100","0","0","0","0","0","0","0","0","0","0"
"2015","Calgary, Alberta, municipal","48014","Cannabis, importation and exportation","0","0","0","0","0","0","0","0","0","0","0","0","0","0"
"2016","Calgary, Alberta, municipal","48014","Cannabis, importation and exportation","2","0","2","0","0.15","0","0","0","0","2","0","0","0","0"
"1998","Calgary, Alberta, municipal","48014","Cannabis, production","37","26","6","0","4.4","0","0","0","0","32","41","41","0","0"
"1999","Calgary, Alberta, municipal","48014","Cannabis, production","8","7","6","-78.92","0.93","0","0","0","0","13","8","8","0","0"
"2000","Calgary, Alberta, municipal","48014","Cannabis, production","10","4","6","22.11","1.13","0","0","0","0","10","5","5","0","0"
"2001","Calgary, Alberta, municipal","48014","Cannabis, production","4","2","1","-60.86","0.44","0","0","0","0","3","4","4","0","1"
"2002","Calgary, Alberta, municipal","48014","Cannabis, production","13","7","5","217.49","1.41","0","0","0","0","12","5","5","0","0"
"2003","Calgary, Alberta, municipal","48014","Cannabis, production","23","10","7","74.16","2.45","0","0","0","0","17","12","12","0","0"
"2004","Calgary, Alberta, municipal","48014","Cannabis, production","12","2","7","-49.38","1.24","0.27","0.48","2.64","0","9","2","4","2","0"
"2005","Calgary, Alberta, municipal","48014","Cannabis, production","4","1","2","-67.65","0.4","0.39","0.35","0","0","3","3","3","0","0"
"2006","Calgary, Alberta, municipal","48014","Cannabis, production","3","1","2","-27.28","0.29","0.12","0.11","0","0","3","1","1","0","0"
"2007","Calgary, Alberta, municipal","48014","Cannabis, production","5","0","3","62.67","0.47","0","0","0","0","3","0","0","0","0"
"2008","Calgary, Alberta, municipal","48014","Cannabis, production","2","1","0","-60.98","0.19","0","0","0","0","1","0","0","0","0"
"2009","Calgary, Alberta, municipal","48014","Cannabis, production","12","3","8","484.93","1.08","0.34","0.31","0","0","11","3","3","0","0"
"2010","Calgary, Alberta, municipal","48014","Cannabis, production","18","4","15","47.8","1.6","0.56","0.52","0","0","19","5","5","0","0"
"2011","Calgary, Alberta, municipal","48014","Cannabis, production","8","0","8","-56.25","0.7","0","0","0","0","8","0","0","0","0"
"2012","Calgary, Alberta, municipal","48014","Cannabis, production","8","2","6","-2.99","0.68","0.21","0.2","0","0","8","2","2","0","0"
"2013","Calgary, Alberta, municipal","48014","Cannabis, production","6","3","3","-27.63","0.49","0.41","0.38","0","0","6","4","4","0","0"
"2014","Calgary, Alberta, municipal","48014","Cannabis, production","8","3","5","29","0.63","0.4","0.37","0","0","8","4","4","0","0"
"2015","Calgary, Alberta, municipal","48014","Cannabis, production","5","4","0","-38.83","0.39","0.49","0.45","0","0","4","5","5","0","0"
"2016","Calgary, Alberta, municipal","48014","Cannabis, production","2","1","0","-60.93","0.15","0.1","0.09","0","0","1","1","1","0","0"
"1998","Calgary, Alberta, municipal","48014","Total cocaine, trafficking, production or distribution","213","168","35","0","25.34","0","0","0","0","203","134","147","13","0"
"1999","Calgary, Alberta, municipal","48014","Total cocaine, trafficking, production or distribution","259","226","34","18.56","30.04","0","0","0","0","260","174","182","8","0"
"2000","Calgary, Alberta, municipal","48014","Total cocaine, trafficking, production or distribution","303","230","47","14.28","34.33","0","0","0","0","277","192","200","8","1"
"2001","Calgary, Alberta, municipal","48014","Total cocaine, trafficking, production or distribution","365","340","29","17.86","40.46","0","0","0","0","369","298","313","15","2"
"2002","Calgary, Alberta, municipal","48014","Total cocaine, trafficking, production or distribution","449","388","37","20.17","48.62","0","0","0","0","425","287","309","22","4"
"2003","Calgary, Alberta, municipal","48014","Total cocaine, trafficking, production or distribution","398","409","19","-12.74","42.42","0","0","0","0","428","329","347","18","0"
"2004","Calgary, Alberta, municipal","48014","Total cocaine, trafficking, production or distribution","504","443","25","22.85","52.12","57.14","54.32","26.38","1.32","468","430","450","20","1"
"2005","Calgary, Alberta, municipal","48014","Total cocaine, trafficking, production or distribution","611","614","15","17.65","61.32","79.7","74.74","24.67","1.3","629","620","639","19","1"
"2006","Calgary, Alberta, municipal","48014","Total cocaine, trafficking, production or distribution","712","664","19","12.98","69.28","73.39","69.87","33.41","2.57","683","591","617","26","2"
"2007","Calgary, Alberta, municipal","48014","Total cocaine, trafficking, production or distribution","699","672","20","-4.18","66.38","69.99","66.22","25.81","0","692","580","600","20","0"
"2008","Calgary, Alberta, municipal","48014","Total cocaine, trafficking, production or distribution","482","456","22","-32.73","44.65","49.87","47.02","15.55","1.3","478","425","437","12","1"
"2009","Calgary, Alberta, municipal","48014","Total cocaine, trafficking, production or distribution","955","885","45","93.16","86.25","71.37","66.51","11.61","2.58","930","625","634","9","2"
"2010","Calgary, Alberta, municipal","48014","Total cocaine, trafficking, production or distribution","599","591","39","-38.2","53.31","55.61","51.95","10.26","0","630","494","502","8","0"
"2011","Calgary, Alberta, municipal","48014","Total cocaine, trafficking, production or distribution","385","303","29","-36.73","33.73","31.59","29.58","6.38","0","332","285","290","5","0"
"2012","Calgary, Alberta, municipal","48014","Total cocaine, trafficking, production or distribution","393","382","40","-0.97","33.4","32.95","30.98","7.62","0","422","307","313","6","0"
"2013","Calgary, Alberta, municipal","48014","Total cocaine, trafficking, production or distribution","328","295","22","-19.46","26.9","27.48","25.88","6.32","0","317","266","271","5","0"
"2014","Calgary, Alberta, municipal","48014","Total cocaine, trafficking, production or distribution","347","315","18","2.35","27.53","27.23","25.97","10.07","0","333","273","281","8","0"
"2015","Calgary, Alberta, municipal","48014","Total cocaine, trafficking, production or distribution","205","209","10","-42.18","15.92","22.95","22.09","11.22","0","219","235","244","9","0"
"2016","Calgary, Alberta, municipal","48014","Total cocaine, trafficking, production or distribution","184","161","21","-12.34","13.95","18.43","17.27","2.44","0","182","193","195","2","0"
"1998","Calgary, Alberta, municipal","48014","Cocaine, trafficking","211","168","34","0","25.1","0","0","0","0","202","134","147","13","0"
"1999","Calgary, Alberta, municipal","48014","Cocaine, trafficking","259","226","34","19.68","30.04","0","0","0","0","260","174","182","8","0"
"2000","Calgary, Alberta, municipal","48014","Cocaine, trafficking","302","229","47","13.9","34.22","0","0","0","0","276","189","197","8","1"
"2001","Calgary, Alberta, municipal","48014","Cocaine, trafficking","364","339","28","17.93","40.35","0","0","0","0","367","297","312","15","2"
"2002","Calgary, Alberta, municipal","48014","Cocaine, trafficking","448","388","37","20.23","48.51","0","0","0","0","425","287","309","22","4"
"2003","Calgary, Alberta, municipal","48014","Cocaine, trafficking","397","408","19","-12.77","42.32","0","0","0","0","427","327","345","18","0"
"2004","Calgary, Alberta, municipal","48014","Cocaine, trafficking","495","438","25","20.96","51.19","56.47","53.72","26.38","1.32","463","425","445","20","1"
"2005","Calgary, Alberta, municipal","48014","Cocaine, trafficking","609","613","15","19.4","61.12","79.57","74.62","24.67","1.3","628","619","638","19","1"
"2006","Calgary, Alberta, municipal","48014","Cocaine, trafficking","710","664","19","13.04","69.09","73.39","69.87","33.41","2.57","683","591","617","26","2"
"2007","Calgary, Alberta, municipal","48014","Cocaine, trafficking","696","672","18","-4.32","66.1","69.99","66.22","25.81","0","690","580","600","20","0"
"2008","Calgary, Alberta, municipal","48014","Cocaine, trafficking","477","453","22","-33.14","44.19","49.76","46.91","15.55","1.3","475","424","436","12","1"
"2009","Calgary, Alberta, municipal","48014","Cocaine, trafficking","951","884","44","94.36","85.89","71.14","66.3","11.61","2.58","928","623","632","9","2"
"2010","Calgary, Alberta, municipal","48014","Cocaine, trafficking","592","588","37","-38.66","52.68","55.28","51.64","10.26","0","625","491","499","8","0"
"2011","Calgary, Alberta, municipal","48014","Cocaine, trafficking","380","303","29","-36.82","33.29","31.59","29.58","6.38","0","332","285","290","5","0"
"2012","Calgary, Alberta, municipal","48014","Cocaine, trafficking","389","381","40","-0.69","33.06","32.84","30.88","7.62","0","421","306","312","6","0"
"2013","Calgary, Alberta, municipal","48014","Cocaine, trafficking","325","295","21","-19.38","26.65","27.48","25.88","6.32","0","316","266","271","5","0"
"2014","Calgary, Alberta, municipal","48014","Cocaine, trafficking","343","315","17","2.1","27.21","27.23","25.97","10.07","0","332","273","281","8","0"
"2015","Calgary, Alberta, municipal","48014","Cocaine, trafficking","202","208","9","-42.37","15.68","22.85","22","11.22","0","217","234","243","9","0"
"2016","Calgary, Alberta, municipal","48014","Cocaine, trafficking","183","161","21","-11.52","13.88","18.43","17.27","2.44","0","182","193","195","2","0"
"1998","Calgary, Alberta, municipal","48014","Cocaine, importation and exportation","2","0","1","0","0.24","0","0","0","0","1","0","0","0","0"
"1999","Calgary, Alberta, municipal","48014","Cocaine, importation and exportation","0","0","0","-100","0","0","0","0","0","0","0","0","0","0"
"2000","Calgary, Alberta, municipal","48014","Cocaine, importation and exportation","1","1","0","0","0.11","0","0","0","0","1","3","3","0","0"
"2001","Calgary, Alberta, municipal","48014","Cocaine, importation and exportation","1","1","1","-2.16","0.11","0","0","0","0","2","1","1","0","0"
"2002","Calgary, Alberta, municipal","48014","Cocaine, importation and exportation","1","0","0","-2.31","0.11","0","0","0","0","0","0","0","0","0"
"2003","Calgary, Alberta, municipal","48014","Cocaine, importation and exportation","1","1","0","-1.56","0.11","0","0","0","0","1","2","2","0","0"
"2004","Calgary, Alberta, municipal","48014","Cocaine, importation and exportation","9","5","0","773.13","0.93","0.66","0.6","0","0","5","5","5","0","0"
"2005","Calgary, Alberta, municipal","48014","Cocaine, importation and exportation","2","1","0","-78.43","0.2","0.13","0.12","0","0","1","1","1","0","0"
"2006","Calgary, Alberta, municipal","48014","Cocaine, importation and exportation","2","0","0","-3.04","0.19","0","0","0","0","0","0","0","0","0"
"2007","Calgary, Alberta, municipal","48014","Cocaine, importation and exportation","3","0","2","46.4","0.28","0","0","0","0","2","0","0","0","0"
"2008","Calgary, Alberta, municipal","48014","Cocaine, importation and exportation","2","0","0","-34.97","0.19","0","0","0","0","0","0","0","0","0"
"2009","Calgary, Alberta, municipal","48014","Cocaine, importation and exportation","3","0","1","46.23","0.27","0","0","0","0","1","0","0","0","0"
"2010","Calgary, Alberta, municipal","48014","Cocaine, importation and exportation","3","0","1","-1.47","0.27","0","0","0","0","1","0","0","0","0"
"2011","Calgary, Alberta, municipal","48014","Cocaine, importation and exportation","5","0","0","64.06","0.44","0","0","0","0","0","0","0","0","0"
"2012","Calgary, Alberta, municipal","48014","Cocaine, importation and exportation","4","1","0","-22.39","0.34","0.11","0.1","0","0","1","1","1","0","0"
"2013","Calgary, Alberta, municipal","48014","Cocaine, importation and exportation","3","0","1","-27.63","0.25","0","0","0","0","1","0","0","0","0"
"2014","Calgary, Alberta, municipal","48014","Cocaine, importation and exportation","3","0","1","-3.25","0.24","0","0","0","0","1","0","0","0","0"
"2015","Calgary, Alberta, municipal","48014","Cocaine, importation and exportation","3","0","1","-2.13","0.23","0","0","0","0","1","0","0","0","0"
"2016","Calgary, Alberta, municipal","48014","Cocaine, importation and exportation","1","0","0","-67.45","0.08","0","0","0","0","0","0","0","0","0"
"2005","Calgary, Alberta, municipal","48014","Cocaine, production","0","0","0","0","0","0","0","0","0","0","0","0","0","0"
"2006","Calgary, Alberta, municipal","48014","Cocaine, production","0","0","0","0","0","0","0","0","0","0","0","0","0","0"
"2007","Calgary, Alberta, municipal","48014","Cocaine, production","0","0","0","0","0","0","0","0","0","0","0","0","0","0"
"2008","Calgary, Alberta, municipal","48014","Cocaine, production","3","3","0","0","0.28","0.12","0.11","0","0","3","1","1","0","0"
"2009","Calgary, Alberta, municipal","48014","Cocaine, production","1","1","0","-67.5","0.09","0.23","0.21","0","0","1","2","2","0","0"
"2010","Calgary, Alberta, municipal","48014","Cocaine, production","4","3","1","294.12","0.36","0.34","0.31","0","0","4","3","3","0","0"
"2011","Calgary, Alberta, municipal","48014","Cocaine, production","0","0","0","-100","0","0","0","0","0","0","0","0","0","0"
"2012","Calgary, Alberta, municipal","48014","Cocaine, production","0","0","0","0","0","0","0","0","0","0","0","0","0","0"
"2013","Calgary, Alberta, municipal","48014","Cocaine, production","0","0","0","0","0","0","0","0","0","0","0","0","0","0"
"2014","Calgary, Alberta, municipal","48014","Cocaine, production","1","0","0","0","0.08","0","0","0","0","0","0","0","0","0"
"2015","Calgary, Alberta, municipal","48014","Cocaine, production","0","1","0","-100","0","0.1","0.09","0","0","1","1","1","0","0"
"2016","Calgary, Alberta, municipal","48014","Cocaine, production","0","0","0","0","0","0","0","0","0","0","0","0","0","0"
"1998","Calgary, Alberta, municipal","48014","Total other Controlled Drugs and Substances Act drugs, trafficking, production or distribution","28","14","11","0","3.33","0","0","0","0","25","18","20","2","2"
"1999","Calgary, Alberta, municipal","48014","Total other Controlled Drugs and Substances Act drugs, trafficking, production or distribution","35","22","10","21.88","4.06","0","0","0","0","32","21","25","4","0"
"2000","Calgary, Alberta, municipal","48014","Total other Controlled Drugs and Substances Act drugs, trafficking, production or distribution","77","49","18","114.91","8.72","0","0","0","0","67","48","57","9","2"
"2001","Calgary, Alberta, municipal","48014","Total other Controlled Drugs and Substances Act drugs, trafficking, production or distribution","51","33","11","-35.2","5.65","0","0","0","0","44","31","38","7","0"
"2002","Calgary, Alberta, municipal","48014","Total other Controlled Drugs and Substances Act drugs, trafficking, production or distribution","73","55","2","39.83","7.9","0","0","0","0","57","50","59","9","0"
"2003","Calgary, Alberta, municipal","48014","Total other Controlled Drugs and Substances Act drugs, trafficking, production or distribution","53","49","2","-28.53","5.65","0","0","0","0","51","50","51","1","2"
"2004","Calgary, Alberta, municipal","48014","Total other Controlled Drugs and Substances Act drugs, trafficking, production or distribution","59","47","6","8","6.1","6.78","6.76","6.59","1.32","53","51","56","5","1"
"2005","Calgary, Alberta, municipal","48014","Total other Controlled Drugs and Substances Act drugs, trafficking, production or distribution","110","90","2","80.94","11.04","10.16","12.05","31.16","2.6","92","79","103","24","2"
"2006","Calgary, Alberta, municipal","48014","Total other Controlled Drugs and Substances Act drugs, trafficking, production or distribution","89","72","7","-21.55","8.66","6.83","9.74","39.84","15.42","79","55","86","31","12"
"2007","Calgary, Alberta, municipal","48014","Total other Controlled Drugs and Substances Act drugs, trafficking, production or distribution","45","34","4","-50.65","4.27","4.47","4.52","5.16","3.87","38","37","41","4","3"
"2008","Calgary, Alberta, municipal","48014","Total other Controlled Drugs and Substances Act drugs, trafficking, production or distribution","44","35","3","-4.62","4.08","3.99","4.41","9.07","2.59","38","34","41","7","2"
"2009","Calgary, Alberta, municipal","48014","Total other Controlled Drugs and Substances Act drugs, trafficking, production or distribution","68","50","8","50.66","6.14","5.82","5.87","6.45","1.29","58","51","56","5","1"
"2010","Calgary, Alberta, municipal","48014","Total other Controlled Drugs and Substances Act drugs, trafficking, production or distribution","96","76","14","39.1","8.54","10.24","9.83","5.13","0","90","91","95","4","0"
"2011","Calgary, Alberta, municipal","48014","Total other Controlled Drugs and Substances Act drugs, trafficking, production or distribution","97","66","23","-0.54","8.5","6.87","6.43","1.28","2.55","89","62","63","1","2"
"2012","Calgary, Alberta, municipal","48014","Total other Controlled Drugs and Substances Act drugs, trafficking, production or distribution","79","64","11","-20.99","6.71","6.01","5.64","1.27","1.27","75","56","57","1","1"
"2013","Calgary, Alberta, municipal","48014","Total other Controlled Drugs and Substances Act drugs, trafficking, production or distribution","69","57","7","-15.72","5.66","7.23","6.69","0","0","64","70","70","0","0"
"2014","Calgary, Alberta, municipal","48014","Total other Controlled Drugs and Substances Act drugs, trafficking, production or distribution","92","73","9","29","7.3","8.88","8.32","1.26","2.52","82","89","90","1","2"
"2015","Calgary, Alberta, municipal","48014","Total other Controlled Drugs and Substances Act drugs, trafficking, production or distribution","159","135","14","69.14","12.34","17.58","16.66","4.98","0","149","180","184","4","0"
"2016","Calgary, Alberta, municipal","48014","Total other Controlled Drugs and Substances Act drugs, trafficking, production or distribution","190","170","19","16.7","14.41","20.05","18.95","4.88","1.22","189","210","214","4","1"
"1998","Calgary, Alberta, municipal","48014","Heroin, trafficking","3","3","0","0","0.36","0","0","0","0","3","9","9","0","0"
"1999","Calgary, Alberta, municipal","48014","Heroin, trafficking","1","0","0","-67.5","0.12","0","0","0","0","0","0","0","0","0"
"2000","Calgary, Alberta, municipal","48014","Heroin, trafficking","0","0","0","-100","0","0","0","0","0","0","0","0","0","0"
"2001","Calgary, Alberta, municipal","48014","Heroin, trafficking","2","1","1","0","0.22","0","0","0","0","2","1","1","0","0"
"2002","Calgary, Alberta, municipal","48014","Heroin, trafficking","1","1","0","-51.15","0.11","0","0","0","0","1","3","3","0","0"
"2003","Calgary, Alberta, municipal","48014","Heroin, trafficking","2","3","0","96.87","0.21","0","0","0","0","3","3","3","0","0"
"2004","Calgary, Alberta, municipal","48014","Heroin, trafficking","1","1","0","-51.49","0.1","0.13","0.12","0","0","1","1","1","0","0"
"2005","Calgary, Alberta, municipal","48014","Heroin, trafficking","1","1","0","-2.95","0.1","0.13","0.12","0","0","1","1","1","0","0"
"2006","Calgary, Alberta, municipal","48014","Heroin, trafficking","6","5","0","481.74","0.58","0.75","0.68","0","0","5","6","6","0","0"
"2007","Calgary, Alberta, municipal","48014","Heroin, trafficking","3","2","0","-51.2","0.28","0.48","0.44","0","0","2","4","4","0","0"
"2008","Calgary, Alberta, municipal","48014","Heroin, trafficking","3","3","0","-2.45","0.28","0.47","0.43","0","0","3","4","4","0","0"
"2009","Calgary, Alberta, municipal","48014","Heroin, trafficking","3","3","0","-2.51","0.27","0.46","0.42","0","0","3","4","4","0","0"
"2010","Calgary, Alberta, municipal","48014","Heroin, trafficking","5","5","0","64.22","0.44","0.56","0.52","0","0","5","5","5","0","0"
"2011","Calgary, Alberta, municipal","48014","Heroin, trafficking","17","15","2","234.67","1.49","1.22","1.12","0","0","17","11","11","0","0"
"2012","Calgary, Alberta, municipal","48014","Heroin, trafficking","11","8","1","-37.23","0.93","1.07","0.99","0","0","9","10","10","0","0"
"2013","Calgary, Alberta, municipal","48014","Heroin, trafficking","20","20","0","75.45","1.64","2.89","2.67","0","0","20","28","28","0","0"
"2014","Calgary, Alberta, municipal","48014","Heroin, trafficking","31","30","1","49.96","2.46","4.49","4.16","0","0","31","45","45","0","0"
"2015","Calgary, Alberta, municipal","48014","Heroin, trafficking","53","49","1","67.32","4.11","7.03","6.52","0","0","50","72","72","0","0"
"2016","Calgary, Alberta, municipal","48014","Heroin, trafficking","53","51","4","-2.34","4.02","5.73","5.49","2.44","0","55","60","62","2","0"
"1998","Calgary, Alberta, municipal","48014","Other Controlled Drugs and Substances Act, trafficking","12","8","4","0","1.43","0","0","0","0","12","6","8","2","2"
"1999","Calgary, Alberta, municipal","48014","Other Controlled Drugs and Substances Act, trafficking","30","21","7","143.76","3.48","0","0","0","0","28","20","24","4","0"
"2000","Calgary, Alberta, municipal","48014","Other Controlled Drugs and Substances Act, trafficking","73","48","18","137.7","8.27","0","0","0","0","66","47","56","9","2"
"2001","Calgary, Alberta, municipal","48014","Other Controlled Drugs and Substances Act, trafficking","44","28","10","-41.03","4.88","0","0","0","0","38","26","33","7","0"
"2002","Calgary, Alberta, municipal","48014","Other Controlled Drugs and Substances Act, trafficking","69","54","2","53.2","7.47","0","0","0","0","56","47","56","9","0"
"2003","Calgary, Alberta, municipal","48014","Other Controlled Drugs and Substances Act, trafficking","43","40","1","-38.66","4.58","0","0","0","0","41","36","37","1","2"
"2004","Calgary, Alberta, municipal","48014","Other Controlled Drugs and Substances Act, trafficking","54","45","6","21.83","5.58","6.51","6.52","6.59","1.32","51","49","54","5","1"
"2005","Calgary, Alberta, municipal","48014","Other Controlled Drugs and Substances Act, trafficking","102","88","2","83.31","10.24","9.9","11.81","31.16","2.6","90","77","101","24","2"
"2006","Calgary, Alberta, municipal","48014","Other Controlled Drugs and Substances Act, trafficking","75","65","7","-28.71","7.3","5.84","8.72","38.55","15.42","72","47","77","30","12"
"2007","Calgary, Alberta, municipal","48014","Other Controlled Drugs and Substances Act, trafficking","39","29","4","-49.25","3.7","3.14","3.31","5.16","3.87","33","26","30","4","3"
"2008","Calgary, Alberta, municipal","48014","Other Controlled Drugs and Substances Act, trafficking","28","24","3","-29.96","2.59","2.7","3.12","7.77","0","27","23","29","6","0"
"2009","Calgary, Alberta, municipal","48014","Other Controlled Drugs and Substances Act, trafficking","49","40","5","70.61","4.43","4.68","4.62","3.87","1.29","45","41","44","3","1"
"2010","Calgary, Alberta, municipal","48014","Other Controlled Drugs and Substances Act, trafficking","60","47","10","20.65","5.34","5.97","5.8","3.85","0","57","53","56","3","0"
"2011","Calgary, Alberta, municipal","48014","Other Controlled Drugs and Substances Act, trafficking","60","36","19","-1.57","5.26","4.1","3.77","0","2.55","55","37","37","0","2"
"2012","Calgary, Alberta, municipal","48014","Other Controlled Drugs and Substances Act, trafficking","40","35","7","-35.33","3.4","2.9","2.67","0","0","42","27","27","0","0"
"2013","Calgary, Alberta, municipal","48014","Other Controlled Drugs and Substances Act, trafficking","25","23","1","-39.69","2.05","2.79","2.58","0","0","24","27","27","0","0"
"2014","Calgary, Alberta, municipal","48014","Other Controlled Drugs and Substances Act, trafficking","31","25","5","19.97","2.46","2.29","2.22","1.26","2.52","30","23","24","1","2"
"2015","Calgary, Alberta, municipal","48014","Other Controlled Drugs and Substances Act, trafficking","47","40","4","48.38","3.65","4.88","4.89","4.98","0","44","50","54","4","0"
"2016","Calgary, Alberta, municipal","48014","Other Controlled Drugs and Substances Act, trafficking","64","57","8","32.99","4.85","7.16","6.73","1.22","1.22","65","75","76","1","1"
"2005","Calgary, Alberta, municipal","48014","Methamphetamines (crystal meth), trafficking","0","0","0","0","0","0","0","0","0","0","0","0","0","0"
"2006","Calgary, Alberta, municipal","48014","Methamphetamines (crystal meth), trafficking","0","0","0","0","0","0","0","0","0","0","0","0","0","0"
"2007","Calgary, Alberta, municipal","48014","Methamphetamines (crystal meth), trafficking","0","0","0","0","0","0","0","0","0","0","0","0","0","0"
"2008","Calgary, Alberta, municipal","48014","Methamphetamines (crystal meth), trafficking","2","2","0","0","0.19","0.23","0.22","0","0","2","2","2","0","0"
"2009","Calgary, Alberta, municipal","48014","Methamphetamines (crystal meth), trafficking","4","3","1","94.98","0.36","0.46","0.63","2.58","0","4","4","6","2","0"
"2010","Calgary, Alberta, municipal","48014","Methamphetamines (crystal meth), trafficking","18","16","2","343.39","1.6","2.59","2.38","0","0","18","23","23","0","0"
"2011","Calgary, Alberta, municipal","48014","Methamphetamines (crystal meth), trafficking","13","12","1","-28.91","1.14","1.33","1.22","0","0","13","12","12","0","0"
"2012","Calgary, Alberta, municipal","48014","Methamphetamines (crystal meth), trafficking","17","16","0","26.86","1.44","1.5","1.39","0","0","16","14","14","0","0"
"2013","Calgary, Alberta, municipal","48014","Methamphetamines (crystal meth), trafficking","13","11","1","-26.21","1.07","1.34","1.24","0","0","12","13","13","0","0"
"2014","Calgary, Alberta, municipal","48014","Methamphetamines (crystal meth), trafficking","18","15","0","33.96","1.43","1.89","1.76","0","0","15","19","19","0","0"
"2015","Calgary, Alberta, municipal","48014","Methamphetamines (crystal meth), trafficking","47","42","4","155.54","3.65","5.27","4.89","0","0","46","54","54","0","0"
"2016","Calgary, Alberta, municipal","48014","Methamphetamines (crystal meth), trafficking","63","61","2","30.91","4.78","7.06","6.64","1.22","0","63","74","75","1","0"
"2005","Calgary, Alberta, municipal","48014","Methylenedioxyamphetamine (ecstasy), trafficking","0","0","0","0","0","0","0","0","0","0","0","0","0","0"
"2006","Calgary, Alberta, municipal","48014","Methylenedioxyamphetamine (ecstasy), trafficking","0","0","0","0","0","0","0","0","0","0","0","0","0","0"
"2007","Calgary, Alberta, municipal","48014","Methylenedioxyamphetamine (ecstasy), trafficking","0","0","0","0","0","0","0","0","0","0","0","0","0","0"
"2008","Calgary, Alberta, municipal","48014","Methylenedioxyamphetamine (ecstasy), trafficking","5","4","0","0","0.46","0.35","0.43","1.3","2.59","4","3","4","1","2"
"2009","Calgary, Alberta, municipal","48014","Methylenedioxyamphetamine (ecstasy), trafficking","3","3","0","-41.51","0.27","0.11","0.1","0","0","3","1","1","0","0"
"2010","Calgary, Alberta, municipal","48014","Methylenedioxyamphetamine (ecstasy), trafficking","3","4","0","-1.47","0.27","0.34","0.41","1.28","0","4","3","4","1","0"
"2011","Calgary, Alberta, municipal","48014","Methylenedioxyamphetamine (ecstasy), trafficking","2","2","0","-34.38","0.18","0.11","0.2","1.28","0","2","1","2","1","0"
"2012","Calgary, Alberta, municipal","48014","Methylenedioxyamphetamine (ecstasy), trafficking","4","3","1","94.02","0.34","0.21","0.2","0","1.27","4","2","2","0","1"
"2013","Calgary, Alberta, municipal","48014","Methylenedioxyamphetamine (ecstasy), trafficking","2","2","0","-51.75","0.16","0.1","0.1","0","0","2","1","1","0","0"
"2014","Calgary, Alberta, municipal","48014","Methylenedioxyamphetamine (ecstasy), trafficking","4","2","2","93.49","0.32","0.1","0.09","0","0","4","1","1","0","0"
"2015","Calgary, Alberta, municipal","48014","Methylenedioxyamphetamine (ecstasy), trafficking","3","1","1","-26.6","0.23","0.1","0.09","0","0","2","1","1","0","0"
"2016","Calgary, Alberta, municipal","48014","Methylenedioxyamphetamine (ecstasy), trafficking","0","0","0","-100","0","0","0","0","0","0","0","0","0","0"
"1998","Calgary, Alberta, municipal","48014","Heroin, importation and exportation","0","0","0","0","0","0","0","0","0","0","0","0","0","0"
"1999","Calgary, Alberta, municipal","48014","Heroin, importation and exportation","0","0","0","0","0","0","0","0","0","0","0","0","0","0"
"2000","Calgary, Alberta, municipal","48014","Heroin, importation and exportation","0","0","0","0","0","0","0","0","0","0","0","0","0","0"
"2001","Calgary, Alberta, municipal","48014","Heroin, importation and exportation","1","0","0","0","0.11","0","0","0","0","0","0","0","0","0"
"2002","Calgary, Alberta, municipal","48014","Heroin, importation and exportation","0","0","0","-100","0","0","0","0","0","0","0","0","0","0"
"2003","Calgary, Alberta, municipal","48014","Heroin, importation and exportation","0","1","0","0","0","0","0","0","0","1","1","1","0","0"
"2004","Calgary, Alberta, municipal","48014","Heroin, importation and exportation","0","0","0","0","0","0","0","0","0","0","0","0","0","0"
"2005","Calgary, Alberta, municipal","48014","Heroin, importation and exportation","2","0","0","0","0.2","0","0","0","0","0","0","0","0","0"
"2006","Calgary, Alberta, municipal","48014","Heroin, importation and exportation","0","0","0","-100","0","0","0","0","0","0","0","0","0","0"
"2007","Calgary, Alberta, municipal","48014","Heroin, importation and exportation","0","0","0","0","0","0","0","0","0","0","0","0","0","0"
"2008","Calgary, Alberta, municipal","48014","Heroin, importation and exportation","0","0","0","0","0","0","0","0","0","0","0","0","0","0"
"2009","Calgary, Alberta, municipal","48014","Heroin, importation and exportation","0","0","0","0","0","0","0","0","0","0","0","0","0","0"
"2010","Calgary, Alberta, municipal","48014","Heroin, importation and exportation","1","0","0","0","0.09","0","0","0","0","0","0","0","0","0"
"2011","Calgary, Alberta, municipal","48014","Heroin, importation and exportation","1","0","0","-1.57","0.09","0","0","0","0","0","0","0","0","0"
"2012","Calgary, Alberta, municipal","48014","Heroin, importation and exportation","2","0","1","94.02","0.17","0","0","0","0","1","0","0","0","0"
"2013","Calgary, Alberta, municipal","48014","Heroin, importation and exportation","3","0","0","44.74","0.25","0","0","0","0","0","0","0","0","0"
"2014","Calgary, Alberta, municipal","48014","Heroin, importation and exportation","4","0","0","29","0.32","0","0","0","0","0","0","0","0","0"
"2015","Calgary, Alberta, municipal","48014","Heroin, importation and exportation","1","0","0","-75.53","0.08","0","0","0","0","0","0","0","0","0"
"2016","Calgary, Alberta, municipal","48014","Heroin, importation and exportation","1","0","1","-2.34","0.08","0","0","0","0","1","0","0","0","0"
"1998","Calgary, Alberta, municipal","48014","Other Controlled Drugs and Substances Act, importation and exportation","13","3","7","0","1.55","0","0","0","0","10","3","3","0","0"
"1999","Calgary, Alberta, municipal","48014","Other Controlled Drugs and Substances Act, importation and exportation","4","1","3","-70","0.46","0","0","0","0","4","1","1","0","0"
"2000","Calgary, Alberta, municipal","48014","Other Controlled Drugs and Substances Act, importation and exportation","4","1","0","-2.32","0.45","0","0","0","0","1","1","1","0","0"
"2001","Calgary, Alberta, municipal","48014","Other Controlled Drugs and Substances Act, importation and exportation","4","4","0","-2.16","0.44","0","0","0","0","4","4","4","0","0"
"2002","Calgary, Alberta, municipal","48014","Other Controlled Drugs and Substances Act, importation and exportation","3","0","0","-26.73","0.32","0","0","0","0","0","0","0","0","0"
"2003","Calgary, Alberta, municipal","48014","Other Controlled Drugs and Substances Act, importation and exportation","8","5","1","162.5","0.85","0","0","0","0","6","10","10","0","0"
"2004","Calgary, Alberta, municipal","48014","Other Controlled Drugs and Substances Act, importation and exportation","4","1","0","-51.49","0.41","0.13","0.12","0","0","1","1","1","0","0"
"2005","Calgary, Alberta, municipal","48014","Other Controlled Drugs and Substances Act, importation and exportation","5","1","0","21.31","0.5","0.13","0.12","0","0","1","1","1","0","0"
"2006","Calgary, Alberta, municipal","48014","Other Controlled Drugs and Substances Act, importation and exportation","8","2","0","55.13","0.78","0.25","0.34","1.29","0","2","2","3","1","0"
"2007","Calgary, Alberta, municipal","48014","Other Controlled Drugs and Substances Act, importation and exportation","3","3","0","-63.4","0.28","0.84","0.77","0","0","3","7","7","0","0"
"2008","Calgary, Alberta, municipal","48014","Other Controlled Drugs and Substances Act, importation and exportation","6","2","0","95.1","0.56","0.23","0.22","0","0","2","2","2","0","0"
"2009","Calgary, Alberta, municipal","48014","Other Controlled Drugs and Substances Act, importation and exportation","8","1","1","29.99","0.72","0.11","0.1","0","0","2","1","1","0","0"
"2010","Calgary, Alberta, municipal","48014","Other Controlled Drugs and Substances Act, importation and exportation","3","1","0","-63.05","0.27","0.23","0.21","0","0","1","2","2","0","0"
"2011","Calgary, Alberta, municipal","48014","Other Controlled Drugs and Substances Act, importation and exportation","2","0","1","-34.38","0.18","0","0","0","0","1","0","0","0","0"
"2012","Calgary, Alberta, municipal","48014","Other Controlled Drugs and Substances Act, importation and exportation","5","1","1","142.53","0.42","0.11","0.1","0","0","2","1","1","0","0"
"2013","Calgary, Alberta, municipal","48014","Other Controlled Drugs and Substances Act, importation and exportation","3","0","3","-42.1","0.25","0","0","0","0","3","0","0","0","0"
"2014","Calgary, Alberta, municipal","48014","Other Controlled Drugs and Substances Act, importation and exportation","3","0","1","-3.25","0.24","0","0","0","0","1","0","0","0","0"
"2015","Calgary, Alberta, municipal","48014","Other Controlled Drugs and Substances Act, importation and exportation","8","3","4","160.97","0.62","0.29","0.27","0","0","7","3","3","0","0"
"2016","Calgary, Alberta, municipal","48014","Other Controlled Drugs and Substances Act, importation and exportation","6","1","3","-26.75","0.45","0.1","0.09","0","0","4","1","1","0","0"
"2005","Calgary, Alberta, municipal","48014","Methamphetamines (crystal meth), importation and exportation","0","0","0","0","0","0","0","0","0","0","0","0","0","0"
"2006","Calgary, Alberta, municipal","48014","Methamphetamines (crystal meth), importation and exportation","0","0","0","0","0","0","0","0","0","0","0","0","0","0"
"2007","Calgary, Alberta, municipal","48014","Methamphetamines (crystal meth), importation and exportation","0","0","0","0","0","0","0","0","0","0","0","0","0","0"
"2008","Calgary, Alberta, municipal","48014","Methamphetamines (crystal meth), importation and exportation","0","0","0","0","0","0","0","0","0","0","0","0","0","0"
"2009","Calgary, Alberta, municipal","48014","Methamphetamines (crystal meth), importation and exportation","0","0","0","0","0","0","0","0","0","0","0","0","0","0"
"2010","Calgary, Alberta, municipal","48014","Methamphetamines (crystal meth), importation and exportation","0","0","0","0","0","0","0","0","0","0","0","0","0","0"
"2011","Calgary, Alberta, municipal","48014","Methamphetamines (crystal meth), importation and exportation","0","0","0","0","0","0","0","0","0","0","0","0","0","0"
"2012","Calgary, Alberta, municipal","48014","Methamphetamines (crystal meth), importation and exportation","0","0","0","0","0","0","0","0","0","0","0","0","0","0"
"2013","Calgary, Alberta, municipal","48014","Methamphetamines (crystal meth), importation and exportation","0","0","0","0","0","0","0","0","0","0","0","0","0","0"
"2014","Calgary, Alberta, municipal","48014","Methamphetamines (crystal meth), importation and exportation","0","0","0","0","0","0","0","0","0","0","0","0","0","0"
"2015","Calgary, Alberta, municipal","48014","Methamphetamines (crystal meth), importation and exportation","0","0","0","0","0","0","0","0","0","0","0","0","0","0"
"2016","Calgary, Alberta, municipal","48014","Methamphetamines (crystal meth), importation and exportation","0","0","0","0","0","0","0","0","0","0","0","0","0","0"
"2005","Calgary, Alberta, municipal","48014","Methylenedioxyamphetamine (ecstasy), importation and exportation","0","0","0","0","0","0","0","0","0","0","0","0","0","0"
"2006","Calgary, Alberta, municipal","48014","Methylenedioxyamphetamine (ecstasy), importation and exportation","0","0","0","0","0","0","0","0","0","0","0","0","0","0"
"2007","Calgary, Alberta, municipal","48014","Methylenedioxyamphetamine (ecstasy), importation and exportation","0","0","0","0","0","0","0","0","0","0","0","0","0","0"
"2008","Calgary, Alberta, municipal","48014","Methylenedioxyamphetamine (ecstasy), importation and exportation","0","0","0","0","0","0","0","0","0","0","0","0","0","0"
"2009","Calgary, Alberta, municipal","48014","Methylenedioxyamphetamine (ecstasy), importation and exportation","0","0","0","0","0","0","0","0","0","0","0","0","0","0"
"2010","Calgary, Alberta, municipal","48014","Methylenedioxyamphetamine (ecstasy), importation and exportation","0","0","0","0","0","0","0","0","0","0","0","0","0","0"
"2011","Calgary, Alberta, municipal","48014","Methylenedioxyamphetamine (ecstasy), importation and exportation","0","0","0","0","0","0","0","0","0","0","0","0","0","0"
"2012","Calgary, Alberta, municipal","48014","Methylenedioxyamphetamine (ecstasy), importation and exportation","0","0","0","0","0","0","0","0","0","0","0","0","0","0"
"2013","Calgary, Alberta, municipal","48014","Methylenedioxyamphetamine (ecstasy), importation and exportation","0","0","0","0","0","0","0","0","0","0","0","0","0","0"
"2014","Calgary, Alberta, municipal","48014","Methylenedioxyamphetamine (ecstasy), importation and exportation","0","0","0","0","0","0","0","0","0","0","0","0","0","0"
"2015","Calgary, Alberta, municipal","48014","Methylenedioxyamphetamine (ecstasy), importation and exportation","0","0","0","0","0","0","0","0","0","0","0","0","0","0"
"2016","Calgary, Alberta, municipal","48014","Methylenedioxyamphetamine (ecstasy), importation and exportation","0","0","0","0","0","0","0","0","0","0","0","0","0","0"
"2005","Calgary, Alberta, municipal","48014","Heroin, production","0","0","0","0","0","0","0","0","0","0","0","0","0","0"
"2006","Calgary, Alberta, municipal","48014","Heroin, production","0","0","0","0","0","0","0","0","0","0","0","0","0","0"
"2007","Calgary, Alberta, municipal","48014","Heroin, production","0","0","0","0","0","0","0","0","0","0","0","0","0","0"
"2008","Calgary, Alberta, municipal","48014","Heroin, production","0","0","0","0","0","0","0","0","0","0","0","0","0","0"
"2009","Calgary, Alberta, municipal","48014","Heroin, production","0","0","0","0","0","0","0","0","0","0","0","0","0","0"
"2010","Calgary, Alberta, municipal","48014","Heroin, production","0","0","0","0","0","0","0","0","0","0","0","0","0","0"
"2011","Calgary, Alberta, municipal","48014","Heroin, production","0","0","0","0","0","0","0","0","0","0","0","0","0","0"
"2012","Calgary, Alberta, municipal","48014","Heroin, production","0","0","0","0","0","0","0","0","0","0","0","0","0","0"
"2013","Calgary, Alberta, municipal","48014","Heroin, production","0","0","0","0","0","0","0","0","0","0","0","0","0","0"
"2014","Calgary, Alberta, municipal","48014","Heroin, production","0","0","0","0","0","0","0","0","0","0","0","0","0","0"
"2015","Calgary, Alberta, municipal","48014","Heroin, production","0","0","0","0","0","0","0","0","0","0","0","0","0","0"
"2016","Calgary, Alberta, municipal","48014","Heroin, production","0","0","0","0","0","0","0","0","0","0","0","0","0","0"
"2005","Calgary, Alberta, municipal","48014","Other Controlled Drugs and Substances Act, production","0","0","0","0","0","0","0","0","0","0","0","0","0","0"
"2006","Calgary, Alberta, municipal","48014","Other Controlled Drugs and Substances Act, production","0","0","0","0","0","0","0","0","0","0","0","0","0","0"
"2007","Calgary, Alberta, municipal","48014","Other Controlled Drugs and Substances Act, production","0","0","0","0","0","0","0","0","0","0","0","0","0","0"
"2008","Calgary, Alberta, municipal","48014","Other Controlled Drugs and Substances Act, production","0","0","0","0","0","0","0","0","0","0","0","0","0","0"
"2009","Calgary, Alberta, municipal","48014","Other Controlled Drugs and Substances Act, production","1","0","1","0","0.09","0","0","0","0","1","0","0","0","0"
"2010","Calgary, Alberta, municipal","48014","Other Controlled Drugs and Substances Act, production","6","3","2","491.19","0.53","0.56","0.52","0","0","5","5","5","0","0"
"2011","Calgary, Alberta, municipal","48014","Other Controlled Drugs and Substances Act, production","2","1","0","-67.19","0.18","0.11","0.1","0","0","1","1","1","0","0"
"2012","Calgary, Alberta, municipal","48014","Other Controlled Drugs and Substances Act, production","0","1","0","-100","0","0.21","0.3","1.27","0","1","2","3","1","0"
"2013","Calgary, Alberta, municipal","48014","Other Controlled Drugs and Substances Act, production","3","1","2","0","0.25","0.1","0.1","0","0","3","1","1","0","0"
"2014","Calgary, Alberta, municipal","48014","Other Controlled Drugs and Substances Act, production","1","1","0","-67.75","0.08","0.1","0.09","0","0","1","1","1","0","0"
"2015","Calgary, Alberta, municipal","48014","Other Controlled Drugs and Substances Act, production","0","0","0","-100","0","0","0","0","0","0","0","0","0","0"
"2016","Calgary, Alberta, municipal","48014","Other Controlled Drugs and Substances Act, production","2","0","1","0","0.15","0","0","0","0","1","0","0","0","0"
"2005","Calgary, Alberta, municipal","48014","Methamphetamines (crystal meth), production","0","0","0","0","0","0","0","0","0","0","0","0","0","0"
"2006","Calgary, Alberta, municipal","48014","Methamphetamines (crystal meth), production","0","0","0","0","0","0","0","0","0","0","0","0","0","0"
"2007","Calgary, Alberta, municipal","48014","Methamphetamines (crystal meth), production","0","0","0","0","0","0","0","0","0","0","0","0","0","0"
"2008","Calgary, Alberta, municipal","48014","Methamphetamines (crystal meth), production","0","0","0","0","0","0","0","0","0","0","0","0","0","0"
"2009","Calgary, Alberta, municipal","48014","Methamphetamines (crystal meth), production","0","0","0","0","0","0","0","0","0","0","0","0","0","0"
"2010","Calgary, Alberta, municipal","48014","Methamphetamines (crystal meth), production","0","0","0","0","0","0","0","0","0","0","0","0","0","0"
"2011","Calgary, Alberta, municipal","48014","Methamphetamines (crystal meth), production","0","0","0","0","0","0","0","0","0","0","0","0","0","0"
"2012","Calgary, Alberta, municipal","48014","Methamphetamines (crystal meth), production","0","0","0","0","0","0","0","0","0","0","0","0","0","0"
"2013","Calgary, Alberta, municipal","48014","Methamphetamines (crystal meth), production","0","0","0","0","0","0","0","0","0","0","0","0","0","0"
"2014","Calgary, Alberta, municipal","48014","Methamphetamines (crystal meth), production","0","0","0","0","0","0","0","0","0","0","0","0","0","0"
"2015","Calgary, Alberta, municipal","48014","Methamphetamines (crystal meth), production","0","0","0","0","0","0","0","0","0","0","0","0","0","0"
"2016","Calgary, Alberta, municipal","48014","Methamphetamines (crystal meth), production","0","0","0","0","0","0","0","0","0","0","0","0","0","0"
"2005","Calgary, Alberta, municipal","48014","Methylenedioxyamphetamine (ecstasy), production","0","0","0","0","0","0","0","0","0","0","0","0","0","0"
"2006","Calgary, Alberta, municipal","48014","Methylenedioxyamphetamine (ecstasy), production","0","0","0","0","0","0","0","0","0","0","0","0","0","0"
"2007","Calgary, Alberta, municipal","48014","Methylenedioxyamphetamine (ecstasy), production","0","0","0","0","0","0","0","0","0","0","0","0","0","0"
"2008","Calgary, Alberta, municipal","48014","Methylenedioxyamphetamine (ecstasy), production","0","0","0","0","0","0","0","0","0","0","0","0","0","0"
"2009","Calgary, Alberta, municipal","48014","Methylenedioxyamphetamine (ecstasy), production","0","0","0","0","0","0","0","0","0","0","0","0","0","0"
"2010","Calgary, Alberta, municipal","48014","Methylenedioxyamphetamine (ecstasy), production","0","0","0","0","0","0","0","0","0","0","0","0","0","0"
"2011","Calgary, Alberta, municipal","48014","Methylenedioxyamphetamine (ecstasy), production","0","0","0","0","0","0","0","0","0","0","0","0","0","0"
"2012","Calgary, Alberta, municipal","48014","Methylenedioxyamphetamine (ecstasy), production","0","0","0","0","0","0","0","0","0","0","0","0","0","0"
"2013","Calgary, Alberta, municipal","48014","Methylenedioxyamphetamine (ecstasy), production","0","0","0","0","0","0","0","0","0","0","0","0","0","0"
"2014","Calgary, Alberta, municipal","48014","Methylenedioxyamphetamine (ecstasy), production","0","0","0","0","0","0","0","0","0","0","0","0","0","0"
"2015","Calgary, Alberta, municipal","48014","Methylenedioxyamphetamine (ecstasy), production","0","0","0","0","0","0","0","0","0","0","0","0","0","0"
"2016","Calgary, Alberta, municipal","48014","Methylenedioxyamphetamine (ecstasy), production","1","0","0","0","0.08","0","0","0","0","0","0","0","0","0"
"2005","Calgary, Alberta, municipal","48014","Precursor or equipment (crystal meth, ecstasy)","0","0","0","0","0","0","0","0","0","0","0","0","0","0"
"2006","Calgary, Alberta, municipal","48014","Precursor or equipment (crystal meth, ecstasy)","0","0","0","0","0","0","0","0","0","0","0","0","0","0"
"2007","Calgary, Alberta, municipal","48014","Precursor or equipment (crystal meth, ecstasy)","0","0","0","0","0","0","0","0","0","0","0","0","0","0"
"2008","Calgary, Alberta, municipal","48014","Precursor or equipment (crystal meth, ecstasy)","0","0","0","0","0","0","0","0","0","0","0","0","0","0"
"2009","Calgary, Alberta, municipal","48014","Precursor or equipment (crystal meth, ecstasy)","0","0","0","0","0","0","0","0","0","0","0","0","0","0"
"2010","Calgary, Alberta, municipal","48014","Precursor or equipment (crystal meth, ecstasy)","0","0","0","0","0","0","0","0","0","0","0","0","0","0"
"2011","Calgary, Alberta, municipal","48014","Precursor or equipment (crystal meth, ecstasy)","0","0","0","0","0","0","0","0","0","0","0","0","0","0"
"2012","Calgary, Alberta, municipal","48014","Precursor or equipment (crystal meth, ecstasy)","1","1","0","0","0.08","0.11","0.1","0","0","1","1","1","0","0"
"2013","Calgary, Alberta, municipal","48014","Precursor or equipment (crystal meth, ecstasy)","0","0","0","-100","0","0","0","0","0","0","0","0","0","0"
"2014","Calgary, Alberta, municipal","48014","Precursor or equipment (crystal meth, ecstasy)","0","0","0","0","0","0","0","0","0","0","0","0","0","0"
"2015","Calgary, Alberta, municipal","48014","Precursor or equipment (crystal meth, ecstasy)","1","0","0","0","0.08","0","0","0","0","0","0","0","0","0"
"2016","Calgary, Alberta, municipal","48014","Precursor or equipment (crystal meth, ecstasy)","0","0","0","-100","0","0","0","0","0","0","0","0","0","0"
"1998","Calgary, Alberta, municipal","48014","Youth Criminal Justice Act","595","412","32","0","70.78","0","0","0","0","444","29","371","342","4"
"1999","Calgary, Alberta, municipal","48014","Youth Criminal Justice Act","440","351","7","-27.9","51.03","0","0","0","0","358","27","310","283","2"
"2000","Calgary, Alberta, municipal","48014","Youth Criminal Justice Act","380","322","4","-15.64","43.05","0","0","0","0","326","42","283","241","2"
"2001","Calgary, Alberta, municipal","48014","Youth Criminal Justice Act","409","367","5","5.31","45.34","0","0","0","0","372","31","279","248","2"
"2002","Calgary, Alberta, municipal","48014","Youth Criminal Justice Act","400","354","4","-4.46","43.31","0","0","0","0","358","32","317","285","2"
"2003","Calgary, Alberta, municipal","48014","Youth Criminal Justice Act","136","126","8","-66.53","14.5","0","0","0","0","134","18","115","97","6"
"2004","Calgary, Alberta, municipal","48014","Youth Criminal Justice Act","211","182","6","50.51","21.82","3.99","17.87","155.64","6.59","188","30","148","118","5"
"2005","Calgary, Alberta, municipal","48014","Youth Criminal Justice Act","216","168","12","-0.65","21.68","3.47","16.49","148.01","7.79","180","27","141","114","6"
"2006","Calgary, Alberta, municipal","48014","Youth Criminal Justice Act","151","143","7","-32.22","14.69","2.11","14.72","145.22","7.71","150","17","130","113","6"
"2007","Calgary, Alberta, municipal","48014","Youth Criminal Justice Act","173","170","3","11.82","16.43","2.78","16","157.41","3.87","173","23","145","122","3"
"2008","Calgary, Alberta, municipal","48014","Youth Criminal Justice Act","166","161","0","-6.39","15.38","2.93","15.6","155.46","0","161","25","145","120","0"
"2009","Calgary, Alberta, municipal","48014","Youth Criminal Justice Act","181","180","4","6.3","16.35","3.43","16.99","170.21","3.87","184","30","162","132","3"
"2010","Calgary, Alberta, municipal","48014","Youth Criminal Justice Act","221","222","1","20.31","19.67","4.73","19.87","192.35","1.28","223","42","192","150","1"
"2011","Calgary, Alberta, municipal","48014","Youth Criminal Justice Act","244","238","3","8.68","21.37","4.21","15.5","145.5","3.83","241","38","152","114","3"
"2012","Calgary, Alberta, municipal","48014","Youth Criminal Justice Act","211","205","4","-16.11","17.93","4.62","15.04","138.37","5.08","209","43","152","109","4"
"2013","Calgary, Alberta, municipal","48014","Youth Criminal Justice Act","169","162","1","-22.71","13.86","3.93","13.27","127.58","1.26","163","38","139","101","1"
"2014","Calgary, Alberta, municipal","48014","Youth Criminal Justice Act","158","159","10","-9.55","12.53","2.39","12.57","140.99","11.33","169","24","136","112","9"
"2015","Calgary, Alberta, municipal","48014","Youth Criminal Justice Act","123","119","2","-23.81","9.55","2.54","9.96","104.68","2.49","121","26","110","84","2"
"2016","Calgary, Alberta, municipal","48014","Youth Criminal Justice Act","81","82","0","-35.69","6.14","1.72","6.91","73.2","0","82","18","78","60","0"
"1998","Calgary, Alberta, municipal","48014","Total other Federal Statutes","275","46","142","0","32.71","0","0","0","0","188","36","37","1","1"
"1999","Calgary, Alberta, municipal","48014","Total other Federal Statutes","232","124","96","-17.74","26.91","0","0","0","0","220","50","50","0","0"
"2000","Calgary, Alberta, municipal","48014","Total other Federal Statutes","115","33","35","-51.58","13.03","0","0","0","0","68","30","32","2","0"
"2001","Calgary, Alberta, municipal","48014","Total other Federal Statutes","99","18","19","-15.77","10.97","0","0","0","0","37","21","21","0","0"
"2002","Calgary, Alberta, municipal","48014","Total other Federal Statutes","85","9","9","-16.12","9.2","0","0","0","0","18","17","17","0","2"
"2003","Calgary, Alberta, municipal","48014","Total other Federal Statutes","45","16","11","-47.89","4.8","0","0","0","0","27","8","8","0","1"
"2004","Calgary, Alberta, municipal","48014","Total other Federal Statutes","77","12","7","66","7.96","0.8","0.72","0","0","19","6","6","0","0"
"2005","Calgary, Alberta, municipal","48014","Total other Federal Statutes","110","25","12","38.64","11.04","3.09","3.04","2.6","1.3","37","24","26","2","1"
"2006","Calgary, Alberta, municipal","48014","Total other Federal Statutes","104","11","60","-8.33","10.12","1.37","1.25","0","1.29","71","11","11","0","1"
"2007","Calgary, Alberta, municipal","48014","Total other Federal Statutes","65","9","36","-39","6.17","0.97","0.88","0","3.87","45","8","8","0","3"
"2008","Calgary, Alberta, municipal","48014","Total other Federal Statutes","83","10","33","24.57","7.69","1.17","1.08","0","2.59","43","10","10","0","2"
"2009","Calgary, Alberta, municipal","48014","Total other Federal Statutes","93","5","34","9.23","8.4","0.57","0.52","0","1.29","39","5","5","0","1"
"2010","Calgary, Alberta, municipal","48014","Total other Federal Statutes","106","7","63","12.3","9.43","0.9","0.83","0","1.28","70","8","8","0","1"
"2011","Calgary, Alberta, municipal","48014","Total other Federal Statutes","64","3","65","-40.57","5.61","0.33","0.31","0","0","68","3","3","0","0"
"2012","Calgary, Alberta, municipal","48014","Total other Federal Statutes","36","7","18","-45.43","3.06","0.64","0.59","0","0","25","6","6","0","0"
"2013","Calgary, Alberta, municipal","48014","Total other Federal Statutes","13","1","5","-65.15","1.07","0.21","0.19","0","0","6","2","2","0","0"
"2014","Calgary, Alberta, municipal","48014","Total other Federal Statutes","27","6","11","100.94","2.14","0.7","0.65","0","0","17","7","7","0","0"
"2015","Calgary, Alberta, municipal","48014","Total other Federal Statutes","36","7","15","30.49","2.8","0.88","0.81","0","2.49","22","9","9","0","2"
"2016","Calgary, Alberta, municipal","48014","Total other Federal Statutes","24","6","10","-34.89","1.82","0.57","0.53","0","0","16","6","6","0","0"
"1998","Calgary, Alberta, municipal","48014","Bankruptcy Act","12","4","0","0","1.43","0","0","0","0","4","1","1","0","0"
"1999","Calgary, Alberta, municipal","48014","Bankruptcy Act","3","38","0","-75.62","0.35","0","0","0","0","38","6","6","0","0"
"2000","Calgary, Alberta, municipal","48014","Bankruptcy Act","4","13","0","30.25","0.45","0","0","0","0","13","3","3","0","0"
"2001","Calgary, Alberta, municipal","48014","Bankruptcy Act","0","0","0","-100","0","0","0","0","0","0","0","0","0","0"
"2002","Calgary, Alberta, municipal","48014","Bankruptcy Act","10","2","0","0","1.08","0","0","0","0","2","2","2","0","0"
"2003","Calgary, Alberta, municipal","48014","Bankruptcy Act","4","7","0","-60.63","0.43","0","0","0","0","7","2","2","0","0"
"2004","Calgary, Alberta, municipal","48014","Bankruptcy Act","1","6","0","-75.75","0.1","0.13","0.12","0","0","6","1","1","0","0"
"2005","Calgary, Alberta, municipal","48014","Bankruptcy Act","1","0","0","-2.95","0.1","0","0","0","0","0","0","0","0","0"
"2006","Calgary, Alberta, municipal","48014","Bankruptcy Act","1","0","0","-3.04","0.1","0","0","0","0","0","0","0","0","0"
"2007","Calgary, Alberta, municipal","48014","Bankruptcy Act","1","2","0","-2.4","0.09","0.12","0.11","0","0","2","1","1","0","0"
"2008","Calgary, Alberta, municipal","48014","Bankruptcy Act","2","0","0","95.1","0.19","0","0","0","0","0","0","0","0","0"
"2009","Calgary, Alberta, municipal","48014","Bankruptcy Act","1","0","0","-51.26","0.09","0","0","0","0","0","0","0","0","0"
"2010","Calgary, Alberta, municipal","48014","Bankruptcy Act","1","0","0","-1.47","0.09","0","0","0","0","0","0","0","0","0"
"2011","Calgary, Alberta, municipal","48014","Bankruptcy Act","4","0","0","293.73","0.35","0","0","0","0","0","0","0","0","0"
"2012","Calgary, Alberta, municipal","48014","Bankruptcy Act","1","1","0","-75.75","0.08","0.11","0.1","0","0","1","1","1","0","0"
"2013","Calgary, Alberta, municipal","48014","Bankruptcy Act","3","0","1","189.49","0.25","0","0","0","0","1","0","0","0","0"
"2014","Calgary, Alberta, municipal","48014","Bankruptcy Act","8","0","0","157.99","0.63","0","0","0","0","0","0","0","0","0"
"2015","Calgary, Alberta, municipal","48014","Bankruptcy Act","3","0","1","-63.3","0.23","0","0","0","0","1","0","0","0","0"
"2016","Calgary, Alberta, municipal","48014","Bankruptcy Act","4","0","2","30.22","0.3","0","0","0","0","2","0","0","0","0"
"1998","Calgary, Alberta, municipal","48014","Income Tax Act","0","0","0","0","0","0","0","0","0","0","0","0","0","0"
"1999","Calgary, Alberta, municipal","48014","Income Tax Act","0","0","0","0","0","0","0","0","0","0","0","0","0","0"
"2000","Calgary, Alberta, municipal","48014","Income Tax Act","0","0","0","0","0","0","0","0","0","0","0","0","0","0"
"2001","Calgary, Alberta, municipal","48014","Income Tax Act","0","0","0","0","0","0","0","0","0","0","0","0","0","0"
"2002","Calgary, Alberta, municipal","48014","Income Tax Act","0","0","0","0","0","0","0","0","0","0","0","0","0","0"
"2003","Calgary, Alberta, municipal","48014","Income Tax Act","0","0","0","0","0","0","0","0","0","0","0","0","0","0"
"2004","Calgary, Alberta, municipal","48014","Income Tax Act","0","0","0","0","0","0","0","0","0","0","0","0","0","0"
"2005","Calgary, Alberta, municipal","48014","Income Tax Act","0","0","0","0","0","0","0","0","0","0","0","0","0","0"
"2006","Calgary, Alberta, municipal","48014","Income Tax Act","3","0","2","0","0.29","0","0","0","0","2","0","0","0","0"
"2007","Calgary, Alberta, municipal","48014","Income Tax Act","1","0","8","-67.47","0.09","0","0","0","0","8","0","0","0","0"
"2008","Calgary, Alberta, municipal","48014","Income Tax Act","0","0","0","-100","0","0","0","0","0","0","0","0","0","0"
"2009","Calgary, Alberta, municipal","48014","Income Tax Act","0","0","0","0","0","0","0","0","0","0","0","0","0","0"
"2010","Calgary, Alberta, municipal","48014","Income Tax Act","0","0","0","0","0","0","0","0","0","0","0","0","0","0"
"2011","Calgary, Alberta, municipal","48014","Income Tax Act","0","0","0","0","0","0","0","0","0","0","0","0","0","0"
"2012","Calgary, Alberta, municipal","48014","Income Tax Act","0","0","0","0","0","0","0","0","0","0","0","0","0","0"
"2013","Calgary, Alberta, municipal","48014","Income Tax Act","0","0","0","0","0","0","0","0","0","0","0","0","0","0"
"2014","Calgary, Alberta, municipal","48014","Income Tax Act","0","0","0","0","0","0","0","0","0","0","0","0","0","0"
"2015","Calgary, Alberta, municipal","48014","Income Tax Act","0","0","0","0","0","0","0","0","0","0","0","0","0","0"
"2016","Calgary, Alberta, municipal","48014","Income Tax Act","1","0","0","0","0.08","0","0","0","0","0","0","0","0","0"
"1998","Calgary, Alberta, municipal","48014","Canada Shipping Act","0","0","0","0","0","0","0","0","0","0","0","0","0","0"
"1999","Calgary, Alberta, municipal","48014","Canada Shipping Act","0","0","0","0","0","0","0","0","0","0","0","0","0","0"
"2000","Calgary, Alberta, municipal","48014","Canada Shipping Act","0","0","0","0","0","0","0","0","0","0","0","0","0","0"
"2001","Calgary, Alberta, municipal","48014","Canada Shipping Act","0","0","0","0","0","0","0","0","0","0","0","0","0","0"
"2002","Calgary, Alberta, municipal","48014","Canada Shipping Act","0","0","0","0","0","0","0","0","0","0","0","0","0","0"
"2003","Calgary, Alberta, municipal","48014","Canada Shipping Act","0","0","0","0","0","0","0","0","0","0","0","0","0","0"
"2004","Calgary, Alberta, municipal","48014","Canada Shipping Act","0","0","0","0","0","0","0","0","0","0","0","0","0","0"
"2005","Calgary, Alberta, municipal","48014","Canada Shipping Act","0","0","0","0","0","0","0","0","0","0","0","0","0","0"
"2006","Calgary, Alberta, municipal","48014","Canada Shipping Act","0","0","0","0","0","0","0","0","0","0","0","0","0","0"
"2007","Calgary, Alberta, municipal","48014","Canada Shipping Act","0","0","0","0","0","0","0","0","0","0","0","0","0","0"
"2008","Calgary, Alberta, municipal","48014","Canada Shipping Act","0","0","0","0","0","0","0","0","0","0","0","0","0","0"
"2009","Calgary, Alberta, municipal","48014","Canada Shipping Act","0","0","0","0","0","0","0","0","0","0","0","0","0","0"
"2010","Calgary, Alberta, municipal","48014","Canada Shipping Act","0","0","0","0","0","0","0","0","0","0","0","0","0","0"
"2011","Calgary, Alberta, municipal","48014","Canada Shipping Act","0","0","0","0","0","0","0","0","0","0","0","0","0","0"
"2012","Calgary, Alberta, municipal","48014","Canada Shipping Act","3","1","2","0","0.25","0.11","0.1","0","0","3","1","1","0","0"
"2013","Calgary, Alberta, municipal","48014","Canada Shipping Act","0","0","0","-100","0","0","0","0","0","0","0","0","0","0"
"2014","Calgary, Alberta, municipal","48014","Canada Shipping Act","0","0","0","0","0","0","0","0","0","0","0","0","0","0"
"2015","Calgary, Alberta, municipal","48014","Canada Shipping Act","0","0","0","0","0","0","0","0","0","0","0","0","0","0"
"2016","Calgary, Alberta, municipal","48014","Canada Shipping Act","1","0","0","0","0.08","0","0","0","0","0","0","0","0","0"
"1998","Calgary, Alberta, municipal","48014","Canada Health Act","0","0","0","0","0","0","0","0","0","0","0","0","0","0"
"1999","Calgary, Alberta, municipal","48014","Canada Health Act","0","0","0","0","0","0","0","0","0","0","0","0","0","0"
"2000","Calgary, Alberta, municipal","48014","Canada Health Act","0","0","0","0","0","0","0","0","0","0","0","0","0","0"
"2001","Calgary, Alberta, municipal","48014","Canada Health Act","1","1","0","0","0.11","0","0","0","0","1","1","1","0","0"
"2002","Calgary, Alberta, municipal","48014","Canada Health Act","0","0","0","-100","0","0","0","0","0","0","0","0","0","0"
"2003","Calgary, Alberta, municipal","48014","Canada Health Act","1","1","0","0","0.11","0","0","0","0","1","1","1","0","0"
"2004","Calgary, Alberta, municipal","48014","Canada Health Act","0","0","0","-100","0","0","0","0","0","0","0","0","0","0"
"2005","Calgary, Alberta, municipal","48014","Canada Health Act","1","1","0","0","0.1","0.13","0.12","0","0","1","1","1","0","0"
"2006","Calgary, Alberta, municipal","48014","Canada Health Act","0","0","0","-100","0","0","0","0","0","0","0","0","0","0"
"2007","Calgary, Alberta, municipal","48014","Canada Health Act","0","0","0","0","0","0","0","0","0","0","0","0","0","0"
"2008","Calgary, Alberta, municipal","48014","Canada Health Act","0","0","0","0","0","0","0","0","0","0","0","0","0","0"
"2009","Calgary, Alberta, municipal","48014","Canada Health Act","0","0","0","0","0","0","0","0","0","0","0","0","0","0"
"2010","Calgary, Alberta, municipal","48014","Canada Health Act","0","0","0","0","0","0","0","0","0","0","0","0","0","0"
"2011","Calgary, Alberta, municipal","48014","Canada Health Act","0","0","0","0","0","0","0","0","0","0","0","0","0","0"
"2012","Calgary, Alberta, municipal","48014","Canada Health Act","0","0","0","0","0","0","0","0","0","0","0","0","0","0"
"2013","Calgary, Alberta, municipal","48014","Canada Health Act","0","0","0","0","0","0","0","0","0","0","0","0","0","0"
"2014","Calgary, Alberta, municipal","48014","Canada Health Act","0","0","0","0","0","0","0","0","0","0","0","0","0","0"
"2015","Calgary, Alberta, municipal","48014","Canada Health Act","0","0","0","0","0","0","0","0","0","0","0","0","0","0"
"2016","Calgary, Alberta, municipal","48014","Canada Health Act","0","0","0","0","0","0","0","0","0","0","0","0","0","0"
"1998","Calgary, Alberta, municipal","48014","Customs Act","20","0","0","0","2.38","0","0","0","0","0","0","0","0","0"
"1999","Calgary, Alberta, municipal","48014","Customs Act","11","1","1","-46.37","1.28","0","0","0","0","2","1","1","0","0"
"2000","Calgary, Alberta, municipal","48014","Customs Act","12","0","1","6.56","1.36","0","0","0","0","1","0","0","0","0"
"2001","Calgary, Alberta, municipal","48014","Customs Act","9","0","2","-26.62","1","0","0","0","0","2","0","0","0","0"
"2002","Calgary, Alberta, municipal","48014","Customs Act","5","0","0","-45.73","0.54","0","0","0","0","0","0","0","0","0"
"2003","Calgary, Alberta, municipal","48014","Customs Act","2","1","3","-60.63","0.21","0","0","0","0","4","1","1","0","0"
"2004","Calgary, Alberta, municipal","48014","Customs Act","5","0","1","142.54","0.52","0","0","0","0","1","0","0","0","0"
"2005","Calgary, Alberta, municipal","48014","Customs Act","45","0","3","773.43","4.52","0","0","0","0","3","0","0","0","0"
"2006","Calgary, Alberta, municipal","48014","Customs Act","65","1","46","40.05","6.32","0.12","0.11","0","1.29","47","1","1","0","1"
"2007","Calgary, Alberta, municipal","48014","Customs Act","6","1","7","-90.99","0.57","0.12","0.11","0","0","8","1","1","0","0"
"2008","Calgary, Alberta, municipal","48014","Customs Act","5","0","0","-18.71","0.46","0","0","0","0","0","0","0","0","0"
"2009","Calgary, Alberta, municipal","48014","Customs Act","8","0","1","55.98","0.72","0","0","0","0","1","0","0","0","0"
"2010","Calgary, Alberta, municipal","48014","Customs Act","4","1","4","-50.73","0.36","0.11","0.1","0","0","5","1","1","0","0"
"2011","Calgary, Alberta, municipal","48014","Customs Act","6","0","3","47.65","0.53","0","0","0","0","3","0","0","0","0"
"2012","Calgary, Alberta, municipal","48014","Customs Act","1","0","0","-83.83","0.08","0","0","0","0","0","0","0","0","0"
"2013","Calgary, Alberta, municipal","48014","Customs Act","0","0","0","-100","0","0","0","0","0","0","0","0","0","0"
"2014","Calgary, Alberta, municipal","48014","Customs Act","4","0","1","0","0.32","0","0","0","0","1","0","0","0","0"
"2015","Calgary, Alberta, municipal","48014","Customs Act","20","0","12","389.33","1.55","0","0","0","2.49","12","0","0","0","2"
"2016","Calgary, Alberta, municipal","48014","Customs Act","5","0","3","-75.58","0.38","0","0","0","0","3","0","0","0","0"
"1998","Calgary, Alberta, municipal","48014","Competition Act","0","0","0","0","0","0","0","0","0","0","0","0","0","0"
"1999","Calgary, Alberta, municipal","48014","Competition Act","0","0","0","0","0","0","0","0","0","0","0","0","0","0"
"2000","Calgary, Alberta, municipal","48014","Competition Act","1","1","0","0","0.11","0","0","0","0","1","2","2","0","0"
"2001","Calgary, Alberta, municipal","48014","Competition Act","1","0","1","-2.16","0.11","0","0","0","0","1","0","0","0","0"
"2002","Calgary, Alberta, municipal","48014","Competition Act","0","0","0","-100","0","0","0","0","0","0","0","0","0","0"
"2003","Calgary, Alberta, municipal","48014","Competition Act","0","0","0","0","0","0","0","0","0","0","0","0","0","0"
"2004","Calgary, Alberta, municipal","48014","Competition Act","0","0","0","0","0","0","0","0","0","0","0","0","0","0"
"2005","Calgary, Alberta, municipal","48014","Competition Act","0","0","0","0","0","0","0","0","0","0","0","0","0","0"
"2006","Calgary, Alberta, municipal","48014","Competition Act","1","1","0","0","0.1","0","0","0","0","1","0","0","0","0"
"2007","Calgary, Alberta, municipal","48014","Competition Act","0","0","0","-100","0","0","0","0","0","0","0","0","0","0"
"2008","Calgary, Alberta, municipal","48014","Competition Act","0","0","0","0","0","0","0","0","0","0","0","0","0","0"
"2009","Calgary, Alberta, municipal","48014","Competition Act","0","0","0","0","0","0","0","0","0","0","0","0","0","0"
"2010","Calgary, Alberta, municipal","48014","Competition Act","0","0","0","0","0","0","0","0","0","0","0","0","0","0"
"2011","Calgary, Alberta, municipal","48014","Competition Act","0","0","0","0","0","0","0","0","0","0","0","0","0","0"
"2012","Calgary, Alberta, municipal","48014","Competition Act","0","0","0","0","0","0","0","0","0","0","0","0","0","0"
"2013","Calgary, Alberta, municipal","48014","Competition Act","0","0","0","0","0","0","0","0","0","0","0","0","0","0"
"2014","Calgary, Alberta, municipal","48014","Competition Act","0","0","0","0","0","0","0","0","0","0","0","0","0","0"
"2015","Calgary, Alberta, municipal","48014","Competition Act","0","0","0","0","0","0","0","0","0","0","0","0","0","0"
"2016","Calgary, Alberta, municipal","48014","Competition Act","0","0","0","0","0","0","0","0","0","0","0","0","0","0"
"1998","Calgary, Alberta, municipal","48014","Excise Act","10","2","0","0","1.19","0","0","0","0","2","2","2","0","0"
"1999","Calgary, Alberta, municipal","48014","Excise Act","6","0","0","-41.5","0.7","0","0","0","0","0","0","0","0","0"
"2000","Calgary, Alberta, municipal","48014","Excise Act","5","0","1","-18.6","0.57","0","0","0","0","1","0","0","0","0"
"2001","Calgary, Alberta, municipal","48014","Excise Act","0","0","0","-100","0","0","0","0","0","0","0","0","0","0"
"2002","Calgary, Alberta, municipal","48014","Excise Act","4","1","0","0","0.43","0","0","0","0","1","1","1","0","0"
"2003","Calgary, Alberta, municipal","48014","Excise Act","3","1","2","-26.17","0.32","0","0","0","0","3","1","1","0","0"
"2004","Calgary, Alberta, municipal","48014","Excise Act","0","0","0","-100","0","0","0","0","0","0","0","0","0","0"
"2005","Calgary, Alberta, municipal","48014","Excise Act","4","0","0","0","0.4","0","0","0","0","0","0","0","0","0"
"2006","Calgary, Alberta, municipal","48014","Excise Act","8","1","2","93.91","0.78","0.25","0.23","0","0","3","2","2","0","0"
"2007","Calgary, Alberta, municipal","48014","Excise Act","8","1","4","-2.4","0.76","0.12","0.11","0","0","5","1","1","0","0"
"2008","Calgary, Alberta, municipal","48014","Excise Act","9","0","2","9.75","0.83","0","0","0","0","2","0","0","0","0"
"2009","Calgary, Alberta, municipal","48014","Excise Act","26","1","4","181.63","2.35","0.11","0.1","0","0","5","1","1","0","0"
"2010","Calgary, Alberta, municipal","48014","Excise Act","11","3","5","-58.31","0.98","0.45","0.41","0","0","8","4","4","0","0"
"2011","Calgary, Alberta, municipal","48014","Excise Act","6","0","4","-46.31","0.53","0","0","0","0","4","0","0","0","0"
"2012","Calgary, Alberta, municipal","48014","Excise Act","4","2","1","-35.33","0.34","0.11","0.1","0","0","3","1","1","0","0"
"2013","Calgary, Alberta, municipal","48014","Excise Act","0","0","0","-100","0","0","0","0","0","0","0","0","0","0"
"2014","Calgary, Alberta, municipal","48014","Excise Act","0","0","0","0","0","0","0","0","0","0","0","0","0","0"
"2015","Calgary, Alberta, municipal","48014","Excise Act","0","0","1","0","0","0","0","0","0","1","0","0","0","0"
"2016","Calgary, Alberta, municipal","48014","Excise Act","0","0","0","0","0","0","0","0","0","0","0","0","0","0"
"1998","Calgary, Alberta, municipal","48014","Total Immigration and Refugee Protection Act","201","22","128","0","23.91","0","0","0","0","150","14","14","0","0"
"1999","Calgary, Alberta, municipal","48014","Total Immigration and Refugee Protection Act","178","59","91","-13.65","20.64","0","0","0","0","150","13","13","0","0"
"2000","Calgary, Alberta, municipal","48014","Total Immigration and Refugee Protection Act","77","6","33","-57.74","8.72","0","0","0","0","39","6","6","0","0"
"2001","Calgary, Alberta, municipal","48014","Total Immigration and Refugee Protection Act","67","0","16","-14.87","7.43","0","0","0","0","16","0","0","0","0"
"2002","Calgary, Alberta, municipal","48014","Total Immigration and Refugee Protection Act","58","1","7","-15.43","6.28","0","0","0","0","8","1","1","0","2"
"2003","Calgary, Alberta, municipal","48014","Total Immigration and Refugee Protection Act","32","4","5","-45.69","3.41","0","0","0","0","9","2","2","0","0"
"2004","Calgary, Alberta, municipal","48014","Total Immigration and Refugee Protection Act","68","4","6","106.15","7.03","0.4","0.36","0","0","10","3","3","0","0"
"2005","Calgary, Alberta, municipal","48014","Total Immigration and Refugee Protection Act","43","17","2","-38.63","4.32","2.19","1.99","0","0","19","17","17","0","0"
"2006","Calgary, Alberta, municipal","48014","Total Immigration and Refugee Protection Act","15","3","7","-66.18","1.46","0.37","0.34","0","0","10","3","3","0","0"
"2007","Calgary, Alberta, municipal","48014","Total Immigration and Refugee Protection Act","4","0","2","-73.97","0.38","0","0","0","0","2","0","0","0","0"
"2008","Calgary, Alberta, municipal","48014","Total Immigration and Refugee Protection Act","9","0","3","119.49","0.83","0","0","0","0","3","0","0","0","0"
"2009","Calgary, Alberta, municipal","48014","Total Immigration and Refugee Protection Act","9","0","3","-2.51","0.81","0","0","0","0","3","0","0","0","0"
"2010","Calgary, Alberta, municipal","48014","Total Immigration and Refugee Protection Act","10","0","7","9.48","0.89","0","0","0","0","7","0","0","0","0"
"2011","Calgary, Alberta, municipal","48014","Total Immigration and Refugee Protection Act","10","1","8","-1.57","0.88","0.11","0.1","0","0","9","1","1","0","0"
"2012","Calgary, Alberta, municipal","48014","Total Immigration and Refugee Protection Act","4","0","1","-61.2","0.34","0","0","0","0","1","0","0","0","0"
"2013","Calgary, Alberta, municipal","48014","Total Immigration and Refugee Protection Act","0","0","0","-100","0","0","0","0","0","0","0","0","0","0"
"2014","Calgary, Alberta, municipal","48014","Total Immigration and Refugee Protection Act","2","0","0","0","0.16","0","0","0","0","0","0","0","0","0"
"2015","Calgary, Alberta, municipal","48014","Total Immigration and Refugee Protection Act","5","2","0","144.66","0.39","0.39","0.36","0","0","2","4","4","0","0"
"2016","Calgary, Alberta, municipal","48014","Total Immigration and Refugee Protection Act","0","0","2","-100","0","0","0","0","0","2","0","0","0","0"
"1998","Calgary, Alberta, municipal","48014","Firearms Act","0","0","0","0","0","0","0","0","0","0","0","0","0","0"
"1999","Calgary, Alberta, municipal","48014","Firearms Act","0","0","0","0","0","0","0","0","0","0","0","0","0","0"
"2000","Calgary, Alberta, municipal","48014","Firearms Act","0","0","0","0","0","0","0","0","0","0","0","0","0","0"
"2001","Calgary, Alberta, municipal","48014","Firearms Act","0","0","0","0","0","0","0","0","0","0","0","0","0","0"
"2002","Calgary, Alberta, municipal","48014","Firearms Act","0","0","0","0","0","0","0","0","0","0","0","0","0","0"
"2003","Calgary, Alberta, municipal","48014","Firearms Act","0","0","0","0","0","0","0","0","0","0","0","0","0","0"
"2004","Calgary, Alberta, municipal","48014","Firearms Act","0","0","0","0","0","0","0","0","0","0","0","0","0","0"
"2005","Calgary, Alberta, municipal","48014","Firearms Act","0","0","0","0","0","0","0","0","0","0","0","0","0","0"
"2006","Calgary, Alberta, municipal","48014","Firearms Act","0","0","0","0","0","0","0","0","0","0","0","0","0","0"
"2007","Calgary, Alberta, municipal","48014","Firearms Act","0","0","0","0","0","0","0","0","0","0","0","0","0","0"
"2008","Calgary, Alberta, municipal","48014","Firearms Act","0","0","0","0","0","0","0","0","0","0","0","0","0","0"
"2009","Calgary, Alberta, municipal","48014","Firearms Act","0","0","0","0","0","0","0","0","0","0","0","0","0","0"
"2010","Calgary, Alberta, municipal","48014","Firearms Act","0","0","0","0","0","0","0","0","0","0","0","0","0","0"
"2011","Calgary, Alberta, municipal","48014","Firearms Act","0","0","0","0","0","0","0","0","0","0","0","0","0","0"
"2012","Calgary, Alberta, municipal","48014","Firearms Act","0","0","0","0","0","0","0","0","0","0","0","0","0","0"
"2013","Calgary, Alberta, municipal","48014","Firearms Act","1","0","0","0","0.08","0","0","0","0","0","0","0","0","0"
"2014","Calgary, Alberta, municipal","48014","Firearms Act","1","0","1","-3.25","0.08","0","0","0","0","1","0","0","0","0"
"2015","Calgary, Alberta, municipal","48014","Firearms Act","0","0","0","-100","0","0","0","0","0","0","0","0","0","0"
"2016","Calgary, Alberta, municipal","48014","Firearms Act","0","0","0","0","0","0","0","0","0","0","0","0","0","0"
"2002","Calgary, Alberta, municipal","48014","National Defence Act","0","0","0","0","0","0","0","0","0","0","0","0","0","0"
"2003","Calgary, Alberta, municipal","48014","National Defence Act","0","0","0","0","0","0","0","0","0","0","0","0","0","0"
"2004","Calgary, Alberta, municipal","48014","National Defence Act","0","0","0","0","0","0","0","0","0","0","0","0","0","0"
"2005","Calgary, Alberta, municipal","48014","National Defence Act","0","0","0","0","0","0","0","0","0","0","0","0","0","0"
"2006","Calgary, Alberta, municipal","48014","National Defence Act","0","0","0","0","0","0","0","0","0","0","0","0","0","0"
"2007","Calgary, Alberta, municipal","48014","National Defence Act","0","0","0","0","0","0","0","0","0","0","0","0","0","0"
"2008","Calgary, Alberta, municipal","48014","National Defence Act","0","0","0","0","0","0","0","0","0","0","0","0","0","0"
"2009","Calgary, Alberta, municipal","48014","National Defence Act","0","0","0","0","0","0","0","0","0","0","0","0","0","0"
"2010","Calgary, Alberta, municipal","48014","National Defence Act","0","0","0","0","0","0","0","0","0","0","0","0","0","0"
"2011","Calgary, Alberta, municipal","48014","National Defence Act","0","0","0","0","0","0","0","0","0","0","0","0","0","0"
"2012","Calgary, Alberta, municipal","48014","National Defence Act","0","0","0","0","0","0","0","0","0","0","0","0","0","0"
"2013","Calgary, Alberta, municipal","48014","National Defence Act","0","0","0","0","0","0","0","0","0","0","0","0","0","0"
"2014","Calgary, Alberta, municipal","48014","National Defence Act","0","0","0","0","0","0","0","0","0","0","0","0","0","0"
"2015","Calgary, Alberta, municipal","48014","National Defence Act","0","0","0","0","0","0","0","0","0","0","0","0","0","0"
"2016","Calgary, Alberta, municipal","48014","National Defence Act","0","0","0","0","0","0","0","0","0","0","0","0","0","0"
"1998","Calgary, Alberta, municipal","48014","Other federal statutes","32","18","14","0","3.81","0","0","0","0","32","19","20","1","1"
"1999","Calgary, Alberta, municipal","48014","Other federal statutes","34","26","4","3.6","3.94","0","0","0","0","30","30","30","0","0"
"2000","Calgary, Alberta, municipal","48014","Other federal statutes","16","13","0","-54.03","1.81","0","0","0","0","13","19","21","2","0"
"2001","Calgary, Alberta, municipal","48014","Other federal statutes","21","17","0","28.41","2.33","0","0","0","0","17","20","20","0","0"
"2002","Calgary, Alberta, municipal","48014","Other federal statutes","8","5","2","-62.78","0.87","0","0","0","0","7","13","13","0","0"
"2003","Calgary, Alberta, municipal","48014","Other federal statutes","3","2","1","-63.09","0.32","0","0","0","0","3","1","1","0","1"
"2004","Calgary, Alberta, municipal","48014","Other federal statutes","3","2","0","-2.99","0.31","0.27","0.24","0","0","2","2","2","0","0"
"2005","Calgary, Alberta, municipal","48014","Other federal statutes","16","7","7","417.59","1.61","0.77","0.94","2.6","1.3","14","6","8","2","1"
"2006","Calgary, Alberta, municipal","48014","Other federal statutes","11","5","3","-33.34","1.07","0.62","0.57","0","0","8","5","5","0","0"
"2007","Calgary, Alberta, municipal","48014","Other federal statutes","45","5","15","299.27","4.27","0.6","0.55","0","3.87","20","5","5","0","3"
"2008","Calgary, Alberta, municipal","48014","Other federal statutes","58","10","28","25.73","5.37","1.17","1.08","0","2.59","38","10","10","0","2"
"2009","Calgary, Alberta, municipal","48014","Other federal statutes","49","4","26","-17.64","4.43","0.46","0.42","0","1.29","30","4","4","0","1"
"2010","Calgary, Alberta, municipal","48014","Other federal statutes","80","3","47","60.87","7.12","0.34","0.31","0","1.28","50","3","3","0","1"
"2011","Calgary, Alberta, municipal","48014","Other federal statutes","38","2","50","-53.24","3.33","0.22","0.2","0","0","52","2","2","0","0"
"2012","Calgary, Alberta, municipal","48014","Other federal statutes","23","3","14","-41.28","1.95","0.32","0.3","0","0","17","3","3","0","0"
"2013","Calgary, Alberta, municipal","48014","Other federal statutes","9","1","4","-62.24","0.74","0.21","0.19","0","0","5","2","2","0","0"
"2014","Calgary, Alberta, municipal","48014","Other federal statutes","12","6","9","29","0.95","0.7","0.65","0","0","15","7","7","0","0"
"2015","Calgary, Alberta, municipal","48014","Other federal statutes","8","5","1","-34.76","0.62","0.49","0.45","0","0","6","5","5","0","0"
"2016","Calgary, Alberta, municipal","48014","Other federal statutes","13","6","3","58.7","0.99","0.57","0.53","0","0","9","6","6","0","0"
"1998","Edmonton, Alberta, municipal","48033","Total, all violations","68482","28041","3624","0","10485.06","0","0","0","0","31665","21057","25163","4106","1828"
"1999","Edmonton, Alberta, municipal","48033","Total, all violations","66087","27813","3617","-5","9960.71","0","0","0","0","31430","21331","25260","3929","1871"
"2000","Edmonton, Alberta, municipal","48033","Total, all violations","67040","29471","3424","-0.08","9952.86","0","0","0","0","32895","21658","25824","4166","1811"
"2001","Edmonton, Alberta, municipal","48033","Total, all violations","73452","28884","2796","8.07","10755.77","0","0","0","0","31680","22786","27301","4515","1449"
"2002","Edmonton, Alberta, municipal","48033","Total, all violations","77962","28333","2761","4.31","11219.44","0","0","0","0","31094","22444","26380","3936","1503"
"2003","Edmonton, Alberta, municipal","48033","Total, all violations","85026","29141","2849","7.84","12098.83","0","0","0","0","31990","23431","27396","3965","1546"
"2004","Edmonton, Alberta, municipal","48033","Total, all violations","87770","28039","2691","0.68","12180.58","4054.9","4227.77","6004.27","2568.09","30730","23041","26361","3320","1420"
"2005","Edmonton, Alberta, municipal","48033","Total, all violations","87553","26651","2400","-2.51","11874.88","3606.4","3758.12","5353.28","2094.14","29051","21058","24031","2973","1163"
"2006","Edmonton, Alberta, municipal","48033","Total, all violations","84045","25865","2124","-6.75","11073.4","2782.81","2887.53","4016.65","1685.96","27989","16799","19048","2249","944"
"2007","Edmonton, Alberta, municipal","48033","Total, all violations","80809","25016","3816","-6.35","10370.65","3223.06","3364.72","4946.27","2662.41","28832","20057","22814","2757","1484"
"2008","Edmonton, Alberta, municipal","48033","Total, all violations","80762","29544","3681","-2.36","10125.51","3722.42","3874.54","5629.28","2379.53","33225","23783","26901","3118","1318"
"2009","Edmonton, Alberta, municipal","48033","Total, all violations","79610","28878","4632","-3.87","9733.86","3514.49","3653.94","5322.89","2308.04","33510","23091","26013","2922","1267"
"2010","Edmonton, Alberta, municipal","48033","Total, all violations","71699","29846","4152","-11.38","8626.4","3512.68","3620.92","4946.3","2459.41","33998","23471","26170","2699","1342"
"2011","Edmonton, Alberta, municipal","48033","Total, all violations","64613","29927","3368","-11.42","7641.22","3323.01","3415.8","4561.23","1831.03","33295","22584","25095","2511","1008"
"2012","Edmonton, Alberta, municipal","48033","Total, all violations","64772","30838","3005","-2.27","7467.86","3356.85","3451.08","4657.13","1723.98","33843","23450","25992","2542","941"
"2013","Edmonton, Alberta, municipal","48033","Total, all violations","69190","32037","2967","3.3","7714.5","3335.52","3425.54","4622.25","1836.41","35004","24146","26663","2517","1000"
"2014","Edmonton, Alberta, municipal","48033","Total, all violations","73758","34558","3196","3.13","7955.78","3475.2","3523.12","4183.21","1395.02","37754","26043","28319","2276","759"
"2015","Edmonton, Alberta, municipal","48033","Total, all violations","83592","37749","3684","10.88","8821.69","3645.7","3695.7","4394.44","1590.84","41433","27899","30305","2406","871"
"2016","Edmonton, Alberta, municipal","48033","Total, all violations","92154","42191","3838","7.8","9509.55","4112.02","4093.73","3837.04","1495.67","46029","32135","34272","2137","833"
"1998","Edmonton, Alberta, municipal","48033","Total, all Criminal Code violations (including traffic)","67015","26795","3492","0","10260.45","0","0","0","0","30287","19844","23691","3847","1789"
"1999","Edmonton, Alberta, municipal","48033","Total, all Criminal Code violations (including traffic)","64561","26422","3543","-5.16","9730.71","0","0","0","0","29965","19891","23535","3644","1850"
"2000","Edmonton, Alberta, municipal","48033","Total, all Criminal Code violations (including traffic)","65299","28047","3354","-0.37","9694.39","0","0","0","0","31401","20159","24016","3857","1791"
"2001","Edmonton, Alberta, municipal","48033","Total, all Criminal Code violations (including traffic)","72179","27739","2733","9.03","10569.36","0","0","0","0","30472","21568","25812","4244","1419"
"2002","Edmonton, Alberta, municipal","48033","Total, all Criminal Code violations (including traffic)","76845","27294","2700","4.63","11058.7","0","0","0","0","29994","21406","25105","3699","1479"
"2003","Edmonton, Alberta, municipal","48033","Total, all Criminal Code violations (including traffic)","83847","28053","2807","7.89","11931.07","0","0","0","0","30860","22350","26119","3769","1513"
"2004","Edmonton, Alberta, municipal","48033","Total, all Criminal Code violations (including traffic)","86615","26996","2652","0.75","12020.29","3865.36","4026.66","5684.16","2502.98","29648","21964","25107","3143","1384"
"2005","Edmonton, Alberta, municipal","48033","Total, all Criminal Code violations (including traffic)","86471","25660","2357","-2.43","11728.13","3432.06","3579.21","5126.4","2025.71","28017","20040","22887","2847","1125"
"2006","Edmonton, Alberta, municipal","48033","Total, all Criminal Code violations (including traffic)","82838","24729","2079","-6.94","10914.37","2592.97","2692.44","3764.82","1616.3","26808","15653","17761","2108","905"
"2007","Edmonton, Alberta, municipal","48033","Total, all Criminal Code violations (including traffic)","79625","23944","3757","-6.37","10218.7","3055.94","3187","4650.24","2592.44","27701","19017","21609","2592","1445"
"2008","Edmonton, Alberta, municipal","48033","Total, all Criminal Code violations (including traffic)","79483","28396","3619","-2.48","9965.16","3555.1","3692.2","5273.61","2321.76","32015","22714","25635","2921","1286"
"2009","Edmonton, Alberta, municipal","48033","Total, all Criminal Code violations (including traffic)","78158","27617","4540","-4.1","9556.32","3331.85","3459.25","4984.06","2224.25","32157","21891","24627","2736","1221"
"2010","Edmonton, Alberta, municipal","48033","Total, all Criminal Code violations (including traffic)","69864","28198","4051","-12.04","8405.62","3277.56","3371.31","4519.3","2420.92","32249","21900","24366","2466","1321"
"2011","Edmonton, Alberta, municipal","48033","Total, all Criminal Code violations (including traffic)","62896","28323","3292","-11.51","7438.16","3093.77","3170.11","4112.55","1760.19","31615","21026","23290","2264","969"
"2012","Edmonton, Alberta, municipal","48033","Total, all Criminal Code violations (including traffic)","62986","29209","2909","-2.37","7261.95","3130.39","3211.16","4244.91","1643.37","32118","21868","24185","2317","897"
"2013","Edmonton, Alberta, municipal","48033","Total, all Criminal Code violations (including traffic)","67215","30172","2893","3.2","7494.29","3070.02","3150.22","4216.4","1744.59","33065","22224","24520","2296","950"
"2014","Edmonton, Alberta, municipal","48033","Total, all Criminal Code violations (including traffic)","71362","32301","3113","2.71","7697.34","3171.75","3212.6","3775.18","1363.77","35414","23769","25823","2054","742"
"2015","Edmonton, Alberta, municipal","48033","Total, all Criminal Code violations (including traffic)","81254","35529","3609","11.4","8574.95","3352.34","3400.33","4071.16","1550.66","39138","25654","27883","2229","849"
"2016","Edmonton, Alberta, municipal","48033","Total, all Criminal Code violations (including traffic)","89452","39683","3735","7.65","9230.72","3769.34","3757.12","3585.66","1440.01","43418","29457","31454","1997","802"
"1998","Edmonton, Alberta, municipal","48033","Total, all Criminal Code violations (excluding traffic)","63743","23539","3492","0","9759.48","0","0","0","0","27031","16826","20673","3847","1789"
"1999","Edmonton, Alberta, municipal","48033","Total, all Criminal Code violations (excluding traffic)","61505","23356","3542","-5.01","9270.1","0","0","0","0","26898","16821","20465","3644","1850"
"2000","Edmonton, Alberta, municipal","48033","Total, all Criminal Code violations (excluding traffic)","62198","25160","3353","-0.39","9234.01","0","0","0","0","28513","17278","21134","3856","1791"
"2001","Edmonton, Alberta, municipal","48033","Total, all Criminal Code violations (excluding traffic)","69444","24999","2732","10.12","10168.87","0","0","0","0","27731","18837","23081","4244","1419"
"2002","Edmonton, Alberta, municipal","48033","Total, all Criminal Code violations (excluding traffic)","74224","24672","2700","5.04","10681.51","0","0","0","0","27372","18797","22496","3699","1479"
"2003","Edmonton, Alberta, municipal","48033","Total, all Criminal Code violations (excluding traffic)","81218","25422","2807","8.2","11556.97","0","0","0","0","28229","19731","23500","3769","1513"
"2004","Edmonton, Alberta, municipal","48033","Total, all Criminal Code violations (excluding traffic)","83954","24331","2649","0.81","11651.01","3399.35","3601.97","5684.16","2502.98","26980","19316","22459","3143","1384"
"2005","Edmonton, Alberta, municipal","48033","Total, all Criminal Code violations (excluding traffic)","83947","23150","2356","-2.28","11385.79","3003.57","3187.94","5126.4","2025.71","25506","17538","20385","2847","1125"
"2006","Edmonton, Alberta, municipal","48033","Total, all Criminal Code violations (excluding traffic)","80046","22152","2049","-7.37","10546.51","2174.36","2309.36","3764.82","1616.3","24201","13126","15234","2108","905"
"2007","Edmonton, Alberta, municipal","48033","Total, all Criminal Code violations (excluding traffic)","76565","20986","3718","-6.83","9825.99","2593.62","2752.07","4521.07","2588.85","24704","16140","18660","2520","1443"
"2008","Edmonton, Alberta, municipal","48033","Total, all Criminal Code violations (excluding traffic)","76242","25274","3555","-2.72","9558.82","3075.22","3245.13","5205","2319.96","28829","19648","22531","2883","1285"
"2009","Edmonton, Alberta, municipal","48033","Total, all Criminal Code violations (excluding traffic)","74942","24572","4508","-4.14","9163.1","2873.57","3032.38","4933.05","2224.25","29080","18880","21588","2708","1221"
"2010","Edmonton, Alberta, municipal","48033","Total, all Criminal Code violations (excluding traffic)","66697","25121","4002","-12.43","8024.59","2825.74","2948.2","4447.82","2419.09","29123","18881","21308","2427","1320"
"2011","Edmonton, Alberta, municipal","48033","Total, all Criminal Code violations (excluding traffic)","59790","25293","3261","-11.89","7070.84","2654.41","2760.13","4065.32","1756.55","28554","18040","20278","2238","967"
"2012","Edmonton, Alberta, municipal","48033","Total, all Criminal Code violations (excluding traffic)","59835","26182","2844","-2.44","6898.65","2702.66","2810.18","4186.29","1643.37","29026","18880","21165","2285","897"
"2013","Edmonton, Alberta, municipal","48033","Total, all Criminal Code violations (excluding traffic)","64234","27310","2850","3.82","7161.92","2683.78","2785.73","4141.11","1744.59","30160","19428","21683","2255","950"
"2014","Edmonton, Alberta, municipal","48033","Total, all Criminal Code violations (excluding traffic)","68238","29355","3066","2.77","7360.37","2785.04","2847.34","3705.34","1361.93","32421","20871","22887","2016","741"
"2015","Edmonton, Alberta, municipal","48033","Total, all Criminal Code violations (excluding traffic)","78249","32713","3557","12.19","8257.82","2991.67","3058.51","3992.62","1548.83","36270","22894","25080","2186","848"
"2016","Edmonton, Alberta, municipal","48033","Total, all Criminal Code violations (excluding traffic)","86507","37050","3680","8.1","8926.82","3438.82","3445.12","3533.59","1436.42","40730","26874","28842","1968","800"
"1998","Edmonton, Alberta, municipal","48033","Total violent Criminal Code violations","8100","4997","414","0","1240.16","0","0","0","0","5411","4036","4710","674","145"
"1999","Edmonton, Alberta, municipal","48033","Total violent Criminal Code violations","7559","4782","377","-8.13","1139.3","0","0","0","0","5159","3806","4587","781","156"
"2000","Edmonton, Alberta, municipal","48033","Total violent Criminal Code violations","8468","5360","385","10.35","1257.17","0","0","0","0","5745","3937","4805","868","154"
"2001","Edmonton, Alberta, municipal","48033","Total violent Criminal Code violations","8912","5436","339","3.8","1305.01","0","0","0","0","5775","3944","4861","917","128"
"2002","Edmonton, Alberta, municipal","48033","Total violent Criminal Code violations","8385","4870","370","-7.53","1206.68","0","0","0","0","5240","3545","4350","805","139"
"2003","Edmonton, Alberta, municipal","48033","Total violent Criminal Code violations","8382","4507","286","-1.16","1192.72","0","0","0","0","4793","3300","3955","655","122"
"2004","Edmonton, Alberta, municipal","48033","Total violent Criminal Code violations","7763","4012","329","-9.67","1077.34","508.25","560.85","1101.39","222.45","4341","2888","3497","609","123"
"2005","Edmonton, Alberta, municipal","48033","Total violent Criminal Code violations","7962","4056","337","0.24","1079.89","503.16","557.05","1123.6","199.87","4393","2938","3562","624","111"
"2006","Edmonton, Alberta, municipal","48033","Total violent Criminal Code violations","8223","4020","391","0.33","1083.43","494.31","530.27","917.99","166.1","4411","2984","3498","514","93"
"2007","Edmonton, Alberta, municipal","48033","Total violent Criminal Code violations","10242","4093","1189","21.32","1314.41","481.44","522.54","981.36","426.99","5282","2996","3543","547","238"
"2008","Edmonton, Alberta, municipal","48033","Total violent Criminal Code violations","10840","4678","1053","3.4","1359.06","544.99","593.83","1157.27","319.56","5731","3482","4123","641","177"
"2009","Edmonton, Alberta, municipal","48033","Total violent Criminal Code violations","11080","4723","1726","-0.32","1354.74","553.71","597.12","1116.68","404.41","6449","3638","4251","613","222"
"2010","Edmonton, Alberta, municipal","48033","Total violent Criminal Code violations","10624","4914","1435","-5.65","1278.22","569.01","600.21","982.3","405.01","6349","3802","4338","536","221"
"2011","Edmonton, Alberta, municipal","48033","Total violent Criminal Code violations","10239","5044","1120","-5.27","1210.88","561.93","595.23","1006.34","330.6","6164","3819","4373","554","182"
"2012","Edmonton, Alberta, municipal","48033","Total violent Criminal Code violations","10599","5435","917","0.92","1222.01","611.1","637.98","981.99","315.12","6352","4269","4805","536","172"
"2013","Edmonton, Alberta, municipal","48033","Total violent Criminal Code violations","10613","5589","941","-3.17","1183.32","599.11","622.46","932.9","325.04","6530","4337","4845","508","177"
"2014","Edmonton, Alberta, municipal","48033","Total violent Criminal Code violations","10807","5721","815","-1.49","1165.68","599.95","618.43","873.03","253.64","6536","4496","4971","475","138"
"2015","Edmonton, Alberta, municipal","48033","Total violent Criminal Code violations","11838","6182","949","7.17","1249.3","629.85","647.19","889.48","253.88","7131","4820","5307","487","139"
"2016","Edmonton, Alberta, municipal","48033","Total violent Criminal Code violations","11623","6073","839","-3.99","1199.4","625.22","639.88","845.69","217.26","6912","4886","5357","471","121"
"1998","Edmonton, Alberta, municipal","48033","Homicide","21","17","0","0","3.22","0","0","0","0","17","15","17","2","0"
"1999","Edmonton, Alberta, municipal","48033","Homicide","18","15","0","-15.62","2.71","0","0","0","0","15","16","18","2","0"
"2000","Edmonton, Alberta, municipal","48033","Homicide","17","14","1","-6.97","2.52","0","0","0","0","15","17","19","2","0"
"2001","Edmonton, Alberta, municipal","48033","Homicide","21","18","1","21.84","3.08","0","0","0","0","19","19","21","2","0"
"2002","Edmonton, Alberta, municipal","48033","Homicide","24","14","1","12.32","3.45","0","0","0","0","15","18","19","1","0"
"2003","Edmonton, Alberta, municipal","48033","Homicide","18","11","0","-25.84","2.56","0","0","0","0","11","14","15","1","0"
"2004","Edmonton, Alberta, municipal","48033","Homicide","29","14","1","57.13","4.02","2.11","2.08","1.81","0","15","12","13","1","0"
"2005","Edmonton, Alberta, municipal","48033","Homicide","37","26","0","24.69","5.02","5.65","5.79","7.2","0","26","33","37","4","0"
"2006","Edmonton, Alberta, municipal","48033","Homicide","35","21","0","-8.11","4.61","2.48","3.79","17.86","0","21","15","25","10","0"
"2007","Edmonton, Alberta, municipal","48033","Homicide","32","13","0","-10.94","4.11","2.09","2.36","5.38","0","13","13","16","3","0"
"2008","Edmonton, Alberta, municipal","48033","Homicide","34","11","1","3.8","4.26","2.19","2.02","0","1.81","12","14","14","0","1"
"2009","Edmonton, Alberta, municipal","48033","Homicide","26","15","2","-25.42","3.18","2.44","2.81","7.29","0","17","16","20","4","0"
"2010","Edmonton, Alberta, municipal","48033","Homicide","26","17","4","-1.6","3.13","2.69","3.46","12.83","0","21","18","25","7","0"
"2011","Edmonton, Alberta, municipal","48033","Homicide","46","28","4","73.9","5.44","5.59","5.44","3.63","0","32","38","40","2","0"
"2012","Edmonton, Alberta, municipal","48033","Homicide","30","18","1","-36.42","3.46","3.44","3.32","1.83","0","19","24","25","1","0"
"2013","Edmonton, Alberta, municipal","48033","Homicide","26","22","0","-16.19","2.9","3.59","3.6","3.67","0","22","26","28","2","0"
"2014","Edmonton, Alberta, municipal","48033","Homicide","35","23","10","30.23","3.78","3.34","3.23","1.84","0","33","25","26","1","0"
"2015","Edmonton, Alberta, municipal","48033","Homicide","30","19","3","-16.14","3.17","3.4","3.78","9.13","0","22","26","31","5","0"
"2016","Edmonton, Alberta, municipal","48033","Homicide","38","23","0","23.86","3.92","3.2","3.23","3.59","0","23","25","27","2","0"
"1998","Edmonton, Alberta, municipal","48033","Murder, first degree","3","2","0","0","0.46","0","0","0","0","2","1","1","0","0"
"1999","Edmonton, Alberta, municipal","48033","Murder, first degree","4","2","0","31.26","0.6","0","0","0","0","2","1","2","1","0"
"2000","Edmonton, Alberta, municipal","48033","Murder, first degree","4","2","1","-1.5","0.59","0","0","0","0","3","4","4","0","0"
"2001","Edmonton, Alberta, municipal","48033","Murder, first degree","5","3","0","23.29","0.73","0","0","0","0","3","4","4","0","0"
"2002","Edmonton, Alberta, municipal","48033","Murder, first degree","9","2","1","76.9","1.3","0","0","0","0","3","4","4","0","0"
"2003","Edmonton, Alberta, municipal","48033","Murder, first degree","10","5","0","9.87","1.42","0","0","0","0","5","8","8","0","0"
"2004","Edmonton, Alberta, municipal","48033","Murder, first degree","14","5","0","36.54","1.94","0.7","0.64","0","0","5","4","4","0","0"
"2005","Edmonton, Alberta, municipal","48033","Murder, first degree","13","5","0","-9.25","1.76","1.37","1.25","0","0","5","8","8","0","0"
"2006","Edmonton, Alberta, municipal","48033","Murder, first degree","11","2","0","-17.8","1.45","0.33","0.3","0","0","2","2","2","0","0"
"2007","Edmonton, Alberta, municipal","48033","Murder, first degree","18","2","0","59.39","2.31","0","0.44","5.38","0","2","0","3","3","0"
"2008","Edmonton, Alberta, municipal","48033","Murder, first degree","16","4","0","-13.16","2.01","0.78","0.72","0","0","4","5","5","0","0"
"2009","Edmonton, Alberta, municipal","48033","Murder, first degree","10","2","2","-39.05","1.22","0.46","0.42","0","0","4","3","3","0","0"
"2010","Edmonton, Alberta, municipal","48033","Murder, first degree","10","5","1","-1.6","1.2","0.6","0.55","0","0","6","4","4","0","0"
"2011","Edmonton, Alberta, municipal","48033","Murder, first degree","15","5","1","47.44","1.77","1.03","0.95","0","0","6","7","7","0","0"
"2012","Edmonton, Alberta, municipal","48033","Murder, first degree","10","3","0","-35.01","1.15","0.14","0.13","0","0","3","1","1","0","0"
"2013","Edmonton, Alberta, municipal","48033","Murder, first degree","9","5","0","-12.96","1","0.97","0.9","0","0","5","7","7","0","0"
"2014","Edmonton, Alberta, municipal","48033","Murder, first degree","13","4","9","39.74","1.4","0.4","0.37","0","0","13","3","3","0","0"
"2015","Edmonton, Alberta, municipal","48033","Murder, first degree","10","7","1","-24.74","1.06","1.57","1.71","3.65","0","8","12","14","2","0"
"2016","Edmonton, Alberta, municipal","48033","Murder, first degree","11","7","0","7.56","1.14","1.02","0.96","0","0","7","8","8","0","0"
"1998","Edmonton, Alberta, municipal","48033","Murder, second degree","14","13","0","0","2.14","0","0","0","0","13","12","14","2","0"
"1999","Edmonton, Alberta, municipal","48033","Murder, second degree","13","12","0","-8.59","1.96","0","0","0","0","12","13","14","1","0"
"2000","Edmonton, Alberta, municipal","48033","Murder, second degree","10","9","0","-24.23","1.48","0","0","0","0","9","10","12","2","0"
"2001","Edmonton, Alberta, municipal","48033","Murder, second degree","14","13","1","38.09","2.05","0","0","0","0","14","13","15","2","0"
"2002","Edmonton, Alberta, municipal","48033","Murder, second degree","9","8","0","-36.82","1.3","0","0","0","0","8","10","11","1","0"
"2003","Edmonton, Alberta, municipal","48033","Murder, second degree","8","6","0","-12.11","1.14","0","0","0","0","6","6","7","1","0"
"2004","Edmonton, Alberta, municipal","48033","Murder, second degree","11","7","0","34.1","1.53","1.06","1.12","1.81","0","7","6","7","1","0"
"2005","Edmonton, Alberta, municipal","48033","Murder, second degree","21","18","0","86.58","2.85","3.77","3.91","5.4","0","18","22","25","3","0"
"2006","Edmonton, Alberta, municipal","48033","Murder, second degree","18","13","0","-16.73","2.37","1.33","1.67","5.36","0","13","8","11","3","0"
"2007","Edmonton, Alberta, municipal","48033","Murder, second degree","13","11","0","-29.65","1.67","2.09","1.92","0","0","11","13","13","0","0"
"2008","Edmonton, Alberta, municipal","48033","Murder, second degree","16","7","1","20.24","2.01","1.41","1.3","0","1.81","8","9","9","0","1"
"2009","Edmonton, Alberta, municipal","48033","Murder, second degree","15","12","0","-8.57","1.83","1.83","2.25","7.29","0","12","12","16","4","0"
"2010","Edmonton, Alberta, municipal","48033","Murder, second degree","16","12","3","4.96","1.93","2.1","2.91","12.83","0","15","14","21","7","0"
"2011","Edmonton, Alberta, municipal","48033","Murder, second degree","26","20","0","59.73","3.07","3.97","3.95","3.63","0","20","27","29","2","0"
"2012","Edmonton, Alberta, municipal","48033","Murder, second degree","17","13","1","-36.26","1.96","3.01","2.92","1.83","0","14","21","22","1","0"
"2013","Edmonton, Alberta, municipal","48033","Murder, second degree","16","16","0","-8.98","1.78","2.49","2.57","3.67","0","16","18","20","2","0"
"2014","Edmonton, Alberta, municipal","48033","Murder, second degree","15","12","1","-9.31","1.62","2","1.99","1.84","0","13","15","16","1","0"
"2015","Edmonton, Alberta, municipal","48033","Murder, second degree","17","11","1","10.88","1.79","1.7","1.95","5.48","0","12","13","16","3","0"
"2016","Edmonton, Alberta, municipal","48033","Murder, second degree","22","12","0","26.54","2.27","1.66","1.79","3.59","0","12","13","15","2","0"
"1998","Edmonton, Alberta, municipal","48033","Manslaughter","3","2","0","0","0.46","0","0","0","0","2","2","2","0","0"
"1999","Edmonton, Alberta, municipal","48033","Manslaughter","1","1","0","-67.19","0.15","0","0","0","0","1","2","2","0","0"
"2000","Edmonton, Alberta, municipal","48033","Manslaughter","3","3","0","195.5","0.45","0","0","0","0","3","3","3","0","0"
"2001","Edmonton, Alberta, municipal","48033","Manslaughter","2","2","0","-34.24","0.29","0","0","0","0","2","2","2","0","0"
"2002","Edmonton, Alberta, municipal","48033","Manslaughter","6","4","0","194.83","0.86","0","0","0","0","4","4","4","0","0"
"2003","Edmonton, Alberta, municipal","48033","Manslaughter","0","0","0","-100","0","0","0","0","0","0","0","0","0","0"
"2004","Edmonton, Alberta, municipal","48033","Manslaughter","4","2","1","0","0.56","0.35","0.32","0","0","3","2","2","0","0"
"2005","Edmonton, Alberta, municipal","48033","Manslaughter","3","3","0","-26.7","0.41","0.51","0.63","1.8","0","3","3","4","1","0"
"2006","Edmonton, Alberta, municipal","48033","Manslaughter","6","6","0","94.29","0.79","0.83","1.82","12.5","0","6","5","12","7","0"
"2007","Edmonton, Alberta, municipal","48033","Manslaughter","1","0","0","-83.77","0.13","0","0","0","0","0","0","0","0","0"
"2008","Edmonton, Alberta, municipal","48033","Manslaughter","2","0","0","95.39","0.25","0","0","0","0","0","0","0","0","0"
"2009","Edmonton, Alberta, municipal","48033","Manslaughter","1","1","0","-51.24","0.12","0.15","0.14","0","0","1","1","1","0","0"
"2010","Edmonton, Alberta, municipal","48033","Manslaughter","0","0","0","-100","0","0","0","0","0","0","0","0","0","0"
"2011","Edmonton, Alberta, municipal","48033","Manslaughter","5","3","3","0","0.59","0.59","0.54","0","0","6","4","4","0","0"
"2012","Edmonton, Alberta, municipal","48033","Manslaughter","3","2","0","-41.51","0.35","0.29","0.27","0","0","2","2","2","0","0"
"2013","Edmonton, Alberta, municipal","48033","Manslaughter","1","1","0","-67.76","0.11","0.14","0.13","0","0","1","1","1","0","0"
"2014","Edmonton, Alberta, municipal","48033","Manslaughter","7","7","0","577.18","0.76","0.93","0.87","0","0","7","7","7","0","0"
"2015","Edmonton, Alberta, municipal","48033","Manslaughter","3","1","1","-58.07","0.32","0.13","0.12","0","0","2","1","1","0","0"
"2016","Edmonton, Alberta, municipal","48033","Manslaughter","5","4","0","62.97","0.52","0.51","0.48","0","0","4","4","4","0","0"
"1998","Edmonton, Alberta, municipal","48033","Infanticide","1","0","0","0","0.15","0","0","0","0","0","0","0","0","0"
"1999","Edmonton, Alberta, municipal","48033","Infanticide","0","0","0","-100","0","0","0","0","0","0","0","0","0","0"
"2000","Edmonton, Alberta, municipal","48033","Infanticide","0","0","0","0","0","0","0","0","0","0","0","0","0","0"
"2001","Edmonton, Alberta, municipal","48033","Infanticide","0","0","0","0","0","0","0","0","0","0","0","0","0","0"
"2002","Edmonton, Alberta, municipal","48033","Infanticide","0","0","0","0","0","0","0","0","0","0","0","0","0","0"
"2003","Edmonton, Alberta, municipal","48033","Infanticide","0","0","0","0","0","0","0","0","0","0","0","0","0","0"
"2004","Edmonton, Alberta, municipal","48033","Infanticide","0","0","0","0","0","0","0","0","0","0","0","0","0","0"
"2005","Edmonton, Alberta, municipal","48033","Infanticide","0","0","0","0","0","0","0","0","0","0","0","0","0","0"
"2006","Edmonton, Alberta, municipal","48033","Infanticide","0","0","0","0","0","0","0","0","0","0","0","0","0","0"
"2007","Edmonton, Alberta, municipal","48033","Infanticide","0","0","0","0","0","0","0","0","0","0","0","0","0","0"
"2008","Edmonton, Alberta, municipal","48033","Infanticide","0","0","0","0","0","0","0","0","0","0","0","0","0","0"
"2009","Edmonton, Alberta, municipal","48033","Infanticide","0","0","0","0","0","0","0","0","0","0","0","0","0","0"
"2010","Edmonton, Alberta, municipal","48033","Infanticide","0","0","0","0","0","0","0","0","0","0","0","0","0","0"
"2011","Edmonton, Alberta, municipal","48033","Infanticide","0","0","0","0","0","0","0","0","0","0","0","0","0","0"
"2012","Edmonton, Alberta, municipal","48033","Infanticide","0","0","0","0","0","0","0","0","0","0","0","0","0","0"
"2013","Edmonton, Alberta, municipal","48033","Infanticide","0","0","0","0","0","0","0","0","0","0","0","0","0","0"
"2014","Edmonton, Alberta, municipal","48033","Infanticide","0","0","0","0","0","0","0","0","0","0","0","0","0","0"
"2015","Edmonton, Alberta, municipal","48033","Infanticide","0","0","0","0","0","0","0","0","0","0","0","0","0","0"
"2016","Edmonton, Alberta, municipal","48033","Infanticide","0","0","0","0","0","0","0","0","0","0","0","0","0","0"
"1998","Edmonton, Alberta, municipal","48033","Total other violations causing death","4","2","0","0","0.61","0","0","0","0","2","2","2","0","0"
"1999","Edmonton, Alberta, municipal","48033","Total other violations causing death","4","4","0","-1.56","0.6","0","0","0","0","4","4","5","1","0"
"2000","Edmonton, Alberta, municipal","48033","Total other violations causing death","1","1","0","-75.37","0.15","0","0","0","0","1","1","1","0","0"
"2001","Edmonton, Alberta, municipal","48033","Total other violations causing death","8","8","0","689.07","1.17","0","0","0","0","8","8","8","0","0"
"2002","Edmonton, Alberta, municipal","48033","Total other violations causing death","3","2","0","-63.15","0.43","0","0","0","0","2","3","3","0","0"
"2003","Edmonton, Alberta, municipal","48033","Total other violations causing death","2","2","0","-34.08","0.28","0","0","0","0","2","2","2","0","0"
"2004","Edmonton, Alberta, municipal","48033","Total other violations causing death","4","2","0","95.06","0.56","0.35","0.32","0","0","2","2","2","0","0"
"2005","Edmonton, Alberta, municipal","48033","Total other violations causing death","3","3","0","-26.7","0.41","0.51","0.47","0","0","3","3","3","0","0"
"2006","Edmonton, Alberta, municipal","48033","Total other violations causing death","0","0","0","-100","0","0","0","0","0","0","0","0","0","0"
"2007","Edmonton, Alberta, municipal","48033","Total other violations causing death","2","2","0","0","0.26","0.48","0.44","0","0","2","3","3","0","0"
"2008","Edmonton, Alberta, municipal","48033","Total other violations causing death","1","1","0","-51.15","0.13","0.16","0.14","0","0","1","1","1","0","0"
"2009","Edmonton, Alberta, municipal","48033","Total other violations causing death","1","0","0","-2.48","0.12","0","0","0","0","0","0","0","0","0"
"2010","Edmonton, Alberta, municipal","48033","Total other violations causing death","0","1","0","-100","0","0.15","0.14","0","0","1","1","1","0","0"
"2011","Edmonton, Alberta, municipal","48033","Total other violations causing death","0","0","0","0","0","0","0","0","0","0","0","0","0","0"
"2012","Edmonton, Alberta, municipal","48033","Total other violations causing death","1","1","0","0","0.12","0.14","0.13","0","0","1","1","1","0","0"
"2013","Edmonton, Alberta, municipal","48033","Total other violations causing death","1","1","0","-3.29","0.11","0.14","0.13","0","0","1","1","1","0","0"
"2014","Edmonton, Alberta, municipal","48033","Total other violations causing death","2","1","0","93.48","0.22","0","0","0","0","1","0","0","0","0"
"2015","Edmonton, Alberta, municipal","48033","Total other violations causing death","0","0","1","-100","0","0","0","0","0","1","0","0","0","0"
"2016","Edmonton, Alberta, municipal","48033","Total other violations causing death","1","0","0","0","0.1","0","0","0","0","0","0","0","0","0"
"1998","Edmonton, Alberta, municipal","48033","Criminal negligence causing death","4","2","0","0","0.61","0","0","0","0","2","2","2","0","0"
"1999","Edmonton, Alberta, municipal","48033","Criminal negligence causing death","4","4","0","-1.56","0.6","0","0","0","0","4","4","5","1","0"
"2000","Edmonton, Alberta, municipal","48033","Criminal negligence causing death","1","1","0","-75.37","0.15","0","0","0","0","1","1","1","0","0"
"2001","Edmonton, Alberta, municipal","48033","Criminal negligence causing death","8","8","0","689.07","1.17","0","0","0","0","8","8","8","0","0"
"2002","Edmonton, Alberta, municipal","48033","Criminal negligence causing death","3","2","0","-63.15","0.43","0","0","0","0","2","3","3","0","0"
"2003","Edmonton, Alberta, municipal","48033","Criminal negligence causing death","2","2","0","-34.08","0.28","0","0","0","0","2","2","2","0","0"
"2004","Edmonton, Alberta, municipal","48033","Criminal negligence causing death","4","2","0","95.06","0.56","0.35","0.32","0","0","2","2","2","0","0"
"2005","Edmonton, Alberta, municipal","48033","Criminal negligence causing death","3","3","0","-26.7","0.41","0.51","0.47","0","0","3","3","3","0","0"
"2006","Edmonton, Alberta, municipal","48033","Criminal negligence causing death","0","0","0","-100","0","0","0","0","0","0","0","0","0","0"
"2007","Edmonton, Alberta, municipal","48033","Criminal negligence causing death","2","2","0","0","0.26","0.48","0.44","0","0","2","3","3","0","0"
"2008","Edmonton, Alberta, municipal","48033","Criminal negligence causing death","0","0","0","-100","0","0","0","0","0","0","0","0","0","0"
"2009","Edmonton, Alberta, municipal","48033","Criminal negligence causing death","1","0","0","0","0.12","0","0","0","0","0","0","0","0","0"
"2010","Edmonton, Alberta, municipal","48033","Criminal negligence causing death","0","1","0","-100","0","0.15","0.14","0","0","1","1","1","0","0"
"2011","Edmonton, Alberta, municipal","48033","Criminal negligence causing death","0","0","0","0","0","0","0","0","0","0","0","0","0","0"
"2012","Edmonton, Alberta, municipal","48033","Criminal negligence causing death","1","1","0","0","0.12","0.14","0.13","0","0","1","1","1","0","0"
"2013","Edmonton, Alberta, municipal","48033","Criminal negligence causing death","1","1","0","-3.29","0.11","0.14","0.13","0","0","1","1","1","0","0"
"2014","Edmonton, Alberta, municipal","48033","Criminal negligence causing death","2","1","0","93.48","0.22","0","0","0","0","1","0","0","0","0"
"2015","Edmonton, Alberta, municipal","48033","Criminal negligence causing death","0","0","1","-100","0","0","0","0","0","1","0","0","0","0"
"2016","Edmonton, Alberta, municipal","48033","Criminal negligence causing death","1","0","0","0","0.1","0","0","0","0","0","0","0","0","0"
"1998","Edmonton, Alberta, municipal","48033","Other related violations causing death","0","0","0","0","0","0","0","0","0","0","0","0","0","0"
"1999","Edmonton, Alberta, municipal","48033","Other related violations causing death","0","0","0","0","0","0","0","0","0","0","0","0","0","0"
"2000","Edmonton, Alberta, municipal","48033","Other related violations causing death","0","0","0","0","0","0","0","0","0","0","0","0","0","0"
"2001","Edmonton, Alberta, municipal","48033","Other related violations causing death","0","0","0","0","0","0","0","0","0","0","0","0","0","0"
"2002","Edmonton, Alberta, municipal","48033","Other related violations causing death","0","0","0","0","0","0","0","0","0","0","0","0","0","0"
"2003","Edmonton, Alberta, municipal","48033","Other related violations causing death","0","0","0","0","0","0","0","0","0","0","0","0","0","0"
"2004","Edmonton, Alberta, municipal","48033","Other related violations causing death","0","0","0","0","0","0","0","0","0","0","0","0","0","0"
"2005","Edmonton, Alberta, municipal","48033","Other related violations causing death","0","0","0","0","0","0","0","0","0","0","0","0","0","0"
"2006","Edmonton, Alberta, municipal","48033","Other related violations causing death","0","0","0","0","0","0","0","0","0","0","0","0","0","0"
"2007","Edmonton, Alberta, municipal","48033","Other related violations causing death","0","0","0","0","0","0","0","0","0","0","0","0","0","0"
"2008","Edmonton, Alberta, municipal","48033","Other related violations causing death","1","1","0","0","0.13","0.16","0.14","0","0","1","1","1","0","0"
"2009","Edmonton, Alberta, municipal","48033","Other related violations causing death","0","0","0","-100","0","0","0","0","0","0","0","0","0","0"
"2010","Edmonton, Alberta, municipal","48033","Other related violations causing death","0","0","0","0","0","0","0","0","0","0","0","0","0","0"
"2011","Edmonton, Alberta, municipal","48033","Other related violations causing death","0","0","0","0","0","0","0","0","0","0","0","0","0","0"
"2012","Edmonton, Alberta, municipal","48033","Other related violations causing death","0","0","0","0","0","0","0","0","0","0","0","0","0","0"
"2013","Edmonton, Alberta, municipal","48033","Other related violations causing death","0","0","0","0","0","0","0","0","0","0","0","0","0","0"
"2014","Edmonton, Alberta, municipal","48033","Other related violations causing death","0","0","0","0","0","0","0","0","0","0","0","0","0","0"
"2015","Edmonton, Alberta, municipal","48033","Other related violations causing death","0","0","0","0","0","0","0","0","0","0","0","0","0","0"
"2016","Edmonton, Alberta, municipal","48033","Other related violations causing death","0","0","0","0","0","0","0","0","0","0","0","0","0","0"
"1998","Edmonton, Alberta, municipal","48033","Attempted murder","10","5","0","0","1.53","0","0","0","0","5","3","3","0","0"
"1999","Edmonton, Alberta, municipal","48033","Attempted murder","8","6","0","-21.25","1.21","0","0","0","0","6","8","8","0","0"
"2000","Edmonton, Alberta, municipal","48033","Attempted murder","12","8","0","47.75","1.78","0","0","0","0","8","6","9","3","0"
"2001","Edmonton, Alberta, municipal","48033","Attempted murder","8","7","0","-34.24","1.17","0","0","0","0","7","4","5","1","0"
"2002","Edmonton, Alberta, municipal","48033","Attempted murder","8","10","0","-1.72","1.15","0","0","0","0","10","14","15","1","0"
"2003","Edmonton, Alberta, municipal","48033","Attempted murder","3","2","0","-62.92","0.43","0","0","0","0","2","1","1","0","0"
"2004","Edmonton, Alberta, municipal","48033","Attempted murder","14","10","0","355.13","1.94","1.06","0.96","0","0","10","6","6","0","0"
"2005","Edmonton, Alberta, municipal","48033","Attempted murder","7","5","0","-51.13","0.95","0.69","0.63","0","0","5","4","4","0","0"
"2006","Edmonton, Alberta, municipal","48033","Attempted murder","10","8","1","38.78","1.32","1.82","1.67","0","0","9","11","11","0","0"
"2007","Edmonton, Alberta, municipal","48033","Attempted murder","7","4","0","-31.82","0.9","1.29","1.18","0","0","4","8","8","0","0"
"2008","Edmonton, Alberta, municipal","48033","Attempted murder","5","2","0","-30.22","0.63","0.31","0.29","0","0","2","2","2","0","0"
"2009","Edmonton, Alberta, municipal","48033","Attempted murder","8","8","0","56.04","0.98","1.22","1.12","0","0","8","8","8","0","0"
"2010","Edmonton, Alberta, municipal","48033","Attempted murder","6","6","0","-26.2","0.72","1.05","1.11","1.83","0","6","7","8","1","0"
"2011","Edmonton, Alberta, municipal","48033","Attempted murder","9","8","0","47.44","1.06","1.32","1.23","0","0","8","9","9","0","0"
"2012","Edmonton, Alberta, municipal","48033","Attempted murder","9","10","0","-2.51","1.04","2","1.99","1.83","0","10","14","15","1","0"
"2013","Edmonton, Alberta, municipal","48033","Attempted murder","4","4","1","-57.02","0.45","0.69","0.64","0","0","5","5","5","0","0"
"2014","Edmonton, Alberta, municipal","48033","Attempted murder","12","12","0","190.22","1.29","1.47","1.49","1.84","0","12","11","12","1","0"
"2015","Edmonton, Alberta, municipal","48033","Attempted murder","24","21","0","95.68","2.53","2.22","2.32","3.65","0","21","17","19","2","0"
"2016","Edmonton, Alberta, municipal","48033","Attempted murder","10","12","0","-59.26","1.03","0.38","0.36","0","0","12","3","3","0","0"
"1998","Edmonton, Alberta, municipal","48033","Sexual assault, level 3, aggravated","2","2","0","0","0.31","0","0","0","0","2","2","2","0","0"
"1999","Edmonton, Alberta, municipal","48033","Sexual assault, level 3, aggravated","7","6","0","244.55","1.06","0","0","0","0","6","5","5","0","0"
"2000","Edmonton, Alberta, municipal","48033","Sexual assault, level 3, aggravated","3","3","0","-57.79","0.45","0","0","0","0","3","3","3","0","0"
"2001","Edmonton, Alberta, municipal","48033","Sexual assault, level 3, aggravated","5","4","0","64.39","0.73","0","0","0","0","4","3","3","0","0"
"2002","Edmonton, Alberta, municipal","48033","Sexual assault, level 3, aggravated","7","5","0","37.59","1.01","0","0","0","0","5","6","6","0","0"
"2003","Edmonton, Alberta, municipal","48033","Sexual assault, level 3, aggravated","4","4","1","-43.5","0.57","0","0","0","0","5","4","4","0","0"
"2004","Edmonton, Alberta, municipal","48033","Sexual assault, level 3, aggravated","3","4","0","-26.85","0.42","0.7","0.64","0","0","4","4","4","0","0"
"2005","Edmonton, Alberta, municipal","48033","Sexual assault, level 3, aggravated","1","1","0","-67.42","0.14","0.17","0.16","0","0","1","1","1","0","0"
"2006","Edmonton, Alberta, municipal","48033","Sexual assault, level 3, aggravated","3","1","0","191.43","0.4","0.17","0.15","0","0","1","1","1","0","0"
"2007","Edmonton, Alberta, municipal","48033","Sexual assault, level 3, aggravated","1","1","0","-67.53","0.13","0.16","0.15","0","0","1","1","1","0","0"
"2008","Edmonton, Alberta, municipal","48033","Sexual assault, level 3, aggravated","5","2","0","388.47","0.63","0.31","0.29","0","0","2","2","2","0","0"
"2009","Edmonton, Alberta, municipal","48033","Sexual assault, level 3, aggravated","3","0","0","-41.49","0.37","0","0","0","0","0","0","0","0","0"
"2010","Edmonton, Alberta, municipal","48033","Sexual assault, level 3, aggravated","10","7","0","228","1.2","1.2","1.11","0","0","7","8","8","0","0"
"2011","Edmonton, Alberta, municipal","48033","Sexual assault, level 3, aggravated","8","6","1","-21.36","0.95","0.59","0.68","1.82","0","7","4","5","1","0"
"2012","Edmonton, Alberta, municipal","48033","Sexual assault, level 3, aggravated","5","4","0","-39.07","0.58","0.43","0.53","1.83","0","4","3","4","1","0"
"2013","Edmonton, Alberta, municipal","48033","Sexual assault, level 3, aggravated","3","1","0","-41.98","0.33","0.14","0.13","0","0","1","1","1","0","0"
"2014","Edmonton, Alberta, municipal","48033","Sexual assault, level 3, aggravated","4","2","0","28.99","0.43","0.13","0.25","1.84","0","2","1","2","1","0"
"2015","Edmonton, Alberta, municipal","48033","Sexual assault, level 3, aggravated","2","2","0","-51.08","0.21","0.26","0.24","0","0","2","2","2","0","0"
"2016","Edmonton, Alberta, municipal","48033","Sexual assault, level 3, aggravated","3","0","0","46.67","0.31","0","0","0","0","0","0","0","0","0"
"1998","Edmonton, Alberta, municipal","48033","Sexual assault, level 2, weapon or bodily harm","18","9","0","0","2.76","0","0","0","0","9","8","8","0","0"
"1999","Edmonton, Alberta, municipal","48033","Sexual assault, level 2, weapon or bodily harm","11","5","1","-39.84","1.66","0","0","0","0","6","5","5","0","0"
"2000","Edmonton, Alberta, municipal","48033","Sexual assault, level 2, weapon or bodily harm","15","6","1","34.32","2.23","0","0","0","0","7","5","5","0","0"
"2001","Edmonton, Alberta, municipal","48033","Sexual assault, level 2, weapon or bodily harm","11","6","0","-27.67","1.61","0","0","0","0","6","4","5","1","0"
"2002","Edmonton, Alberta, municipal","48033","Sexual assault, level 2, weapon or bodily harm","18","6","1","60.82","2.59","0","0","0","0","7","3","5","2","0"
"2003","Edmonton, Alberta, municipal","48033","Sexual assault, level 2, weapon or bodily harm","11","5","0","-39.57","1.57","0","0","0","0","5","2","5","3","0"
"2004","Edmonton, Alberta, municipal","48033","Sexual assault, level 2, weapon or bodily harm","10","3","0","-11.34","1.39","0.53","0.48","0","0","3","3","3","0","0"
"2005","Edmonton, Alberta, municipal","48033","Sexual assault, level 2, weapon or bodily harm","9","4","0","-12.04","1.22","0.51","0.47","0","0","4","3","3","0","0"
"2006","Edmonton, Alberta, municipal","48033","Sexual assault, level 2, weapon or bodily harm","12","3","0","29.52","1.58","0.17","0.15","0","0","3","1","1","0","0"
"2007","Edmonton, Alberta, municipal","48033","Sexual assault, level 2, weapon or bodily harm","18","7","0","46.11","2.31","0.96","0.88","0","0","7","6","6","0","0"
"2008","Edmonton, Alberta, municipal","48033","Sexual assault, level 2, weapon or bodily harm","10","1","0","-45.73","1.25","0.16","0.14","0","0","1","1","1","0","0"
"2009","Edmonton, Alberta, municipal","48033","Sexual assault, level 2, weapon or bodily harm","8","4","0","-21.98","0.98","0.61","0.56","0","0","4","4","4","0","0"
"2010","Edmonton, Alberta, municipal","48033","Sexual assault, level 2, weapon or bodily harm","17","11","0","109.1","2.05","1.2","1.38","3.67","0","11","8","10","2","0"
"2011","Edmonton, Alberta, municipal","48033","Sexual assault, level 2, weapon or bodily harm","24","13","0","38.77","2.84","1.18","1.5","5.45","0","13","8","11","3","0"
"2012","Edmonton, Alberta, municipal","48033","Sexual assault, level 2, weapon or bodily harm","19","11","0","-22.82","2.19","1.29","1.33","1.83","0","11","9","10","1","0"
"2013","Edmonton, Alberta, municipal","48033","Sexual assault, level 2, weapon or bodily harm","24","15","0","22.16","2.68","2.07","2.44","7.35","0","15","15","19","4","0"
"2014","Edmonton, Alberta, municipal","48033","Sexual assault, level 2, weapon or bodily harm","13","11","0","-47.6","1.4","1.07","1.12","1.84","0","11","8","9","1","0"
"2015","Edmonton, Alberta, municipal","48033","Sexual assault, level 2, weapon or bodily harm","21","12","0","58.05","2.22","1.44","1.46","1.83","0","12","11","12","1","0"
"2016","Edmonton, Alberta, municipal","48033","Sexual assault, level 2, weapon or bodily harm","20","11","0","-6.87","2.06","1.15","1.08","0","0","11","9","9","0","0"
"1998","Edmonton, Alberta, municipal","48033","Sexual assault, level 1","634","228","65","0","97.07","0","0","0","0","293","169","188","19","23"
"1999","Edmonton, Alberta, municipal","48033","Sexual assault, level 1","542","208","34","-15.84","81.69","0","0","0","0","242","148","170","22","12"
"2000","Edmonton, Alberta, municipal","48033","Sexual assault, level 1","561","212","42","1.95","83.29","0","0","0","0","254","138","168","30","18"
"2001","Edmonton, Alberta, municipal","48033","Sexual assault, level 1","590","232","39","3.73","86.4","0","0","0","0","271","140","172","32","18"
"2002","Edmonton, Alberta, municipal","48033","Sexual assault, level 1","569","203","56","-5.22","81.88","0","0","0","0","259","128","158","30","24"
"2003","Edmonton, Alberta, municipal","48033","Sexual assault, level 1","506","159","21","-12.07","72","0","0","0","0","180","114","129","15","7"
"2004","Edmonton, Alberta, municipal","48033","Sexual assault, level 1","547","178","42","5.43","75.91","19.89","23.09","56.06","14.47","220","113","144","31","8"
"2005","Edmonton, Alberta, municipal","48033","Sexual assault, level 1","461","157","30","-17.63","62.53","19.01","20.17","32.41","21.61","187","111","129","18","12"
"2006","Edmonton, Alberta, municipal","48033","Sexual assault, level 1","467","165","16","-1.59","61.53","19.05","21.68","50.01","7.14","181","115","143","28","4"
"2007","Edmonton, Alberta, municipal","48033","Sexual assault, level 1","623","154","61","29.94","79.95","15.91","17.11","30.5","21.53","215","99","116","17","12"
"2008","Edmonton, Alberta, municipal","48033","Sexual assault, level 1","638","184","54","0.05","79.99","19.25","22.04","54.16","10.83","238","123","153","30","6"
"2009","Edmonton, Alberta, municipal","48033","Sexual assault, level 1","441","177","91","-32.59","53.92","19.94","22.33","51.01","20.04","268","131","159","28","11"
"2010","Edmonton, Alberta, municipal","48033","Sexual assault, level 1","752","214","58","67.79","90.48","22","24.63","56.81","16.49","272","147","178","31","9"
"2011","Edmonton, Alberta, municipal","48033","Sexual assault, level 1","807","258","64","5.48","95.44","25.31","26.68","43.6","27.25","322","172","196","24","15"
"2012","Edmonton, Alberta, municipal","48033","Sexual assault, level 1","842","239","57","1.72","97.08","25.05","27.09","53.13","45.8","296","175","204","29","25"
"2013","Edmonton, Alberta, municipal","48033","Sexual assault, level 1","798","253","51","-8.35","88.97","26.8","27.62","38.56","23.87","304","194","215","21","13"
"2014","Edmonton, Alberta, municipal","48033","Sexual assault, level 1","811","300","38","-1.68","87.48","28.56","30.36","55.14","20.22","338","214","244","30","11"
"2015","Edmonton, Alberta, municipal","48033","Sexual assault, level 1","868","256","57","4.72","91.6","24.04","26.22","56.62","20.09","313","184","215","31","11"
"2016","Edmonton, Alberta, municipal","48033","Sexual assault, level 1","824","174","39","-7.17","85.03","18.04","17.92","16.16","19.75","213","141","150","9","11"
"1998","Edmonton, Alberta, municipal","48033","Total sexual violations against children","0","0","0","0","0","0","0","0","0","0","0","0","0","0"
"1999","Edmonton, Alberta, municipal","48033","Total sexual violations against children","0","0","0","0","0","0","0","0","0","0","0","0","0","0"
"2000","Edmonton, Alberta, municipal","48033","Total sexual violations against children","0","0","0","0","0","0","0","0","0","0","0","0","0","0"
"2001","Edmonton, Alberta, municipal","48033","Total sexual violations against children","0","0","0","0","0","0","0","0","0","0","0","0","0","0"
"2002","Edmonton, Alberta, municipal","48033","Total sexual violations against children","0","0","0","0","0","0","0","0","0","0","0","0","0","0"
"2003","Edmonton, Alberta, municipal","48033","Total sexual violations against children","0","0","0","0","0","0","0","0","0","0","0","0","0","0"
"2004","Edmonton, Alberta, municipal","48033","Total sexual violations against children","2","0","1","0","0.28","0","0","0","0","1","0","0","0","0"
"2005","Edmonton, Alberta, municipal","48033","Total sexual violations against children","2","0","0","-2.27","0.27","0","0","0","0","0","0","0","0","0"
"2006","Edmonton, Alberta, municipal","48033","Total sexual violations against children","8","1","2","288.57","1.05","0.17","0.15","0","0","3","1","1","0","0"
"2007","Edmonton, Alberta, municipal","48033","Total sexual violations against children","10","0","0","21.76","1.28","0","0","0","0","0","0","0","0","0"
"2008","Edmonton, Alberta, municipal","48033","Total sexual violations against children","20","0","1","95.39","2.51","0","0","0","0","1","0","0","0","0"
"2009","Edmonton, Alberta, municipal","48033","Total sexual violations against children","61","12","7","197.45","7.46","0.76","0.7","0","0","19","5","5","0","0"
"2010","Edmonton, Alberta, municipal","48033","Total sexual violations against children","46","5","7","-25.8","5.53","0.45","0.42","0","3.67","12","3","3","0","2"
"2011","Edmonton, Alberta, municipal","48033","Total sexual violations against children","40","11","2","-14.53","4.73","0.59","0.82","3.63","1.82","13","4","6","2","1"
"2012","Edmonton, Alberta, municipal","48033","Total sexual violations against children","56","10","6","36.49","6.46","1.15","1.06","0","1.83","16","8","8","0","1"
"2013","Edmonton, Alberta, municipal","48033","Total sexual violations against children","89","23","7","53.69","9.92","1.8","1.8","1.84","1.84","30","13","14","1","1"
"2014","Edmonton, Alberta, municipal","48033","Total sexual violations against children","99","37","8","7.61","10.68","1.87","1.87","1.84","7.35","45","14","15","1","4"
"2015","Edmonton, Alberta, municipal","48033","Total sexual violations against children","99","25","8","-2.16","10.45","2.74","2.56","0","3.65","33","21","21","0","2"
"2016","Edmonton, Alberta, municipal","48033","Total sexual violations against children","143","89","7","41.24","14.76","7.55","9.68","39.5","0","96","59","81","22","0"
"1999","Edmonton, Alberta, municipal","48033","Sexual interference","0","0","0","0","0","0","0","0","0","0","0","0","0","0"
"2000","Edmonton, Alberta, municipal","48033","Sexual interference","0","0","0","0","0","0","0","0","0","0","0","0","0","0"
"2001","Edmonton, Alberta, municipal","48033","Sexual interference","0","0","0","0","0","0","0","0","0","0","0","0","0","0"
"2002","Edmonton, Alberta, municipal","48033","Sexual interference","0","0","0","0","0","0","0","0","0","0","0","0","0","0"
"2003","Edmonton, Alberta, municipal","48033","Sexual interference","0","0","0","0","0","0","0","0","0","0","0","0","0","0"
"2004","Edmonton, Alberta, municipal","48033","Sexual interference","0","0","0","0","0","0","0","0","0","0","0","0","0","0"
"2005","Edmonton, Alberta, municipal","48033","Sexual interference","0","0","0","0","0","0","0","0","0","0","0","0","0","0"
"2006","Edmonton, Alberta, municipal","48033","Sexual interference","0","0","0","0","0","0","0","0","0","0","0","0","0","0"
"2007","Edmonton, Alberta, municipal","48033","Sexual interference","0","0","0","0","0","0","0","0","0","0","0","0","0","0"
"2008","Edmonton, Alberta, municipal","48033","Sexual interference","5","0","0","0","0.63","0","0","0","0","0","0","0","0","0"
"2009","Edmonton, Alberta, municipal","48033","Sexual interference","33","7","2","543.65","4.03","0.46","0.42","0","0","9","3","3","0","0"
"2010","Edmonton, Alberta, municipal","48033","Sexual interference","29","0","5","-13.53","3.49","0","0","0","1.83","5","0","0","0","1"
"2011","Edmonton, Alberta, municipal","48033","Sexual interference","24","4","1","-18.65","2.84","0.29","0.27","0","0","5","2","2","0","0"
"2012","Edmonton, Alberta, municipal","48033","Sexual interference","38","4","6","54.36","4.38","0.43","0.4","0","1.83","10","3","3","0","1"
"2013","Edmonton, Alberta, municipal","48033","Sexual interference","51","11","4","29.79","5.69","1.11","1.03","0","1.84","15","8","8","0","1"
"2014","Edmonton, Alberta, municipal","48033","Sexual interference","45","15","3","-14.64","4.85","0.93","1","1.84","1.84","18","7","8","1","1"
"2015","Edmonton, Alberta, municipal","48033","Sexual interference","61","12","5","32.63","6.44","1.31","1.22","0","3.65","17","10","10","0","2"
"2016","Edmonton, Alberta, municipal","48033","Sexual interference","108","79","2","73.12","11.14","6.53","8.6","37.71","0","81","51","72","21","0"
"2003","Edmonton, Alberta, municipal","48033","Invitation to sexual touching","0","0","0","0","0","0","0","0","0","0","0","0","0","0"
"2004","Edmonton, Alberta, municipal","48033","Invitation to sexual touching","0","0","0","0","0","0","0","0","0","0","0","0","0","0"
"2005","Edmonton, Alberta, municipal","48033","Invitation to sexual touching","0","0","0","0","0","0","0","0","0","0","0","0","0","0"
"2006","Edmonton, Alberta, municipal","48033","Invitation to sexual touching","0","0","0","0","0","0","0","0","0","0","0","0","0","0"
"2007","Edmonton, Alberta, municipal","48033","Invitation to sexual touching","0","0","0","0","0","0","0","0","0","0","0","0","0","0"
"2008","Edmonton, Alberta, municipal","48033","Invitation to sexual touching","5","0","0","0","0.63","0","0","0","0","0","0","0","0","0"
"2009","Edmonton, Alberta, municipal","48033","Invitation to sexual touching","10","5","3","95.05","1.22","0.3","0.28","0","0","8","2","2","0","0"
"2010","Edmonton, Alberta, municipal","48033","Invitation to sexual touching","9","4","0","-11.44","1.08","0.3","0.28","0","0","4","2","2","0","0"
"2011","Edmonton, Alberta, municipal","48033","Invitation to sexual touching","8","5","0","-12.63","0.95","0","0.27","3.63","0","5","0","2","2","0"
"2012","Edmonton, Alberta, municipal","48033","Invitation to sexual touching","4","4","0","-51.25","0.46","0.43","0.4","0","0","4","3","3","0","0"
"2013","Edmonton, Alberta, municipal","48033","Invitation to sexual touching","13","8","1","214.3","1.45","0.41","0.51","1.84","0","9","3","4","1","0"
"2014","Edmonton, Alberta, municipal","48033","Invitation to sexual touching","16","6","3","19.07","1.73","0.13","0.12","0","3.68","9","1","1","0","2"
"2015","Edmonton, Alberta, municipal","48033","Invitation to sexual touching","10","1","1","-38.85","1.06","0.13","0.12","0","0","2","1","1","0","0"
"2016","Edmonton, Alberta, municipal","48033","Invitation to sexual touching","8","5","0","-21.77","0.83","0.38","0.48","1.8","0","5","3","4","1","0"
"2003","Edmonton, Alberta, municipal","48033","Sexual exploitation","0","0","0","0","0","0","0","0","0","0","0","0","0","0"
"2004","Edmonton, Alberta, municipal","48033","Sexual exploitation","0","0","0","0","0","0","0","0","0","0","0","0","0","0"
"2005","Edmonton, Alberta, municipal","48033","Sexual exploitation","0","0","0","0","0","0","0","0","0","0","0","0","0","0"
"2006","Edmonton, Alberta, municipal","48033","Sexual exploitation","0","0","0","0","0","0","0","0","0","0","0","0","0","0"
"2007","Edmonton, Alberta, municipal","48033","Sexual exploitation","0","0","0","0","0","0","0","0","0","0","0","0","0","0"
"2008","Edmonton, Alberta, municipal","48033","Sexual exploitation","1","0","0","0","0.13","0","0","0","0","0","0","0","0","0"
"2009","Edmonton, Alberta, municipal","48033","Sexual exploitation","3","0","0","192.57","0.37","0","0","0","0","0","0","0","0","0"
"2010","Edmonton, Alberta, municipal","48033","Sexual exploitation","2","1","0","-34.4","0.24","0.15","0.14","0","0","1","1","1","0","0"
"2011","Edmonton, Alberta, municipal","48033","Sexual exploitation","0","0","0","-100","0","0","0","0","0","0","0","0","0","0"
"2012","Edmonton, Alberta, municipal","48033","Sexual exploitation","0","0","0","0","0","0","0","0","0","0","0","0","0","0"
"2013","Edmonton, Alberta, municipal","48033","Sexual exploitation","4","1","0","0","0.45","0","0","0","0","1","0","0","0","0"
"2014","Edmonton, Alberta, municipal","48033","Sexual exploitation","7","6","0","69.3","0.76","0","0","0","0","6","0","0","0","0"
"2015","Edmonton, Alberta, municipal","48033","Sexual exploitation","8","5","0","11.82","0.84","0.65","0.61","0","0","5","5","5","0","0"
"2016","Edmonton, Alberta, municipal","48033","Sexual exploitation","4","3","0","-51.11","0.41","0.38","0.36","0","0","3","3","3","0","0"
"2005","Edmonton, Alberta, municipal","48033","Making sexually explicit material available to children","0","0","0","0","0","0","0","0","0","0","0","0","0","0"
"2006","Edmonton, Alberta, municipal","48033","Making sexually explicit material available to children","0","0","0","0","0","0","0","0","0","0","0","0","0","0"
"2007","Edmonton, Alberta, municipal","48033","Making sexually explicit material available to children","0","0","0","0","0","0","0","0","0","0","0","0","0","0"
"2008","Edmonton, Alberta, municipal","48033","Making sexually explicit material available to children","0","0","0","0","0","0","0","0","0","0","0","0","0","0"
"2009","Edmonton, Alberta, municipal","48033","Making sexually explicit material available to children","0","0","0","0","0","0","0","0","0","0","0","0","0","0"
"2010","Edmonton, Alberta, municipal","48033","Making sexually explicit material available to children","0","0","0","0","0","0","0","0","0","0","0","0","0","0"
"2011","Edmonton, Alberta, municipal","48033","Making sexually explicit material available to children","0","0","0","0","0","0","0","0","0","0","0","0","0","0"
"2012","Edmonton, Alberta, municipal","48033","Making sexually explicit material available to children","0","0","0","0","0","0","0","0","0","0","0","0","0","0"
"2013","Edmonton, Alberta, municipal","48033","Making sexually explicit material available to children","0","0","0","0","0","0","0","0","0","0","0","0","0","0"
"2014","Edmonton, Alberta, municipal","48033","Making sexually explicit material available to children","1","1","0","0","0.11","0.13","0.12","0","0","1","1","1","0","0"
"2015","Edmonton, Alberta, municipal","48033","Making sexually explicit material available to children","3","2","0","193.52","0.32","0.26","0.24","0","0","2","2","2","0","0"
"2016","Edmonton, Alberta, municipal","48033","Making sexually explicit material available to children","2","0","1","-34.81","0.21","0","0","0","0","1","0","0","0","0"
"2012","Edmonton, Alberta, municipal","48033","Parent or guardian procuring sexual activity: person procured under the age of 16 years","0","0","0","0","0","0","0","0","0","0","0","0","0","0"
"2002","Edmonton, Alberta, municipal","48033","Luring a child via a computer","0","0","0","0","0","0","0","0","0","0","0","0","0","0"
"2013","Edmonton, Alberta, municipal","48033","Parent or guardian procuring sexual activity: person procured under the age of 16 years","0","0","0","0","0","0","0","0","0","0","0","0","0","0"
"2003","Edmonton, Alberta, municipal","48033","Luring a child via a computer","0","0","0","0","0","0","0","0","0","0","0","0","0","0"
"2014","Edmonton, Alberta, municipal","48033","Parent or guardian procuring sexual activity: person procured under the age of 16 years","0","0","0","0","0","0","0","0","0","0","0","0","0","0"
"2004","Edmonton, Alberta, municipal","48033","Luring a child via a computer","2","0","1","0","0.28","0","0","0","0","1","0","0","0","0"
"2005","Edmonton, Alberta, municipal","48033","Luring a child via a computer","2","0","0","-2.27","0.27","0","0","0","0","0","0","0","0","0"
"2006","Edmonton, Alberta, municipal","48033","Luring a child via a computer","8","1","2","288.57","1.05","0.17","0.15","0","0","3","1","1","0","0"
"2007","Edmonton, Alberta, municipal","48033","Luring a child via a computer","10","0","0","21.76","1.28","0","0","0","0","0","0","0","0","0"
"2008","Edmonton, Alberta, municipal","48033","Luring a child via a computer","9","0","1","-12.08","1.13","0","0","0","0","1","0","0","0","0"
"2009","Edmonton, Alberta, municipal","48033","Luring a child via a computer","15","0","2","62.54","1.83","0","0","0","0","2","0","0","0","0"
"2010","Edmonton, Alberta, municipal","48033","Luring a child via a computer","6","0","2","-60.64","0.72","0","0","0","1.83","2","0","0","0","1"
"2012","Edmonton, Alberta, municipal","48033","Parent or guardian procuring sexual activity","0","0","0","0","0","0","0","0","0","0","0","0","0","0"
"2011","Edmonton, Alberta, municipal","48033","Luring a child via a computer","8","2","1","31.06","0.95","0.29","0.27","0","1.82","3","2","2","0","1"
"2013","Edmonton, Alberta, municipal","48033","Parent or guardian procuring sexual activity","0","0","0","0","0","0","0","0","0","0","0","0","0","0"
"2012","Edmonton, Alberta, municipal","48033","Luring a child via a computer","14","2","0","70.61","1.61","0.29","0.27","0","0","2","2","2","0","0"
"2014","Edmonton, Alberta, municipal","48033","Parent or guardian procuring sexual activity","0","0","0","0","0","0","0","0","0","0","0","0","0","0"
"2013","Edmonton, Alberta, municipal","48033","Luring a child via a computer","21","3","2","45.06","2.34","0.28","0.26","0","0","5","2","2","0","0"
"2015","Edmonton, Alberta, municipal","48033","Parent or guardian procuring sexual activity","0","0","0","0","0","0","0","0","0","0","0","0","0","0"
"2014","Edmonton, Alberta, municipal","48033","Luring a child via a computer","30","9","2","38.2","3.24","0.67","0.62","0","1.84","11","5","5","0","1"
"2016","Edmonton, Alberta, municipal","48033","Parent or guardian procuring sexual activity","0","0","0","0","0","0","0","0","0","0","0","0","0","0"
"2015","Edmonton, Alberta, municipal","48033","Luring a child via a computer","17","5","2","-44.56","1.79","0.39","0.37","0","0","7","3","3","0","0"
"2016","Edmonton, Alberta, municipal","48033","Luring a child via a computer","20","2","4","15.04","2.06","0.26","0.24","0","0","6","2","2","0","0"
"1998","Edmonton, Alberta, municipal","48033","Luring a child via a computer","0","0","0","0","0","0","0","0","0","0","0","0","0","0"
"1999","Edmonton, Alberta, municipal","48033","Luring a child via a computer","0","0","0","0","0","0","0","0","0","0","0","0","0","0"
"2000","Edmonton, Alberta, municipal","48033","Luring a child via a computer","0","0","0","0","0","0","0","0","0","0","0","0","0","0"
"2001","Edmonton, Alberta, municipal","48033","Luring a child via a computer","0","0","0","0","0","0","0","0","0","0","0","0","0","0"
"2012","Edmonton, Alberta, municipal","48033","Householder permitting illegal sexual activity: person under the age of 16 years","0","0","0","0","0","0","0","0","0","0","0","0","0","0"
"2013","Edmonton, Alberta, municipal","48033","Householder permitting illegal sexual activity: person under the age of 16 years","0","0","0","0","0","0","0","0","0","0","0","0","0","0"
"2014","Edmonton, Alberta, municipal","48033","Householder permitting illegal sexual activity: person under the age of 16 years","0","0","0","0","0","0","0","0","0","0","0","0","0","0"
"2012","Edmonton, Alberta, municipal","48033","Householder permitting prohibited sexual activity","0","0","0","0","0","0","0","0","0","0","0","0","0","0"
"2013","Edmonton, Alberta, municipal","48033","Householder permitting prohibited sexual activity","0","0","0","0","0","0","0","0","0","0","0","0","0","0"
"2014","Edmonton, Alberta, municipal","48033","Householder permitting prohibited sexual activity","0","0","0","0","0","0","0","0","0","0","0","0","0","0"
"2015","Edmonton, Alberta, municipal","48033","Householder permitting prohibited sexual activity","0","0","0","0","0","0","0","0","0","0","0","0","0","0"
"2016","Edmonton, Alberta, municipal","48033","Householder permitting prohibited sexual activity","1","0","0","0","0.1","0","0","0","0","0","0","0","0","0"
"1998","Edmonton, Alberta, municipal","48033","Assault, level 3, aggravated","144","104","2","0","22.05","0","0","0","0","106","106","116","10","0"
"1999","Edmonton, Alberta, municipal","48033","Assault, level 3, aggravated","139","108","1","-4.98","20.95","0","0","0","0","109","119","134","15","0"
"2000","Edmonton, Alberta, municipal","48033","Assault, level 3, aggravated","154","112","1","9.13","22.86","0","0","0","0","113","115","125","10","0"
"2001","Edmonton, Alberta, municipal","48033","Assault, level 3, aggravated","185","123","0","18.49","27.09","0","0","0","0","123","116","135","19","0"
"2002","Edmonton, Alberta, municipal","48033","Assault, level 3, aggravated","151","112","0","-19.78","21.73","0","0","0","0","112","107","128","21","0"
"2003","Edmonton, Alberta, municipal","48033","Assault, level 3, aggravated","131","98","0","-14.22","18.64","0","0","0","0","98","99","113","14","0"
"2004","Edmonton, Alberta, municipal","48033","Assault, level 3, aggravated","168","112","2","25.07","23.31","17.6","20.53","50.64","1.81","114","100","128","28","1"
"2005","Edmonton, Alberta, municipal","48033","Assault, level 3, aggravated","169","113","0","-1.69","22.92","18.67","19.7","30.61","0","113","109","126","17","0"
"2006","Edmonton, Alberta, municipal","48033","Assault, level 3, aggravated","156","93","4","-10.33","20.55","15.24","15.61","19.65","1.79","97","92","103","11","1"
"2007","Edmonton, Alberta, municipal","48033","Assault, level 3, aggravated","225","120","6","40.49","28.88","16.55","19.47","52.03","0","126","103","132","29","0"
"2008","Edmonton, Alberta, municipal","48033","Assault, level 3, aggravated","206","128","3","-10.56","25.83","18.16","18.58","23.47","0","131","116","129","13","0"
"2009","Edmonton, Alberta, municipal","48033","Assault, level 3, aggravated","239","147","4","13.15","29.22","22.83","23.74","34.61","1.82","151","150","169","19","1"
"2010","Edmonton, Alberta, municipal","48033","Assault, level 3, aggravated","239","160","5","-1.6","28.76","21.55","22.97","40.32","0","165","144","166","22","0"
"2011","Edmonton, Alberta, municipal","48033","Assault, level 3, aggravated","253","185","4","4.05","29.92","27.07","27.5","32.7","0","189","184","202","18","0"
"2012","Edmonton, Alberta, municipal","48033","Assault, level 3, aggravated","250","184","1","-3.66","28.82","26.77","28.41","49.47","0","185","187","214","27","0"
"2013","Edmonton, Alberta, municipal","48033","Assault, level 3, aggravated","236","170","1","-8.71","26.31","23.76","23.77","23.87","0","171","172","185","13","0"
"2014","Edmonton, Alberta, municipal","48033","Assault, level 3, aggravated","231","156","3","-5.31","24.92","20.95","21.4","27.57","0","159","157","172","15","0"
"2015","Edmonton, Alberta, municipal","48033","Assault, level 3, aggravated","222","161","3","-5.97","23.43","22.21","21.34","9.13","0","164","170","175","5","0"
"2016","Edmonton, Alberta, municipal","48033","Assault, level 3, aggravated","243","176","1","7.03","25.08","22.9","23.05","25.14","0","177","179","193","14","0"
"1998","Edmonton, Alberta, municipal","48033","Assault, level 2, weapon or bodily harm","1375","1023","38","0","210.52","0","0","0","0","1061","874","1056","182","10"
"1999","Edmonton, Alberta, municipal","48033","Assault, level 2, weapon or bodily harm","1155","839","35","-17.31","174.08","0","0","0","0","874","724","884","160","14"
"2000","Edmonton, Alberta, municipal","48033","Assault, level 2, weapon or bodily harm","1386","1004","23","18.2","205.77","0","0","0","0","1027","765","995","230","11"
"2001","Edmonton, Alberta, municipal","48033","Assault, level 2, weapon or bodily harm","1433","937","26","1.98","209.84","0","0","0","0","963","747","912","165","10"
"2002","Edmonton, Alberta, municipal","48033","Assault, level 2, weapon or bodily harm","1352","863","26","-7.28","194.57","0","0","0","0","889","667","858","191","11"
"2003","Edmonton, Alberta, municipal","48033","Assault, level 2, weapon or bodily harm","1306","768","22","-4.49","185.84","0","0","0","0","790","594","735","141","8"
"2004","Edmonton, Alberta, municipal","48033","Assault, level 2, weapon or bodily harm","1379","742","38","2.98","191.38","100.49","112.11","231.49","30.74","780","571","699","128","17"
"2005","Edmonton, Alberta, municipal","48033","Assault, level 2, weapon or bodily harm","1409","725","26","-0.14","191.1","97.79","110.88","248.49","7.2","751","571","709","138","4"
"2006","Edmonton, Alberta, municipal","48033","Assault, level 2, weapon or bodily harm","1462","789","44","0.8","192.63","109.83","117.48","200.03","8.93","833","663","775","112","5"
"2007","Edmonton, Alberta, municipal","48033","Assault, level 2, weapon or bodily harm","1784","832","112","18.86","228.95","101.56","112.53","235.02","52.03","944","632","763","131","29"
"2008","Edmonton, Alberta, municipal","48033","Assault, level 2, weapon or bodily harm","1923","888","95","5.3","241.1","108.47","118.25","231.09","39.72","983","693","821","128","22"
"2009","Edmonton, Alberta, municipal","48033","Assault, level 2, weapon or bodily harm","1749","857","146","-11.3","213.85","107.15","116.87","233.17","41.9","1003","704","832","128","23"
"2010","Edmonton, Alberta, municipal","48033","Assault, level 2, weapon or bodily harm","1642","932","115","-7.62","197.56","115.09","120.79","190.59","27.49","1047","769","873","104","15"
"2011","Edmonton, Alberta, municipal","48033","Assault, level 2, weapon or bodily harm","1572","960","45","-5.9","185.91","119.92","127.4","219.8","9.08","1005","815","936","121","5"
"2012","Edmonton, Alberta, municipal","48033","Assault, level 2, weapon or bodily harm","1578","1020","55","-2.14","181.93","127.98","130.38","161.22","20.15","1075","894","982","88","11"
"2013","Edmonton, Alberta, municipal","48033","Assault, level 2, weapon or bodily harm","1696","1100","36","3.94","189.1","125.57","130.92","202.01","11.02","1136","909","1019","110","6"
"2014","Edmonton, Alberta, municipal","48033","Assault, level 2, weapon or bodily harm","1765","1119","33","0.68","190.38","125.43","129.63","187.47","5.51","1152","940","1042","102","3"
"2015","Edmonton, Alberta, municipal","48033","Assault, level 2, weapon or bodily harm","2105","1254","50","16.69","222.15","136.29","138.29","166.21","5.48","1304","1043","1134","91","3"
"2016","Edmonton, Alberta, municipal","48033","Assault, level 2, weapon or bodily harm","2042","1275","42","-5.14","210.72","136.28","139.63","186.73","10.77","1317","1065","1169","104","6"
"1998","Edmonton, Alberta, municipal","48033","Assault, level 1","3556","2545","240","0","544.45","0","0","0","0","2785","2053","2294","241","91"
"1999","Edmonton, Alberta, municipal","48033","Assault, level 1","2845","2098","214","-21.24","428.8","0","0","0","0","2312","1731","2032","301","93"
"2000","Edmonton, Alberta, municipal","48033","Assault, level 1","3346","2436","218","15.85","496.75","0","0","0","0","2654","1847","2175","328","70"
"2001","Edmonton, Alberta, municipal","48033","Assault, level 1","3350","2422","188","-1.25","490.55","0","0","0","0","2610","1804","2202","398","79"
"2002","Edmonton, Alberta, municipal","48033","Assault, level 1","3177","2155","185","-6.8","457.2","0","0","0","0","2340","1592","1888","296","82"
"2003","Edmonton, Alberta, municipal","48033","Assault, level 1","2995","1940","178","-6.79","426.18","0","0","0","0","2118","1403","1666","263","90"
"2004","Edmonton, Alberta, municipal","48033","Assault, level 1","2622","1582","180","-14.62","363.88","202.03","221.48","421.38","126.6","1762","1148","1381","233","70"
"2005","Edmonton, Alberta, municipal","48033","Assault, level 1","2742","1636","194","2.2","371.9","216.3","230.67","381.73","109.84","1830","1263","1475","212","61"
"2006","Edmonton, Alberta, municipal","48033","Assault, level 1","2974","1621","234","5.36","391.84","202.59","212.99","325.05","117.87","1855","1223","1405","182","66"
"2007","Edmonton, Alberta, municipal","48033","Assault, level 1","3718","1641","696","21.77","477.15","206.33","210.02","251.17","245.79","2337","1284","1424","140","137"
"2008","Edmonton, Alberta, municipal","48033","Assault, level 1","3899","1952","519","2.45","488.84","242.29","249.6","334","167.9","2471","1548","1733","185","93"
"2009","Edmonton, Alberta, municipal","48033","Assault, level 1","4363","1989","930","9.13","533.46","241.54","247.92","324.26","213.13","2919","1587","1765","178","117"
"2010","Edmonton, Alberta, municipal","48033","Assault, level 1","4070","2089","688","-8.21","489.68","247.39","252.79","318.88","196.09","2777","1653","1827","174","107"
"2011","Edmonton, Alberta, municipal","48033","Assault, level 1","3766","2008","460","-9.05","445.37","225.71","234.25","339.69","174.38","2468","1534","1721","187","96"
"2012","Edmonton, Alberta, municipal","48033","Assault, level 1","4019","2280","345","4.04","463.37","260.1","266.74","351.76","131.91","2625","1817","2009","192","72"
"2013","Edmonton, Alberta, municipal","48033","Assault, level 1","3761","2202","361","-9.5","419.34","250.72","252.71","279.13","165.28","2563","1815","1967","152","90"
"2014","Edmonton, Alberta, municipal","48033","Assault, level 1","3774","2198","306","-2.92","407.08","237.92","241.35","288.56","137.85","2504","1783","1940","157","75"
"2015","Edmonton, Alberta, municipal","48033","Assault, level 1","4026","2395","362","4.37","424.87","248.67","252.19","301.36","146.12","2757","1903","2068","165","80"
"2016","Edmonton, Alberta, municipal","48033","Assault, level 1","3943","2341","359","-4.23","406.89","247.22","248.93","272.92","109.53","2700","1932","2084","152","61"
"1998","Edmonton, Alberta, municipal","48033","Total assaults against a peace officer","250","244","1","0","38.28","0","0","0","0","245","252","272","20","0"
"1999","Edmonton, Alberta, municipal","48033","Total assaults against a peace officer","286","292","0","12.62","43.11","0","0","0","0","292","265","283","18","0"
"2000","Edmonton, Alberta, municipal","48033","Total assaults against a peace officer","287","283","0","-1.15","42.61","0","0","0","0","283","235","254","19","0"
"2001","Edmonton, Alberta, municipal","48033","Total assaults against a peace officer","274","272","1","-5.83","40.12","0","0","0","0","273","232","261","29","0"
"2002","Edmonton, Alberta, municipal","48033","Total assaults against a peace officer","242","236","0","-13.2","34.83","0","0","0","0","236","197","216","19","0"
"2003","Edmonton, Alberta, municipal","48033","Total assaults against a peace officer","224","217","5","-8.48","31.87","0","0","0","0","222","190","207","17","2"
"2004","Edmonton, Alberta, municipal","48033","Total assaults against a peace officer","214","211","2","-6.83","29.7","33.26","34.8","50.64","0","213","189","217","28","0"
"2005","Edmonton, Alberta, municipal","48033","Total assaults against a peace officer","202","194","5","-7.75","27.4","26.2","28.62","54.02","1.8","199","153","183","30","1"
"2006","Edmonton, Alberta, municipal","48033","Total assaults against a peace officer","219","214","1","5.32","28.85","27.83","28.04","30.36","0","215","168","185","17","0"
"2007","Edmonton, Alberta, municipal","48033","Total assaults against a peace officer","241","237","5","7.19","30.93","25.71","26.69","37.68","1.79","242","160","181","21","1"
"2008","Edmonton, Alberta, municipal","48033","Total assaults against a peace officer","232","213","13","-5.96","29.09","22.07","22.9","32.5","1.81","226","141","159","18","1"
"2009","Edmonton, Alberta, municipal","48033","Total assaults against a peace officer","285","271","3","19.8","34.85","25.72","27.53","49.18","0","274","169","196","27","0"
"2010","Edmonton, Alberta, municipal","48033","Total assaults against a peace officer","307","285","16","6","36.94","32.18","33.35","47.65","5.5","301","215","241","26","3"
"2011","Edmonton, Alberta, municipal","48033","Total assaults against a peace officer","301","290","4","-3.63","35.6","28.25","29.4","43.6","0","294","192","216","24","0"
"2012","Edmonton, Alberta, municipal","48033","Total assaults against a peace officer","359","355","4","16.28","41.39","34.79","36.65","60.46","1.83","359","243","276","33","1"
"2013","Edmonton, Alberta, municipal","48033","Total assaults against a peace officer","356","343","6","-4.1","39.69","29.42","30.32","42.24","0","349","213","236","23","0"
"2014","Edmonton, Alberta, municipal","48033","Total assaults against a peace officer","400","380","14","8.7","43.15","36.16","36.2","36.76","1.84","394","271","291","20","1"
"2015","Edmonton, Alberta, municipal","48033","Total assaults against a peace officer","393","370","12","-3.87","41.47","32.93","34.02","49.31","0","382","252","279","27","0"
"2016","Edmonton, Alberta, municipal","48033","Total assaults against a peace officer","403","392","1","0.27","41.59","34.04","32.97","17.96","0","393","266","276","10","0"
"1998","Edmonton, Alberta, municipal","48033","Total other assaults","118","107","1","0","18.07","0","0","0","0","108","77","93","16","0"
"1999","Edmonton, Alberta, municipal","48033","Total other assaults","148","136","2","23.47","22.31","0","0","0","0","138","118","130","12","0"
"2000","Edmonton, Alberta, municipal","48033","Total other assaults","154","147","0","2.49","22.86","0","0","0","0","147","110","129","19","0"
"2001","Edmonton, Alberta, municipal","48033","Total other assaults","163","145","0","4.4","23.87","0","0","0","0","145","123","135","12","0"
"2002","Edmonton, Alberta, municipal","48033","Total other assaults","199","185","0","19.98","28.64","0","0","0","0","185","141","162","21","0"
"2003","Edmonton, Alberta, municipal","48033","Total other assaults","238","219","1","18.26","33.87","0","0","0","0","220","181","203","22","0"
"2004","Edmonton, Alberta, municipal","48033","Total other assaults","157","144","0","-35.66","21.79","20.41","21.01","27.13","1.81","144","116","131","15","1"
"2005","Edmonton, Alberta, municipal","48033","Total other assaults","174","157","0","8.31","23.6","16.44","18.14","36.01","3.6","157","96","116","20","2"
"2006","Edmonton, Alberta, municipal","48033","Total other assaults","142","126","3","-20.72","18.71","13.58","13.79","16.07","0","129","82","91","9","0"
"2007","Edmonton, Alberta, municipal","48033","Total other assaults","137","130","0","-6.03","17.58","12.86","13.72","23.32","0","130","80","93","13","0"
"2008","Edmonton, Alberta, municipal","48033","Total other assaults","145","142","0","3.4","18.18","16.12","17.43","32.5","0","142","103","121","18","0"
"2009","Edmonton, Alberta, municipal","48033","Total other assaults","128","118","2","-13.91","15.65","13.85","14.33","20.04","0","120","91","102","11","0"
"2010","Edmonton, Alberta, municipal","48033","Total other assaults","82","72","4","-36.96","9.87","9.13","9.27","11","1.83","76","61","67","6","1"
"2011","Edmonton, Alberta, municipal","48033","Total other assaults","127","115","5","52.24","15.02","14.27","14.43","16.35","0","120","97","106","9","0"
"2012","Edmonton, Alberta, municipal","48033","Total other assaults","85","75","0","-34.75","9.8","7.87","8.1","10.99","0","75","55","61","6","0"
"2013","Edmonton, Alberta, municipal","48033","Total other assaults","134","122","3","52.45","14.94","13.26","14","23.87","0","125","96","109","13","0"
"2014","Edmonton, Alberta, municipal","48033","Total other assaults","174","170","0","25.62","18.77","16.28","16.42","18.38","0","170","122","132","10","0"
"2015","Edmonton, Alberta, municipal","48033","Total other assaults","150","148","2","-15.66","15.83","14.64","15.12","21.92","0","150","112","124","12","0"
"2016","Edmonton, Alberta, municipal","48033","Total other assaults","107","106","1","-30.25","11.04","11.13","10.99","8.98","1.8","107","87","92","5","1"
"1998","Edmonton, Alberta, municipal","48033","Unlawfully causing bodily harm","16","7","0","0","2.45","0","0","0","0","7","5","5","0","0"
"1999","Edmonton, Alberta, municipal","48033","Unlawfully causing bodily harm","16","8","1","-1.56","2.41","0","0","0","0","9","7","7","0","0"
"2000","Edmonton, Alberta, municipal","48033","Unlawfully causing bodily harm","17","10","0","4.66","2.52","0","0","0","0","10","10","10","0","0"
"2001","Edmonton, Alberta, municipal","48033","Unlawfully causing bodily harm","21","8","0","21.84","3.08","0","0","0","0","8","9","9","0","0"
"2002","Edmonton, Alberta, municipal","48033","Unlawfully causing bodily harm","13","8","0","-39.16","1.87","0","0","0","0","8","7","7","0","0"
"2003","Edmonton, Alberta, municipal","48033","Unlawfully causing bodily harm","53","35","1","303.12","7.54","0","0","0","0","36","33","36","3","0"
"2004","Edmonton, Alberta, municipal","48033","Unlawfully causing bodily harm","25","15","0","-54","3.47","2.29","2.73","7.23","1.81","15","13","17","4","1"
"2005","Edmonton, Alberta, municipal","48033","Unlawfully causing bodily harm","22","6","0","-14","2.98","0.86","0.94","1.8","0","6","5","6","1","0"
"2006","Edmonton, Alberta, municipal","48033","Unlawfully causing bodily harm","24","12","1","5.97","3.16","1.49","1.52","1.79","0","13","9","10","1","0"
"2007","Edmonton, Alberta, municipal","48033","Unlawfully causing bodily harm","12","8","0","-51.3","1.54","0.64","0.59","0","0","8","4","4","0","0"
"2008","Edmonton, Alberta, municipal","48033","Unlawfully causing bodily harm","2","1","0","-83.72","0.25","0.16","0.14","0","0","1","1","1","0","0"
"2009","Edmonton, Alberta, municipal","48033","Unlawfully causing bodily harm","0","0","0","-100","0","0","0","0","0","0","0","0","0","0"
"2010","Edmonton, Alberta, municipal","48033","Unlawfully causing bodily harm","0","0","0","0","0","0","0","0","0","0","0","0","0","0"
"2011","Edmonton, Alberta, municipal","48033","Unlawfully causing bodily harm","1","1","0","0","0.12","0.15","0.14","0","0","1","1","1","0","0"
"2012","Edmonton, Alberta, municipal","48033","Unlawfully causing bodily harm","1","0","0","-2.51","0.12","0","0","0","0","0","0","0","0","0"
"2013","Edmonton, Alberta, municipal","48033","Unlawfully causing bodily harm","0","1","0","-100","0","0.14","0.13","0","0","1","1","1","0","0"
"2014","Edmonton, Alberta, municipal","48033","Unlawfully causing bodily harm","0","0","0","0","0","0","0","0","0","0","0","0","0","0"
"2015","Edmonton, Alberta, municipal","48033","Unlawfully causing bodily harm","0","0","0","0","0","0","0","0","0","0","0","0","0","0"
"2016","Edmonton, Alberta, municipal","48033","Unlawfully causing bodily harm","0","0","0","0","0","0","0","0","0","0","0","0","0","0"
"1998","Edmonton, Alberta, municipal","48033","Criminal negligence causing bodily harm","10","9","0","0","1.53","0","0","0","0","9","7","7","0","0"
"1999","Edmonton, Alberta, municipal","48033","Criminal negligence causing bodily harm","7","6","0","-31.09","1.06","0","0","0","0","6","3","4","1","0"
"2000","Edmonton, Alberta, municipal","48033","Criminal negligence causing bodily harm","2","2","0","-71.86","0.3","0","0","0","0","2","1","1","0","0"
"2001","Edmonton, Alberta, municipal","48033","Criminal negligence causing bodily harm","8","8","0","294.53","1.17","0","0","0","0","8","5","7","2","0"
"2002","Edmonton, Alberta, municipal","48033","Criminal negligence causing bodily harm","5","5","0","-38.58","0.72","0","0","0","0","5","3","3","0","0"
"2003","Edmonton, Alberta, municipal","48033","Criminal negligence causing bodily harm","6","6","0","18.65","0.85","0","0","0","0","6","4","5","1","0"
"2004","Edmonton, Alberta, municipal","48033","Criminal negligence causing bodily harm","1","1","0","-83.75","0.14","0","0","0","0","1","0","0","0","0"
"2005","Edmonton, Alberta, municipal","48033","Criminal negligence causing bodily harm","2","2","0","95.46","0.27","0.34","0.31","0","0","2","2","2","0","0"
"2006","Edmonton, Alberta, municipal","48033","Criminal negligence causing bodily harm","2","2","0","-2.86","0.26","0","0","0","0","2","0","0","0","0"
"2007","Edmonton, Alberta, municipal","48033","Criminal negligence causing bodily harm","4","3","0","94.81","0.51","0.16","0.15","0","0","3","1","1","0","0"
"2008","Edmonton, Alberta, municipal","48033","Criminal negligence causing bodily harm","4","3","0","-2.31","0.5","0.47","0.43","0","0","3","3","3","0","0"
"2009","Edmonton, Alberta, municipal","48033","Criminal negligence causing bodily harm","3","3","0","-26.86","0.37","0.46","0.42","0","0","3","3","3","0","0"
"2010","Edmonton, Alberta, municipal","48033","Criminal negligence causing bodily harm","4","3","0","31.2","0.48","0.75","0.69","0","0","3","5","5","0","0"
"2011","Edmonton, Alberta, municipal","48033","Criminal negligence causing bodily harm","3","3","0","-26.28","0.35","0.29","0.27","0","0","3","2","2","0","0"
"2012","Edmonton, Alberta, municipal","48033","Criminal negligence causing bodily harm","2","2","0","-35.01","0.23","0.14","0.13","0","0","2","1","1","0","0"
"2013","Edmonton, Alberta, municipal","48033","Criminal negligence causing bodily harm","9","5","0","335.18","1","0.14","0.13","0","0","5","1","1","0","0"
"2014","Edmonton, Alberta, municipal","48033","Criminal negligence causing bodily harm","3","3","0","-67.75","0.32","0.4","0.37","0","0","3","3","3","0","0"
"2015","Edmonton, Alberta, municipal","48033","Criminal negligence causing bodily harm","2","2","1","-34.77","0.21","0.26","0.24","0","0","3","2","2","0","0"
"2016","Edmonton, Alberta, municipal","48033","Criminal negligence causing bodily harm","3","4","0","46.67","0.31","0.51","0.6","1.8","0","4","4","5","1","0"
"1998","Edmonton, Alberta, municipal","48033","Other assaults","92","91","1","0","14.09","0","0","0","0","92","65","81","16","0"
"1999","Edmonton, Alberta, municipal","48033","Other assaults","125","122","1","33.75","18.84","0","0","0","0","123","108","119","11","0"
"2000","Edmonton, Alberta, municipal","48033","Other assaults","135","135","0","6.38","20.04","0","0","0","0","135","99","118","19","0"
"2001","Edmonton, Alberta, municipal","48033","Other assaults","134","129","0","-2.1","19.62","0","0","0","0","129","109","119","10","0"
"2002","Edmonton, Alberta, municipal","48033","Other assaults","181","172","0","32.75","26.05","0","0","0","0","172","131","152","21","0"
"2003","Edmonton, Alberta, municipal","48033","Other assaults","179","178","0","-2.21","25.47","0","0","0","0","178","144","162","18","0"
"2004","Edmonton, Alberta, municipal","48033","Other assaults","131","128","0","-28.62","18.18","18.13","18.28","19.89","0","128","103","114","11","0"
"2005","Edmonton, Alberta, municipal","48033","Other assaults","150","149","0","11.91","20.34","15.24","16.89","34.21","3.6","149","89","108","19","2"
"2006","Edmonton, Alberta, municipal","48033","Other assaults","116","112","2","-24.88","15.28","12.09","12.28","14.29","0","114","73","81","8","0"
"2007","Edmonton, Alberta, municipal","48033","Other assaults","121","119","0","1.6","15.53","12.05","12.98","23.32","0","119","75","88","13","0"
"2008","Edmonton, Alberta, municipal","48033","Other assaults","139","138","0","12.23","17.43","15.5","16.85","32.5","0","138","99","117","18","0"
"2009","Edmonton, Alberta, municipal","48033","Other assaults","125","115","2","-12.3","15.28","13.39","13.91","20.04","0","117","88","99","11","0"
"2010","Edmonton, Alberta, municipal","48033","Other assaults","78","69","4","-38.6","9.38","8.38","8.58","11","1.83","73","56","62","6","1"
"2011","Edmonton, Alberta, municipal","48033","Other assaults","123","111","5","55","14.55","13.83","14.02","16.35","0","116","94","103","9","0"
"2012","Edmonton, Alberta, municipal","48033","Other assaults","82","73","0","-35.01","9.45","7.73","7.97","10.99","0","73","54","60","6","0"
"2013","Edmonton, Alberta, municipal","48033","Other assaults","125","116","3","47.42","13.94","12.99","13.75","23.87","0","119","94","107","13","0"
"2014","Edmonton, Alberta, municipal","48033","Other assaults","171","167","0","32.34","18.44","15.88","16.05","18.38","0","167","119","129","10","0"
"2015","Edmonton, Alberta, municipal","48033","Other assaults","148","146","1","-15.32","15.62","14.37","14.88","21.92","0","147","110","122","12","0"
"2016","Edmonton, Alberta, municipal","48033","Other assaults","104","102","1","-31.29","10.73","10.62","10.39","7.18","1.8","103","83","87","4","1"
"1998","Edmonton, Alberta, municipal","48033","Total firearms, use of, discharge, pointing","6","2","1","0","0.92","0","0","0","0","3","2","3","1","2"
"1999","Edmonton, Alberta, municipal","48033","Total firearms, use of, discharge, pointing","18","12","0","195.33","2.71","0","0","0","0","12","13","13","0","0"
"2000","Edmonton, Alberta, municipal","48033","Total firearms, use of, discharge, pointing","26","24","1","42.28","3.86","0","0","0","0","25","19","19","0","1"
"2001","Edmonton, Alberta, municipal","48033","Total firearms, use of, discharge, pointing","15","16","0","-43.1","2.2","0","0","0","0","16","13","16","3","0"
"2002","Edmonton, Alberta, municipal","48033","Total firearms, use of, discharge, pointing","15","13","0","-1.72","2.16","0","0","0","0","13","8","11","3","0"
"2003","Edmonton, Alberta, municipal","48033","Total firearms, use of, discharge, pointing","17","16","0","12.06","2.42","0","0","0","0","16","9","12","3","0"
"2004","Edmonton, Alberta, municipal","48033","Total firearms, use of, discharge, pointing","11","10","0","-36.89","1.53","1.06","0.96","0","0","10","6","6","0","0"
"2005","Edmonton, Alberta, municipal","48033","Total firearms, use of, discharge, pointing","21","20","0","86.58","2.85","1.88","1.88","1.8","0","20","11","12","1","0"
"2006","Edmonton, Alberta, municipal","48033","Total firearms, use of, discharge, pointing","8","5","0","-62.99","1.05","0.83","1.06","3.57","0","5","5","7","2","0"
"2007","Edmonton, Alberta, municipal","48033","Total firearms, use of, discharge, pointing","3","0","1","-63.47","0.39","0","0","0","0","1","0","0","0","0"
"2008","Edmonton, Alberta, municipal","48033","Total firearms, use of, discharge, pointing","15","5","1","388.47","1.88","1.25","1.3","1.81","0","6","8","9","1","0"
"2009","Edmonton, Alberta, municipal","48033","Total firearms, use of, discharge, pointing","23","16","0","49.54","2.81","1.98","2.39","7.29","0","16","13","17","4","0"
"2010","Edmonton, Alberta, municipal","48033","Total firearms, use of, discharge, pointing","23","17","1","-1.6","2.77","1.95","1.94","1.83","1.83","18","13","14","1","1"
"2011","Edmonton, Alberta, municipal","48033","Total firearms, use of, discharge, pointing","32","18","0","36.76","3.78","2.5","2.72","5.45","0","18","17","20","3","0"
"2012","Edmonton, Alberta, municipal","48033","Total firearms, use of, discharge, pointing","25","19","0","-23.83","2.88","1.57","1.99","7.33","0","19","11","15","4","0"
"2013","Edmonton, Alberta, municipal","48033","Total firearms, use of, discharge, pointing","41","33","0","58.6","4.57","4.83","4.88","5.51","0","33","35","38","3","0"
"2014","Edmonton, Alberta, municipal","48033","Total firearms, use of, discharge, pointing","54","37","1","27.41","5.82","5.74","5.6","3.68","0","38","43","45","2","0"
"2015","Edmonton, Alberta, municipal","48033","Total firearms, use of, discharge, pointing","52","39","0","-5.78","5.49","3.4","3.9","10.96","0","39","26","32","6","0"
"2016","Edmonton, Alberta, municipal","48033","Total firearms, use of, discharge, pointing","77","42","2","44.79","7.95","4.99","4.78","1.8","0","44","39","40","1","0"
"1998","Edmonton, Alberta, municipal","48033","Discharge firearm with intent","0","0","0","0","0","0","0","0","0","0","0","0","0","0"
"1999","Edmonton, Alberta, municipal","48033","Discharge firearm with intent","4","0","0","0","0.6","0","0","0","0","0","0","0","0","0"
"2000","Edmonton, Alberta, municipal","48033","Discharge firearm with intent","8","8","0","97","1.19","0","0","0","0","8","4","4","0","0"
"2001","Edmonton, Alberta, municipal","48033","Discharge firearm with intent","2","2","0","-75.34","0.29","0","0","0","0","2","0","1","1","0"
"2002","Edmonton, Alberta, municipal","48033","Discharge firearm with intent","3","3","0","47.42","0.43","0","0","0","0","3","0","2","2","0"
"2003","Edmonton, Alberta, municipal","48033","Discharge firearm with intent","10","10","0","229.6","1.42","0","0","0","0","10","4","6","2","0"
"2004","Edmonton, Alberta, municipal","48033","Discharge firearm with intent","8","8","0","-21.98","1.11","0.7","0.64","0","0","8","4","4","0","0"
"2005","Edmonton, Alberta, municipal","48033","Discharge firearm with intent","14","14","0","71.03","1.9","0.51","0.47","0","0","14","3","3","0","0"
"2006","Edmonton, Alberta, municipal","48033","Discharge firearm with intent","4","3","0","-72.24","0.53","0.33","0.61","3.57","0","3","2","4","2","0"
"2007","Edmonton, Alberta, municipal","48033","Discharge firearm with intent","2","0","0","-51.3","0.26","0","0","0","0","0","0","0","0","0"
"2008","Edmonton, Alberta, municipal","48033","Discharge firearm with intent","9","2","1","339.62","1.13","0.31","0.29","0","0","3","2","2","0","0"
"2009","Edmonton, Alberta, municipal","48033","Discharge firearm with intent","7","0","0","-24.15","0.86","0.3","0.28","0","0","0","2","2","0","0"
"2010","Edmonton, Alberta, municipal","48033","Discharge firearm with intent","9","4","1","26.52","1.08","0.75","0.83","1.83","1.83","5","5","6","1","1"
"2011","Edmonton, Alberta, municipal","48033","Discharge firearm with intent","17","5","0","85.67","2.01","0.74","0.82","1.82","0","5","5","6","1","0"
"2012","Edmonton, Alberta, municipal","48033","Discharge firearm with intent","8","3","0","-54.12","0.92","0.14","0.4","3.66","0","3","1","3","2","0"
"2013","Edmonton, Alberta, municipal","48033","Discharge firearm with intent","8","5","0","-3.29","0.89","1.38","1.28","0","0","5","10","10","0","0"
"2014","Edmonton, Alberta, municipal","48033","Discharge firearm with intent","16","4","0","93.48","1.73","1.07","1","0","0","4","8","8","0","0"
"2015","Edmonton, Alberta, municipal","48033","Discharge firearm with intent","14","5","0","-14.39","1.48","0.65","0.61","0","0","5","5","5","0","0"
"2016","Edmonton, Alberta, municipal","48033","Discharge firearm with intent","28","5","2","95.56","2.89","1.02","0.96","0","0","7","8","8","0","0"
"1998","Edmonton, Alberta, municipal","48033","Using firearm in commission of offence","1","0","0","0","0.15","0","0","0","0","0","0","0","0","0"
"1999","Edmonton, Alberta, municipal","48033","Using firearm in commission of offence","1","1","0","-1.56","0.15","0","0","0","0","1","1","1","0","0"
"2000","Edmonton, Alberta, municipal","48033","Using firearm in commission of offence","3","2","0","195.5","0.45","0","0","0","0","2","1","1","0","0"
"2001","Edmonton, Alberta, municipal","48033","Using firearm in commission of offence","1","1","0","-67.12","0.15","0","0","0","0","1","1","1","0","0"
"2002","Edmonton, Alberta, municipal","48033","Using firearm in commission of offence","7","6","0","587.94","1.01","0","0","0","0","6","2","3","1","0"
"2003","Edmonton, Alberta, municipal","48033","Using firearm in commission of offence","3","3","0","-57.62","0.43","0","0","0","0","3","3","3","0","0"
"2004","Edmonton, Alberta, municipal","48033","Using firearm in commission of offence","1","1","0","-67.49","0.14","0","0","0","0","1","0","0","0","0"
"2005","Edmonton, Alberta, municipal","48033","Using firearm in commission of offence","4","4","0","290.93","0.54","1.2","1.09","0","0","4","7","7","0","0"
"2006","Edmonton, Alberta, municipal","48033","Using firearm in commission of offence","2","1","0","-51.43","0.26","0.33","0.3","0","0","1","2","2","0","0"
"2007","Edmonton, Alberta, municipal","48033","Using firearm in commission of offence","1","0","1","-51.3","0.13","0","0","0","0","1","0","0","0","0"
"2008","Edmonton, Alberta, municipal","48033","Using firearm in commission of offence","3","2","0","193.08","0.38","0.78","0.86","1.81","0","2","5","6","1","0"
"2009","Edmonton, Alberta, municipal","48033","Using firearm in commission of offence","8","9","0","160.06","0.98","0.91","1.4","7.29","0","9","6","10","4","0"
"2010","Edmonton, Alberta, municipal","48033","Using firearm in commission of offence","9","9","0","10.7","1.08","1.2","1.11","0","0","9","8","8","0","0"
"2011","Edmonton, Alberta, municipal","48033","Using firearm in commission of offence","9","9","0","-1.71","1.06","1.03","1.09","1.82","0","9","7","8","1","0"
"2012","Edmonton, Alberta, municipal","48033","Using firearm in commission of offence","7","7","0","-24.17","0.81","1","0.93","0","0","7","7","7","0","0"
"2013","Edmonton, Alberta, municipal","48033","Using firearm in commission of offence","22","21","0","203.93","2.45","2.62","2.7","3.67","0","21","19","21","2","0"
"2014","Edmonton, Alberta, municipal","48033","Using firearm in commission of offence","29","28","0","27.52","3.13","4.14","4.11","3.68","0","28","31","33","2","0"
"2015","Edmonton, Alberta, municipal","48033","Using firearm in commission of offence","25","26","0","-15.66","2.64","2.22","2.8","10.96","0","26","17","23","6","0"
"2016","Edmonton, Alberta, municipal","48033","Using firearm in commission of offence","29","29","0","13.43","2.99","3.33","3.23","1.8","0","29","26","27","1","0"
"1998","Edmonton, Alberta, municipal","48033","Pointing a firearm","5","2","1","0","0.77","0","0","0","0","3","2","3","1","2"
"1999","Edmonton, Alberta, municipal","48033","Pointing a firearm","13","11","0","155.95","1.96","0","0","0","0","11","12","12","0","0"
"2000","Edmonton, Alberta, municipal","48033","Pointing a firearm","15","14","1","13.65","2.23","0","0","0","0","15","14","14","0","1"
"2001","Edmonton, Alberta, municipal","48033","Pointing a firearm","12","13","0","-21.09","1.76","0","0","0","0","13","12","14","2","0"
"2002","Edmonton, Alberta, municipal","48033","Pointing a firearm","5","4","0","-59.05","0.72","0","0","0","0","4","6","6","0","0"
"2003","Edmonton, Alberta, municipal","48033","Pointing a firearm","4","3","0","-20.9","0.57","0","0","0","0","3","2","3","1","0"
"2004","Edmonton, Alberta, municipal","48033","Pointing a firearm","2","1","0","-51.24","0.28","0.35","0.32","0","0","1","2","2","0","0"
"2005","Edmonton, Alberta, municipal","48033","Pointing a firearm","3","2","0","46.6","0.41","0.17","0.31","1.8","0","2","1","2","1","0"
"2006","Edmonton, Alberta, municipal","48033","Pointing a firearm","2","1","0","-35.24","0.26","0.17","0.15","0","0","1","1","1","0","0"
"2007","Edmonton, Alberta, municipal","48033","Pointing a firearm","0","0","0","-100","0","0","0","0","0","0","0","0","0","0"
"2008","Edmonton, Alberta, municipal","48033","Pointing a firearm","3","1","0","0","0.38","0.16","0.14","0","0","1","1","1","0","0"
"2009","Edmonton, Alberta, municipal","48033","Pointing a firearm","8","7","0","160.06","0.98","0.76","0.7","0","0","7","5","5","0","0"
"2010","Edmonton, Alberta, municipal","48033","Pointing a firearm","5","4","0","-38.5","0.6","0","0","0","0","4","0","0","0","0"
"2011","Edmonton, Alberta, municipal","48033","Pointing a firearm","6","4","0","17.95","0.71","0.74","0.82","1.82","0","4","5","6","1","0"
"2012","Edmonton, Alberta, municipal","48033","Pointing a firearm","10","9","0","62.49","1.15","0.43","0.66","3.66","0","9","3","5","2","0"
"2013","Edmonton, Alberta, municipal","48033","Pointing a firearm","11","7","0","6.38","1.23","0.83","0.9","1.84","0","7","6","7","1","0"
"2014","Edmonton, Alberta, municipal","48033","Pointing a firearm","9","5","1","-20.85","0.97","0.53","0.5","0","0","6","4","4","0","0"
"2015","Edmonton, Alberta, municipal","48033","Pointing a firearm","13","8","0","41.32","1.37","0.52","0.49","0","0","8","4","4","0","0"
"2016","Edmonton, Alberta, municipal","48033","Pointing a firearm","20","8","0","50.43","2.06","0.64","0.6","0","0","8","5","5","0","0"
"1998","Edmonton, Alberta, municipal","48033","Total robbery","1434","459","4","0","219.56","0","0","0","0","463","301","462","161","2"
"1999","Edmonton, Alberta, municipal","48033","Total robbery","1395","465","10","-4.24","210.26","0","0","0","0","475","295","475","180","8"
"2000","Edmonton, Alberta, municipal","48033","Total robbery","1394","470","6","-1.57","206.96","0","0","0","0","476","287","449","162","5"
"2001","Edmonton, Alberta, municipal","48033","Total robbery","1519","548","3","7.48","222.43","0","0","0","0","551","304","461","157","1"
"2002","Edmonton, Alberta, municipal","48033","Total robbery","1431","450","3","-7.42","205.93","0","0","0","0","453","287","437","150","7"
"2003","Edmonton, Alberta, municipal","48033","Total robbery","1763","467","2","21.82","250.87","0","0","0","0","469","289","403","114","3"
"2004","Edmonton, Alberta, municipal","48033","Total robbery","1548","492","6","-14.37","214.83","46.28","59.66","197.13","14.47","498","263","372","109","8"
"2005","Edmonton, Alberta, municipal","48033","Total robbery","1597","463","17","0.83","216.6","38.36","57.71","261.09","12.6","480","224","369","145","7"
"2006","Edmonton, Alberta, municipal","48033","Total robbery","1599","461","9","-2.74","210.68","46.71","61.09","216.1","5.36","470","282","403","121","3"
"2007","Edmonton, Alberta, municipal","48033","Total robbery","1809","387","32","10.2","232.16","38.08","56.63","263.73","26.91","419","237","384","147","15"
"2008","Edmonton, Alberta, municipal","48033","Total robbery","1857","448","20","0.29","232.82","39.91","65.68","362.89","14.44","468","255","456","201","8"
"2009","Edmonton, Alberta, municipal","48033","Total robbery","1658","447","46","-12.93","202.72","44.14","63.07","289.64","36.43","493","290","449","159","20"
"2010","Edmonton, Alberta, municipal","48033","Total robbery","1300","419","27","-22.85","156.41","47.74","60.6","218.08","25.66","446","319","438","119","14"
"2011","Edmonton, Alberta, municipal","48033","Total robbery","1145","385","9","-13.43","135.41","40.76","52.95","203.45","5.45","394","277","389","112","3"
"2012","Edmonton, Alberta, municipal","48033","Total robbery","1153","391","14","-1.83","132.93","42.66","52.58","179.54","7.33","405","298","396","98","4"
"2013","Edmonton, Alberta, municipal","48033","Total robbery","1102","363","13","-7.57","122.87","39.51","50.62","198.33","5.51","376","286","394","108","3"
"2014","Edmonton, Alberta, municipal","48033","Total robbery","1121","371","8","-1.59","120.91","43.37","50.14","143.36","3.68","379","325","403","78","2"
"2015","Edmonton, Alberta, municipal","48033","Total robbery","1395","546","8","21.75","147.22","53.58","61.83","177.17","9.13","554","410","507","97","5"
"2016","Edmonton, Alberta, municipal","48033","Total robbery","1342","479","10","-5.93","138.48","51.44","60.56","188.53","3.59","489","402","507","105","2"
"1998","Edmonton, Alberta, municipal","48033","Robbery","1434","459","4","0","219.56","0","0","0","0","463","301","462","161","2"
"1999","Edmonton, Alberta, municipal","48033","Robbery","1395","465","10","-4.24","210.26","0","0","0","0","475","295","475","180","8"
"2000","Edmonton, Alberta, municipal","48033","Robbery","1394","470","6","-1.57","206.96","0","0","0","0","476","287","449","162","5"
"2001","Edmonton, Alberta, municipal","48033","Robbery","1519","548","3","7.48","222.43","0","0","0","0","551","304","461","157","1"
"2002","Edmonton, Alberta, municipal","48033","Robbery","1431","450","3","-7.42","205.93","0","0","0","0","453","287","437","150","7"
"2003","Edmonton, Alberta, municipal","48033","Robbery","1763","467","2","21.82","250.87","0","0","0","0","469","289","403","114","3"
"2004","Edmonton, Alberta, municipal","48033","Robbery","1548","492","6","-14.37","214.83","46.28","59.66","197.13","14.47","498","263","372","109","8"
"2005","Edmonton, Alberta, municipal","48033","Robbery","1597","463","17","0.83","216.6","38.36","57.71","261.09","12.6","480","224","369","145","7"
"2006","Edmonton, Alberta, municipal","48033","Robbery","1599","461","9","-2.74","210.68","46.71","61.09","216.1","5.36","470","282","403","121","3"
"2007","Edmonton, Alberta, municipal","48033","Robbery","1809","387","32","10.2","232.16","38.08","56.63","263.73","26.91","419","237","384","147","15"
"2008","Edmonton, Alberta, municipal","48033","Robbery","1857","448","20","0.29","232.82","39.91","65.68","362.89","14.44","468","255","456","201","8"
"2009","Edmonton, Alberta, municipal","48033","Robbery","1658","447","46","-12.93","202.72","44.14","63.07","289.64","36.43","493","290","449","159","20"
"2010","Edmonton, Alberta, municipal","48033","Robbery","1300","419","27","-22.85","156.41","47.74","60.6","218.08","25.66","446","319","438","119","14"
"2011","Edmonton, Alberta, municipal","48033","Robbery","1145","385","9","-13.43","135.41","40.76","52.95","203.45","5.45","394","277","389","112","3"
"2012","Edmonton, Alberta, municipal","48033","Robbery","1153","391","14","-1.83","132.93","42.66","52.58","179.54","7.33","405","298","396","98","4"
"2013","Edmonton, Alberta, municipal","48033","Robbery","1102","363","13","-7.57","122.87","39.51","50.62","198.33","5.51","376","286","394","108","3"
"2014","Edmonton, Alberta, municipal","48033","Robbery","1121","371","8","-1.59","120.91","43.37","50.14","143.36","3.68","379","325","403","78","2"
"2015","Edmonton, Alberta, municipal","48033","Robbery","1395","546","8","21.75","147.22","53.58","61.83","177.17","9.13","554","410","507","97","5"
"2016","Edmonton, Alberta, municipal","48033","Robbery","1342","479","10","-5.93","138.48","51.44","60.56","188.53","3.59","489","402","507","105","2"
"2005","Edmonton, Alberta, municipal","48033","Robbery to steal a firearm","0","0","0","0","0","0","0","0","0","0","0","0","0","0"
"2006","Edmonton, Alberta, municipal","48033","Robbery to steal a firearm","0","0","0","0","0","0","0","0","0","0","0","0","0","0"
"2007","Edmonton, Alberta, municipal","48033","Robbery to steal a firearm","0","0","0","0","0","0","0","0","0","0","0","0","0","0"
"2008","Edmonton, Alberta, municipal","48033","Robbery to steal a firearm","0","0","0","0","0","0","0","0","0","0","0","0","0","0"
"2009","Edmonton, Alberta, municipal","48033","Robbery to steal a firearm","0","0","0","0","0","0","0","0","0","0","0","0","0","0"
"2010","Edmonton, Alberta, municipal","48033","Robbery to steal a firearm","0","0","0","0","0","0","0","0","0","0","0","0","0","0"
"2011","Edmonton, Alberta, municipal","48033","Robbery to steal a firearm","0","0","0","0","0","0","0","0","0","0","0","0","0","0"
"2012","Edmonton, Alberta, municipal","48033","Robbery to steal a firearm","0","0","0","0","0","0","0","0","0","0","0","0","0","0"
"2013","Edmonton, Alberta, municipal","48033","Robbery to steal a firearm","0","0","0","0","0","0","0","0","0","0","0","0","0","0"
"2014","Edmonton, Alberta, municipal","48033","Robbery to steal a firearm","0","0","0","0","0","0","0","0","0","0","0","0","0","0"
"2015","Edmonton, Alberta, municipal","48033","Robbery to steal a firearm","0","0","0","0","0","0","0","0","0","0","0","0","0","0"
"2016","Edmonton, Alberta, municipal","48033","Robbery to steal a firearm","0","0","0","0","0","0","0","0","0","0","0","0","0","0"
"1998","Edmonton, Alberta, municipal","48033","Total forcible confinement or kidnapping","58","43","1","0","8.88","0","0","0","0","44","34","42","8","0"
"1999","Edmonton, Alberta, municipal","48033","Total forcible confinement or kidnapping","60","53","5","1.84","9.04","0","0","0","0","58","61","74","13","0"
"2000","Edmonton, Alberta, municipal","48033","Total forcible confinement or kidnapping","95","93","0","55.96","14.1","0","0","0","0","93","84","99","15","2"
"2001","Edmonton, Alberta, municipal","48033","Total forcible confinement or kidnapping","129","113","0","33.93","18.89","0","0","0","0","113","99","121","22","0"
"2002","Edmonton, Alberta, municipal","48033","Total forcible confinement or kidnapping","124","107","0","-5.53","17.84","0","0","0","0","107","105","114","9","0"
"2003","Edmonton, Alberta, municipal","48033","Total forcible confinement or kidnapping","112","102","1","-10.69","15.94","0","0","0","0","103","97","111","14","0"
"2004","Edmonton, Alberta, municipal","48033","Total forcible confinement or kidnapping","91","77","0","-20.76","12.63","18.48","17.64","9.04","0","77","105","110","5","0"
"2005","Edmonton, Alberta, municipal","48033","Total forcible confinement or kidnapping","90","68","0","-3.34","12.21","11.65","11.42","9","0","68","68","73","5","0"
"2006","Edmonton, Alberta, municipal","48033","Total forcible confinement or kidnapping","98","87","0","5.78","12.91","15.41","14.7","7.14","0","87","93","97","4","0"
"2007","Edmonton, Alberta, municipal","48033","Total forcible confinement or kidnapping","105","90","2","4.36","13.48","13.66","13.57","12.56","1.79","92","85","92","7","1"
"2008","Edmonton, Alberta, municipal","48033","Total forcible confinement or kidnapping","143","124","1","33.05","17.93","20.5","18.87","0","0","125","131","131","0","0"
"2009","Edmonton, Alberta, municipal","48033","Total forcible confinement or kidnapping","160","140","0","9.12","19.56","19.03","18.54","12.75","0","140","125","132","7","0"
"2010","Edmonton, Alberta, municipal","48033","Total forcible confinement or kidnapping","122","108","2","-24.97","14.68","15.71","14.94","5.5","1.83","110","105","108","3","1"
"2011","Edmonton, Alberta, municipal","48033","Total forcible confinement or kidnapping","77","82","0","-37.96","9.11","8.68","8.58","7.27","0","82","59","63","4","0"
"2012","Edmonton, Alberta, municipal","48033","Total forcible confinement or kidnapping","95","84","0","20.28","10.95","11.45","11.29","9.16","0","84","80","85","5","0"
"2013","Edmonton, Alberta, municipal","48033","Total forcible confinement or kidnapping","87","78","0","-11.44","9.7","10.64","10.53","9.18","0","78","77","82","5","0"
"2014","Edmonton, Alberta, municipal","48033","Total forcible confinement or kidnapping","93","75","1","3.41","10.03","9.61","9.21","3.68","0","76","72","74","2","0"
"2015","Edmonton, Alberta, municipal","48033","Total forcible confinement or kidnapping","98","86","1","3.1","10.34","10.19","10","7.31","0","87","78","82","4","0"
"2016","Edmonton, Alberta, municipal","48033","Total forcible confinement or kidnapping","118","100","1","17.74","12.18","11.52","11.11","5.39","0","101","90","93","3","0"
"1998","Edmonton, Alberta, municipal","48033","Forcible confinement or kidnapping","58","43","1","0","8.88","0","0","0","0","44","34","42","8","0"
"1999","Edmonton, Alberta, municipal","48033","Forcible confinement or kidnapping","60","53","5","1.84","9.04","0","0","0","0","58","61","74","13","0"
"2000","Edmonton, Alberta, municipal","48033","Forcible confinement or kidnapping","95","93","0","55.96","14.1","0","0","0","0","93","84","99","15","2"
"2001","Edmonton, Alberta, municipal","48033","Forcible confinement or kidnapping","129","113","0","33.93","18.89","0","0","0","0","113","99","121","22","0"
"2002","Edmonton, Alberta, municipal","48033","Forcible confinement or kidnapping","124","107","0","-5.53","17.84","0","0","0","0","107","105","114","9","0"
"2003","Edmonton, Alberta, municipal","48033","Forcible confinement or kidnapping","112","102","1","-10.69","15.94","0","0","0","0","103","97","111","14","0"
"2004","Edmonton, Alberta, municipal","48033","Forcible confinement or kidnapping","91","77","0","-20.76","12.63","18.48","17.64","9.04","0","77","105","110","5","0"
"2005","Edmonton, Alberta, municipal","48033","Forcible confinement or kidnapping","90","68","0","-3.34","12.21","11.65","11.42","9","0","68","68","73","5","0"
"2006","Edmonton, Alberta, municipal","48033","Forcible confinement or kidnapping","98","87","0","5.78","12.91","15.41","14.7","7.14","0","87","93","97","4","0"
"2007","Edmonton, Alberta, municipal","48033","Forcible confinement or kidnapping","105","90","2","4.36","13.48","13.66","13.57","12.56","1.79","92","85","92","7","1"
"2008","Edmonton, Alberta, municipal","48033","Forcible confinement or kidnapping","143","124","1","33.05","17.93","20.5","18.87","0","0","125","131","131","0","0"
"2009","Edmonton, Alberta, municipal","48033","Forcible confinement or kidnapping","160","140","0","9.12","19.56","19.03","18.54","12.75","0","140","125","132","7","0"
"2010","Edmonton, Alberta, municipal","48033","Forcible confinement or kidnapping","73","72","2","-55.1","8.78","10.03","9.69","5.5","1.83","74","67","70","3","1"
"2011","Edmonton, Alberta, municipal","48033","Forcible confinement or kidnapping","0","3","0","-100","0","0.29","0.27","0","0","3","2","2","0","0"
"2012","Edmonton, Alberta, municipal","48033","Forcible confinement or kidnapping","0","0","0","0","0","0","0","0","0","0","0","0","0","0"
"2013","Edmonton, Alberta, municipal","48033","Forcible confinement or kidnapping","0","0","0","0","0","0","0","0","0","0","0","0","0","0"
"2014","Edmonton, Alberta, municipal","48033","Forcible confinement or kidnapping","0","0","0","0","0","0","0","0","0","0","0","0","0","0"
"2015","Edmonton, Alberta, municipal","48033","Forcible confinement or kidnapping","0","0","0","0","0","0","0","0","0","0","0","0","0","0"
"2016","Edmonton, Alberta, municipal","48033","Forcible confinement or kidnapping","0","0","0","0","0","0","0","0","0","0","0","0","0","0"
"2005","Edmonton, Alberta, municipal","48033","Kidnapping","0","0","0","0","0","0","0","0","0","0","0","0","0","0"
"2006","Edmonton, Alberta, municipal","48033","Kidnapping","0","0","0","0","0","0","0","0","0","0","0","0","0","0"
"2007","Edmonton, Alberta, municipal","48033","Kidnapping","0","0","0","0","0","0","0","0","0","0","0","0","0","0"
"2008","Edmonton, Alberta, municipal","48033","Kidnapping","0","0","0","0","0","0","0","0","0","0","0","0","0","0"
"2009","Edmonton, Alberta, municipal","48033","Kidnapping","0","0","0","0","0","0","0","0","0","0","0","0","0","0"
"2010","Edmonton, Alberta, municipal","48033","Kidnapping","8","8","0","0","0.96","1.5","1.38","0","0","8","10","10","0","0"
"2011","Edmonton, Alberta, municipal","48033","Kidnapping","19","14","0","133.45","2.25","1.91","1.91","1.82","0","14","13","14","1","0"
"2012","Edmonton, Alberta, municipal","48033","Kidnapping","25","15","0","28.28","2.88","3.15","3.05","1.83","0","15","22","23","1","0"
"2013","Edmonton, Alberta, municipal","48033","Kidnapping","23","16","0","-11.03","2.56","3.04","3.34","7.35","0","16","22","26","4","0"
"2014","Edmonton, Alberta, municipal","48033","Kidnapping","36","22","1","51.42","3.88","3.47","3.36","1.84","0","23","26","27","1","0"
"2015","Edmonton, Alberta, municipal","48033","Kidnapping","26","17","0","-29.34","2.74","2.74","2.68","1.83","0","17","21","22","1","0"
"2016","Edmonton, Alberta, municipal","48033","Kidnapping","24","13","0","-9.74","2.48","2.43","2.27","0","0","13","19","19","0","0"
"2005","Edmonton, Alberta, municipal","48033","Forcible confinement","0","0","0","0","0","0","0","0","0","0","0","0","0","0"
"2006","Edmonton, Alberta, municipal","48033","Forcible confinement","0","0","0","0","0","0","0","0","0","0","0","0","0","0"
"2007","Edmonton, Alberta, municipal","48033","Forcible confinement","0","0","0","0","0","0","0","0","0","0","0","0","0","0"
"2008","Edmonton, Alberta, municipal","48033","Forcible confinement","0","0","0","0","0","0","0","0","0","0","0","0","0","0"
"2009","Edmonton, Alberta, municipal","48033","Forcible confinement","0","0","0","0","0","0","0","0","0","0","0","0","0","0"
"2010","Edmonton, Alberta, municipal","48033","Forcible confinement","41","28","0","0","4.93","4.19","3.87","0","0","28","28","28","0","0"
"2011","Edmonton, Alberta, municipal","48033","Forcible confinement","58","65","0","39.05","6.86","6.47","6.4","5.45","0","65","44","47","3","0"
"2012","Edmonton, Alberta, municipal","48033","Forcible confinement","70","69","0","17.66","8.07","8.3","8.23","7.33","0","69","58","62","4","0"
"2013","Edmonton, Alberta, municipal","48033","Forcible confinement","64","62","0","-11.58","7.14","7.6","7.19","1.84","0","62","55","56","1","0"
"2014","Edmonton, Alberta, municipal","48033","Forcible confinement","57","53","0","-13.84","6.15","6.14","5.85","1.84","0","53","46","47","1","0"
"2015","Edmonton, Alberta, municipal","48033","Forcible confinement","72","69","1","23.59","7.6","7.45","7.32","5.48","0","70","57","60","3","0"
"2016","Edmonton, Alberta, municipal","48033","Forcible confinement","94","87","1","27.66","9.7","9.09","8.84","5.39","0","88","71","74","3","0"
"1998","Edmonton, Alberta, municipal","48033","Total abduction","0","1","0","0","0","0","0","0","0","1","1","1","0","0"
"1999","Edmonton, Alberta, municipal","48033","Total abduction","15","12","0","0","2.26","0","0","0","0","12","10","10","0","0"
"2000","Edmonton, Alberta, municipal","48033","Total abduction","10","6","0","-34.33","1.48","0","0","0","0","6","6","6","0","0"
"2001","Edmonton, Alberta, municipal","48033","Total abduction","6","4","0","-40.82","0.88","0","0","0","0","4","4","4","0","0"
"2002","Edmonton, Alberta, municipal","48033","Total abduction","4","3","0","-34.48","0.58","0","0","0","0","3","2","2","0","0"
"2003","Edmonton, Alberta, municipal","48033","Total abduction","3","0","0","-25.84","0.43","0","0","0","0","0","0","0","0","0"
"2004","Edmonton, Alberta, municipal","48033","Total abduction","9","4","0","192.58","1.25","0.35","0.32","0","0","4","2","2","0","0"
"2005","Edmonton, Alberta, municipal","48033","Total abduction","16","2","0","73.75","2.17","0.34","0.31","0","0","2","2","2","0","0"
"2006","Edmonton, Alberta, municipal","48033","Total abduction","10","2","0","-39.29","1.32","0.17","0.15","0","0","2","1","1","0","0"
"2007","Edmonton, Alberta, municipal","48033","Total abduction","18","5","1","75.33","2.31","0.64","0.59","0","0","6","4","4","0","0"
"2008","Edmonton, Alberta, municipal","48033","Total abduction","10","3","1","-45.73","1.25","0.47","0.43","0","0","4","3","3","0","0"
"2009","Edmonton, Alberta, municipal","48033","Total abduction","11","3","1","7.28","1.34","0.3","0.28","0","0","4","2","2","0","0"
"2010","Edmonton, Alberta, municipal","48033","Total abduction","18","3","5","61.02","2.17","0.3","0.28","0","0","8","2","2","0","0"
"2011","Edmonton, Alberta, municipal","48033","Total abduction","21","0","3","14.68","2.48","0","0","0","0","3","0","0","0","0"
"2012","Edmonton, Alberta, municipal","48033","Total abduction","15","7","2","-30.36","1.73","0.86","0.8","0","0","9","6","6","0","0"
"2013","Edmonton, Alberta, municipal","48033","Total abduction","8","1","0","-48.42","0.89","0.14","0.13","0","0","1","1","1","0","0"
"2014","Edmonton, Alberta, municipal","48033","Total abduction","18","4","0","117.67","1.94","0.4","0.37","0","0","4","3","3","0","0"
"2015","Edmonton, Alberta, municipal","48033","Total abduction","12","4","1","-34.77","1.27","0.78","0.73","0","0","5","6","6","0","0"
"2016","Edmonton, Alberta, municipal","48033","Total abduction","14","8","2","14.08","1.44","0.64","0.6","0","0","10","5","5","0","0"
"1998","Edmonton, Alberta, municipal","48033","Abduction under the age 14, not parent or guardian","0","1","0","0","0","0","0","0","0","1","1","1","0","0"
"1999","Edmonton, Alberta, municipal","48033","Abduction under the age 14, not parent or guardian","6","1","0","0","0.9","0","0","0","0","1","1","1","0","0"
"2000","Edmonton, Alberta, municipal","48033","Abduction under the age 14, not parent or guardian","5","4","0","-17.92","0.74","0","0","0","0","4","4","4","0","0"
"2001","Edmonton, Alberta, municipal","48033","Abduction under the age 14, not parent or guardian","2","0","0","-60.55","0.29","0","0","0","0","0","0","0","0","0"
"2002","Edmonton, Alberta, municipal","48033","Abduction under the age 14, not parent or guardian","1","0","0","-50.86","0.14","0","0","0","0","0","0","0","0","0"
"2003","Edmonton, Alberta, municipal","48033","Abduction under the age 14, not parent or guardian","3","0","0","196.64","0.43","0","0","0","0","0","0","0","0","0"
"2004","Edmonton, Alberta, municipal","48033","Abduction under the age 14, not parent or guardian","4","0","0","30.04","0.56","0","0","0","0","0","0","0","0","0"
"2005","Edmonton, Alberta, municipal","48033","Abduction under the age 14, not parent or guardian","9","0","0","119.9","1.22","0","0","0","0","0","0","0","0","0"
"2006","Edmonton, Alberta, municipal","48033","Abduction under the age 14, not parent or guardian","5","0","0","-46.03","0.66","0","0","0","0","0","0","0","0","0"
"2007","Edmonton, Alberta, municipal","48033","Abduction under the age 14, not parent or guardian","13","2","1","153.25","1.67","0.32","0.29","0","0","3","2","2","0","0"
"2008","Edmonton, Alberta, municipal","48033","Abduction under the age 14, not parent or guardian","5","1","0","-62.43","0.63","0.16","0.14","0","0","1","1","1","0","0"
"2009","Edmonton, Alberta, municipal","48033","Abduction under the age 14, not parent or guardian","3","0","0","-41.49","0.37","0","0","0","0","0","0","0","0","0"
"2010","Edmonton, Alberta, municipal","48033","Abduction under the age 14, not parent or guardian","10","3","1","228","1.2","0.3","0.28","0","0","4","2","2","0","0"
"2011","Edmonton, Alberta, municipal","48033","Abduction under the age 14, not parent or guardian","9","0","1","-11.54","1.06","0","0","0","0","1","0","0","0","0"
"2012","Edmonton, Alberta, municipal","48033","Abduction under the age 14, not parent or guardian","9","5","0","-2.51","1.04","0.57","0.53","0","0","5","4","4","0","0"
"2013","Edmonton, Alberta, municipal","48033","Abduction under the age 14, not parent or guardian","3","0","0","-67.76","0.33","0","0","0","0","0","0","0","0","0"
"2014","Edmonton, Alberta, municipal","48033","Abduction under the age 14, not parent or guardian","4","1","0","28.99","0.43","0.13","0.12","0","0","1","1","1","0","0"
"2015","Edmonton, Alberta, municipal","48033","Abduction under the age 14, not parent or guardian","1","0","0","-75.54","0.11","0","0","0","0","0","0","0","0","0"
"2016","Edmonton, Alberta, municipal","48033","Abduction under the age 14, not parent or guardian","4","2","0","291.13","0.41","0.13","0.12","0","0","2","1","1","0","0"
"1998","Edmonton, Alberta, municipal","48033","Abduction under the age 16","0","0","0","0","0","0","0","0","0","0","0","0","0","0"
"1999","Edmonton, Alberta, municipal","48033","Abduction under the age 16","2","1","0","0","0.3","0","0","0","0","1","1","1","0","0"
"2000","Edmonton, Alberta, municipal","48033","Abduction under the age 16","0","0","0","-100","0","0","0","0","0","0","0","0","0","0"
"2001","Edmonton, Alberta, municipal","48033","Abduction under the age 16","0","0","0","0","0","0","0","0","0","0","0","0","0","0"
"2002","Edmonton, Alberta, municipal","48033","Abduction under the age 16","0","0","0","0","0","0","0","0","0","0","0","0","0","0"
"2003","Edmonton, Alberta, municipal","48033","Abduction under the age 16","0","0","0","0","0","0","0","0","0","0","0","0","0","0"
"2004","Edmonton, Alberta, municipal","48033","Abduction under the age 16","0","0","0","0","0","0","0","0","0","0","0","0","0","0"
"2005","Edmonton, Alberta, municipal","48033","Abduction under the age 16","2","0","0","0","0.27","0","0","0","0","0","0","0","0","0"
"2006","Edmonton, Alberta, municipal","48033","Abduction under the age 16","1","0","0","-51.43","0.13","0","0","0","0","0","0","0","0","0"
"2007","Edmonton, Alberta, municipal","48033","Abduction under the age 16","3","0","0","192.21","0.39","0","0","0","0","0","0","0","0","0"
"2008","Edmonton, Alberta, municipal","48033","Abduction under the age 16","0","0","0","-100","0","0","0","0","0","0","0","0","0","0"
"2009","Edmonton, Alberta, municipal","48033","Abduction under the age 16","2","0","0","0","0.24","0","0","0","0","0","0","0","0","0"
"2010","Edmonton, Alberta, municipal","48033","Abduction under the age 16","3","0","0","47.6","0.36","0","0","0","0","0","0","0","0","0"
"2011","Edmonton, Alberta, municipal","48033","Abduction under the age 16","2","0","1","-34.47","0.24","0","0","0","0","1","0","0","0","0"
"2012","Edmonton, Alberta, municipal","48033","Abduction under the age 16","2","1","1","-2.51","0.23","0.14","0.13","0","0","2","1","1","0","0"
"2013","Edmonton, Alberta, municipal","48033","Abduction under the age 16","1","0","0","-51.65","0.11","0","0","0","0","0","0","0","0","0"
"2014","Edmonton, Alberta, municipal","48033","Abduction under the age 16","2","0","0","93.48","0.22","0","0","0","0","0","0","0","0","0"
"2015","Edmonton, Alberta, municipal","48033","Abduction under the age 16","0","0","0","-100","0","0","0","0","0","0","0","0","0","0"
"2016","Edmonton, Alberta, municipal","48033","Abduction under the age 16","2","0","0","0","0.21","0","0","0","0","0","0","0","0","0"
"1998","Edmonton, Alberta, municipal","48033","Removal of children from Canada","0","0","0","0","0","0","0","0","0","0","0","0","0","0"
"1999","Edmonton, Alberta, municipal","48033","Removal of children from Canada","0","0","0","0","0","0","0","0","0","0","0","0","0","0"
"2000","Edmonton, Alberta, municipal","48033","Removal of children from Canada","0","0","0","0","0","0","0","0","0","0","0","0","0","0"
"2001","Edmonton, Alberta, municipal","48033","Removal of children from Canada","0","0","0","0","0","0","0","0","0","0","0","0","0","0"
"2002","Edmonton, Alberta, municipal","48033","Removal of children from Canada","0","0","0","0","0","0","0","0","0","0","0","0","0","0"
"2003","Edmonton, Alberta, municipal","48033","Removal of children from Canada","0","0","0","0","0","0","0","0","0","0","0","0","0","0"
"2004","Edmonton, Alberta, municipal","48033","Removal of children from Canada","0","0","0","0","0","0","0","0","0","0","0","0","0","0"
"2005","Edmonton, Alberta, municipal","48033","Removal of children from Canada","0","0","0","0","0","0","0","0","0","0","0","0","0","0"
"2006","Edmonton, Alberta, municipal","48033","Removal of children from Canada","0","0","0","0","0","0","0","0","0","0","0","0","0","0"
"2007","Edmonton, Alberta, municipal","48033","Removal of children from Canada","0","0","0","0","0","0","0","0","0","0","0","0","0","0"
"2008","Edmonton, Alberta, municipal","48033","Removal of children from Canada","1","0","0","0","0.13","0","0","0","0","0","0","0","0","0"
"2009","Edmonton, Alberta, municipal","48033","Removal of children from Canada","0","0","0","-100","0","0","0","0","0","0","0","0","0","0"
"2010","Edmonton, Alberta, municipal","48033","Removal of children from Canada","0","0","0","0","0","0","0","0","0","0","0","0","0","0"
"2011","Edmonton, Alberta, municipal","48033","Removal of children from Canada","0","0","0","0","0","0","0","0","0","0","0","0","0","0"
"2012","Edmonton, Alberta, municipal","48033","Removal of children from Canada","0","0","0","0","0","0","0","0","0","0","0","0","0","0"
"2013","Edmonton, Alberta, municipal","48033","Removal of children from Canada","1","0","0","0","0.11","0","0","0","0","0","0","0","0","0"
"2014","Edmonton, Alberta, municipal","48033","Removal of children from Canada","0","0","0","-100","0","0","0","0","0","0","0","0","0","0"
"2015","Edmonton, Alberta, municipal","48033","Removal of children from Canada","0","0","0","0","0","0","0","0","0","0","0","0","0","0"
"2016","Edmonton, Alberta, municipal","48033","Removal of children from Canada","0","0","0","0","0","0","0","0","0","0","0","0","0","0"
"1998","Edmonton, Alberta, municipal","48033","Abduction under the age 14 contravening a custody order","0","0","0","0","0","0","0","0","0","0","0","0","0","0"
"1999","Edmonton, Alberta, municipal","48033","Abduction under the age 14 contravening a custody order","5","8","0","0","0.75","0","0","0","0","8","6","6","0","0"
"2000","Edmonton, Alberta, municipal","48033","Abduction under the age 14 contravening a custody order","3","1","0","-40.9","0.45","0","0","0","0","1","1","1","0","0"
"2001","Edmonton, Alberta, municipal","48033","Abduction under the age 14 contravening a custody order","3","3","0","-1.37","0.44","0","0","0","0","3","3","3","0","0"
"2002","Edmonton, Alberta, municipal","48033","Abduction under the age 14 contravening a custody order","1","1","0","-67.24","0.14","0","0","0","0","1","1","1","0","0"
"2003","Edmonton, Alberta, municipal","48033","Abduction under the age 14 contravening a custody order","0","0","0","-100","0","0","0","0","0","0","0","0","0","0"
"2004","Edmonton, Alberta, municipal","48033","Abduction under the age 14 contravening a custody order","4","3","0","0","0.56","0.18","0.16","0","0","3","1","1","0","0"
"2005","Edmonton, Alberta, municipal","48033","Abduction under the age 14 contravening a custody order","2","1","0","-51.13","0.27","0.17","0.16","0","0","1","1","1","0","0"
"2006","Edmonton, Alberta, municipal","48033","Abduction under the age 14 contravening a custody order","4","2","0","94.29","0.53","0.17","0.15","0","0","2","1","1","0","0"
"2007","Edmonton, Alberta, municipal","48033","Abduction under the age 14 contravening a custody order","2","3","0","-51.3","0.26","0.32","0.29","0","0","3","2","2","0","0"
"2008","Edmonton, Alberta, municipal","48033","Abduction under the age 14 contravening a custody order","2","1","1","-2.31","0.25","0.16","0.14","0","0","2","1","1","0","0"
"2009","Edmonton, Alberta, municipal","48033","Abduction under the age 14 contravening a custody order","5","3","0","143.81","0.61","0.3","0.28","0","0","3","2","2","0","0"
"2010","Edmonton, Alberta, municipal","48033","Abduction under the age 14 contravening a custody order","3","0","3","-40.96","0.36","0","0","0","0","3","0","0","0","0"
"2011","Edmonton, Alberta, municipal","48033","Abduction under the age 14 contravening a custody order","6","0","1","96.59","0.71","0","0","0","0","1","0","0","0","0"
"2012","Edmonton, Alberta, municipal","48033","Abduction under the age 14 contravening a custody order","1","0","0","-83.75","0.12","0","0","0","0","0","0","0","0","0"
"2013","Edmonton, Alberta, municipal","48033","Abduction under the age 14 contravening a custody order","0","0","0","-100","0","0","0","0","0","0","0","0","0","0"
"2014","Edmonton, Alberta, municipal","48033","Abduction under the age 14 contravening a custody order","6","2","0","0","0.65","0.13","0.12","0","0","2","1","1","0","0"
"2015","Edmonton, Alberta, municipal","48033","Abduction under the age 14 contravening a custody order","5","3","0","-18.47","0.53","0.65","0.61","0","0","3","5","5","0","0"
"2016","Edmonton, Alberta, municipal","48033","Abduction under the age 14 contravening a custody order","4","0","2","-21.77","0.41","0","0","0","0","2","0","0","0","0"
"1998","Edmonton, Alberta, municipal","48033","Abduction under age 14, by parent or guardian","0","0","0","0","0","0","0","0","0","0","0","0","0","0"
"1999","Edmonton, Alberta, municipal","48033","Abduction under age 14, by parent or guardian","2","2","0","0","0.3","0","0","0","0","2","2","2","0","0"
"2000","Edmonton, Alberta, municipal","48033","Abduction under age 14, by parent or guardian","2","1","0","-1.5","0.3","0","0","0","0","1","1","1","0","0"
"2001","Edmonton, Alberta, municipal","48033","Abduction under age 14, by parent or guardian","1","1","0","-50.68","0.15","0","0","0","0","1","1","1","0","0"
"2002","Edmonton, Alberta, municipal","48033","Abduction under age 14, by parent or guardian","2","2","0","96.55","0.29","0","0","0","0","2","1","1","0","0"
"2003","Edmonton, Alberta, municipal","48033","Abduction under age 14, by parent or guardian","0","0","0","-100","0","0","0","0","0","0","0","0","0","0"
"2004","Edmonton, Alberta, municipal","48033","Abduction under age 14, by parent or guardian","1","1","0","0","0.14","0.18","0.16","0","0","1","1","1","0","0"
"2005","Edmonton, Alberta, municipal","48033","Abduction under age 14, by parent or guardian","3","1","0","193.2","0.41","0.17","0.16","0","0","1","1","1","0","0"
"2006","Edmonton, Alberta, municipal","48033","Abduction under age 14, by parent or guardian","0","0","0","-100","0","0","0","0","0","0","0","0","0","0"
"2007","Edmonton, Alberta, municipal","48033","Abduction under age 14, by parent or guardian","0","0","0","0","0","0","0","0","0","0","0","0","0","0"
"2008","Edmonton, Alberta, municipal","48033","Abduction under age 14, by parent or guardian","2","1","0","0","0.25","0.16","0.14","0","0","1","1","1","0","0"
"2009","Edmonton, Alberta, municipal","48033","Abduction under age 14, by parent or guardian","1","0","1","-51.24","0.12","0","0","0","0","1","0","0","0","0"
"2010","Edmonton, Alberta, municipal","48033","Abduction under age 14, by parent or guardian","2","0","1","96.8","0.24","0","0","0","0","1","0","0","0","0"
"2011","Edmonton, Alberta, municipal","48033","Abduction under age 14, by parent or guardian","4","0","0","96.59","0.47","0","0","0","0","0","0","0","0","0"
"2012","Edmonton, Alberta, municipal","48033","Abduction under age 14, by parent or guardian","3","1","1","-26.88","0.35","0.14","0.13","0","0","2","1","1","0","0"
"2013","Edmonton, Alberta, municipal","48033","Abduction under age 14, by parent or guardian","3","1","0","-3.29","0.33","0.14","0.13","0","0","1","1","1","0","0"
"2014","Edmonton, Alberta, municipal","48033","Abduction under age 14, by parent or guardian","6","1","0","93.48","0.65","0.13","0.12","0","0","1","1","1","0","0"
"2015","Edmonton, Alberta, municipal","48033","Abduction under age 14, by parent or guardian","6","1","1","-2.16","0.63","0.13","0.12","0","0","2","1","1","0","0"
"2016","Edmonton, Alberta, municipal","48033","Abduction under age 14, by parent or guardian","4","6","0","-34.81","0.41","0.51","0.48","0","0","6","4","4","0","0"
"1998","Edmonton, Alberta, municipal","48033","Extortion","18","15","0","0","2.76","0","0","0","0","15","11","17","6","0"
"1999","Edmonton, Alberta, municipal","48033","Extortion","16","8","1","-12.5","2.41","0","0","0","0","9","6","6","0","0"
"2000","Edmonton, Alberta, municipal","48033","Extortion","14","11","1","-13.81","2.08","0","0","0","0","12","8","10","2","1"
"2001","Edmonton, Alberta, municipal","48033","Extortion","23","11","1","62.04","3.37","0","0","0","0","12","12","19","7","0"
"2002","Edmonton, Alberta, municipal","48033","Extortion","37","31","0","58.1","5.32","0","0","0","0","31","7","8","1","0"
"2003","Edmonton, Alberta, municipal","48033","Extortion","18","9","1","-51.9","2.56","0","0","0","0","10","7","8","1","0"
"2004","Edmonton, Alberta, municipal","48033","Extortion","21","16","1","13.78","2.91","2.64","2.73","3.62","0","17","15","17","2","0"
"2005","Edmonton, Alberta, municipal","48033","Extortion","41","20","2","90.81","5.56","2.4","2.5","3.6","0","22","14","16","2","0"
"2006","Edmonton, Alberta, municipal","48033","Extortion","23","13","2","-45.51","3.03","1.99","1.82","0","0","15","12","12","0","0"
"2007","Edmonton, Alberta, municipal","48033","Extortion","34","14","1","43.99","4.36","2.73","2.51","0","0","15","17","17","0","0"
"2008","Edmonton, Alberta, municipal","48033","Extortion","37","18","6","6.31","4.64","2.66","3.02","7.22","1.81","24","17","21","4","1"
"2009","Edmonton, Alberta, municipal","48033","Extortion","64","13","4","68.69","7.83","1.37","1.83","7.29","0","17","9","13","4","0"
"2010","Edmonton, Alberta, municipal","48033","Extortion","31","16","2","-52.34","3.73","1.5","2.08","9.16","0","18","10","15","5","0"
"2011","Edmonton, Alberta, municipal","48033","Extortion","36","23","5","14.15","4.26","2.8","2.86","3.63","0","28","19","21","2","0"
"2012","Edmonton, Alberta, municipal","48033","Extortion","43","18","5","16.45","4.96","3.01","2.92","1.83","0","23","21","22","1","0"
"2013","Edmonton, Alberta, municipal","48033","Extortion","65","36","6","46.18","7.25","4.7","4.88","7.35","0","42","34","38","4","0"
"2014","Edmonton, Alberta, municipal","48033","Extortion","79","39","6","17.58","8.52","4.14","4.11","3.68","1.84","45","31","33","2","1"
"2015","Edmonton, Alberta, municipal","48033","Extortion","90","15","8","11.46","9.5","2.22","2.07","0","3.65","23","17","17","0","2"
"2016","Edmonton, Alberta, municipal","48033","Extortion","89","27","3","-3.3","9.18","2.56","2.99","8.98","0","30","20","25","5","0"
"1998","Edmonton, Alberta, municipal","48033","Criminal harassment","61","48","4","0","9.34","0","0","0","0","52","36","37","1","0"
"1999","Edmonton, Alberta, municipal","48033","Criminal harassment","68","56","1","9.74","10.25","0","0","0","0","57","40","42","2","0"
"2000","Edmonton, Alberta, municipal","48033","Criminal harassment","128","85","12","85.41","19","0","0","0","0","97","56","59","3","4"
"2001","Edmonton, Alberta, municipal","48033","Criminal harassment","81","50","2","-37.58","11.86","0","0","0","0","52","40","41","1","0"
"2002","Edmonton, Alberta, municipal","48033","Criminal harassment","82","59","3","-0.51","11.8","0","0","0","0","62","44","46","2","0"
"2003","Edmonton, Alberta, municipal","48033","Criminal harassment","108","74","1","30.23","15.37","0","0","0","0","75","60","63","3","0"
"2004","Edmonton, Alberta, municipal","48033","Criminal harassment","90","57","2","-18.73","12.49","6.69","6.74","7.23","0","59","38","42","4","0"
"2005","Edmonton, Alberta, municipal","48033","Criminal harassment","110","72","6","19.45","14.92","9.59","8.76","0","0","78","56","56","0","0"
"2006","Edmonton, Alberta, municipal","48033","Criminal harassment","81","58","3","-28.47","10.67","7.29","6.97","3.57","0","61","44","46","2","0"
"2007","Edmonton, Alberta, municipal","48033","Criminal harassment","111","63","15","33.48","14.25","8.68","7.96","0","1.79","78","54","54","0","1"
"2008","Edmonton, Alberta, municipal","48033","Criminal harassment","177","104","20","55.78","22.19","12.21","11.52","3.61","3.61","124","78","80","2","2"
"2009","Edmonton, Alberta, municipal","48033","Criminal harassment","174","83","37","-4.13","21.27","9.74","9.27","3.64","1.82","120","64","66","2","1"
"2010","Edmonton, Alberta, municipal","48033","Criminal harassment","160","66","40","-9.52","19.25","8.53","8.44","7.33","9.16","106","57","61","4","5"
"2011","Edmonton, Alberta, municipal","48033","Criminal harassment","243","104","68","49.28","28.74","12.21","11.3","0","7.27","172","83","83","0","4"
"2012","Edmonton, Alberta, municipal","48033","Criminal harassment","222","114","51","-10.93","25.6","14.31","13.94","9.16","18.32","165","100","105","5","10"
"2013","Edmonton, Alberta, municipal","48033","Criminal harassment","268","133","42","16.74","29.88","14.23","14","11.02","16.53","175","103","109","6","9"
"2014","Edmonton, Alberta, municipal","48033","Criminal harassment","291","112","60","5.04","31.39","12.41","12.19","9.19","9.19","172","93","98","5","5"
"2015","Edmonton, Alberta, municipal","48033","Criminal harassment","266","95","57","-10.57","28.07","11.5","10.98","3.65","5.48","152","88","90","2","3"
"2016","Edmonton, Alberta, municipal","48033","Criminal harassment","260","97","64","-4.42","26.83","11.39","10.99","5.39","8.98","161","89","92","3","5"
"1998","Edmonton, Alberta, municipal","48033","Uttering threats","61","55","5","0","9.34","0","0","0","0","60","28","31","3","0"
"1999","Edmonton, Alberta, municipal","48033","Uttering threats","595","392","40","860.21","89.68","0","0","0","0","432","186","237","51","13"
"2000","Edmonton, Alberta, municipal","48033","Uttering threats","596","378","56","-1.33","88.48","0","0","0","0","434","202","243","41","34"
"2001","Edmonton, Alberta, municipal","48033","Uttering threats","862","467","52","42.65","126.22","0","0","0","0","519","236","299","63","15"
"2002","Edmonton, Alberta, municipal","48033","Uttering threats","699","367","49","-20.31","100.59","0","0","0","0","416","179","230","51","9"
"2003","Edmonton, Alberta, municipal","48033","Uttering threats","703","363","42","-0.56","100.03","0","0","0","0","405","191","229","38","7"
"2004","Edmonton, Alberta, municipal","48033","Uttering threats","642","325","37","-10.93","89.1","30.97","31.59","37.98","19.89","362","176","197","21","11"
"2005","Edmonton, Alberta, municipal","48033","Uttering threats","694","353","42","5.65","94.13","31.85","33.62","52.22","27.01","395","186","215","29","15"
"2006","Edmonton, Alberta, municipal","48033","Uttering threats","718","328","59","0.5","94.6","26.67","26.53","25","25","387","161","175","14","14"
"2007","Edmonton, Alberta, municipal","48033","Uttering threats","1023","371","196","38.78","131.29","30.21","33.48","69.97","66.38","567","188","227","39","37"
"2008","Edmonton, Alberta, municipal","48033","Uttering threats","1123","420","231","7.24","140.8","35.22","37.59","64.99","64.99","651","225","261","36","36"
"2009","Edmonton, Alberta, municipal","48033","Uttering threats","1270","380","333","10.29","155.28","34.7","36.24","54.65","81.97","713","228","258","30","45"
"2010","Edmonton, Alberta, municipal","48033","Uttering threats","1303","439","325","0.96","156.77","34.87","35.84","47.65","95.3","764","233","259","26","52"
"2011","Edmonton, Alberta, municipal","48033","Uttering threats","1248","497","279","-5.86","147.59","40.02","41.65","61.76","78.11","776","272","306","34","43"
"2012","Edmonton, Alberta, municipal","48033","Uttering threats","1332","513","252","4.05","153.57","37.51","40.1","73.28","69.62","765","262","302","40","38"
"2013","Edmonton, Alberta, municipal","48033","Uttering threats","1388","599","264","0.77","154.76","37.99","40.08","67.95","84.47","863","275","312","37","46"
"2014","Edmonton, Alberta, municipal","48033","Uttering threats","1414","582","227","-1.45","152.52","42.17","44.41","75.36","55.14","809","316","357","41","30"
"2015","Edmonton, Alberta, municipal","48033","Uttering threats","1441","598","246","-0.29","152.07","42.99","44.27","62.1","51.14","844","329","363","34","28"
"2016","Edmonton, Alberta, municipal","48033","Uttering threats","1387","536","203","-5.88","143.13","41.08","42.05","55.66","53.87","739","321","352","31","30"
"1998","Edmonton, Alberta, municipal","48033","Indecent/Harassing communications","264","30","50","0","40.42","0","0","0","0","80","20","21","1","17"
"1999","Edmonton, Alberta, municipal","48033","Indecent/Harassing communications","170","25","32","-36.61","25.62","0","0","0","0","57","21","22","1","16"
"2000","Edmonton, Alberta, municipal","48033","Indecent/Harassing communications","220","31","21","27.47","32.66","0","0","0","0","52","11","12","1","7"
"2001","Edmonton, Alberta, municipal","48033","Indecent/Harassing communications","175","13","22","-21.54","25.63","0","0","0","0","35","11","13","2","4"
"2002","Edmonton, Alberta, municipal","48033","Indecent/Harassing communications","186","12","43","4.45","26.77","0","0","0","0","55","10","14","4","6"
"2003","Edmonton, Alberta, municipal","48033","Indecent/Harassing communications","174","12","11","-7.5","24.76","0","0","0","0","23","11","11","0","5"
"2004","Edmonton, Alberta, municipal","48033","Indecent/Harassing communications","169","5","13","-5.27","23.45","0.88","0.8","0","7.23","18","5","5","0","4"
"2005","Edmonton, Alberta, municipal","48033","Indecent/Harassing communications","138","8","14","-20.2","18.72","1.37","1.25","0","14.41","22","8","8","0","8"
"2006","Edmonton, Alberta, municipal","48033","Indecent/Harassing communications","169","6","13","18.96","22.27","0.33","0.3","0","0","19","2","2","0","0"
"2007","Edmonton, Alberta, municipal","48033","Indecent/Harassing communications","309","8","59","78.09","39.66","1.12","1.03","0","8.97","67","7","7","0","5"
"2008","Edmonton, Alberta, municipal","48033","Indecent/Harassing communications","302","10","86","-4.52","37.86","1.1","1.3","3.61","10.83","96","7","9","2","6"
"2009","Edmonton, Alberta, municipal","48033","Indecent/Harassing communications","349","8","113","12.7","42.67","1.07","0.98","0","7.29","121","7","7","0","4"
"2010","Edmonton, Alberta, municipal","48033","Indecent/Harassing communications","366","10","121","3.19","44.03","1.5","1.38","0","18.33","131","10","10","0","10"
"2011","Edmonton, Alberta, municipal","48033","Indecent/Harassing communications","376","14","146","0.98","44.47","1.47","1.36","0","27.25","160","10","10","0","15"
"2012","Edmonton, Alberta, municipal","48033","Indecent/Harassing communications","339","17","106","-12.1","39.08","2.15","2.12","1.83","18.32","123","15","16","1","10"
"2013","Edmonton, Alberta, municipal","48033","Indecent/Harassing communications","331","5","114","-5.58","36.91","0.55","0.51","0","16.53","119","4","4","0","9"
"2014","Edmonton, Alberta, municipal","48033","Indecent/Harassing communications","262","7","75","-23.43","28.26","0.67","0.62","0","7.35","82","5","5","0","4"
"2015","Edmonton, Alberta, municipal","48033","Indecent/Harassing communications","336","11","110","25.47","35.46","0.91","0.85","0","7.31","121","7","7","0","4"
"2016","Edmonton, Alberta, municipal","48033","Indecent/Harassing communications","301","7","83","-12.4","31.06","0.51","0.48","0","8.98","90","4","4","0","5"
"2012","Edmonton, Alberta, municipal","48033","Total commodification of sexual activity violations","0","0","0","0","0","0","0","0","0","0","0","0","0","0"
"2013","Edmonton, Alberta, municipal","48033","Total commodification of sexual activity violations","0","0","0","0","0","0","0","0","0","0","0","0","0","0"
"2014","Edmonton, Alberta, municipal","48033","Total commodification of sexual activity violations","2","1","0","0","0.22","0.27","0.25","0","0","1","2","2","0","0"
"2015","Edmonton, Alberta, municipal","48033","Total commodification of sexual activity violations","55","39","1","2590.58","5.8","5.1","4.76","0","0","40","39","39","0","0"
"2016","Edmonton, Alberta, municipal","48033","Total commodification of sexual activity violations","75","58","3","33.34","7.74","7.42","7.05","1.8","0","61","58","59","1","0"
"2012","Edmonton, Alberta, municipal","48033","Obtaining sexual services for consideration","0","0","0","0","0","0","0","0","0","0","0","0","0","0"
"2013","Edmonton, Alberta, municipal","48033","Obtaining sexual services for consideration","0","0","0","0","0","0","0","0","0","0","0","0","0","0"
"2014","Edmonton, Alberta, municipal","48033","Obtaining sexual services for consideration","0","0","0","0","0","0","0","0","0","0","0","0","0","0"
"2015","Edmonton, Alberta, municipal","48033","Obtaining sexual services for consideration","34","32","0","0","3.59","4.18","3.9","0","0","32","32","32","0","0"
"2016","Edmonton, Alberta, municipal","48033","Obtaining sexual services for consideration","57","56","1","63.93","5.88","7.17","6.69","0","0","57","56","56","0","0"
"2012","Edmonton, Alberta, municipal","48033","Obtaining sexual services for consideration from person under 18 years","0","0","0","0","0","0","0","0","0","0","0","0","0","0"
"2013","Edmonton, Alberta, municipal","48033","Obtaining sexual services for consideration from person under 18 years","0","0","0","0","0","0","0","0","0","0","0","0","0","0"
"2014","Edmonton, Alberta, municipal","48033","Obtaining sexual services for consideration from person under 18 years","0","0","0","0","0","0","0","0","0","0","0","0","0","0"
"2015","Edmonton, Alberta, municipal","48033","Obtaining sexual services for consideration from person under 18 years","4","1","0","0","0.42","0.13","0.12","0","0","1","1","1","0","0"
"2016","Edmonton, Alberta, municipal","48033","Obtaining sexual services for consideration from person under 18 years","2","0","0","-51.11","0.21","0","0","0","0","0","0","0","0","0"
"2012","Edmonton, Alberta, municipal","48033","Receive material benefit from sexual services","0","0","0","0","0","0","0","0","0","0","0","0","0","0"
"2013","Edmonton, Alberta, municipal","48033","Receive material benefit from sexual services","0","0","0","0","0","0","0","0","0","0","0","0","0","0"
"2014","Edmonton, Alberta, municipal","48033","Receive material benefit from sexual services","0","0","0","0","0","0","0","0","0","0","0","0","0","0"
"2015","Edmonton, Alberta, municipal","48033","Receive material benefit from sexual services","4","4","0","0","0.42","0.52","0.49","0","0","4","4","4","0","0"
"2016","Edmonton, Alberta, municipal","48033","Receive material benefit from sexual services","1","1","0","-75.55","0.1","0.13","0.12","0","0","1","1","1","0","0"
"2012","Edmonton, Alberta, municipal","48033","Receive material benefit from sexual services provided by a person under 18 years","0","0","0","0","0","0","0","0","0","0","0","0","0","0"
"2013","Edmonton, Alberta, municipal","48033","Receive material benefit from sexual services provided by a person under 18 years","0","0","0","0","0","0","0","0","0","0","0","0","0","0"
"2014","Edmonton, Alberta, municipal","48033","Receive material benefit from sexual services provided by a person under 18 years","0","0","0","0","0","0","0","0","0","0","0","0","0","0"
"2015","Edmonton, Alberta, municipal","48033","Receive material benefit from sexual services provided by a person under 18 years","0","0","0","0","0","0","0","0","0","0","0","0","0","0"
"2016","Edmonton, Alberta, municipal","48033","Receive material benefit from sexual services provided by a person under 18 years","0","0","0","0","0","0","0","0","0","0","0","0","0","0"
"2012","Edmonton, Alberta, municipal","48033","Procuring","7","7","0","-2.51","0.81","1.86","1.73","0","0","7","13","13","0","0"
"2013","Edmonton, Alberta, municipal","48033","Procuring","13","6","1","79.6","1.45","1.24","1.41","3.67","0","7","9","11","2","0"
"2014","Edmonton, Alberta, municipal","48033","Procuring","21","2","0","41.39","2.27","0.4","0.37","0","0","2","3","3","0","0"
"2015","Edmonton, Alberta, municipal","48033","Procuring","8","1","1","191.36","0.84","0.13","0.12","0","0","2","1","1","0","0"
"2016","Edmonton, Alberta, municipal","48033","Procuring","6","0","0","-26.66","0.62","0","0","0","0","0","0","0","0","0"
"2012","Edmonton, Alberta, municipal","48033","Procuring - person under 18 years","0","0","0","0","0","0","0","0","0","0","0","0","0","0"
"2013","Edmonton, Alberta, municipal","48033","Procuring - person under 18 years","0","0","0","0","0","0","0","0","0","0","0","0","0","0"
"2014","Edmonton, Alberta, municipal","48033","Procuring - person under 18 years","0","0","0","0","0","0","0","0","0","0","0","0","0","0"
"2015","Edmonton, Alberta, municipal","48033","Procuring - person under 18 years","3","1","0","0","0.32","0.13","0.12","0","0","1","1","1","0","0"
"2016","Edmonton, Alberta, municipal","48033","Procuring - person under 18 years","5","1","0","62.97","0.52","0.13","0.24","1.8","0","1","1","2","1","0"
"2012","Edmonton, Alberta, municipal","48033","Advertising sexual services","0","0","0","0","0","0","0","0","0","0","0","0","0","0"
"2013","Edmonton, Alberta, municipal","48033","Advertising sexual services","0","0","0","0","0","0","0","0","0","0","0","0","0","0"
"2014","Edmonton, Alberta, municipal","48033","Advertising sexual services","0","0","0","0","0","0","0","0","0","0","0","0","0","0"
"2015","Edmonton, Alberta, municipal","48033","Advertising sexual services","2","0","0","0","0.21","0","0","0","0","0","0","0","0","0"
"2016","Edmonton, Alberta, municipal","48033","Advertising sexual services","4","0","2","95.56","0.41","0","0","0","0","2","0","0","0","0"
"1998","Edmonton, Alberta, municipal","48033","Total other violent violations","66","58","2","0","10.11","0","0","0","0","60","42","45","3","0"
"1999","Edmonton, Alberta, municipal","48033","Total other violent violations","59","42","1","-12","8.89","0","0","0","0","43","31","34","3","0"
"2000","Edmonton, Alberta, municipal","48033","Total other violent violations","49","36","2","-18.19","7.27","0","0","0","0","38","22","25","3","1"
"2001","Edmonton, Alberta, municipal","48033","Total other violent violations","54","40","4","8.7","7.91","0","0","0","0","44","25","28","3","1"
"2002","Edmonton, Alberta, municipal","48033","Total other violent violations","57","37","3","3.74","8.2","0","0","0","0","40","27","30","3","0"
"2003","Edmonton, Alberta, municipal","48033","Total other violent violations","46","39","0","-20.2","6.55","0","0","0","0","39","32","38","6","0"
"2004","Edmonton, Alberta, municipal","48033","Total other violent violations","33","24","4","-30.03","4.58","2.46","2.89","7.23","5.43","28","14","18","4","3"
"2005","Edmonton, Alberta, municipal","48033","Total other violent violations","39","29","1","15.5","5.29","3.77","3.91","5.4","1.8","30","22","25","3","1"
"2006","Edmonton, Alberta, municipal","48033","Total other violent violations","29","18","0","-27.77","3.82","1.99","2.12","3.57","0","18","12","14","2","0"
"2007","Edmonton, Alberta, municipal","48033","Total other violent violations","32","14","2","7.48","4.11","2.41","2.21","0","0","16","15","15","0","0"
"2008","Edmonton, Alberta, municipal","48033","Total other violent violations","58","22","1","77.07","7.27","2.19","2.45","5.42","1.81","23","14","17","3","1"
"2009","Edmonton, Alberta, municipal","48033","Total other violent violations","59","35","7","-0.8","7.21","5.33","6.6","21.86","0","42","35","47","12","0"
"2010","Edmonton, Alberta, municipal","48033","Total other violent violations","104","37","15","73.45","12.51","2.84","3.32","9.16","1.83","52","19","24","5","1"
"2011","Edmonton, Alberta, municipal","48033","Total other violent violations","108","39","21","2.07","12.77","3.68","4.49","14.53","0","60","25","33","8","0"
"2012","Edmonton, Alberta, municipal","48033","Total other violent violations","122","65","18","10.13","14.07","6.58","6.51","5.5","0","83","46","49","3","0"
"2013","Edmonton, Alberta, municipal","48033","Total other violent violations","195","85","36","54.57","21.74","8.56","8.74","11.02","0","121","62","68","6","0"
"2008","Edmonton, Alberta, municipal","48033","Incest","8","4","0","0","1","0.31","0.58","3.61","0","4","2","4","2","0"
"2014","Edmonton, Alberta, municipal","48033","Total other violent violations","153","84","25","-24.1","16.5","8.01","8.21","11.03","3.68","109","60","66","6","2"
"2009","Edmonton, Alberta, municipal","48033","Incest","8","11","0","-2.48","0.98","1.22","1.4","3.64","0","11","8","10","2","0"
"2015","Edmonton, Alberta, municipal","48033","Total other violent violations","153","86","19","-2.16","16.15","10.32","10.24","9.13","1.83","105","79","84","5","1"
"2010","Edmonton, Alberta, municipal","48033","Incest","5","4","1","-38.5","0.6","0.15","0.28","1.83","1.83","5","1","2","1","1"
"2016","Edmonton, Alberta, municipal","48033","Total other violent violations","183","120","18","16.95","18.88","11.77","11.47","7.18","0","138","92","96","4","0"
"2011","Edmonton, Alberta, municipal","48033","Incest","4","2","0","-21.36","0.47","0.29","0.27","0","0","2","2","2","0","0"
"2012","Edmonton, Alberta, municipal","48033","Incest","6","5","0","46.24","0.69","0.72","0.66","0","0","5","5","5","0","0"
"2013","Edmonton, Alberta, municipal","48033","Incest","17","15","0","174","1.9","0.97","1.28","5.51","0","15","7","10","3","0"
"2014","Edmonton, Alberta, municipal","48033","Incest","2","5","0","-88.62","0.22","0.4","0.62","3.68","0","5","3","5","2","0"
"2015","Edmonton, Alberta, municipal","48033","Incest","7","5","0","242.44","0.74","0.39","0.61","3.65","0","5","3","5","2","0"
"2016","Edmonton, Alberta, municipal","48033","Incest","4","3","0","-44.12","0.41","0","0.24","3.59","0","3","0","2","2","0"
"2005","Edmonton, Alberta, municipal","48033","Incest","0","0","0","0","0","0","0","0","0","0","0","0","0","0"
"2006","Edmonton, Alberta, municipal","48033","Incest","0","0","0","0","0","0","0","0","0","0","0","0","0","0"
"2007","Edmonton, Alberta, municipal","48033","Incest","0","0","0","0","0","0","0","0","0","0","0","0","0","0"
"2005","Edmonton, Alberta, municipal","48033","Corrupting morals of a child","0","0","0","0","0","0","0","0","0","0","0","0","0","0"
"2006","Edmonton, Alberta, municipal","48033","Corrupting morals of a child","0","0","0","0","0","0","0","0","0","0","0","0","0","0"
"2007","Edmonton, Alberta, municipal","48033","Corrupting morals of a child","0","0","0","0","0","0","0","0","0","0","0","0","0","0"
"2008","Edmonton, Alberta, municipal","48033","Corrupting morals of a child","1","0","0","0","0.13","0","0","0","0","0","0","0","0","0"
"2009","Edmonton, Alberta, municipal","48033","Corrupting morals of a child","3","0","0","192.57","0.37","0","0","0","0","0","0","0","0","0"
"2010","Edmonton, Alberta, municipal","48033","Corrupting morals of a child","4","0","1","31.2","0.48","0","0","0","0","1","0","0","0","0"
"2011","Edmonton, Alberta, municipal","48033","Corrupting morals of a child","5","0","0","22.87","0.59","0","0","0","0","0","0","0","0","0"
"2012","Edmonton, Alberta, municipal","48033","Corrupting morals of a child","0","0","0","-100","0","0","0","0","0","0","0","0","0","0"
"2013","Edmonton, Alberta, municipal","48033","Corrupting morals of a child","4","0","1","0","0.45","0","0","0","0","1","0","0","0","0"
"2014","Edmonton, Alberta, municipal","48033","Corrupting morals of a child","3","0","1","-27.44","0.32","0","0","0","0","1","0","0","0","0"
"2015","Edmonton, Alberta, municipal","48033","Corrupting morals of a child","0","0","0","-100","0","0","0","0","0","0","0","0","0","0"
"2016","Edmonton, Alberta, municipal","48033","Corrupting morals of a child","2","0","0","0","0.21","0","0","0","0","0","0","0","0","0"
"1998","Edmonton, Alberta, municipal","48033","Conspire to commit murder","0","0","0","0","0","0","0","0","0","0","0","0","0","0"
"1999","Edmonton, Alberta, municipal","48033","Conspire to commit murder","0","0","0","0","0","0","0","0","0","0","0","0","0","0"
"2000","Edmonton, Alberta, municipal","48033","Conspire to commit murder","0","0","0","0","0","0","0","0","0","0","0","0","0","0"
"2001","Edmonton, Alberta, municipal","48033","Conspire to commit murder","0","0","0","0","0","0","0","0","0","0","0","0","0","0"
"2002","Edmonton, Alberta, municipal","48033","Conspire to commit murder","0","0","0","0","0","0","0","0","0","0","0","0","0","0"
"2003","Edmonton, Alberta, municipal","48033","Conspire to commit murder","0","0","0","0","0","0","0","0","0","0","0","0","0","0"
"2004","Edmonton, Alberta, municipal","48033","Conspire to commit murder","0","0","0","0","0","0","0","0","0","0","0","0","0","0"
"2005","Edmonton, Alberta, municipal","48033","Conspire to commit murder","1","1","0","0","0.14","0","0","0","0","1","0","0","0","0"
"2006","Edmonton, Alberta, municipal","48033","Conspire to commit murder","1","0","0","-2.86","0.13","0","0","0","0","0","0","0","0","0"
"2007","Edmonton, Alberta, municipal","48033","Conspire to commit murder","1","0","1","-2.6","0.13","0","0","0","0","1","0","0","0","0"
"2008","Edmonton, Alberta, municipal","48033","Conspire to commit murder","1","0","0","-2.31","0.13","0","0","0","0","0","0","0","0","0"
"2009","Edmonton, Alberta, municipal","48033","Conspire to commit murder","1","1","0","-2.48","0.12","0.46","0.56","1.82","0","1","3","4","1","0"
"2010","Edmonton, Alberta, municipal","48033","Conspire to commit murder","0","0","0","-100","0","0","0","0","0","0","0","0","0","0"
"2011","Edmonton, Alberta, municipal","48033","Conspire to commit murder","2","0","0","0","0.24","0","0","0","0","0","0","0","0","0"
"2012","Edmonton, Alberta, municipal","48033","Conspire to commit murder","0","0","0","-100","0","0","0","0","0","0","0","0","0","0"
"2013","Edmonton, Alberta, municipal","48033","Conspire to commit murder","1","0","0","0","0.11","0","0","0","0","0","0","0","0","0"
"2014","Edmonton, Alberta, municipal","48033","Conspire to commit murder","1","0","0","-3.26","0.11","0","0","0","0","0","0","0","0","0"
"2015","Edmonton, Alberta, municipal","48033","Conspire to commit murder","2","1","0","95.68","0.21","0.39","0.37","0","0","1","3","3","0","0"
"2016","Edmonton, Alberta, municipal","48033","Conspire to commit murder","1","1","0","-51.11","0.1","0.51","0.48","0","0","1","4","4","0","0"
"2005","Edmonton, Alberta, municipal","48033","Anal intercourse","0","0","0","0","0","0","0","0","0","0","0","0","0","0"
"2006","Edmonton, Alberta, municipal","48033","Anal intercourse","0","0","0","0","0","0","0","0","0","0","0","0","0","0"
"2007","Edmonton, Alberta, municipal","48033","Anal intercourse","0","0","0","0","0","0","0","0","0","0","0","0","0","0"
"2008","Edmonton, Alberta, municipal","48033","Anal intercourse","0","0","0","0","0","0","0","0","0","0","0","0","0","0"
"2009","Edmonton, Alberta, municipal","48033","Anal intercourse","0","0","0","0","0","0","0","0","0","0","0","0","0","0"
"2010","Edmonton, Alberta, municipal","48033","Anal intercourse","0","0","0","0","0","0","0","0","0","0","0","0","0","0"
"2011","Edmonton, Alberta, municipal","48033","Anal intercourse","0","0","0","0","0","0","0","0","0","0","0","0","0","0"
"2012","Edmonton, Alberta, municipal","48033","Anal intercourse","0","0","0","0","0","0","0","0","0","0","0","0","0","0"
"2013","Edmonton, Alberta, municipal","48033","Anal intercourse","0","0","0","0","0","0","0","0","0","0","0","0","0","0"
"2014","Edmonton, Alberta, municipal","48033","Anal intercourse","0","0","0","0","0","0","0","0","0","0","0","0","0","0"
"2015","Edmonton, Alberta, municipal","48033","Anal intercourse","0","0","0","0","0","0","0","0","0","0","0","0","0","0"
"2016","Edmonton, Alberta, municipal","48033","Anal intercourse","0","0","0","0","0","0","0","0","0","0","0","0","0","0"
"1998","Edmonton, Alberta, municipal","48033","Other sexual violations","47","39","2","0","7.2","0","0","0","0","41","22","24","2","0"
"1999","Edmonton, Alberta, municipal","48033","Other sexual violations","37","22","1","-22.5","5.58","0","0","0","0","23","13","15","2","0"
"2000","Edmonton, Alberta, municipal","48033","Other sexual violations","39","27","2","3.83","5.79","0","0","0","0","29","14","17","3","1"
"2001","Edmonton, Alberta, municipal","48033","Other sexual violations","36","22","4","-8.95","5.27","0","0","0","0","26","7","7","0","1"
"2002","Edmonton, Alberta, municipal","48033","Other sexual violations","29","16","3","-20.83","4.17","0","0","0","0","19","9","9","0","0"
"2003","Edmonton, Alberta, municipal","48033","Other sexual violations","14","9","0","-52.27","1.99","0","0","0","0","9","4","5","1","0"
"2004","Edmonton, Alberta, municipal","48033","Other sexual violations","10","4","4","-30.34","1.39","0.35","0.48","1.81","5.43","8","2","3","1","3"
"2005","Edmonton, Alberta, municipal","48033","Other sexual violations","13","8","1","27.05","1.76","0.69","0.63","0","1.8","9","4","4","0","1"
"2006","Edmonton, Alberta, municipal","48033","Other sexual violations","11","4","0","-17.8","1.45","0.33","0.3","0","0","4","2","2","0","0"
"2007","Edmonton, Alberta, municipal","48033","Other sexual violations","11","5","1","-2.6","1.41","0.32","0.29","0","0","6","2","2","0","0"
"2008","Edmonton, Alberta, municipal","48033","Other sexual violations","12","1","0","6.57","1.5","0.16","0.14","0","0","1","1","1","0","0"
"2009","Edmonton, Alberta, municipal","48033","Other sexual violations","0","0","1","-100","0","0","0","0","0","1","0","0","0","0"
"2010","Edmonton, Alberta, municipal","48033","Other sexual violations","0","0","0","0","0","0","0","0","0","0","0","0","0","0"
"2011","Edmonton, Alberta, municipal","48033","Other sexual violations","0","0","0","0","0","0","0","0","0","0","0","0","0","0"
"2012","Edmonton, Alberta, municipal","48033","Other sexual violations","0","0","0","0","0","0","0","0","0","0","0","0","0","0"
"2013","Edmonton, Alberta, municipal","48033","Other sexual violations","0","0","0","0","0","0","0","0","0","0","0","0","0","0"
"2014","Edmonton, Alberta, municipal","48033","Other sexual violations","0","0","0","0","0","0","0","0","0","0","0","0","0","0"
"2015","Edmonton, Alberta, municipal","48033","Other sexual violations","0","0","0","0","0","0","0","0","0","0","0","0","0","0"
"2016","Edmonton, Alberta, municipal","48033","Other sexual violations","0","0","0","0","0","0","0","0","0","0","0","0","0","0"
"2005","Edmonton, Alberta, municipal","48033","Bestiality, commit or compel person","0","0","0","0","0","0","0","0","0","0","0","0","0","0"
"2006","Edmonton, Alberta, municipal","48033","Bestiality, commit or compel person","0","0","0","0","0","0","0","0","0","0","0","0","0","0"
"2007","Edmonton, Alberta, municipal","48033","Bestiality, commit or compel person","0","0","0","0","0","0","0","0","0","0","0","0","0","0"
"2008","Edmonton, Alberta, municipal","48033","Bestiality, commit or compel person","2","0","0","0","0.25","0","0","0","0","0","0","0","0","0"
"2009","Edmonton, Alberta, municipal","48033","Bestiality, commit or compel person","1","1","0","-51.24","0.12","0.15","0.14","0","0","1","1","1","0","0"
"2010","Edmonton, Alberta, municipal","48033","Bestiality, commit or compel person","1","1","0","-1.6","0.12","0","0","0","0","1","0","0","0","0"
"2011","Edmonton, Alberta, municipal","48033","Bestiality, commit or compel person","1","0","0","-1.71","0.12","0","0","0","0","0","0","0","0","0"
"2012","Edmonton, Alberta, municipal","48033","Bestiality, commit or compel person","0","1","0","-100","0","0","0","0","0","1","0","0","0","0"
"2013","Edmonton, Alberta, municipal","48033","Bestiality, commit or compel person","0","0","0","0","0","0","0","0","0","0","0","0","0","0"
"2014","Edmonton, Alberta, municipal","48033","Bestiality, commit or compel person","0","0","0","0","0","0","0","0","0","0","0","0","0","0"
"2015","Edmonton, Alberta, municipal","48033","Bestiality, commit or compel person","0","0","0","0","0","0","0","0","0","0","0","0","0","0"
"2016","Edmonton, Alberta, municipal","48033","Bestiality, commit or compel person","0","0","0","0","0","0","0","0","0","0","0","0","0","0"
"1998","Edmonton, Alberta, municipal","48033","Voyeurism","0","0","0","0","0","0","0","0","0","0","0","0","0","0"
"1999","Edmonton, Alberta, municipal","48033","Voyeurism","0","0","0","0","0","0","0","0","0","0","0","0","0","0"
"2000","Edmonton, Alberta, municipal","48033","Voyeurism","0","0","0","0","0","0","0","0","0","0","0","0","0","0"
"2001","Edmonton, Alberta, municipal","48033","Voyeurism","0","0","0","0","0","0","0","0","0","0","0","0","0","0"
"2002","Edmonton, Alberta, municipal","48033","Voyeurism","0","0","0","0","0","0","0","0","0","0","0","0","0","0"
"2003","Edmonton, Alberta, municipal","48033","Voyeurism","0","0","0","0","0","0","0","0","0","0","0","0","0","0"
"2004","Edmonton, Alberta, municipal","48033","Voyeurism","0","0","0","0","0","0","0","0","0","0","0","0","0","0"
"2005","Edmonton, Alberta, municipal","48033","Voyeurism","1","0","0","0","0.14","0","0","0","0","0","0","0","0","0"
"2005","Edmonton, Alberta, municipal","48033","Sexual Exploitation of a person with a disability","0","0","0","0","0","0","0","0","0","0","0","0","0","0"
"2006","Edmonton, Alberta, municipal","48033","Voyeurism","5","4","0","385.71","0.66","0.5","0.45","0","0","4","3","3","0","0"
"2006","Edmonton, Alberta, municipal","48033","Sexual Exploitation of a person with a disability","0","0","0","0","0","0","0","0","0","0","0","0","0","0"
"2007","Edmonton, Alberta, municipal","48033","Voyeurism","5","2","0","-2.6","0.64","0.32","0.29","0","0","2","2","2","0","0"
"2007","Edmonton, Alberta, municipal","48033","Sexual Exploitation of a person with a disability","0","0","0","0","0","0","0","0","0","0","0","0","0","0"
"2008","Edmonton, Alberta, municipal","48033","Voyeurism","10","4","0","95.39","1.25","0.63","0.58","0","0","4","4","4","0","0"
"2008","Edmonton, Alberta, municipal","48033","Sexual Exploitation of a person with a disability","0","0","0","0","0","0","0","0","0","0","0","0","0","0"
"2009","Edmonton, Alberta, municipal","48033","Voyeurism","8","3","1","-21.98","0.98","0.46","0.42","0","0","4","3","3","0","0"
"2009","Edmonton, Alberta, municipal","48033","Sexual Exploitation of a person with a disability","0","0","0","0","0","0","0","0","0","0","0","0","0","0"
"2010","Edmonton, Alberta, municipal","48033","Voyeurism","22","9","0","170.6","2.65","1.05","1.11","1.83","0","9","7","8","1","0"
"2010","Edmonton, Alberta, municipal","48033","Sexual Exploitation of a person with a disability","0","0","0","0","0","0","0","0","0","0","0","0","0","0"
"2011","Edmonton, Alberta, municipal","48033","Voyeurism","14","8","0","-37.45","1.66","0.74","0.68","0","0","8","5","5","0","0"
"2011","Edmonton, Alberta, municipal","48033","Sexual Exploitation of a person with a disability","0","0","0","0","0","0","0","0","0","0","0","0","0","0"
"2012","Edmonton, Alberta, municipal","48033","Voyeurism","20","13","2","39.27","2.31","1.15","1.06","0","0","15","8","8","0","0"
"2012","Edmonton, Alberta, municipal","48033","Sexual Exploitation of a person with a disability","1","0","0","0","0.12","0","0","0","0","0","0","0","0","0"
"2013","Edmonton, Alberta, municipal","48033","Voyeurism","30","15","2","45.06","3.34","1.93","1.8","0","0","17","14","14","0","0"
"2013","Edmonton, Alberta, municipal","48033","Sexual Exploitation of a person with a disability","1","0","0","-3.29","0.11","0","0","0","0","0","0","0","0","0"
"2014","Edmonton, Alberta, municipal","48033","Voyeurism","19","12","1","-38.73","2.05","1.07","1","0","1.84","13","8","8","0","1"
"2014","Edmonton, Alberta, municipal","48033","Sexual Exploitation of a person with a disability","0","0","0","-100","0","0","0","0","0","0","0","0","0","0"
"2015","Edmonton, Alberta, municipal","48033","Voyeurism","21","5","1","8.14","2.22","0.39","0.37","0","1.83","6","3","3","0","1"
"2015","Edmonton, Alberta, municipal","48033","Sexual Exploitation of a person with a disability","0","0","0","0","0","0","0","0","0","0","0","0","0","0"
"2016","Edmonton, Alberta, municipal","48033","Voyeurism","32","15","3","49","3.3","1.41","1.31","0","0","18","11","11","0","0"
"2016","Edmonton, Alberta, municipal","48033","Sexual Exploitation of a person with a disability","1","0","0","0","0.1","0","0","0","0","0","0","0","0","0"
"2012","Edmonton, Alberta, municipal","48033","Nonconsensual distribution of intimate images","0","0","0","0","0","0","0","0","0","0","0","0","0","0"
"2013","Edmonton, Alberta, municipal","48033","Nonconsensual distribution of intimate images","0","0","0","0","0","0","0","0","0","0","0","0","0","0"
"2014","Edmonton, Alberta, municipal","48033","Nonconsensual distribution of intimate images","0","0","0","0","0","0","0","0","0","0","0","0","0","0"
"2015","Edmonton, Alberta, municipal","48033","Nonconsensual distribution of intimate images","1","0","0","0","0.11","0","0","0","0","0","0","0","0","0"
"2016","Edmonton, Alberta, municipal","48033","Nonconsensual distribution of intimate images","13","3","0","1171.17","1.34","0.26","0.24","0","0","3","2","2","0","0"
"2005","Edmonton, Alberta, municipal","48033","Trap likely to or causing bodily harm","0","0","0","0","0","0","0","0","0","0","0","0","0","0"
"2006","Edmonton, Alberta, municipal","48033","Trap likely to or causing bodily harm","0","0","0","0","0","0","0","0","0","0","0","0","0","0"
"2007","Edmonton, Alberta, municipal","48033","Trap likely to or causing bodily harm","0","0","0","0","0","0","0","0","0","0","0","0","0","0"
"2008","Edmonton, Alberta, municipal","48033","Trap likely to or causing bodily harm","0","0","0","0","0","0","0","0","0","0","0","0","0","0"
"2009","Edmonton, Alberta, municipal","48033","Trap likely to or causing bodily harm","0","0","0","0","0","0","0","0","0","0","0","0","0","0"
"2010","Edmonton, Alberta, municipal","48033","Trap likely to or causing bodily harm","0","0","0","0","0","0","0","0","0","0","0","0","0","0"
"2011","Edmonton, Alberta, municipal","48033","Trap likely to or causing bodily harm","0","0","0","0","0","0","0","0","0","0","0","0","0","0"
"2012","Edmonton, Alberta, municipal","48033","Trap likely to or causing bodily harm","1","0","1","0","0.12","0","0","0","0","1","0","0","0","0"
"2013","Edmonton, Alberta, municipal","48033","Trap likely to or causing bodily harm","0","0","0","-100","0","0","0","0","0","0","0","0","0","0"
"2014","Edmonton, Alberta, municipal","48033","Trap likely to or causing bodily harm","0","0","0","0","0","0","0","0","0","0","0","0","0","0"
"2015","Edmonton, Alberta, municipal","48033","Trap likely to or causing bodily harm","0","0","0","0","0","0","0","0","0","0","0","0","0","0"
"2016","Edmonton, Alberta, municipal","48033","Trap likely to or causing bodily harm","0","0","0","0","0","0","0","0","0","0","0","0","0","0"
"1998","Edmonton, Alberta, municipal","48033","Hostage-taking","17","17","0","0","2.6","0","0","0","0","17","18","19","1","0"
"1999","Edmonton, Alberta, municipal","48033","Hostage-taking","20","19","0","15.81","3.01","0","0","0","0","19","17","18","1","0"
"2000","Edmonton, Alberta, municipal","48033","Hostage-taking","3","3","0","-85.22","0.45","0","0","0","0","3","3","3","0","0"
"2001","Edmonton, Alberta, municipal","48033","Hostage-taking","16","16","0","426.04","2.34","0","0","0","0","16","17","20","3","0"
"2002","Edmonton, Alberta, municipal","48033","Hostage-taking","23","16","0","41.27","3.31","0","0","0","0","16","13","16","3","0"
"2003","Edmonton, Alberta, municipal","48033","Hostage-taking","21","20","0","-9.72","2.99","0","0","0","0","20","21","25","4","0"
"2004","Edmonton, Alberta, municipal","48033","Hostage-taking","17","14","0","-21.05","2.36","1.41","1.76","5.43","0","14","8","11","3","0"
"2005","Edmonton, Alberta, municipal","48033","Hostage-taking","16","12","0","-8.02","2.17","1.88","2.19","5.4","0","12","11","14","3","0"
"2006","Edmonton, Alberta, municipal","48033","Hostage-taking","7","6","0","-57.5","0.92","0.83","0.76","0","0","6","5","5","0","0"
"2007","Edmonton, Alberta, municipal","48033","Hostage-taking","2","0","0","-72.17","0.26","0","0","0","0","0","0","0","0","0"
"2008","Edmonton, Alberta, municipal","48033","Hostage-taking","2","2","0","-2.31","0.25","0.31","0.29","0","0","2","2","2","0","0"
"2009","Edmonton, Alberta, municipal","48033","Hostage-taking","0","0","0","-100","0","0","0","0","0","0","0","0","0","0"
"2010","Edmonton, Alberta, municipal","48033","Hostage-taking","1","0","0","0","0.12","0","0","0","0","0","0","0","0","0"
"2011","Edmonton, Alberta, municipal","48033","Hostage-taking","1","0","0","-1.71","0.12","0","0","0","0","0","0","0","0","0"
"2012","Edmonton, Alberta, municipal","48033","Hostage-taking","2","1","0","94.98","0.23","0.14","0.13","0","0","1","1","1","0","0"
"2013","Edmonton, Alberta, municipal","48033","Hostage-taking","4","4","0","93.41","0.45","0.41","0.39","0","0","4","3","3","0","0"
"2014","Edmonton, Alberta, municipal","48033","Hostage-taking","0","0","0","-100","0","0","0","0","0","0","0","0","0","0"
"2015","Edmonton, Alberta, municipal","48033","Hostage-taking","1","1","0","0","0.11","0.13","0.12","0","0","1","1","1","0","0"
"2016","Edmonton, Alberta, municipal","48033","Hostage-taking","0","0","0","-100","0","0","0","0","0","0","0","0","0","0"
"2005","Edmonton, Alberta, municipal","48033","Trafficking in persons","0","0","0","0","0","0","0","0","0","0","0","0","0","0"
"2006","Edmonton, Alberta, municipal","48033","Trafficking in persons","0","0","0","0","0","0","0","0","0","0","0","0","0","0"
"2007","Edmonton, Alberta, municipal","48033","Trafficking in persons","0","0","0","0","0","0","0","0","0","0","0","0","0","0"
"2008","Edmonton, Alberta, municipal","48033","Trafficking in persons","0","0","0","0","0","0","0","0","0","0","0","0","0","0"
"2009","Edmonton, Alberta, municipal","48033","Trafficking in persons","3","2","0","0","0.37","0.46","0.42","0","0","2","3","3","0","0"
"2010","Edmonton, Alberta, municipal","48033","Trafficking in persons","1","0","0","-67.2","0.12","0","0","0","0","0","0","0","0","0"
"2011","Edmonton, Alberta, municipal","48033","Trafficking in persons","0","0","0","-100","0","0","0","0","0","0","0","0","0","0"
"2012","Edmonton, Alberta, municipal","48033","Trafficking in persons","1","1","0","0","0.12","0","0","0","0","1","0","0","0","0"
"2013","Edmonton, Alberta, municipal","48033","Trafficking in persons","4","3","1","286.83","0.45","0.55","0.64","1.84","0","4","4","5","1","0"
"2014","Edmonton, Alberta, municipal","48033","Trafficking in persons","1","1","0","-75.81","0.11","0.27","0.25","0","0","1","2","2","0","0"
"2015","Edmonton, Alberta, municipal","48033","Trafficking in persons","8","9","0","682.71","0.84","1.7","1.71","1.83","0","9","13","14","1","0"
"2016","Edmonton, Alberta, municipal","48033","Trafficking in persons","4","4","0","-51.11","0.41","0.38","0.36","0","0","4","3","3","0","0"
"1998","Edmonton, Alberta, municipal","48033","Intimidation of a justice system participant or a journalist","0","0","0","0","0","0","0","0","0","0","0","0","0","0"
"1999","Edmonton, Alberta, municipal","48033","Intimidation of a justice system participant or a journalist","0","0","0","0","0","0","0","0","0","0","0","0","0","0"
"2000","Edmonton, Alberta, municipal","48033","Intimidation of a justice system participant or a journalist","0","0","0","0","0","0","0","0","0","0","0","0","0","0"
"2001","Edmonton, Alberta, municipal","48033","Intimidation of a justice system participant or a journalist","0","0","0","0","0","0","0","0","0","0","0","0","0","0"
"2002","Edmonton, Alberta, municipal","48033","Intimidation of a justice system participant or a journalist","0","0","0","0","0","0","0","0","0","0","0","0","0","0"
"2003","Edmonton, Alberta, municipal","48033","Intimidation of a justice system participant or a journalist","0","0","0","0","0","0","0","0","0","0","0","0","0","0"
"2004","Edmonton, Alberta, municipal","48033","Intimidation of a justice system participant or a journalist","0","0","0","0","0","0","0","0","0","0","0","0","0","0"
"2005","Edmonton, Alberta, municipal","48033","Intimidation of a justice system participant or a journalist","0","0","0","0","0","0","0","0","0","0","0","0","0","0"
"2006","Edmonton, Alberta, municipal","48033","Intimidation of a justice system participant or a journalist","0","0","0","0","0","0","0","0","0","0","0","0","0","0"
"2007","Edmonton, Alberta, municipal","48033","Intimidation of a justice system participant or a journalist","0","0","0","0","0","0","0","0","0","0","0","0","0","0"
"2008","Edmonton, Alberta, municipal","48033","Intimidation of a justice system participant or a journalist","0","0","0","0","0","0","0","0","0","0","0","0","0","0"
"2009","Edmonton, Alberta, municipal","48033","Intimidation of a justice system participant or a journalist","1","1","0","0","0.12","0.15","0.14","0","0","1","1","1","0","0"
"2010","Edmonton, Alberta, municipal","48033","Intimidation of a justice system participant or a journalist","4","3","0","293.6","0.48","0.3","0.28","0","0","3","2","2","0","0"
"2011","Edmonton, Alberta, municipal","48033","Intimidation of a justice system participant or a journalist","8","4","2","96.59","0.95","0.44","0.54","1.82","0","6","3","4","1","0"
"2012","Edmonton, Alberta, municipal","48033","Intimidation of a justice system participant or a journalist","7","4","1","-14.7","0.81","1","0.93","0","0","5","7","7","0","0"
"2013","Edmonton, Alberta, municipal","48033","Intimidation of a justice system participant or a journalist","5","5","0","-30.92","0.56","0.41","0.39","0","0","5","3","3","0","0"
"2014","Edmonton, Alberta, municipal","48033","Intimidation of a justice system participant or a journalist","4","3","0","-22.61","0.43","0.4","0.37","0","0","3","3","3","0","0"
"2015","Edmonton, Alberta, municipal","48033","Intimidation of a justice system participant or a journalist","5","3","1","22.3","0.53","0.39","0.37","0","0","4","3","3","0","0"
"2016","Edmonton, Alberta, municipal","48033","Intimidation of a justice system participant or a journalist","4","4","0","-21.77","0.41","0.38","0.36","0","0","4","3","3","0","0"
"2005","Edmonton, Alberta, municipal","48033","Intimidation of a non-justice participant","0","0","0","0","0","0","0","0","0","0","0","0","0","0"
"2006","Edmonton, Alberta, municipal","48033","Intimidation of a non-justice participant","0","0","0","0","0","0","0","0","0","0","0","0","0","0"
"2007","Edmonton, Alberta, municipal","48033","Intimidation of a non-justice participant","0","0","0","0","0","0","0","0","0","0","0","0","0","0"
"2008","Edmonton, Alberta, municipal","48033","Intimidation of a non-justice participant","0","0","0","0","0","0","0","0","0","0","0","0","0","0"
"2009","Edmonton, Alberta, municipal","48033","Intimidation of a non-justice participant","0","0","0","0","0","0","0","0","0","0","0","0","0","0"
"2010","Edmonton, Alberta, municipal","48033","Intimidation of a non-justice participant","1","1","0","0","0.12","0.15","0.28","1.83","0","1","1","2","1","0"
"2011","Edmonton, Alberta, municipal","48033","Intimidation of a non-justice participant","8","8","0","686.35","0.95","0.74","0.68","0","0","8","5","5","0","0"
"2012","Edmonton, Alberta, municipal","48033","Intimidation of a non-justice participant","20","19","0","143.73","2.31","1.72","1.59","0","0","19","12","12","0","0"
"2013","Edmonton, Alberta, municipal","48033","Intimidation of a non-justice participant","17","16","0","-17.8","1.9","1.24","1.16","0","0","16","9","9","0","0"
"2014","Edmonton, Alberta, municipal","48033","Intimidation of a non-justice participant","17","16","0","-3.26","1.83","1.33","1.24","0","0","16","10","10","0","0"
"2015","Edmonton, Alberta, municipal","48033","Intimidation of a non-justice participant","19","20","0","9.35","2.01","1.83","1.71","0","0","20","14","14","0","0"
"2016","Edmonton, Alberta, municipal","48033","Intimidation of a non-justice participant","24","24","0","23.51","2.48","2.18","2.03","0","0","24","17","17","0","0"
"1998","Edmonton, Alberta, municipal","48033","Explosives causing death or bodily harm","1","1","0","0","0.15","0","0","0","0","1","0","0","0","0"
"1999","Edmonton, Alberta, municipal","48033","Explosives causing death or bodily harm","0","0","0","-100","0","0","0","0","0","0","0","0","0","0"
"2000","Edmonton, Alberta, municipal","48033","Explosives causing death or bodily harm","1","1","0","0","0.15","0","0","0","0","1","1","1","0","0"
"2001","Edmonton, Alberta, municipal","48033","Explosives causing death or bodily harm","0","0","0","-100","0","0","0","0","0","0","0","0","0","0"
"2002","Edmonton, Alberta, municipal","48033","Explosives causing death or bodily harm","0","0","0","0","0","0","0","0","0","0","0","0","0","0"
"2003","Edmonton, Alberta, municipal","48033","Explosives causing death or bodily harm","0","0","0","0","0","0","0","0","0","0","0","0","0","0"
"2004","Edmonton, Alberta, municipal","48033","Explosives causing death or bodily harm","0","0","0","0","0","0","0","0","0","0","0","0","0","0"
"2005","Edmonton, Alberta, municipal","48033","Explosives causing death or bodily harm","0","0","0","0","0","0","0","0","0","0","0","0","0","0"
"2006","Edmonton, Alberta, municipal","48033","Explosives causing death or bodily harm","0","0","0","0","0","0","0","0","0","0","0","0","0","0"
"2007","Edmonton, Alberta, municipal","48033","Explosives causing death or bodily harm","0","0","0","0","0","0","0","0","0","0","0","0","0","0"
"2008","Edmonton, Alberta, municipal","48033","Explosives causing death or bodily harm","8","0","0","0","1","0","0","0","0","0","0","0","0","0"
"2009","Edmonton, Alberta, municipal","48033","Explosives causing death or bodily harm","0","8","0","-100","0","1.22","2.25","14.57","0","8","8","16","8","0"
"2010","Edmonton, Alberta, municipal","48033","Explosives causing death or bodily harm","0","0","0","0","0","0","0","0","0","0","0","0","0","0"
"2011","Edmonton, Alberta, municipal","48033","Explosives causing death or bodily harm","0","0","0","0","0","0","0","0","0","0","0","0","0","0"
"2012","Edmonton, Alberta, municipal","48033","Explosives causing death or bodily harm","0","0","0","0","0","0","0","0","0","0","0","0","0","0"
"2013","Edmonton, Alberta, municipal","48033","Explosives causing death or bodily harm","1","1","0","0","0.11","0.14","0.13","0","0","1","1","1","0","0"
"2014","Edmonton, Alberta, municipal","48033","Explosives causing death or bodily harm","2","2","0","93.48","0.22","0","0.25","3.68","0","2","0","2","2","0"
"2015","Edmonton, Alberta, municipal","48033","Explosives causing death or bodily harm","0","0","0","-100","0","0.13","0.12","0","0","0","1","1","0","0"
"2016","Edmonton, Alberta, municipal","48033","Explosives causing death or bodily harm","0","0","0","0","0","0","0","0","0","0","0","0","0","0"
"1998","Edmonton, Alberta, municipal","48033","Arson, disregard for human life","0","0","0","0","0","0","0","0","0","0","0","0","0","0"
"1999","Edmonton, Alberta, municipal","48033","Arson, disregard for human life","0","0","0","0","0","0","0","0","0","0","0","0","0","0"
"2000","Edmonton, Alberta, municipal","48033","Arson, disregard for human life","2","2","0","0","0.3","0","0","0","0","2","2","2","0","0"
"2001","Edmonton, Alberta, municipal","48033","Arson, disregard for human life","0","0","0","-100","0","0","0","0","0","0","0","0","0","0"
"2002","Edmonton, Alberta, municipal","48033","Arson, disregard for human life","3","3","0","0","0.43","0","0","0","0","3","3","3","0","0"
"2003","Edmonton, Alberta, municipal","48033","Arson, disregard for human life","7","7","0","130.72","1","0","0","0","0","7","4","5","1","0"
"2004","Edmonton, Alberta, municipal","48033","Arson, disregard for human life","6","6","0","-16.4","0.83","0.7","0.64","0","0","6","4","4","0","0"
"2005","Edmonton, Alberta, municipal","48033","Arson, disregard for human life","3","3","0","-51.13","0.41","0.51","0.47","0","0","3","3","3","0","0"
"2006","Edmonton, Alberta, municipal","48033","Arson, disregard for human life","4","4","0","29.52","0.53","0.33","0.61","3.57","0","4","2","4","2","0"
"2007","Edmonton, Alberta, municipal","48033","Arson, disregard for human life","11","4","0","167.86","1.41","0.64","0.59","0","0","4","4","4","0","0"
"2008","Edmonton, Alberta, municipal","48033","Arson, disregard for human life","12","10","1","6.57","1.5","0.63","0.72","1.81","1.81","11","4","5","1","1"
"2009","Edmonton, Alberta, municipal","48033","Arson, disregard for human life","6","4","0","-51.24","0.73","0.3","0.42","1.82","0","4","2","3","1","0"
"2010","Edmonton, Alberta, municipal","48033","Arson, disregard for human life","7","6","0","14.8","0.84","0.6","0.55","0","0","6","4","4","0","0"
"2011","Edmonton, Alberta, municipal","48033","Arson, disregard for human life","15","15","0","110.63","1.77","1.18","2.04","12.72","0","15","8","15","7","0"
"2012","Edmonton, Alberta, municipal","48033","Arson, disregard for human life","15","15","0","-2.51","1.73","1","1.33","5.5","0","15","7","10","3","0"
"2013","Edmonton, Alberta, municipal","48033","Arson, disregard for human life","28","12","0","80.52","3.12","0.97","1.16","3.67","0","12","7","9","2","0"
"2014","Edmonton, Alberta, municipal","48033","Arson, disregard for human life","6","6","0","-79.27","0.65","0.53","0.5","0","0","6","4","4","0","0"
"2015","Edmonton, Alberta, municipal","48033","Arson, disregard for human life","24","13","0","291.36","2.53","1.57","1.59","1.83","0","13","12","13","1","0"
"2016","Edmonton, Alberta, municipal","48033","Arson, disregard for human life","21","20","0","-14.44","2.17","2.18","2.27","3.59","0","20","17","19","2","0"
"2012","Edmonton, Alberta, municipal","48033","Failure to comply with mandatory safeguards in relation to medical assistance in dying","0","0","0","0","0","0","0","0","0","0","0","0","0","0"
"2013","Edmonton, Alberta, municipal","48033","Failure to comply with mandatory safeguards in relation to medical assistance in dying","0","0","0","0","0","0","0","0","0","0","0","0","0","0"
"2014","Edmonton, Alberta, municipal","48033","Failure to comply with mandatory safeguards in relation to medical assistance in dying","0","0","0","0","0","0","0","0","0","0","0","0","0","0"
"2015","Edmonton, Alberta, municipal","48033","Failure to comply with mandatory safeguards in relation to medical assistance in dying","0","0","0","0","0","0","0","0","0","0","0","0","0","0"
"2016","Edmonton, Alberta, municipal","48033","Failure to comply with mandatory safeguards in relation to medical assistance in dying","0","0","0","0","0","0","0","0","0","0","0","0","0","0"
"2012","Edmonton, Alberta, municipal","48033","Forging or destroying documents related to assistance requests with criminal intent","0","0","0","0","0","0","0","0","0","0","0","0","0","0"
"2013","Edmonton, Alberta, municipal","48033","Forging or destroying documents related to assistance requests with criminal intent","0","0","0","0","0","0","0","0","0","0","0","0","0","0"
"2014","Edmonton, Alberta, municipal","48033","Forging or destroying documents related to assistance requests with criminal intent","0","0","0","0","0","0","0","0","0","0","0","0","0","0"
"2015","Edmonton, Alberta, municipal","48033","Forging or destroying documents related to assistance requests with criminal intent","0","0","0","0","0","0","0","0","0","0","0","0","0","0"
"2016","Edmonton, Alberta, municipal","48033","Forging or destroying documents related to assistance requests with criminal intent","0","0","0","0","0","0","0","0","0","0","0","0","0","0"
"1998","Edmonton, Alberta, municipal","48033","Other violent violations","1","1","0","0","0.15","0","0","0","0","1","2","2","0","0"
"1999","Edmonton, Alberta, municipal","48033","Other violent violations","2","1","0","96.88","0.3","0","0","0","0","1","1","1","0","0"
"2000","Edmonton, Alberta, municipal","48033","Other violent violations","4","3","0","97","0.59","0","0","0","0","3","2","2","0","0"
"2001","Edmonton, Alberta, municipal","48033","Other violent violations","2","2","0","-50.68","0.29","0","0","0","0","2","1","1","0","0"
"2002","Edmonton, Alberta, municipal","48033","Other violent violations","2","2","0","-1.72","0.29","0","0","0","0","2","2","2","0","0"
"2003","Edmonton, Alberta, municipal","48033","Other violent violations","4","3","0","97.76","0.57","0","0","0","0","3","3","3","0","0"
"2004","Edmonton, Alberta, municipal","48033","Other violent violations","0","0","0","-100","0","0","0","0","0","0","0","0","0","0"
"2005","Edmonton, Alberta, municipal","48033","Other violent violations","5","5","0","0","0.68","0.69","0.63","0","0","5","4","4","0","0"
"2006","Edmonton, Alberta, municipal","48033","Other violent violations","1","0","0","-80.57","0.13","0","0","0","0","0","0","0","0","0"
"2007","Edmonton, Alberta, municipal","48033","Other violent violations","2","3","0","94.81","0.26","1.12","1.03","0","0","3","7","7","0","0"
"2008","Edmonton, Alberta, municipal","48033","Other violent violations","2","1","0","-2.31","0.25","0.16","0.14","0","0","1","1","1","0","0"
"2009","Edmonton, Alberta, municipal","48033","Other violent violations","28","4","5","1265.32","3.42","0.91","0.84","0","0","9","6","6","0","0"
"2010","Edmonton, Alberta, municipal","48033","Other violent violations","58","13","13","103.83","6.98","0.6","0.83","3.67","0","26","4","6","2","0"
"2011","Edmonton, Alberta, municipal","48033","Other violent violations","50","2","19","-15.26","5.91","0.29","0.27","0","0","21","2","2","0","0"
"2012","Edmonton, Alberta, municipal","48033","Other violent violations","49","6","14","-4.46","5.65","0.86","0.8","0","0","20","6","6","0","0"
"2013","Edmonton, Alberta, municipal","48033","Other violent violations","83","14","32","63.81","9.25","1.93","1.8","0","0","46","14","14","0","0"
"2014","Edmonton, Alberta, municipal","48033","Other violent violations","98","39","23","14.22","10.57","4","3.98","3.68","1.84","62","30","32","2","1"
"2015","Edmonton, Alberta, municipal","48033","Other violent violations","65","29","17","-35.11","6.86","3.4","3.29","1.83","0","46","26","27","1","0"
"2016","Edmonton, Alberta, municipal","48033","Other violent violations","77","46","15","15.83","7.95","4.48","4.18","0","0","61","35","35","0","0"
"1998","Edmonton, Alberta, municipal","48033","Total property crime violations","46556","8692","2777","0","7128.04","0","0","0","0","11469","6426","8277","1851","1596"
"1999","Edmonton, Alberta, municipal","48033","Total property crime violations","45760","8879","2879","-3.24","6897","0","0","0","0","11758","6566","8336","1770","1661"
"2000","Edmonton, Alberta, municipal","48033","Total property crime violations","45386","8618","2655","-2.3","6738.08","0","0","0","0","11273","5968","7683","1715","1606"
"2001","Edmonton, Alberta, municipal","48033","Total property crime violations","48446","8009","2034","5.28","7094.07","0","0","0","0","10043","5740","7564","1824","1267"
"2002","Edmonton, Alberta, municipal","48033","Total property crime violations","53992","8355","2120","9.53","7769.94","0","0","0","0","10475","6120","7749","1629","1320"
"2003","Edmonton, Alberta, municipal","48033","Total property crime violations","60435","8792","2407","10.68","8599.64","0","0","0","0","11199","6567","8243","1676","1378"
"2004","Edmonton, Alberta, municipal","48033","Total property crime violations","64300","8730","2193","3.77","8923.45","1193.01","1298.6","2383.62","2231.71","10923","6779","8097","1318","1234"
"2005","Edmonton, Alberta, municipal","48033","Total property crime violations","64355","7991","1891","-2.18","8728.52","1064.9","1164.77","2214.78","1788.03","9882","6218","7448","1230","993"
"2006","Edmonton, Alberta, municipal","48033","Total property crime violations","60639","7573","1446","-8.47","7989.53","881.77","957.76","1777.04","1403.77","9019","5323","6318","995","786"
"2007","Edmonton, Alberta, municipal","48033","Total property crime violations","56782","7230","2435","-8.79","7287.13","893.62","988.44","2047.04","2124.19","9665","5561","6702","1141","1184"
"2008","Edmonton, Alberta, municipal","48033","Total property crime violations","51234","6845","2353","-11.85","6423.45","891.04","967.59","1850.55","1917.35","9198","5693","6718","1025","1062"
"2009","Edmonton, Alberta, municipal","48033","Total property crime violations","50194","6910","2567","-4.46","6137.18","871.05","949.69","1890.88","1745.15","9477","5723","6761","1038","958"
"2010","Edmonton, Alberta, municipal","48033","Total property crime violations","41844","6955","2223","-17.97","5034.42","850.22","924.25","1830.81","1830.81","9178","5681","6680","999","999"
"2011","Edmonton, Alberta, municipal","48033","Total property crime violations","34805","6520","1884","-18.24","4116.09","753.21","813.42","1556.74","1293.35","8404","5119","5976","857","712"
"2012","Edmonton, Alberta, municipal","48033","Total property crime violations","34285","6892","1680","-3.97","3952.88","754.54","825.06","1727.64","1203.67","8572","5271","6214","943","657"
"2013","Edmonton, Alberta, municipal","48033","Total property crime violations","38252","7486","1583","7.9","4264.99","806.6","869.52","1706.03","1276.31","9069","5839","6768","929","695"
"2014","Edmonton, Alberta, municipal","48033","Total property crime violations","39990","8077","1312","1.14","4313.45","767.55","800.57","1255.33","983.31","9389","5752","6435","683","535"
"2015","Edmonton, Alberta, municipal","48033","Total property crime violations","46687","8864","1501","14.22","4927","821.42","857.31","1358.88","1147.01","10365","6286","7030","744","628"
"2016","Edmonton, Alberta, municipal","48033","Total property crime violations","51324","9713","1473","7.49","5296.22","924.39","941.97","1188.64","1127.59","11186","7224","7886","662","628"
"1998","Edmonton, Alberta, municipal","48033","Total breaking and entering","8487","903","269","0","1299.42","0","0","0","0","1172","649","960","311","48"
"1999","Edmonton, Alberta, municipal","48033","Total breaking and entering","8205","913","444","-4.83","1236.67","0","0","0","0","1357","602","855","253","32"
"2000","Edmonton, Alberta, municipal","48033","Total breaking and entering","7946","778","148","-4.61","1179.68","0","0","0","0","926","554","777","223","51"
"2001","Edmonton, Alberta, municipal","48033","Total breaking and entering","7025","727","65","-12.8","1028.69","0","0","0","0","792","494","748","254","24"
"2002","Edmonton, Alberta, municipal","48033","Total breaking and entering","7951","787","192","11.23","1144.22","0","0","0","0","979","467","633","166","24"
"2003","Edmonton, Alberta, municipal","48033","Total breaking and entering","8496","703","114","5.66","1208.94","0","0","0","0","817","470","681","211","35"
"2004","Edmonton, Alberta, municipal","48033","Total breaking and entering","9250","709","65","6.18","1283.7","89.4","103.28","245.96","65.11","774","508","644","136","36"
"2005","Edmonton, Alberta, municipal","48033","Total breaking and entering","8616","544","41","-8.97","1168.59","68.16","85.86","271.9","43.22","585","398","549","151","24"
"2006","Edmonton, Alberta, municipal","48033","Total breaking and entering","7165","530","34","-19.22","944.03","67.59","76.25","169.67","14.29","564","408","503","95","8"
"2007","Edmonton, Alberta, municipal","48033","Total breaking and entering","6958","496","54","-5.41","892.96","57.53","72.12","235.02","39.47","550","358","489","131","22"
"2008","Edmonton, Alberta, municipal","48033","Total breaking and entering","6523","457","64","-8.41","817.82","57.6","68.41","193.18","50.55","521","368","475","107","28"
"2009","Edmonton, Alberta, municipal","48033","Total breaking and entering","6533","451","64","-2.33","798.79","51.29","60.68","173.06","29.15","515","337","432","95","16"
"2010","Edmonton, Alberta, municipal","48033","Total breaking and entering","5393","578","61","-18.77","648.85","71.24","79","174.1","49.48","639","476","571","95","27"
"2011","Edmonton, Alberta, municipal","48033","Total breaking and entering","4040","530","54","-26.37","477.78","61.8","66.7","127.15","25.43","584","420","490","70","14"
"2012","Edmonton, Alberta, municipal","48033","Total breaking and entering","4290","583","53","3.52","494.61","65.28","70.77","141.07","32.98","636","456","533","77","18"
"2013","Edmonton, Alberta, municipal","48033","Total breaking and entering","4250","573","23","-4.2","473.86","56.5","58.97","91.82","20.2","596","409","459","50","11"
"2014","Edmonton, Alberta, municipal","48033","Total breaking and entering","4484","572","19","2.07","483.66","60.45","64.19","115.79","3.68","591","453","516","63","2"
"2015","Edmonton, Alberta, municipal","48033","Total breaking and entering","6120","671","26","33.54","645.86","77.49","83.05","160.73","14.61","697","593","681","88","8"
"2016","Edmonton, Alberta, municipal","48033","Total breaking and entering","5938","772","25","-5.13","612.75","84.33","88.39","145.44","35.91","797","659","740","81","20"
"1998","Edmonton, Alberta, municipal","48033","Breaking and entering","8487","903","269","0","1299.42","0","0","0","0","1172","649","960","311","48"
"1999","Edmonton, Alberta, municipal","48033","Breaking and entering","8205","913","444","-4.83","1236.67","0","0","0","0","1357","602","855","253","32"
"2000","Edmonton, Alberta, municipal","48033","Breaking and entering","7946","778","148","-4.61","1179.68","0","0","0","0","926","554","777","223","51"
"2001","Edmonton, Alberta, municipal","48033","Breaking and entering","7025","727","65","-12.8","1028.69","0","0","0","0","792","494","748","254","24"
"2002","Edmonton, Alberta, municipal","48033","Breaking and entering","7951","787","192","11.23","1144.22","0","0","0","0","979","467","633","166","24"
"2003","Edmonton, Alberta, municipal","48033","Breaking and entering","8496","703","114","5.66","1208.94","0","0","0","0","817","470","681","211","35"
"2004","Edmonton, Alberta, municipal","48033","Breaking and entering","9250","709","65","6.18","1283.7","89.4","103.28","245.96","65.11","774","508","644","136","36"
"2005","Edmonton, Alberta, municipal","48033","Breaking and entering","8616","544","41","-8.97","1168.59","68.16","85.86","271.9","43.22","585","398","549","151","24"
"2006","Edmonton, Alberta, municipal","48033","Breaking and entering","7165","530","34","-19.22","944.03","67.59","76.25","169.67","14.29","564","408","503","95","8"
"2007","Edmonton, Alberta, municipal","48033","Breaking and entering","6958","496","54","-5.41","892.96","57.53","72.12","235.02","39.47","550","358","489","131","22"
"2008","Edmonton, Alberta, municipal","48033","Breaking and entering","6519","457","64","-8.47","817.32","57.6","68.41","193.18","50.55","521","368","475","107","28"
"2009","Edmonton, Alberta, municipal","48033","Breaking and entering","6522","451","64","-2.43","797.44","51.29","60.68","173.06","29.15","515","337","432","95","16"
"2010","Edmonton, Alberta, municipal","48033","Breaking and entering","5375","578","61","-18.9","646.69","71.24","79","174.1","49.48","639","476","571","95","27"
"2011","Edmonton, Alberta, municipal","48033","Breaking and entering","4015","528","54","-26.58","474.82","61.65","66.42","125.34","25.43","582","419","488","69","14"
"2012","Edmonton, Alberta, municipal","48033","Breaking and entering","4264","581","53","3.54","491.62","65.13","70.64","141.07","32.98","634","455","532","77","18"
"2013","Edmonton, Alberta, municipal","48033","Breaking and entering","4226","571","23","-4.16","471.19","56.36","58.84","91.82","20.2","594","408","458","50","11"
"2014","Edmonton, Alberta, municipal","48033","Breaking and entering","4444","572","19","1.73","479.34","60.45","64.19","115.79","3.68","591","453","516","63","2"
"2015","Edmonton, Alberta, municipal","48033","Breaking and entering","6069","662","25","33.62","640.48","76.44","81.71","155.25","14.61","687","585","670","85","8"
"2016","Edmonton, Alberta, municipal","48033","Breaking and entering","5883","770","24","-5.21","607.08","84.07","88.15","145.44","35.91","794","657","738","81","20"
"2005","Edmonton, Alberta, municipal","48033","Breaking and entering to steal a firearm","0","0","0","0","0","0","0","0","0","0","0","0","0","0"
"2006","Edmonton, Alberta, municipal","48033","Breaking and entering to steal a firearm","0","0","0","0","0","0","0","0","0","0","0","0","0","0"
"2007","Edmonton, Alberta, municipal","48033","Breaking and entering to steal a firearm","0","0","0","0","0","0","0","0","0","0","0","0","0","0"
"2008","Edmonton, Alberta, municipal","48033","Breaking and entering to steal a firearm","4","0","0","0","0.5","0","0","0","0","0","0","0","0","0"
"2009","Edmonton, Alberta, municipal","48033","Breaking and entering to steal a firearm","11","0","0","168.19","1.34","0","0","0","0","0","0","0","0","0"
"2010","Edmonton, Alberta, municipal","48033","Breaking and entering to steal a firearm","10","0","0","-10.54","1.2","0","0","0","0","0","0","0","0","0"
"2011","Edmonton, Alberta, municipal","48033","Breaking and entering to steal a firearm","10","1","0","-1.71","1.18","0.15","0.14","0","0","1","1","1","0","0"
"2012","Edmonton, Alberta, municipal","48033","Breaking and entering to steal a firearm","13","1","0","26.74","1.5","0.14","0.13","0","0","1","1","1","0","0"
"2013","Edmonton, Alberta, municipal","48033","Breaking and entering to steal a firearm","15","2","0","11.58","1.67","0.14","0.13","0","0","2","1","1","0","0"
"2014","Edmonton, Alberta, municipal","48033","Breaking and entering to steal a firearm","20","0","0","28.99","2.16","0","0","0","0","0","0","0","0","0"
"2015","Edmonton, Alberta, municipal","48033","Breaking and entering to steal a firearm","29","7","0","41.87","3.06","0.78","1.1","5.48","0","7","6","9","3","0"
"2016","Edmonton, Alberta, municipal","48033","Breaking and entering to steal a firearm","33","2","1","11.27","3.41","0.26","0.24","0","0","3","2","2","0","0"
"2005","Edmonton, Alberta, municipal","48033","Break and enter to steal a firearm from a motor vehicle","0","0","0","0","0","0","0","0","0","0","0","0","0","0"
"2006","Edmonton, Alberta, municipal","48033","Break and enter to steal a firearm from a motor vehicle","0","0","0","0","0","0","0","0","0","0","0","0","0","0"
"2007","Edmonton, Alberta, municipal","48033","Break and enter to steal a firearm from a motor vehicle","0","0","0","0","0","0","0","0","0","0","0","0","0","0"
"2008","Edmonton, Alberta, municipal","48033","Break and enter to steal a firearm from a motor vehicle","0","0","0","0","0","0","0","0","0","0","0","0","0","0"
"2009","Edmonton, Alberta, municipal","48033","Break and enter to steal a firearm from a motor vehicle","0","0","0","0","0","0","0","0","0","0","0","0","0","0"
"2010","Edmonton, Alberta, municipal","48033","Break and enter to steal a firearm from a motor vehicle","8","0","0","0","0.96","0","0","0","0","0","0","0","0","0"
"2011","Edmonton, Alberta, municipal","48033","Break and enter to steal a firearm from a motor vehicle","15","1","0","84.3","1.77","0","0.14","1.82","0","1","0","1","1","0"
"2012","Edmonton, Alberta, municipal","48033","Break and enter to steal a firearm from a motor vehicle","13","1","0","-15.51","1.5","0","0","0","0","1","0","0","0","0"
"2013","Edmonton, Alberta, municipal","48033","Break and enter to steal a firearm from a motor vehicle","9","0","0","-33.05","1","0","0","0","0","0","0","0","0","0"
"2014","Edmonton, Alberta, municipal","48033","Break and enter to steal a firearm from a motor vehicle","20","0","0","114.98","2.16","0","0","0","0","0","0","0","0","0"
"2015","Edmonton, Alberta, municipal","48033","Break and enter to steal a firearm from a motor vehicle","22","2","1","7.62","2.32","0.26","0.24","0","0","3","2","2","0","0"
"2016","Edmonton, Alberta, municipal","48033","Break and enter to steal a firearm from a motor vehicle","22","0","0","-2.22","2.27","0","0","0","0","0","0","0","0","0"
"1998","Edmonton, Alberta, municipal","48033","Total possession of stolen property","1382","1310","75","0","211.59","0","0","0","0","1385","1076","1434","358","91"
"1999","Edmonton, Alberta, municipal","48033","Total possession of stolen property","1420","1330","77","1.15","214.02","0","0","0","0","1407","1150","1458","308","103"
"2000","Edmonton, Alberta, municipal","48033","Total possession of stolen property","1267","1215","53","-12.11","188.1","0","0","0","0","1268","977","1290","313","81"
"2001","Edmonton, Alberta, municipal","48033","Total possession of stolen property","1430","1322","47","11.32","209.4","0","0","0","0","1369","1038","1439","401","63"
"2002","Edmonton, Alberta, municipal","48033","Total possession of stolen property","1579","1451","55","8.52","227.23","0","0","0","0","1506","1179","1565","386","55"
"2003","Edmonton, Alberta, municipal","48033","Total possession of stolen property","1862","1719","50","16.6","264.95","0","0","0","0","1769","1500","1903","403","47"
"2004","Edmonton, Alberta, municipal","48033","Total possession of stolen property","1941","1794","63","1.67","269.37","278.76","312.74","661.92","97.66","1857","1584","1950","366","54"
"2005","Edmonton, Alberta, municipal","48033","Total possession of stolen property","1778","1643","45","-10.48","241.15","255.01","276.18","498.78","66.62","1688","1489","1766","277","37"
"2006","Edmonton, Alberta, municipal","48033","Total possession of stolen property","1876","1746","52","2.5","247.17","213.03","222.39","323.26","14.29","1798","1286","1467","181","8"
"2007","Edmonton, Alberta, municipal","48033","Total possession of stolen property","1673","1571","85","-13.14","214.7","206.01","221.08","389.31","50.23","1656","1282","1499","217","28"
"2008","Edmonton, Alberta, municipal","48033","Total possession of stolen property","1314","1221","75","-23.27","164.74","174.98","183.21","278.03","50.55","1296","1118","1272","154","28"
"2009","Edmonton, Alberta, municipal","48033","Total possession of stolen property","1055","932","55","-21.7","128.99","137.29","143.7","220.42","29.15","987","902","1023","121","16"
"2010","Edmonton, Alberta, municipal","48033","Total possession of stolen property","977","845","46","-8.87","117.55","121.08","131.44","258.4","45.82","891","809","950","141","25"
"2011","Edmonton, Alberta, municipal","48033","Total possession of stolen property","720","616","39","-27.56","85.15","78.57","83.03","138.05","14.53","655","534","610","76","8"
"2012","Edmonton, Alberta, municipal","48033","Total possession of stolen property","797","689","40","7.92","91.89","77.16","84.84","183.21","43.97","729","539","639","100","24"
"2013","Edmonton, Alberta, municipal","48033","Total possession of stolen property","1104","960","30","33.96","123.09","94.07","103.55","229.55","29.38","990","681","806","125","16"
"2014","Edmonton, Alberta, municipal","48033","Total possession of stolen property","1264","1105","23","10.76","136.34","87.4","91.81","152.55","20.22","1128","655","738","83","11"
"2015","Edmonton, Alberta, municipal","48033","Total possession of stolen property","1652","1442","27","27.87","174.34","111.34","119.75","237.44","18.26","1469","852","982","130","10"
"2016","Edmonton, Alberta, municipal","48033","Total possession of stolen property","1698","1529","28","0.5","175.22","117.08","116.58","109.53","7.18","1557","915","976","61","4"
"2005","Edmonton, Alberta, municipal","48033","Total trafficking in stolen property","0","0","0","0","0","0","0","0","0","0","0","0","0","0"
"2006","Edmonton, Alberta, municipal","48033","Total trafficking in stolen property","0","0","0","0","0","0","0","0","0","0","0","0","0","0"
"2007","Edmonton, Alberta, municipal","48033","Total trafficking in stolen property","0","0","0","0","0","0","0","0","0","0","0","0","0","0"
"2008","Edmonton, Alberta, municipal","48033","Total trafficking in stolen property","0","0","0","0","0","0","0","0","0","0","0","0","0","0"
"2009","Edmonton, Alberta, municipal","48033","Total trafficking in stolen property","0","0","0","0","0","0","0","0","0","0","0","0","0","0"
"2010","Edmonton, Alberta, municipal","48033","Total trafficking in stolen property","0","0","0","0","0","0","0","0","0","0","0","0","0","0"
"2011","Edmonton, Alberta, municipal","48033","Total trafficking in stolen property","5","5","0","0","0.59","0.44","0.41","0","0","5","3","3","0","0"
"2012","Edmonton, Alberta, municipal","48033","Total trafficking in stolen property","5","3","1","-2.51","0.58","0.43","0.4","0","0","4","3","3","0","0"
"2013","Edmonton, Alberta, municipal","48033","Total trafficking in stolen property","46","27","0","789.7","5.13","1.8","1.93","3.67","0","27","13","15","2","0"
"2014","Edmonton, Alberta, municipal","48033","Total trafficking in stolen property","35","47","1","-26.39","3.78","3.74","3.98","7.35","0","48","28","32","4","0"
"2015","Edmonton, Alberta, municipal","48033","Total trafficking in stolen property","61","49","1","70.52","6.44","4.44","4.63","7.31","0","50","34","38","4","0"
"2016","Edmonton, Alberta, municipal","48033","Total trafficking in stolen property","78","69","2","25.03","8.05","6.78","6.57","3.59","0","71","53","55","2","0"
"1998","Edmonton, Alberta, municipal","48033","Total theft of motor vehicle","3818","182","93","0","584.56","0","0","0","0","275","125","178","53","23"
"1999","Edmonton, Alberta, municipal","48033","Total theft of motor vehicle","3811","245","107","-1.74","574.4","0","0","0","0","352","139","261","122","18"
"2000","Edmonton, Alberta, municipal","48033","Total theft of motor vehicle","4464","271","73","15.38","662.73","0","0","0","0","344","180","264","84","18"
"2001","Edmonton, Alberta, municipal","48033","Total theft of motor vehicle","6462","353","81","42.78","946.25","0","0","0","0","434","226","380","154","24"
"2002","Edmonton, Alberta, municipal","48033","Total theft of motor vehicle","6785","302","72","3.19","976.42","0","0","0","0","374","191","319","128","20"
"2003","Edmonton, Alberta, municipal","48033","Total theft of motor vehicle","8435","351","74","22.92","1200.26","0","0","0","0","425","228","395","167","17"
"2004","Edmonton, Alberta, municipal","48033","Total theft of motor vehicle","8975","277","64","3.77","1245.54","33.44","49.08","209.79","16.28","341","190","306","116","9"
"2005","Edmonton, Alberta, municipal","48033","Total theft of motor vehicle","9365","247","60","1.98","1270.18","27.57","36.44","129.65","30.61","307","161","233","72","17"
"2006","Edmonton, Alberta, municipal","48033","Total theft of motor vehicle","9941","268","42","3.12","1309.78","29.98","38.5","130.38","10.72","310","181","254","73","6"
"2007","Edmonton, Alberta, municipal","48033","Total theft of motor vehicle","7752","169","97","-24.04","994.86","15.91","19.62","61","28.71","266","99","133","34","16"
"2008","Edmonton, Alberta, municipal","48033","Total theft of motor vehicle","6605","177","102","-16.76","828.1","18","22.04","68.61","23.47","279","115","153","38","13"
"2009","Edmonton, Alberta, municipal","48033","Total theft of motor vehicle","5829","165","75","-13.93","712.71","15.98","18.26","45.54","23.68","240","105","130","25","13"
"2010","Edmonton, Alberta, municipal","48033","Total theft of motor vehicle","4286","165","88","-27.65","515.67","13.92","16.88","53.15","27.49","253","93","122","29","15"
"2011","Edmonton, Alberta, municipal","48033","Total theft of motor vehicle","3599","210","44","-17.46","425.62","20.01","22.87","58.13","9.08","254","136","168","32","5"
"2012","Edmonton, Alberta, municipal","48033","Total theft of motor vehicle","3120","242","57","-15.48","359.72","21.9","25.76","75.11","14.66","299","153","194","41","8"
"2013","Edmonton, Alberta, municipal","48033","Total theft of motor vehicle","3823","287","45","18.5","426.25","24.59","31.22","119.37","7.35","332","178","243","65","4"
"2014","Edmonton, Alberta, municipal","48033","Total theft of motor vehicle","3870","307","30","-2.07","417.43","25.22","29.61","90.06","23.89","337","189","238","49","13"
"2015","Edmonton, Alberta, municipal","48033","Total theft of motor vehicle","4525","347","45","14.4","477.54","27.18","31.34","89.5","10.96","392","208","257","49","6"
"2016","Edmonton, Alberta, municipal","48033","Total theft of motor vehicle","5049","269","34","9.11","521.02","23.42","24.01","32.32","21.55","303","183","201","18","12"
"1998","Edmonton, Alberta, municipal","48033","Total theft over $5,000 (non-motor vehicle)","315","68","7","0","48.23","0","0","0","0","75","68","81","13","0"
"1999","Edmonton, Alberta, municipal","48033","Total theft over $5,000 (non-motor vehicle)","540","61","10","68.76","81.39","0","0","0","0","71","56","65","9","1"
"2000","Edmonton, Alberta, municipal","48033","Total theft over $5,000 (non-motor vehicle)","281","93","22","-48.74","41.72","0","0","0","0","115","65","75","10","0"
"2001","Edmonton, Alberta, municipal","48033","Total theft over $5,000 (non-motor vehicle)","359","52","5","26.01","52.57","0","0","0","0","57","58","63","5","0"
"2002","Edmonton, Alberta, municipal","48033","Total theft over $5,000 (non-motor vehicle)","517","69","11","41.53","74.4","0","0","0","0","80","60","67","7","1"
"2003","Edmonton, Alberta, municipal","48033","Total theft over $5,000 (non-motor vehicle)","415","59","5","-20.63","59.05","0","0","0","0","64","59","61","2","1"
"2004","Edmonton, Alberta, municipal","48033","Total theft over $5,000 (non-motor vehicle)","387","32","5","-9.05","53.71","5.98","5.93","5.43","0","37","34","37","3","0"
"2005","Edmonton, Alberta, municipal","48033","Total theft over $5,000 (non-motor vehicle)","405","25","2","2.28","54.93","4.62","4.54","3.6","0","27","27","29","2","0"
"2006","Edmonton, Alberta, municipal","48033","Total theft over $5,000 (non-motor vehicle)","408","40","4","-2.14","53.76","6.46","6.37","5.36","1.79","44","39","42","3","1"
"2007","Edmonton, Alberta, municipal","48033","Total theft over $5,000 (non-motor vehicle)","532","33","11","27.01","68.27","5.95","5.6","1.79","5.38","44","37","38","1","3"
"2008","Edmonton, Alberta, municipal","48033","Total theft over $5,000 (non-motor vehicle)","542","33","13","-0.47","67.95","5.63","5.62","5.42","1.81","46","36","39","3","1"
"2009","Edmonton, Alberta, municipal","48033","Total theft over $5,000 (non-motor vehicle)","492","38","7","-11.47","60.16","5.17","5.06","3.64","0","45","34","36","2","0"
"2010","Edmonton, Alberta, municipal","48033","Total theft over $5,000 (non-motor vehicle)","416","25","18","-16.8","50.05","3.89","3.87","3.67","0","43","26","28","2","0"
"2011","Edmonton, Alberta, municipal","48033","Total theft over $5,000 (non-motor vehicle)","380","27","7","-10.21","44.94","3.97","4.08","5.45","0","34","27","30","3","0"
"2012","Edmonton, Alberta, municipal","48033","Total theft over $5,000 (non-motor vehicle)","420","35","4","7.75","48.42","4.01","3.85","1.83","1.83","39","28","29","1","1"
"2013","Edmonton, Alberta, municipal","48033","Total theft over $5,000 (non-motor vehicle)","475","46","2","9.37","52.96","5.39","5.14","1.84","0","48","39","40","1","0"
"2014","Edmonton, Alberta, municipal","48033","Total theft over $5,000 (non-motor vehicle)","471","52","3","-4.07","50.8","5.87","5.85","5.51","1.84","55","44","47","3","1"
"2015","Edmonton, Alberta, municipal","48033","Total theft over $5,000 (non-motor vehicle)","647","47","9","34.4","68.28","4.44","4.15","0","0","56","34","34","0","0"
"2016","Edmonton, Alberta, municipal","48033","Total theft over $5,000 (non-motor vehicle)","642","55","10","-2.97","66.25","6.78","6.33","0","3.59","65","53","53","0","2"
"1998","Edmonton, Alberta, municipal","48033","Theft over $5,000","278","65","7","0","42.56","0","0","0","0","72","64","77","13","0"
"1999","Edmonton, Alberta, municipal","48033","Theft over $5,000","496","61","10","75.64","74.76","0","0","0","0","71","56","65","9","1"
"2000","Edmonton, Alberta, municipal","48033","Theft over $5,000","228","68","21","-54.72","33.85","0","0","0","0","89","55","63","8","0"
"2001","Edmonton, Alberta, municipal","48033","Theft over $5,000","264","46","5","14.21","38.66","0","0","0","0","51","51","53","2","0"
"2002","Edmonton, Alberta, municipal","48033","Theft over $5,000","344","51","5","28.06","49.5","0","0","0","0","56","48","50","2","1"
"2003","Edmonton, Alberta, municipal","48033","Theft over $5,000","347","56","5","-0.26","49.38","0","0","0","0","61","55","57","2","1"
"2004","Edmonton, Alberta, municipal","48033","Theft over $5,000","311","26","5","-12.59","43.16","4.93","4.81","3.62","0","31","28","30","2","0"
"2005","Edmonton, Alberta, municipal","48033","Theft over $5,000","335","21","2","5.27","45.44","4.11","3.75","0","0","23","24","24","0","0"
"2006","Edmonton, Alberta, municipal","48033","Theft over $5,000","306","38","3","-11.27","40.32","6.13","6.06","5.36","0","41","37","40","3","0"
"2007","Edmonton, Alberta, municipal","48033","Theft over $5,000","403","32","10","28.28","51.72","5.79","5.46","1.79","3.59","42","36","37","1","2"
"2008","Edmonton, Alberta, municipal","48033","Theft over $5,000","387","31","13","-6.19","48.52","5.32","5.33","5.42","1.81","44","34","37","3","1"
"2009","Edmonton, Alberta, municipal","48033","Theft over $5,000","331","36","7","-16.59","40.47","5.02","4.92","3.64","0","43","33","35","2","0"
"2010","Edmonton, Alberta, municipal","48033","Theft over $5,000","277","25","17","-17.65","33.33","3.89","3.87","3.67","0","42","26","28","2","0"
"2011","Edmonton, Alberta, municipal","48033","Theft over $5,000","267","24","6","-5.25","31.58","3.38","3.54","5.45","0","30","23","26","3","0"
"2012","Edmonton, Alberta, municipal","48033","Theft over $5,000","284","27","1","3.7","32.74","3.29","3.05","0","0","28","23","23","0","0"
"2013","Edmonton, Alberta, municipal","48033","Theft over $5,000","302","38","2","2.84","33.67","5.11","4.75","0","0","40","37","37","0","0"
"2014","Edmonton, Alberta, municipal","48033","Theft over $5,000","337","45","2","7.95","36.35","5.07","4.98","3.68","0","47","38","40","2","0"
"2015","Edmonton, Alberta, municipal","48033","Theft over $5,000","452","40","8","31.23","47.7","3.66","3.41","0","0","48","28","28","0","0"
"2016","Edmonton, Alberta, municipal","48033","Theft over $5,000","438","42","9","-5.25","45.2","4.73","4.42","0","3.59","51","37","37","0","2"
"1998","Edmonton, Alberta, municipal","48033","Theft over $5,000 from a motor vehicle","31","1","0","0","4.75","0","0","0","0","1","1","1","0","0"
"1999","Edmonton, Alberta, municipal","48033","Theft over $5,000 from a motor vehicle","42","0","0","33.37","6.33","0","0","0","0","0","0","0","0","0"
"2000","Edmonton, Alberta, municipal","48033","Theft over $5,000 from a motor vehicle","46","21","1","7.88","6.83","0","0","0","0","22","9","11","2","0"
"2001","Edmonton, Alberta, municipal","48033","Theft over $5,000 from a motor vehicle","85","3","0","82.26","12.45","0","0","0","0","3","4","6","2","0"
"2002","Edmonton, Alberta, municipal","48033","Theft over $5,000 from a motor vehicle","166","18","6","91.93","23.89","0","0","0","0","24","12","17","5","0"
"2003","Edmonton, Alberta, municipal","48033","Theft over $5,000 from a motor vehicle","60","1","0","-64.26","8.54","0","0","0","0","1","1","1","0","0"
"2004","Edmonton, Alberta, municipal","48033","Theft over $5,000 from a motor vehicle","69","3","0","12.16","9.58","0.35","0.32","0","0","3","2","2","0","0"
"2005","Edmonton, Alberta, municipal","48033","Theft over $5,000 from a motor vehicle","64","3","0","-9.35","8.68","0.34","0.31","0","0","3","2","2","0","0"
"2006","Edmonton, Alberta, municipal","48033","Theft over $5,000 from a motor vehicle","97","1","0","47.23","12.78","0.17","0.15","0","0","1","1","1","0","0"
"2007","Edmonton, Alberta, municipal","48033","Theft over $5,000 from a motor vehicle","119","0","0","19.5","15.27","0","0","0","0","0","0","0","0","0"
"2008","Edmonton, Alberta, municipal","48033","Theft over $5,000 from a motor vehicle","145","2","0","19.04","18.18","0.31","0.29","0","0","2","2","2","0","0"
"2009","Edmonton, Alberta, municipal","48033","Theft over $5,000 from a motor vehicle","152","1","0","2.23","18.58","0","0","0","0","1","0","0","0","0"
"2010","Edmonton, Alberta, municipal","48033","Theft over $5,000 from a motor vehicle","134","0","1","-13.25","16.12","0","0","0","0","1","0","0","0","0"
"2011","Edmonton, Alberta, municipal","48033","Theft over $5,000 from a motor vehicle","105","0","0","-22.98","12.42","0","0","0","0","0","0","0","0","0"
"2012","Edmonton, Alberta, municipal","48033","Theft over $5,000 from a motor vehicle","118","3","1","9.56","13.6","0.14","0.27","1.83","1.83","4","1","2","1","1"
"2013","Edmonton, Alberta, municipal","48033","Theft over $5,000 from a motor vehicle","163","4","0","33.59","18.17","0.28","0.39","1.84","0","4","2","3","1","0"
"2014","Edmonton, Alberta, municipal","48033","Theft over $5,000 from a motor vehicle","120","4","0","-28.78","12.94","0.53","0.5","0","0","4","4","4","0","0"
"2015","Edmonton, Alberta, municipal","48033","Theft over $5,000 from a motor vehicle","184","3","0","50.02","19.42","0.26","0.24","0","0","3","2","2","0","0"
"2016","Edmonton, Alberta, municipal","48033","Theft over $5,000 from a motor vehicle","178","2","0","-5.41","18.37","0.26","0.24","0","0","2","2","2","0","0"
"1998","Edmonton, Alberta, municipal","48033","Shoplifting over $5,000","6","2","0","0","0.92","0","0","0","0","2","3","3","0","0"
"1999","Edmonton, Alberta, municipal","48033","Shoplifting over $5,000","2","0","0","-67.19","0.3","0","0","0","0","0","0","0","0","0"
"2000","Edmonton, Alberta, municipal","48033","Shoplifting over $5,000","7","4","0","244.75","1.04","0","0","0","0","4","1","1","0","0"
"2001","Edmonton, Alberta, municipal","48033","Shoplifting over $5,000","10","3","0","40.9","1.46","0","0","0","0","3","3","4","1","0"
"2002","Edmonton, Alberta, municipal","48033","Shoplifting over $5,000","7","0","0","-31.21","1.01","0","0","0","0","0","0","0","0","0"
"2003","Edmonton, Alberta, municipal","48033","Shoplifting over $5,000","8","2","0","13","1.14","0","0","0","0","2","3","3","0","0"
"2004","Edmonton, Alberta, municipal","48033","Shoplifting over $5,000","7","3","0","-14.66","0.97","0.7","0.8","1.81","0","3","4","5","1","0"
"2005","Edmonton, Alberta, municipal","48033","Shoplifting over $5,000","6","1","0","-16.23","0.81","0.17","0.47","3.6","0","1","1","3","2","0"
"2006","Edmonton, Alberta, municipal","48033","Shoplifting over $5,000","5","1","1","-19.05","0.66","0.17","0.15","0","1.79","2","1","1","0","1"
"2007","Edmonton, Alberta, municipal","48033","Shoplifting over $5,000","10","1","1","94.81","1.28","0.16","0.15","0","1.79","2","1","1","0","1"
"2008","Edmonton, Alberta, municipal","48033","Shoplifting over $5,000","10","0","0","-2.31","1.25","0","0","0","0","0","0","0","0","0"
"2009","Edmonton, Alberta, municipal","48033","Shoplifting over $5,000","9","1","0","-12.23","1.1","0.15","0.14","0","0","1","1","1","0","0"
"2010","Edmonton, Alberta, municipal","48033","Shoplifting over $5,000","5","0","0","-45.33","0.6","0","0","0","0","0","0","0","0","0"
"2011","Edmonton, Alberta, municipal","48033","Shoplifting over $5,000","8","3","1","57.27","0.95","0.59","0.54","0","0","4","4","4","0","0"
"2012","Edmonton, Alberta, municipal","48033","Shoplifting over $5,000","18","5","2","119.36","2.08","0.57","0.53","0","0","7","4","4","0","0"
"2013","Edmonton, Alberta, municipal","48033","Shoplifting over $5,000","10","4","0","-46.27","1.11","0","0","0","0","4","0","0","0","0"
"2014","Edmonton, Alberta, municipal","48033","Shoplifting over $5,000","14","3","1","35.44","1.51","0.27","0.37","1.84","1.84","4","2","3","1","1"
"2015","Edmonton, Alberta, municipal","48033","Shoplifting over $5,000","11","4","1","-23.13","1.16","0.52","0.49","0","0","5","4","4","0","0"
"2016","Edmonton, Alberta, municipal","48033","Shoplifting over $5,000","26","11","1","131.12","2.68","1.79","1.67","0","0","12","14","14","0","0"
"1998","Edmonton, Alberta, municipal","48033","Total theft under $5,000 (non-motor vehicle)","20282","3436","1600","0","3105.31","0","0","0","0","5036","2691","3497","806","1128"
"1999","Edmonton, Alberta, municipal","48033","Total theft under $5,000 (non-motor vehicle)","19703","3313","1575","-4.37","2969.66","0","0","0","0","4888","2552","3314","762","1235"
"2000","Edmonton, Alberta, municipal","48033","Total theft under $5,000 (non-motor vehicle)","19275","3165","1703","-3.64","2861.6","0","0","0","0","4868","2308","3023","715","1188"
"2001","Edmonton, Alberta, municipal","48033","Total theft under $5,000 (non-motor vehicle)","19824","2777","1326","1.44","2902.88","0","0","0","0","4103","2163","2831","668","879"
"2002","Edmonton, Alberta, municipal","48033","Total theft under $5,000 (non-motor vehicle)","23242","3132","1312","15.22","3344.74","0","0","0","0","4444","2480","3132","652","964"
"2003","Edmonton, Alberta, municipal","48033","Total theft under $5,000 (non-motor vehicle)","26226","3207","1446","11.57","3731.85","0","0","0","0","4653","2591","3207","616","1042"
"2004","Edmonton, Alberta, municipal","48033","Total theft under $5,000 (non-motor vehicle)","27243","3156","1250","1.31","3780.74","468.65","499.26","813.83","1618.62","4406","2663","3113","450","895"
"2005","Edmonton, Alberta, municipal","48033","Total theft under $5,000 (non-motor vehicle)","28548","2933","1068","2.41","3871.99","415.48","459.31","920.12","1292.86","4001","2426","2937","511","718"
"2006","Edmonton, Alberta, municipal","48033","Total theft under $5,000 (non-motor vehicle)","25923","2581","888","-11.79","3415.5","351.68","392.02","826.9","1043.01","3469","2123","2586","463","584"
"2007","Edmonton, Alberta, municipal","48033","Total theft under $5,000 (non-motor vehicle)","24018","2656","1439","-9.75","3082.36","350.8","404.11","999.3","1537.52","4095","2183","2740","557","857"
"2008","Edmonton, Alberta, municipal","48033","Total theft under $5,000 (non-motor vehicle)","21788","2782","1405","-11.38","2731.66","384.56","428.06","929.79","1298.09","4187","2457","2972","515","719"
"2009","Edmonton, Alberta, municipal","48033","Total theft under $5,000 (non-motor vehicle)","22114","3210","1593","-1.02","2703.86","428.9","483.06","1131.25","1295.2","4803","2818","3439","621","711"
"2010","Edmonton, Alberta, municipal","48033","Total theft under $5,000 (non-motor vehicle)","18108","2969","1397","-19.42","2178.65","391.51","440.13","1035.44","1346.99","4366","2616","3181","565","735"
"2011","Edmonton, Alberta, municipal","48033","Total theft under $5,000 (non-motor vehicle)","15283","2800","1136","-17.04","1807.39","353.58","400.04","973.64","988.17","3936","2403","2939","536","544"
"2012","Edmonton, Alberta, municipal","48033","Total theft under $5,000 (non-motor vehicle)","15181","2784","1068","-3.16","1750.29","345.28","393.28","1007.64","866.57","3852","2412","2962","550","473"
"2013","Edmonton, Alberta, municipal","48033","Total theft under $5,000 (non-motor vehicle)","17122","3049","1023","9.07","1909.06","366.9","403.8","894.33","1017.37","4072","2656","3143","487","554"
"2014","Edmonton, Alberta, municipal","48033","Total theft under $5,000 (non-motor vehicle)","18222","2964","890","2.96","1965.48","300.64","322.34","621.23","784.81","3854","2253","2591","338","427"
"2015","Edmonton, Alberta, municipal","48033","Total theft under $5,000 (non-motor vehicle)","20545","3209","900","10.31","2168.17","306.83","329.02","639.26","960.71","4109","2348","2698","350","526"
"2016","Edmonton, Alberta, municipal","48033","Total theft under $5,000 (non-motor vehicle)","24212","3804","1083","15.23","2498.48","364.05","384.74","675.12","971.38","4887","2845","3221","376","541"
"1998","Edmonton, Alberta, municipal","48033","Theft $5,000 or under","7135","725","237","0","1092.42","0","0","0","0","962","471","630","159","149"
"1999","Edmonton, Alberta, municipal","48033","Theft $5,000 or under","6126","551","188","-15.48","923.32","0","0","0","0","739","375","477","102","95"
"2000","Edmonton, Alberta, municipal","48033","Theft $5,000 or under","5984","648","174","-3.78","888.39","0","0","0","0","822","374","511","137","108"
"2001","Edmonton, Alberta, municipal","48033","Theft $5,000 or under","5983","470","174","-1.38","876.11","0","0","0","0","644","338","432","94","83"
"2002","Edmonton, Alberta, municipal","48033","Theft $5,000 or under","6661","478","165","9.41","958.58","0","0","0","0","643","311","396","85","97"
"2003","Edmonton, Alberta, municipal","48033","Theft $5,000 or under","7835","408","188","16.31","1114.89","0","0","0","0","596","276","343","67","97"
"2004","Edmonton, Alberta, municipal","48033","Theft $5,000 or under","8318","430","180","3.54","1154.36","44.52","48.27","86.81","222.45","610","253","301","48","123"
"2005","Edmonton, Alberta, municipal","48033","Theft $5,000 or under","8731","445","170","2.58","1184.19","48.12","53.48","109.84","124.24","615","281","342","61","69"
"2006","Edmonton, Alberta, municipal","48033","Theft $5,000 or under","8193","639","308","-8.84","1079.47","83.65","90.96","169.67","280.4","947","505","600","95","157"
"2007","Edmonton, Alberta, municipal","48033","Theft $5,000 or under","8586","814","663","2.08","1101.89","107.83","115.92","206.32","556.16","1477","671","786","115","310"
"2008","Edmonton, Alberta, municipal","48033","Theft $5,000 or under","6989","502","490","-20.48","876.24","64.48","71.01","146.24","324.97","992","412","493","81","180"
"2009","Edmonton, Alberta, municipal","48033","Theft $5,000 or under","6588","465","491","-8.07","805.51","55.86","62.79","145.73","222.24","956","367","447","80","122"
"2010","Edmonton, Alberta, municipal","48033","Theft $5,000 or under","5509","378","432","-17.72","662.81","44.9","47.18","75.14","263.9","810","300","341","41","144"
"2011","Edmonton, Alberta, municipal","48033","Theft $5,000 or under","4958","371","349","-11.54","586.34","41.49","45.6","96.27","174.38","720","282","335","53","96"
"2012","Edmonton, Alberta, municipal","48033","Theft $5,000 or under","5185","462","358","1.96","597.8","49.96","56.43","139.24","177.71","820","349","425","76","97"
"2013","Edmonton, Alberta, municipal","48033","Theft $5,000 or under","5784","483","312","7.88","644.9","47.93","53.45","126.71","170.79","795","347","416","69","93"
"2014","Edmonton, Alberta, municipal","48033","Theft $5,000 or under","6051","431","252","1.21","652.68","32.69","34.71","62.49","119.47","683","245","279","34","65"
"2015","Edmonton, Alberta, municipal","48033","Theft $5,000 or under","6693","471","245","8.22","706.33","40.64","42.56","69.41","122.37","716","311","349","38","67"
"2016","Edmonton, Alberta, municipal","48033","Theft $5,000 or under","7034","518","206","2.76","725.85","41.59","43.72","73.62","129.28","724","325","366","41","72"
"1998","Edmonton, Alberta, municipal","48033","Theft $5,000 or under from a motor vehicle","9078","287","147","0","1389.9","0","0","0","0","434","153","228","75","37"
"1999","Edmonton, Alberta, municipal","48033","Theft $5,000 or under from a motor vehicle","9246","264","47","0.26","1393.57","0","0","0","0","311","108","160","52","20"
"2000","Edmonton, Alberta, municipal","48033","Theft $5,000 or under from a motor vehicle","8907","147","63","-5.11","1322.35","0","0","0","0","210","62","88","26","29"
"2001","Edmonton, Alberta, municipal","48033","Theft $5,000 or under from a motor vehicle","10102","179","34","11.87","1479.26","0","0","0","0","213","83","128","45","11"
"2002","Edmonton, Alberta, municipal","48033","Theft $5,000 or under from a motor vehicle","12371","227","34","20.35","1780.3","0","0","0","0","261","101","138","37","11"
"2003","Edmonton, Alberta, municipal","48033","Theft $5,000 or under from a motor vehicle","13828","210","54","10.52","1967.66","0","0","0","0","264","89","136","47","19"
"2004","Edmonton, Alberta, municipal","48033","Theft $5,000 or under from a motor vehicle","14441","134","33","1.85","2004.1","14.43","15.88","30.74","19.89","167","82","99","17","11"
"2005","Edmonton, Alberta, municipal","48033","Theft $5,000 or under from a motor vehicle","15529","138","16","5.1","2106.21","13.87","16.26","41.41","7.2","154","81","104","23","4"
"2006","Edmonton, Alberta, municipal","48033","Theft $5,000 or under from a motor vehicle","14415","113","16","-9.83","1899.26","9.44","11.07","28.58","16.07","129","57","73","16","9"
"2007","Edmonton, Alberta, municipal","48033","Theft $5,000 or under from a motor vehicle","12239","73","37","-17.3","1570.7","4.98","6.34","21.53","10.76","110","31","43","12","6"
"2008","Edmonton, Alberta, municipal","48033","Theft $5,000 or under from a motor vehicle","10973","59","25","-12.41","1375.74","7.98","8.35","12.64","21.66","84","51","58","7","12"
"2009","Edmonton, Alberta, municipal","48033","Theft $5,000 or under from a motor vehicle","10641","52","17","-5.43","1301.07","4.41","6.88","36.43","12.75","69","29","49","20","7"
"2010","Edmonton, Alberta, municipal","48033","Theft $5,000 or under from a motor vehicle","8338","63","22","-22.9","1003.18","7.48","9.27","31.15","12.83","85","50","67","17","7"
"2011","Edmonton, Alberta, municipal","48033","Theft $5,000 or under from a motor vehicle","6349","117","17","-25.15","750.84","10.15","13.75","58.13","21.8","134","69","101","32","12"
"2012","Edmonton, Alberta, municipal","48033","Theft $5,000 or under from a motor vehicle","6193","105","15","-4.9","714.02","10.45","15.27","76.95","7.33","120","73","115","42","4"
"2013","Edmonton, Alberta, municipal","48033","Theft $5,000 or under from a motor vehicle","7113","112","14","11.07","793.08","9.39","11.69","42.24","16.53","126","68","91","23","9"
"2014","Edmonton, Alberta, municipal","48033","Theft $5,000 or under from a motor vehicle","7865","101","16","6.97","848.34","7.47","9.33","34.92","11.03","117","56","75","19","6"
"2015","Edmonton, Alberta, municipal","48033","Theft $5,000 or under from a motor vehicle","8888","90","12","10.57","937.97","6.4","7.2","18.26","9.13","102","49","59","10","5"
"2016","Edmonton, Alberta, municipal","48033","Theft $5,000 or under from a motor vehicle","10664","96","12","17.32","1100.44","6.27","7.88","30.52","8.98","108","49","66","17","5"
"1998","Edmonton, Alberta, municipal","48033","Shoplifting $5,000 or under","4069","2424","1216","0","622.99","0","0","0","0","3640","2067","2639","572","942"
"1999","Edmonton, Alberta, municipal","48033","Shoplifting $5,000 or under","4331","2498","1340","4.78","652.77","0","0","0","0","3838","2069","2677","608","1120"
"2000","Edmonton, Alberta, municipal","48033","Shoplifting $5,000 or under","4384","2370","1466","-0.29","650.86","0","0","0","0","3836","1872","2424","552","1051"
"2001","Edmonton, Alberta, municipal","48033","Shoplifting $5,000 or under","3739","2128","1118","-15.88","547.51","0","0","0","0","3246","1742","2271","529","785"
"2002","Edmonton, Alberta, municipal","48033","Shoplifting $5,000 or under","4210","2427","1113","10.66","605.86","0","0","0","0","3540","2068","2598","530","856"
"2003","Edmonton, Alberta, municipal","48033","Shoplifting $5,000 or under","4563","2589","1204","7.17","649.3","0","0","0","0","3793","2226","2728","502","926"
"2004","Edmonton, Alberta, municipal","48033","Shoplifting $5,000 or under","4484","2592","1037","-4.16","622.28","409.7","435.11","696.28","1376.28","3629","2328","2713","385","761"
"2005","Edmonton, Alberta, municipal","48033","Shoplifting $5,000 or under","4288","2350","882","-6.54","581.58","353.48","389.56","768.87","1161.41","3232","2064","2491","427","645"
"2006","Edmonton, Alberta, municipal","48033","Shoplifting $5,000 or under","3315","1829","564","-24.9","436.77","258.58","290","628.66","746.54","2393","1561","1913","352","418"
"2007","Edmonton, Alberta, municipal","48033","Shoplifting $5,000 or under","3193","1769","739","-6.18","409.77","237.99","281.84","771.45","970.6","2508","1481","1911","430","541"
"2008","Edmonton, Alberta, municipal","48033","Shoplifting $5,000 or under","3826","2221","890","17.06","479.68","312.09","348.7","770.91","951.45","3111","1994","2421","427","527"
"2009","Edmonton, Alberta, municipal","48033","Shoplifting $5,000 or under","4885","2693","1085","24.52","597.29","368.63","413.39","949.08","1060.21","3778","2422","2943","521","582"
"2010","Edmonton, Alberta, municipal","48033","Shoplifting $5,000 or under","4261","2528","943","-14.17","512.66","339.13","383.68","929.15","1070.26","3471","2266","2773","507","584"
"2011","Edmonton, Alberta, municipal","48033","Shoplifting $5,000 or under","3976","2312","770","-8.28","470.21","301.93","340.69","819.24","791.99","3082","2052","2503","451","436"
"2012","Edmonton, Alberta, municipal","48033","Shoplifting $5,000 or under","3803","2217","695","-6.75","438.47","284.87","321.58","791.46","681.53","2912","1990","2422","432","372"
"2013","Edmonton, Alberta, municipal","48033","Shoplifting $5,000 or under","4225","2454","697","7.44","471.08","309.57","338.66","725.38","830.06","3151","2241","2636","395","452"
"2014","Edmonton, Alberta, municipal","48033","Shoplifting $5,000 or under","4306","2432","622","-1.4","464.46","260.48","278.3","523.82","654.32","3054","1952","2237","285","356"
"2015","Edmonton, Alberta, municipal","48033","Shoplifting $5,000 or under","4964","2648","643","12.79","523.86","259.78","279.27","551.59","829.21","3291","1988","2290","302","454"
"2016","Edmonton, Alberta, municipal","48033","Shoplifting $5,000 or under","6514","3190","865","28.31","672.19","316.19","333.14","570.98","833.12","4055","2471","2789","318","464"
"1998","Edmonton, Alberta, municipal","48033","Fraud","3933","1818","352","0","602.17","0","0","0","0","2170","1215","1319","104","65"
"1999","Edmonton, Alberta, municipal","48033","Fraud","3982","2085","353","-0.33","600.17","0","0","0","0","2438","1460","1582","122","70"
"2000","Edmonton, Alberta, municipal","48033","Fraud","3711","2032","293","-8.2","550.94","0","0","0","0","2325","1299","1430","131","51"
"2001","Edmonton, Alberta, municipal","48033","Fraud","4009","1816","221","6.55","587.05","0","0","0","0","2037","1160","1279","119","26"
"2002","Edmonton, Alberta, municipal","48033","Fraud","4731","1755","233","15.98","680.83","0","0","0","0","1988","1206","1304","98","24"
"2003","Edmonton, Alberta, municipal","48033","Fraud","5068","1920","371","5.92","721.15","0","0","0","0","2291","1215","1294","79","26"
"2004","Edmonton, Alberta, municipal","48033","Fraud","5448","1922","459","4.84","756.06","227.73","222.29","166.38","74.15","2381","1294","1386","92","41"
"2005","Edmonton, Alberta, municipal","48033","Fraud","4966","1813","409","-10.91","673.54","202.09","193.29","100.84","52.22","2222","1180","1236","56","29"
"2006","Edmonton, Alberta, municipal","48033","Fraud","3774","1553","203","-26.17","497.25","149.75","141.89","57.15","19.65","1756","904","936","32","11"
"2007","Edmonton, Alberta, municipal","48033","Fraud","4631","1513","340","19.52","594.32","164.87","159.58","100.47","66.38","1853","1026","1082","56","37"
"2008","Edmonton, Alberta, municipal","48033","Fraud","4433","1392","248","-6.48","555.79","158.71","154.4","104.71","55.97","1640","1014","1072","58","31"
"2009","Edmonton, Alberta, municipal","48033","Fraud","4259","1313","320","-6.3","520.74","140.79","137.24","94.73","63.76","1633","925","977","52","35"
"2010","Edmonton, Alberta, municipal","48033","Fraud","4119","1467","217","-4.83","495.57","149.96","145.28","87.97","47.65","1684","1002","1050","48","26"
"2011","Edmonton, Alberta, municipal","48033","Fraud","3262","1217","295","-22.16","385.77","125.22","119.37","47.23","25.43","1512","851","877","26","14"
"2012","Edmonton, Alberta, municipal","48033","Fraud","2829","1289","180","-15.45","326.17","118.53","114.58","64.12","27.48","1469","828","863","35","15"
"2013","Edmonton, Alberta, municipal","48033","Fraud","3327","1262","195","13.73","370.95","125.15","120.51","58.77","22.04","1457","906","938","32","12"
"2014","Edmonton, Alberta, municipal","48033","Fraud","3797","1517","123","10.41","409.56","148.92","142.82","58.81","22.06","1640","1116","1148","32","12"
"2015","Edmonton, Alberta, municipal","48033","Fraud","4488","1673","213","15.64","473.63","156.03","149.27","54.79","20.09","1886","1194","1224","30","11"
"2016","Edmonton, Alberta, municipal","48033","Fraud","5380","1727","120","17.22","555.17","184.52","176.66","66.43","14.36","1847","1442","1479","37","8"
"2005","Edmonton, Alberta, municipal","48033","Identity theft","0","0","0","0","0","0","0","0","0","0","0","0","0","0"
"2006","Edmonton, Alberta, municipal","48033","Identity theft","0","0","0","0","0","0","0","0","0","0","0","0","0","0"
"2007","Edmonton, Alberta, municipal","48033","Identity theft","0","0","0","0","0","0","0","0","0","0","0","0","0","0"
"2008","Edmonton, Alberta, municipal","48033","Identity theft","0","0","0","0","0","0","0","0","0","0","0","0","0","0"
"2009","Edmonton, Alberta, municipal","48033","Identity theft","0","0","0","0","0","0","0","0","0","0","0","0","0","0"
"2010","Edmonton, Alberta, municipal","48033","Identity theft","0","0","0","0","0","0","0","0","0","0","0","0","0","0"
"2011","Edmonton, Alberta, municipal","48033","Identity theft","15","5","1","0","1.77","0.44","0.54","1.82","0","6","3","4","1","0"
"2012","Edmonton, Alberta, municipal","48033","Identity theft","61","44","0","296.47","7.03","2.86","2.66","0","0","44","20","20","0","0"
"2013","Edmonton, Alberta, municipal","48033","Identity theft","46","29","0","-27.07","5.13","2.9","3.21","7.35","0","29","21","25","4","0"
"2014","Edmonton, Alberta, municipal","48033","Identity theft","93","73","1","95.58","10.03","6.94","6.97","7.35","0","74","52","56","4","0"
"2015","Edmonton, Alberta, municipal","48033","Identity theft","103","91","0","8.36","10.87","8.62","8.9","12.79","0","91","66","73","7","0"
"2016","Edmonton, Alberta, municipal","48033","Identity theft","161","119","0","52.84","16.61","12.16","12.06","10.77","0","119","95","101","6","0"
"2005","Edmonton, Alberta, municipal","48033","Identity fraud","0","0","0","0","0","0","0","0","0","0","0","0","0","0"
"2006","Edmonton, Alberta, municipal","48033","Identity fraud","0","0","0","0","0","0","0","0","0","0","0","0","0","0"
"2007","Edmonton, Alberta, municipal","48033","Identity fraud","0","0","0","0","0","0","0","0","0","0","0","0","0","0"
"2008","Edmonton, Alberta, municipal","48033","Identity fraud","0","0","0","0","0","0","0","0","0","0","0","0","0","0"
"2009","Edmonton, Alberta, municipal","48033","Identity fraud","0","0","0","0","0","0","0","0","0","0","0","0","0","0"
"2010","Edmonton, Alberta, municipal","48033","Identity fraud","11","7","0","0","1.32","0.75","0.69","0","0","7","5","5","0","0"
"2011","Edmonton, Alberta, municipal","48033","Identity fraud","153","93","2","1267.18","18.09","12.51","11.84","3.63","12.72","95","85","87","2","7"
"2012","Edmonton, Alberta, municipal","48033","Identity fraud","298","201","2","89.89","34.36","25.19","25.36","27.48","0","203","176","191","15","0"
"2013","Edmonton, Alberta, municipal","48033","Identity fraud","338","247","3","9.69","37.69","32.74","32.5","29.38","0","250","237","253","16","0"
"2014","Edmonton, Alberta, municipal","48033","Identity fraud","468","332","1","33.95","50.48","44.04","43.29","33.08","0","333","330","348","18","0"
"2015","Edmonton, Alberta, municipal","48033","Identity fraud","554","353","2","15.82","58.47","46.91","45.73","29.22","0","355","359","375","16","0"
"2016","Edmonton, Alberta, municipal","48033","Identity fraud","693","352","7","22.32","71.51","42.61","41.81","30.52","1.8","359","333","350","17","1"
"1998","Edmonton, Alberta, municipal","48033","Total mischief","8048","948","362","0","1232.2","0","0","0","0","1310","577","766","189","227"
"1999","Edmonton, Alberta, municipal","48033","Total mischief","7816","899","300","-4.4","1178.04","0","0","0","0","1199","590","771","181","198"
"2000","Edmonton, Alberta, municipal","48033","Total mischief","8165","1043","347","2.9","1212.19","0","0","0","0","1390","572","796","224","208"
"2001","Edmonton, Alberta, municipal","48033","Total mischief","8998","937","277","8.7","1317.6","0","0","0","0","1214","583","796","213","241"
"2002","Edmonton, Alberta, municipal","48033","Total mischief","8919","813","233","-2.59","1283.53","0","0","0","0","1046","521","698","177","208"
"2003","Edmonton, Alberta, municipal","48033","Total mischief","9605","802","333","6.48","1366.75","0","0","0","0","1135","495","682","187","197"
"2004","Edmonton, Alberta, municipal","48033","Total mischief","10764","827","278","9.3","1493.81","88.35","103.44","258.62","349.04","1105","502","645","143","193"
"2005","Edmonton, Alberta, municipal","48033","Total mischief","10345","776","261","-6.07","1403.1","90.25","106.5","277.3","291.7","1037","527","681","154","162"
"2006","Edmonton, Alberta, municipal","48033","Total mischief","11233","834","216","5.48","1480.01","61.79","77.31","244.68","282.18","1050","373","510","137","158"
"2007","Edmonton, Alberta, municipal","48033","Total mischief","10789","784","391","-6.45","1384.61","92.08","105.3","252.96","362.4","1175","573","714","141","202"
"2008","Edmonton, Alberta, municipal","48033","Total mischief","9529","760","425","-13.72","1194.7","90.62","104.71","267.2","399","1185","579","727","148","221"
"2009","Edmonton, Alberta, municipal","48033","Total mischief","9500","789","437","-2.77","1161.56","90.56","100.43","218.6","275.07","1226","595","715","120","151"
"2010","Edmonton, Alberta, municipal","48033","Total mischief","8221","879","382","-14.85","989.1","96.08","104.05","201.59","285.89","1261","642","752","110","156"
"2011","Edmonton, Alberta, municipal","48033","Total mischief","7065","1004","298","-15.53","835.52","95.35","102.49","190.73","201.63","1302","648","753","105","111"
"2012","Edmonton, Alberta, municipal","48033","Total mischief","7022","1003","262","-3.1","809.6","93.05","101.97","216.18","183.21","1265","650","768","118","100"
"2013","Edmonton, Alberta, municipal","48033","Total mischief","7400","959","250","1.91","825.08","94.21","104.71","244.24","170.79","1209","682","815","133","93"
"2014","Edmonton, Alberta, municipal","48033","Total mischief","7023","1080","217","-8.19","757.52","82.33","86.59","145.2","124.98","1297","617","696","79","68"
"2015","Edmonton, Alberta, municipal","48033","Total mischief","7698","954","271","7.24","812.39","76.71","79.51","118.72","102.28","1225","587","652","65","56"
"2016","Edmonton, Alberta, municipal","48033","Total mischief","7207","984","157","-8.45","743.7","80.23","82.18","109.53","64.64","1141","627","688","61","36"
"1998","Edmonton, Alberta, municipal","48033","Mischief","8048","948","362","0","1232.2","0","0","0","0","1310","577","766","189","227"
"1999","Edmonton, Alberta, municipal","48033","Mischief","7816","899","300","-4.4","1178.04","0","0","0","0","1199","590","771","181","198"
"2000","Edmonton, Alberta, municipal","48033","Mischief","8165","1043","347","2.9","1212.19","0","0","0","0","1390","572","796","224","208"
"2001","Edmonton, Alberta, municipal","48033","Mischief","8998","937","277","8.7","1317.6","0","0","0","0","1214","583","796","213","241"
"2002","Edmonton, Alberta, municipal","48033","Mischief","8919","813","233","-2.59","1283.53","0","0","0","0","1046","521","698","177","208"
"2003","Edmonton, Alberta, municipal","48033","Mischief","9605","802","333","6.48","1366.75","0","0","0","0","1135","495","682","187","197"
"2004","Edmonton, Alberta, municipal","48033","Mischief","10764","827","278","9.3","1493.81","88.35","103.44","258.62","349.04","1105","502","645","143","193"
"2005","Edmonton, Alberta, municipal","48033","Mischief","10345","776","261","-6.07","1403.1","90.25","106.5","277.3","291.7","1037","527","681","154","162"
"2006","Edmonton, Alberta, municipal","48033","Mischief","11233","834","216","5.48","1480.01","61.79","77.31","244.68","282.18","1050","373","510","137","158"
"2007","Edmonton, Alberta, municipal","48033","Mischief","10789","784","391","-6.45","1384.61","92.08","105.3","252.96","362.4","1175","573","714","141","202"
"2008","Edmonton, Alberta, municipal","48033","Mischief","9529","760","425","-13.72","1194.7","90.62","104.71","267.2","399","1185","579","727","148","221"
"2009","Edmonton, Alberta, municipal","48033","Mischief","9495","788","437","-2.82","1160.95","90.41","100.29","218.6","275.07","1225","594","714","120","151"
"2010","Edmonton, Alberta, municipal","48033","Mischief","8221","879","382","-14.8","989.1","96.08","104.05","201.59","285.89","1261","642","752","110","156"
"2011","Edmonton, Alberta, municipal","48033","Mischief","7065","1004","298","-15.53","835.52","95.35","102.49","190.73","201.63","1302","648","753","105","111"
"2012","Edmonton, Alberta, municipal","48033","Mischief","7021","1003","262","-3.12","809.48","93.05","101.97","216.18","183.21","1265","650","768","118","100"
"2013","Edmonton, Alberta, municipal","48033","Mischief","7400","959","250","1.93","825.08","94.21","104.71","244.24","170.79","1209","682","815","133","93"
"2014","Edmonton, Alberta, municipal","48033","Mischief","7023","1080","217","-8.19","757.52","82.33","86.59","145.2","124.98","1297","617","696","79","68"
"2015","Edmonton, Alberta, municipal","48033","Mischief","7695","954","271","7.2","812.07","76.71","79.51","118.72","102.28","1225","587","652","65","56"
"2016","Edmonton, Alberta, municipal","48033","Mischief","7206","983","157","-8.43","743.6","80.1","82.06","109.53","64.64","1140","626","687","61","36"
"2012","Edmonton, Alberta, municipal","48033","Mischief in relation to cultural property","0","0","0","0","0","0","0","0","0","0","0","0","0","0"
"2013","Edmonton, Alberta, municipal","48033","Mischief in relation to cultural property","0","0","0","0","0","0","0","0","0","0","0","0","0","0"
"2014","Edmonton, Alberta, municipal","48033","Mischief in relation to cultural property","0","0","0","0","0","0","0","0","0","0","0","0","0","0"
"2015","Edmonton, Alberta, municipal","48033","Mischief in relation to cultural property","0","0","0","0","0","0","0","0","0","0","0","0","0","0"
"2016","Edmonton, Alberta, municipal","48033","Mischief in relation to cultural property","0","0","0","0","0","0","0","0","0","0","0","0","0","0"
"2005","Edmonton, Alberta, municipal","48033","Mischief to religious property motivated by hate","0","0","0","0","0","0","0","0","0","0","0","0","0","0"
"2006","Edmonton, Alberta, municipal","48033","Mischief to religious property motivated by hate","0","0","0","0","0","0","0","0","0","0","0","0","0","0"
"2007","Edmonton, Alberta, municipal","48033","Mischief to religious property motivated by hate","0","0","0","0","0","0","0","0","0","0","0","0","0","0"
"2008","Edmonton, Alberta, municipal","48033","Mischief to religious property motivated by hate","0","0","0","0","0","0","0","0","0","0","0","0","0","0"
"2009","Edmonton, Alberta, municipal","48033","Mischief to religious property motivated by hate","5","1","0","0","0.61","0.15","0.14","0","0","1","1","1","0","0"
"2010","Edmonton, Alberta, municipal","48033","Mischief to religious property motivated by hate","0","0","0","-100","0","0","0","0","0","0","0","0","0","0"
"2011","Edmonton, Alberta, municipal","48033","Mischief to religious property motivated by hate","0","0","0","0","0","0","0","0","0","0","0","0","0","0"
"2012","Edmonton, Alberta, municipal","48033","Mischief to religious property motivated by hate","1","0","0","0","0.12","0","0","0","0","0","0","0","0","0"
"2013","Edmonton, Alberta, municipal","48033","Mischief to religious property motivated by hate","0","0","0","-100","0","0","0","0","0","0","0","0","0","0"
"2014","Edmonton, Alberta, municipal","48033","Mischief to religious property motivated by hate","0","0","0","0","0","0","0","0","0","0","0","0","0","0"
"2015","Edmonton, Alberta, municipal","48033","Mischief to religious property motivated by hate","3","0","0","0","0.32","0","0","0","0","0","0","0","0","0"
"2016","Edmonton, Alberta, municipal","48033","Mischief to religious property motivated by hate","1","1","0","-67.41","0.1","0.13","0.12","0","0","1","1","1","0","0"
"2012","Edmonton, Alberta, municipal","48033","Mischief relating to war memorials","0","0","0","0","0","0","0","0","0","0","0","0","0","0"
"2013","Edmonton, Alberta, municipal","48033","Mischief relating to war memorials","0","0","0","0","0","0","0","0","0","0","0","0","0","0"
"2014","Edmonton, Alberta, municipal","48033","Mischief relating to war memorials","0","0","0","0","0","0","0","0","0","0","0","0","0","0"
"2015","Edmonton, Alberta, municipal","48033","Mischief relating to war memorials","0","0","0","0","0","0","0","0","0","0","0","0","0","0"
"2016","Edmonton, Alberta, municipal","48033","Mischief relating to war memorials","0","0","0","0","0","0","0","0","0","0","0","0","0","0"
"1998","Edmonton, Alberta, municipal","48033","Arson","291","27","19","0","44.55","0","0","0","0","46","25","42","17","14"
"1999","Edmonton, Alberta, municipal","48033","Arson","283","33","13","-4.26","42.65","0","0","0","0","46","17","30","13","4"
"2000","Edmonton, Alberta, municipal","48033","Arson","277","21","16","-3.59","41.12","0","0","0","0","37","13","28","15","9"
"2001","Edmonton, Alberta, municipal","48033","Arson","339","25","12","20.71","49.64","0","0","0","0","37","18","28","10","10"
"2002","Edmonton, Alberta, municipal","48033","Arson","268","46","12","-22.31","38.57","0","0","0","0","58","16","31","15","24"
"2003","Edmonton, Alberta, municipal","48033","Arson","328","31","14","21.02","46.67","0","0","0","0","45","9","20","11","13"
"2004","Edmonton, Alberta, municipal","48033","Arson","292","13","9","-13.18","40.52","0.7","2.57","21.7","10.85","22","4","16","12","6"
"2005","Edmonton, Alberta, municipal","48033","Arson","332","10","5","11.12","45.03","1.71","2.66","12.6","10.8","15","10","17","7","6"
"2006","Edmonton, Alberta, municipal","48033","Arson","319","21","7","-6.66","42.03","1.49","3.03","19.65","17.86","28","9","20","11","10"
"2007","Edmonton, Alberta, municipal","48033","Arson","429","8","18","30.99","55.06","0.48","1.03","7.18","34.09","26","3","7","4","19"
"2008","Edmonton, Alberta, municipal","48033","Arson","500","23","21","13.86","62.69","0.94","1.15","3.61","37.91","44","6","8","2","21"
"2009","Edmonton, Alberta, municipal","48033","Arson","412","12","16","-19.64","50.37","1.07","1.26","3.64","29.15","28","7","9","2","16"
"2010","Edmonton, Alberta, municipal","48033","Arson","313","20","14","-25.24","37.66","1.8","2.91","16.49","27.49","34","12","21","9","15"
"2011","Edmonton, Alberta, municipal","48033","Arson","283","13","8","-11.13","33.47","1.32","2.04","10.9","16.35","21","9","15","6","9"
"2012","Edmonton, Alberta, municipal","48033","Arson","262","19","13","-9.74","30.21","0.86","1.59","10.99","32.98","32","6","12","6","18"
"2013","Edmonton, Alberta, municipal","48033","Arson","309","37","12","14.05","34.45","2.35","3.98","25.71","9.18","49","17","31","14","5"
"2014","Edmonton, Alberta, municipal","48033","Arson","260","27","4","-18.6","28.04","2","2.99","16.54","1.84","31","15","24","9","1"
"2015","Edmonton, Alberta, municipal","48033","Arson","284","19","7","6.87","29.97","1.44","1.95","9.13","20.09","26","11","16","5","11"
"2016","Edmonton, Alberta, municipal","48033","Arson","262","28","7","-9.79","27.04","2.3","2.51","5.39","7.18","35","18","21","3","4"
"2005","Edmonton, Alberta, municipal","48033","Altering, removing or destroying Vehicle Identification Number (VIN)","0","0","0","0","0","0","0","0","0","0","0","0","0","0"
"2006","Edmonton, Alberta, municipal","48033","Altering, removing or destroying Vehicle Identification Number (VIN)","0","0","0","0","0","0","0","0","0","0","0","0","0","0"
"2007","Edmonton, Alberta, municipal","48033","Altering, removing or destroying Vehicle Identification Number (VIN)","0","0","0","0","0","0","0","0","0","0","0","0","0","0"
"2008","Edmonton, Alberta, municipal","48033","Altering, removing or destroying Vehicle Identification Number (VIN)","0","0","0","0","0","0","0","0","0","0","0","0","0","0"
"2009","Edmonton, Alberta, municipal","48033","Altering, removing or destroying Vehicle Identification Number (VIN)","0","0","0","0","0","0","0","0","0","0","0","0","0","0"
"2010","Edmonton, Alberta, municipal","48033","Altering, removing or destroying Vehicle Identification Number (VIN)","0","0","0","0","0","0","0","0","0","0","0","0","0","0"
"2011","Edmonton, Alberta, municipal","48033","Altering, removing or destroying Vehicle Identification Number (VIN)","0","0","0","0","0","0","0","0","0","0","0","0","0","0"
"2012","Edmonton, Alberta, municipal","48033","Altering, removing or destroying Vehicle Identification Number (VIN)","0","0","0","0","0","0","0","0","0","0","0","0","0","0"
"2013","Edmonton, Alberta, municipal","48033","Altering, removing or destroying Vehicle Identification Number (VIN)","12","10","0","0","1.34","0","0","0","0","10","0","0","0","0"
"2014","Edmonton, Alberta, municipal","48033","Altering, removing or destroying Vehicle Identification Number (VIN)","3","1","0","-75.81","0.32","0","0.12","1.84","0","1","0","1","1","0"
"2015","Edmonton, Alberta, municipal","48033","Altering, removing or destroying Vehicle Identification Number (VIN)","10","9","0","226.13","1.06","0","0","0","0","9","0","0","0","0"
"2016","Edmonton, Alberta, municipal","48033","Altering, removing or destroying Vehicle Identification Number (VIN)","4","5","0","-60.89","0.41","0.13","0.12","0","0","5","1","1","0","0"
"1998","Edmonton, Alberta, municipal","48033","Total other Criminal Code violations","9087","9850","301","0","1391.28","0","0","0","0","10151","6364","7686","1322","48"
"1999","Edmonton, Alberta, municipal","48033","Total other Criminal Code violations","8186","9695","286","-11.32","1233.8","0","0","0","0","9981","6449","7542","1093","33"
"2000","Edmonton, Alberta, municipal","48033","Total other Criminal Code violations","8344","11182","313","0.4","1238.76","0","0","0","0","11495","7373","8646","1273","31"
"2001","Edmonton, Alberta, municipal","48033","Total other Criminal Code violations","12086","11554","359","42.87","1769.78","0","0","0","0","11913","9153","10656","1503","24"
"2002","Edmonton, Alberta, municipal","48033","Total other Criminal Code violations","11847","11447","210","-3.67","1704.89","0","0","0","0","11657","9132","10397","1265","20"
"2003","Edmonton, Alberta, municipal","48033","Total other Criminal Code violations","12401","12123","114","3.5","1764.61","0","0","0","0","12237","9864","11302","1438","13"
"2004","Edmonton, Alberta, municipal","48033","Total other Criminal Code violations","11891","11589","127","-6.48","1650.21","1698.09","1742.53","2199.15","48.83","11716","9649","10865","1216","27"
"2005","Edmonton, Alberta, municipal","48033","Total other Criminal Code violations","11630","11103","128","-4.41","1577.39","1435.51","1466.12","1788.03","37.81","11231","8382","9375","993","21"
"2006","Edmonton, Alberta, municipal","48033","Total other Criminal Code violations","11184","10559","212","-6.58","1473.55","798.28","821.33","1069.8","46.44","10771","4819","5418","599","26"
"2007","Edmonton, Alberta, municipal","48033","Total other Criminal Code violations","9541","9663","94","-16.91","1224.45","1218.55","1241.08","1492.67","37.68","9757","7583","8415","832","21"
"2008","Edmonton, Alberta, municipal","48033","Total other Criminal Code violations","14168","13751","149","45.07","1776.31","1639.19","1683.71","2197.19","83.05","13900","10473","11690","1217","46"
"2009","Edmonton, Alberta, municipal","48033","Total other Criminal Code violations","13668","12939","215","-5.92","1671.18","1448.81","1485.57","1925.49","74.69","13154","9519","10576","1057","41"
"2010","Edmonton, Alberta, municipal","48033","Total other Criminal Code violations","14229","13252","344","2.44","1711.95","1406.51","1423.74","1634.72","183.26","13596","9398","10290","892","100"
"2011","Edmonton, Alberta, municipal","48033","Total other Criminal Code violations","14746","13729","257","1.87","1743.88","1339.27","1351.48","1502.24","132.6","13986","9102","9929","827","73"
"2012","Edmonton, Alberta, municipal","48033","Total other Criminal Code violations","14951","13855","247","-1.15","1723.77","1337.01","1347.13","1476.65","124.58","14102","9340","10146","806","68"
"2013","Edmonton, Alberta, municipal","48033","Total other Criminal Code violations","15369","14235","326","-0.59","1713.6","1278.07","1293.75","1502.19","143.24","14561","9252","10070","818","78"
"2014","Edmonton, Alberta, municipal","48033","Total other Criminal Code violations","17441","15557","939","9.78","1881.24","1417.54","1428.33","1576.97","124.98","16496","10623","11481","858","68"
"2015","Edmonton, Alberta, municipal","48033","Total other Criminal Code violations","19724","17667","1107","10.65","2081.53","1540.4","1554.01","1744.26","147.94","18774","11788","12743","955","81"
"2016","Edmonton, Alberta, municipal","48033","Total other Criminal Code violations","23560","21264","1368","16.8","2431.2","1889.21","1863.27","1499.26","91.57","22632","14764","15599","835","51"
"1998","Edmonton, Alberta, municipal","48033","Counterfeiting","25","20","5","0","3.83","0","0","0","0","25","18","22","4","4"
"1999","Edmonton, Alberta, municipal","48033","Counterfeiting","86","79","7","238.64","12.96","0","0","0","0","86","65","75","10","3"
"2000","Edmonton, Alberta, municipal","48033","Counterfeiting","43","40","3","-50.75","6.38","0","0","0","0","43","34","38","4","6"
"2001","Edmonton, Alberta, municipal","48033","Counterfeiting","30","30","0","-31.19","4.39","0","0","0","0","30","31","35","4","0"
"2002","Edmonton, Alberta, municipal","48033","Counterfeiting","73","69","4","139.14","10.51","0","0","0","0","73","76","78","2","1"
"2003","Edmonton, Alberta, municipal","48033","Counterfeiting","54","54","0","-26.86","7.68","0","0","0","0","54","52","57","5","0"
"2004","Edmonton, Alberta, municipal","48033","Counterfeiting","88","82","6","58.93","12.21","14.25","13.31","3.62","5.43","88","81","83","2","3"
"2005","Edmonton, Alberta, municipal","48033","Counterfeiting","59","57","2","-34.48","8","9.08","8.91","7.2","5.4","59","53","57","4","3"
"2006","Edmonton, Alberta, municipal","48033","Counterfeiting","29","25","4","-52.25","3.82","3.31","3.18","1.79","1.79","29","20","21","1","1"
"2007","Edmonton, Alberta, municipal","48033","Counterfeiting","17","15","2","-42.9","2.18","1.93","1.77","0","1.79","17","12","12","0","1"
"2008","Edmonton, Alberta, municipal","48033","Counterfeiting","61","58","3","250.55","7.65","7.83","7.49","3.61","1.81","61","50","52","2","1"
"2009","Edmonton, Alberta, municipal","48033","Counterfeiting","33","31","2","-47.24","4.03","4.72","4.35","0","0","33","31","31","0","0"
"2010","Edmonton, Alberta, municipal","48033","Counterfeiting","12","10","2","-64.22","1.44","1.2","1.25","1.83","0","12","8","9","1","0"
"2011","Edmonton, Alberta, municipal","48033","Counterfeiting","26","23","3","112.97","3.07","3.97","3.68","0","3.63","26","27","27","0","2"
"2012","Edmonton, Alberta, municipal","48033","Counterfeiting","8","5","3","-70","0.92","0.72","0.66","0","3.66","8","5","5","0","2"
"2013","Edmonton, Alberta, municipal","48033","Counterfeiting","7","7","0","-15.38","0.78","0.97","0.9","0","0","7","7","7","0","0"
"2014","Edmonton, Alberta, municipal","48033","Counterfeiting","9","8","1","24.38","0.97","0.93","0.87","0","0","9","7","7","0","0"
"2015","Edmonton, Alberta, municipal","48033","Counterfeiting","14","9","5","52.19","1.48","0.78","0.73","0","0","14","6","6","0","0"
"2016","Edmonton, Alberta, municipal","48033","Counterfeiting","33","26","7","130.49","3.41","2.94","2.75","0","0","33","23","23","0","0"
"1998","Edmonton, Alberta, municipal","48033","Total weapons violations","288","247","15","0","44.09","0","0","0","0","262","209","288","79","17"
"1999","Edmonton, Alberta, municipal","48033","Total weapons violations","263","231","14","-10.1","39.64","0","0","0","0","245","196","273","77","13"
"2000","Edmonton, Alberta, municipal","48033","Total weapons violations","268","243","12","0.37","39.79","0","0","0","0","255","193","268","75","8"
"2001","Edmonton, Alberta, municipal","48033","Total weapons violations","307","300","5","12.99","44.95","0","0","0","0","305","263","357","94","8"
"2002","Edmonton, Alberta, municipal","48033","Total weapons violations","283","275","4","-9.41","40.73","0","0","0","0","279","228","310","82","3"
"2003","Edmonton, Alberta, municipal","48033","Total weapons violations","311","306","3","8.66","44.25","0","0","0","0","309","238","317","79","3"
"2004","Edmonton, Alberta, municipal","48033","Total weapons violations","308","298","7","-3.41","42.74","42.41","51","139.26","12.66","305","241","318","77","7"
"2005","Edmonton, Alberta, municipal","48033","Total weapons violations","267","243","14","-15.28","36.21","33.57","39.1","97.23","21.61","257","196","250","54","12"
"2006","Edmonton, Alberta, municipal","48033","Total weapons violations","350","316","12","27.34","46.11","37.6","42.6","96.44","19.65","328","227","281","54","11"
"2007","Edmonton, Alberta, municipal","48033","Total weapons violations","349","315","19","-2.87","44.79","36.16","44.54","138.14","23.32","334","225","302","77","13"
"2008","Edmonton, Alberta, municipal","48033","Total weapons violations","428","320","46","19.81","53.66","39.76","47.39","135.41","39.72","366","254","329","75","22"
"2009","Edmonton, Alberta, municipal","48033","Total weapons violations","368","278","38","-16.15","45","35.46","41.44","112.94","29.15","316","233","295","62","16"
"2010","Edmonton, Alberta, municipal","48033","Total weapons violations","453","298","60","21.13","54.5","39.06","44.69","113.62","60.48","358","261","323","62","33"
"2011","Edmonton, Alberta, municipal","48033","Total weapons violations","426","304","35","-7.56","50.38","40.02","45.05","107.17","54.49","339","272","331","59","30"
"2012","Edmonton, Alberta, municipal","48033","Total weapons violations","454","331","35","3.9","52.34","41.94","46.47","104.43","40.31","366","293","350","57","22"
"2013","Edmonton, Alberta, municipal","48033","Total weapons violations","612","463","36","30.36","68.24","58.85","65.52","154.26","51.42","499","426","510","84","28"
"2014","Edmonton, Alberta, municipal","48033","Total weapons violations","780","642","40","23.3","84.13","84.33","87.58","132.33","34.92","682","632","704","72","19"
"2015","Edmonton, Alberta, municipal","48033","Total weapons violations","1132","913","67","41.99","119.46","109.51","113.9","175.34","62.1","980","838","934","96","34"
"2016","Edmonton, Alberta, municipal","48033","Total weapons violations","1141","932","63","-1.44","117.74","118.36","120.88","156.21","41.3","995","925","1012","87","23"
"1998","Edmonton, Alberta, municipal","48033","Offensive weapons, explosives","5","2","1","0","0.77","0","0","0","0","3","1","2","1","1"
"1999","Edmonton, Alberta, municipal","48033","Offensive weapons, explosives","6","4","0","18.13","0.9","0","0","0","0","4","3","4","1","0"
"2000","Edmonton, Alberta, municipal","48033","Offensive weapons, explosives","3","1","0","-50.75","0.45","0","0","0","0","1","1","2","1","0"
"2001","Edmonton, Alberta, municipal","48033","Offensive weapons, explosives","1","1","0","-67.12","0.15","0","0","0","0","1","0","0","0","0"
"2002","Edmonton, Alberta, municipal","48033","Offensive weapons, explosives","4","2","0","293.11","0.58","0","0","0","0","2","1","1","0","0"
"2003","Edmonton, Alberta, municipal","48033","Offensive weapons, explosives","6","5","1","48.32","0.85","0","0","0","0","6","5","6","1","0"
"2004","Edmonton, Alberta, municipal","48033","Offensive weapons, explosives","4","3","0","-34.98","0.56","0.7","0.64","0","0","3","4","4","0","0"
"2005","Edmonton, Alberta, municipal","48033","Offensive weapons, explosives","1","1","0","-75.57","0.14","0.17","0.16","0","0","1","1","1","0","0"
"2006","Edmonton, Alberta, municipal","48033","Offensive weapons, explosives","2","0","0","94.29","0.26","0","0","0","0","0","0","0","0","0"
"2007","Edmonton, Alberta, municipal","48033","Offensive weapons, explosives","2","2","0","-2.6","0.26","0.16","0.29","1.79","0","2","1","2","1","0"
"2008","Edmonton, Alberta, municipal","48033","Offensive weapons, explosives","5","3","0","144.23","0.63","0.31","0.86","7.22","0","3","2","6","4","0"
"2009","Edmonton, Alberta, municipal","48033","Offensive weapons, explosives","6","0","1","17.03","0.73","0","0","0","1.82","1","0","0","0","1"
"2010","Edmonton, Alberta, municipal","48033","Offensive weapons, explosives","14","6","0","129.6","1.68","1.2","1.11","0","0","6","8","8","0","0"
"2011","Edmonton, Alberta, municipal","48033","Offensive weapons, explosives","14","0","0","-1.71","1.66","0","0","0","0","0","0","0","0","0"
"2012","Edmonton, Alberta, municipal","48033","Offensive weapons, explosives","14","3","0","-2.51","1.61","0.43","0.4","0","0","3","3","3","0","0"
"2013","Edmonton, Alberta, municipal","48033","Offensive weapons, explosives","11","2","0","-24.02","1.23","0.55","0.51","0","0","2","4","4","0","0"
"2014","Edmonton, Alberta, municipal","48033","Offensive weapons, explosives","13","2","1","14.33","1.4","0.4","0.37","0","0","3","3","3","0","0"
"2015","Edmonton, Alberta, municipal","48033","Offensive weapons, explosives","27","4","0","103.2","2.85","0.65","0.61","0","0","4","5","5","0","0"
"2016","Edmonton, Alberta, municipal","48033","Offensive weapons, explosives","14","6","0","-49.3","1.44","1.15","1.08","0","0","6","9","9","0","0"
"1998","Edmonton, Alberta, municipal","48033","Offensive weapons, prohibited","26","22","2","0","3.98","0","0","0","0","24","22","29","7","3"
"1999","Edmonton, Alberta, municipal","48033","Offensive weapons, prohibited","25","24","0","-5.34","3.77","0","0","0","0","24","25","27","2","0"
"2000","Edmonton, Alberta, municipal","48033","Offensive weapons, prohibited","1","1","0","-96.06","0.15","0","0","0","0","1","1","1","0","0"
"2001","Edmonton, Alberta, municipal","48033","Offensive weapons, prohibited","0","0","0","-100","0","0","0","0","0","0","0","0","0","0"
"2002","Edmonton, Alberta, municipal","48033","Offensive weapons, prohibited","0","0","0","0","0","0","0","0","0","0","0","0","0","0"
"2003","Edmonton, Alberta, municipal","48033","Offensive weapons, prohibited","0","0","0","0","0","0","0","0","0","0","0","0","0","0"
"2004","Edmonton, Alberta, municipal","48033","Offensive weapons, prohibited","0","0","0","0","0","0","0","0","0","0","0","0","0","0"
"2005","Edmonton, Alberta, municipal","48033","Offensive weapons, prohibited","0","0","0","0","0","0","0","0","0","0","0","0","0","0"
"2006","Edmonton, Alberta, municipal","48033","Offensive weapons, prohibited","0","0","0","0","0","0","0","0","0","0","0","0","0","0"
"2007","Edmonton, Alberta, municipal","48033","Offensive weapons, prohibited","0","0","0","0","0","0","0","0","0","0","0","0","0","0"
"2008","Edmonton, Alberta, municipal","48033","Offensive weapons, prohibited","0","0","0","0","0","0","0","0","0","0","0","0","0","0"
"2009","Edmonton, Alberta, municipal","48033","Offensive weapons, prohibited","0","0","0","0","0","0","0","0","0","0","0","0","0","0"
"2010","Edmonton, Alberta, municipal","48033","Offensive weapons, prohibited","0","0","0","0","0","0","0","0","0","0","0","0","0","0"
"2011","Edmonton, Alberta, municipal","48033","Offensive weapons, prohibited","0","0","0","0","0","0","0","0","0","0","0","0","0","0"
"2012","Edmonton, Alberta, municipal","48033","Offensive weapons, prohibited","0","0","0","0","0","0","0","0","0","0","0","0","0","0"
"2013","Edmonton, Alberta, municipal","48033","Offensive weapons, prohibited","0","0","0","0","0","0","0","0","0","0","0","0","0","0"
"2014","Edmonton, Alberta, municipal","48033","Offensive weapons, prohibited","0","0","0","0","0","0","0","0","0","0","0","0","0","0"
"2015","Edmonton, Alberta, municipal","48033","Offensive weapons, prohibited","0","0","0","0","0","0","0","0","0","0","0","0","0","0"
"2016","Edmonton, Alberta, municipal","48033","Offensive weapons, prohibited","0","0","0","0","0","0","0","0","0","0","0","0","0","0"
"1998","Edmonton, Alberta, municipal","48033","Offensive weapons, restricted","8","7","0","0","1.22","0","0","0","0","7","7","7","0","0"
"1999","Edmonton, Alberta, municipal","48033","Offensive weapons, restricted","6","5","0","-26.17","0.9","0","0","0","0","5","2","3","1","0"
"2000","Edmonton, Alberta, municipal","48033","Offensive weapons, restricted","0","0","0","-100","0","0","0","0","0","0","0","0","0","0"
"2001","Edmonton, Alberta, municipal","48033","Offensive weapons, restricted","0","0","0","0","0","0","0","0","0","0","0","0","0","0"
"2002","Edmonton, Alberta, municipal","48033","Offensive weapons, restricted","0","0","0","0","0","0","0","0","0","0","0","0","0","0"
"2003","Edmonton, Alberta, municipal","48033","Offensive weapons, restricted","0","0","0","0","0","0","0","0","0","0","0","0","0","0"
"2004","Edmonton, Alberta, municipal","48033","Offensive weapons, restricted","0","0","0","0","0","0","0","0","0","0","0","0","0","0"
"2005","Edmonton, Alberta, municipal","48033","Offensive weapons, restricted","0","0","0","0","0","0","0","0","0","0","0","0","0","0"
"2006","Edmonton, Alberta, municipal","48033","Offensive weapons, restricted","0","0","0","0","0","0","0","0","0","0","0","0","0","0"
"2007","Edmonton, Alberta, municipal","48033","Offensive weapons, restricted","0","0","0","0","0","0","0","0","0","0","0","0","0","0"
"2008","Edmonton, Alberta, municipal","48033","Offensive weapons, restricted","0","0","0","0","0","0","0","0","0","0","0","0","0","0"
"2009","Edmonton, Alberta, municipal","48033","Offensive weapons, restricted","0","0","0","0","0","0","0","0","0","0","0","0","0","0"
"2010","Edmonton, Alberta, municipal","48033","Offensive weapons, restricted","0","0","0","0","0","0","0","0","0","0","0","0","0","0"
"2011","Edmonton, Alberta, municipal","48033","Offensive weapons, restricted","0","0","0","0","0","0","0","0","0","0","0","0","0","0"
"2012","Edmonton, Alberta, municipal","48033","Offensive weapons, restricted","0","0","0","0","0","0","0","0","0","0","0","0","0","0"
"2013","Edmonton, Alberta, municipal","48033","Offensive weapons, restricted","0","0","0","0","0","0","0","0","0","0","0","0","0","0"
"2014","Edmonton, Alberta, municipal","48033","Offensive weapons, restricted","0","0","0","0","0","0","0","0","0","0","0","0","0","0"
"2015","Edmonton, Alberta, municipal","48033","Offensive weapons, restricted","0","0","0","0","0","0","0","0","0","0","0","0","0","0"
"2016","Edmonton, Alberta, municipal","48033","Offensive weapons, restricted","0","0","0","0","0","0","0","0","0","0","0","0","0","0"
"1998","Edmonton, Alberta, municipal","48033","Firearm transfers or serial numbers","7","6","0","0","1.07","0","0","0","0","6","5","6","1","0"
"1999","Edmonton, Alberta, municipal","48033","Firearm transfers or serial numbers","4","3","1","-43.75","0.6","0","0","0","0","4","3","3","0","0"
"2000","Edmonton, Alberta, municipal","48033","Firearm transfers or serial numbers","1","1","0","-75.37","0.15","0","0","0","0","1","1","1","0","0"
"2001","Edmonton, Alberta, municipal","48033","Firearm transfers or serial numbers","0","0","0","-100","0","0","0","0","0","0","0","0","0","0"
"2002","Edmonton, Alberta, municipal","48033","Firearm transfers or serial numbers","0","0","0","0","0","0","0","0","0","0","0","0","0","0"
"2003","Edmonton, Alberta, municipal","48033","Firearm transfers or serial numbers","0","0","0","0","0","0","0","0","0","0","0","0","0","0"
"2004","Edmonton, Alberta, municipal","48033","Firearm transfers or serial numbers","0","0","0","0","0","0","0","0","0","0","0","0","0","0"
"2005","Edmonton, Alberta, municipal","48033","Firearm transfers or serial numbers","0","0","0","0","0","0","0","0","0","0","0","0","0","0"
"2006","Edmonton, Alberta, municipal","48033","Firearm transfers or serial numbers","0","0","0","0","0","0","0","0","0","0","0","0","0","0"
"2007","Edmonton, Alberta, municipal","48033","Firearm transfers or serial numbers","0","0","0","0","0","0","0","0","0","0","0","0","0","0"
"2008","Edmonton, Alberta, municipal","48033","Firearm transfers or serial numbers","0","0","0","0","0","0","0","0","0","0","0","0","0","0"
"2009","Edmonton, Alberta, municipal","48033","Firearm transfers or serial numbers","0","0","0","0","0","0","0","0","0","0","0","0","0","0"
"2010","Edmonton, Alberta, municipal","48033","Firearm transfers or serial numbers","0","0","0","0","0","0","0","0","0","0","0","0","0","0"
"2011","Edmonton, Alberta, municipal","48033","Firearm transfers or serial numbers","0","0","0","0","0","0","0","0","0","0","0","0","0","0"
"2012","Edmonton, Alberta, municipal","48033","Firearm transfers or serial numbers","0","0","0","0","0","0","0","0","0","0","0","0","0","0"
"2013","Edmonton, Alberta, municipal","48033","Firearm transfers or serial numbers","0","0","0","0","0","0","0","0","0","0","0","0","0","0"
"2014","Edmonton, Alberta, municipal","48033","Firearm transfers or serial numbers","0","0","0","0","0","0","0","0","0","0","0","0","0","0"
"2015","Edmonton, Alberta, municipal","48033","Firearm transfers or serial numbers","0","0","0","0","0","0","0","0","0","0","0","0","0","0"
"2016","Edmonton, Alberta, municipal","48033","Firearm transfers or serial numbers","0","0","0","0","0","0","0","0","0","0","0","0","0","0"
"1998","Edmonton, Alberta, municipal","48033","Other offensive weapons","189","164","10","0","28.94","0","0","0","0","174","116","180","64","9"
"1999","Edmonton, Alberta, municipal","48033","Other offensive weapons","95","79","9","-50.52","14.32","0","0","0","0","88","74","103","29","9"
"2000","Edmonton, Alberta, municipal","48033","Other offensive weapons","5","3","1","-94.82","0.74","0","0","0","0","4","2","3","1","1"
"2001","Edmonton, Alberta, municipal","48033","Other offensive weapons","0","0","0","-100","0","0","0","0","0","0","0","0","0","0"
"2002","Edmonton, Alberta, municipal","48033","Other offensive weapons","0","0","0","0","0","0","0","0","0","0","0","0","0","0"
"2003","Edmonton, Alberta, municipal","48033","Other offensive weapons","0","0","0","0","0","0","0","0","0","0","0","0","0","0"
"2004","Edmonton, Alberta, municipal","48033","Other offensive weapons","0","0","0","0","0","0","0","0","0","0","0","0","0","0"
"2005","Edmonton, Alberta, municipal","48033","Other offensive weapons","0","0","0","0","0","0","0","0","0","0","0","0","0","0"
"2006","Edmonton, Alberta, municipal","48033","Other offensive weapons","0","0","0","0","0","0","0","0","0","0","0","0","0","0"
"2007","Edmonton, Alberta, municipal","48033","Other offensive weapons","0","0","0","0","0","0","0","0","0","0","0","0","0","0"
"2008","Edmonton, Alberta, municipal","48033","Other offensive weapons","0","0","0","0","0","0","0","0","0","0","0","0","0","0"
"2009","Edmonton, Alberta, municipal","48033","Other offensive weapons","0","0","0","0","0","0","0","0","0","0","0","0","0","0"
"2010","Edmonton, Alberta, municipal","48033","Other offensive weapons","0","0","0","0","0","0","0","0","0","0","0","0","0","0"
"2011","Edmonton, Alberta, municipal","48033","Other offensive weapons","0","0","0","0","0","0","0","0","0","0","0","0","0","0"
"2012","Edmonton, Alberta, municipal","48033","Other offensive weapons","0","0","0","0","0","0","0","0","0","0","0","0","0","0"
"2013","Edmonton, Alberta, municipal","48033","Other offensive weapons","0","0","0","0","0","0","0","0","0","0","0","0","0","0"
"2014","Edmonton, Alberta, municipal","48033","Other offensive weapons","0","0","0","0","0","0","0","0","0","0","0","0","0","0"
"2015","Edmonton, Alberta, municipal","48033","Other offensive weapons","0","0","0","0","0","0","0","0","0","0","0","0","0","0"
"2016","Edmonton, Alberta, municipal","48033","Other offensive weapons","0","0","0","0","0","0","0","0","0","0","0","0","0","0"
"1998","Edmonton, Alberta, municipal","48033","Weapons trafficking","8","8","0","0","1.22","0","0","0","0","8","10","10","0","0"
"1999","Edmonton, Alberta, municipal","48033","Weapons trafficking","1","1","0","-87.69","0.15","0","0","0","0","1","0","0","0","0"
"2000","Edmonton, Alberta, municipal","48033","Weapons trafficking","0","0","0","-100","0","0","0","0","0","0","0","0","0","0"
"2001","Edmonton, Alberta, municipal","48033","Weapons trafficking","3","3","0","0","0.44","0","0","0","0","3","2","3","1","0"
"2002","Edmonton, Alberta, municipal","48033","Weapons trafficking","3","2","0","-1.72","0.43","0","0","0","0","2","1","1","0","0"
"2003","Edmonton, Alberta, municipal","48033","Weapons trafficking","19","7","0","526.23","2.7","0","0","0","0","7","2","2","0","0"
"2004","Edmonton, Alberta, municipal","48033","Weapons trafficking","0","12","0","-100","0","0.35","0.32","0","0","12","2","2","0","0"
"2005","Edmonton, Alberta, municipal","48033","Weapons trafficking","0","0","0","0","0","0","0","0","0","0","0","0","0","0"
"2006","Edmonton, Alberta, municipal","48033","Weapons trafficking","3","2","1","0","0.4","0.33","0.3","0","0","3","2","2","0","0"
"2007","Edmonton, Alberta, municipal","48033","Weapons trafficking","0","0","0","-100","0","0","0","0","0","0","0","0","0","0"
"2008","Edmonton, Alberta, municipal","48033","Weapons trafficking","3","3","0","0","0.38","0.16","0.14","0","1.81","3","1","1","0","1"
"2009","Edmonton, Alberta, municipal","48033","Weapons trafficking","3","2","1","-2.48","0.37","0.3","0.28","0","0","3","2","2","0","0"
"2010","Edmonton, Alberta, municipal","48033","Weapons trafficking","4","1","0","31.2","0.48","0.15","0.14","0","0","1","1","1","0","0"
"2011","Edmonton, Alberta, municipal","48033","Weapons trafficking","1","0","1","-75.43","0.12","0","0","0","3.63","1","0","0","0","2"
"2012","Edmonton, Alberta, municipal","48033","Weapons trafficking","1","1","0","-2.51","0.12","0.14","0.13","0","0","1","1","1","0","0"
"2013","Edmonton, Alberta, municipal","48033","Weapons trafficking","2","2","0","93.41","0.22","0.28","0.26","0","0","2","2","2","0","0"
"2014","Edmonton, Alberta, municipal","48033","Weapons trafficking","4","2","0","93.48","0.43","0.27","0.25","0","0","2","2","2","0","0"
"2015","Edmonton, Alberta, municipal","48033","Weapons trafficking","2","2","0","-51.08","0.21","0","0","0","0","2","0","0","0","0"
"2016","Edmonton, Alberta, municipal","48033","Weapons trafficking","8","7","0","291.13","0.83","1.41","1.31","0","0","7","11","11","0","0"
"1998","Edmonton, Alberta, municipal","48033","Weapons possession contrary to order","1","1","0","0","0.15","0","0","0","0","1","1","1","0","0"
"1999","Edmonton, Alberta, municipal","48033","Weapons possession contrary to order","1","1","0","-1.56","0.15","0","0","0","0","1","0","0","0","0"
"2000","Edmonton, Alberta, municipal","48033","Weapons possession contrary to order","9","8","0","786.51","1.34","0","0","0","0","8","7","8","1","0"
"2001","Edmonton, Alberta, municipal","48033","Weapons possession contrary to order","11","11","0","20.55","1.61","0","0","0","0","11","13","13","0","0"
"2002","Edmonton, Alberta, municipal","48033","Weapons possession contrary to order","9","9","0","-19.59","1.3","0","0","0","0","9","8","9","1","0"
"2003","Edmonton, Alberta, municipal","48033","Weapons possession contrary to order","14","14","0","53.81","1.99","0","0","0","0","14","14","14","0","0"
"2004","Edmonton, Alberta, municipal","48033","Weapons possession contrary to order","15","14","0","4.49","2.08","2.64","2.41","0","0","14","15","15","0","0"
"2005","Edmonton, Alberta, municipal","48033","Weapons possession contrary to order","28","27","0","82.43","3.8","3.94","3.91","3.6","0","27","23","25","2","0"
"2006","Edmonton, Alberta, municipal","48033","Weapons possession contrary to order","13","13","0","-54.9","1.71","2.15","2.12","1.79","0","13","13","14","1","0"
"2007","Edmonton, Alberta, municipal","48033","Weapons possession contrary to order","23","27","0","72.33","2.95","4.34","4.13","1.79","0","27","27","28","1","0"
"2008","Edmonton, Alberta, municipal","48033","Weapons possession contrary to order","37","34","0","57.16","4.64","5.32","5.19","3.61","0","34","34","36","2","0"
"2009","Edmonton, Alberta, municipal","48033","Weapons possession contrary to order","31","30","1","-18.29","3.79","4.72","5.06","9.11","1.82","31","31","36","5","1"
"2010","Edmonton, Alberta, municipal","48033","Weapons possession contrary to order","33","31","1","4.75","3.97","5.24","4.98","1.83","0","32","35","36","1","0"
"2011","Edmonton, Alberta, municipal","48033","Weapons possession contrary to order","31","29","0","-7.66","3.67","4.41","4.22","1.82","0","29","30","31","1","0"
"2012","Edmonton, Alberta, municipal","48033","Weapons possession contrary to order","37","36","1","16.36","4.27","4.87","4.91","5.5","1.83","37","34","37","3","1"
"2013","Edmonton, Alberta, municipal","48033","Weapons possession contrary to order","39","36","0","1.93","4.35","6.35","6.17","3.67","0","36","46","48","2","0"
"2014","Edmonton, Alberta, municipal","48033","Weapons possession contrary to order","57","56","0","41.39","6.15","8.81","8.21","0","0","56","66","66","0","0"
"2015","Edmonton, Alberta, municipal","48033","Weapons possession contrary to order","88","89","1","51.05","9.29","12.94","12.56","7.31","1.83","90","99","103","4","1"
"2016","Edmonton, Alberta, municipal","48033","Weapons possession contrary to order","109","105","0","21.12","11.25","14.97","14.21","3.59","0","105","117","119","2","0"
"1998","Edmonton, Alberta, municipal","48033","Possession of weapons","41","35","2","0","6.28","0","0","0","0","37","46","52","6","4"
"1999","Edmonton, Alberta, municipal","48033","Possession of weapons","116","107","3","178.52","17.48","0","0","0","0","110","83","127","44","4"
"2000","Edmonton, Alberta, municipal","48033","Possession of weapons","236","217","11","100.4","35.04","0","0","0","0","228","171","242","71","7"
"2001","Edmonton, Alberta, municipal","48033","Possession of weapons","286","280","4","19.53","41.88","0","0","0","0","284","243","336","93","4"
"2002","Edmonton, Alberta, municipal","48033","Possession of weapons","260","256","4","-10.66","37.42","0","0","0","0","260","213","294","81","3"
"2003","Edmonton, Alberta, municipal","48033","Possession of weapons","266","275","2","1.16","37.85","0","0","0","0","277","214","292","78","3"
"2004","Edmonton, Alberta, municipal","48033","Possession of weapons","279","262","7","2.29","38.72","38.01","46.99","139.26","12.66","269","216","293","77","7"
"2005","Edmonton, Alberta, municipal","48033","Possession of weapons","231","208","14","-19.08","31.33","28.09","33.78","93.63","21.61","222","164","216","52","12"
"2006","Edmonton, Alberta, municipal","48033","Possession of weapons","321","294","9","34.99","42.29","34.12","39.26","94.66","19.65","303","206","259","53","11"
"2007","Edmonton, Alberta, municipal","48033","Possession of weapons","310","274","19","-5.93","39.78","29.73","38.35","134.56","23.32","293","185","260","75","13"
"2008","Edmonton, Alberta, municipal","48033","Possession of weapons","373","272","45","17.55","46.76","33.49","40.76","124.57","37.91","317","214","283","69","21"
"2009","Edmonton, Alberta, municipal","48033","Possession of weapons","318","238","34","-16.86","38.88","29.37","35.12","103.83","25.5","272","193","250","57","14"
"2010","Edmonton, Alberta, municipal","48033","Possession of weapons","394","256","57","21.92","47.4","32.03","38.05","111.79","58.64","313","214","275","61","32"
"2011","Edmonton, Alberta, municipal","48033","Possession of weapons","368","272","33","-8.19","43.52","35.17","40.43","105.36","50.86","305","239","297","58","28"
"2012","Edmonton, Alberta, municipal","48033","Possession of weapons","394","286","34","4.38","45.43","35.79","40.36","98.93","38.47","320","250","304","54","21"
"2013","Edmonton, Alberta, municipal","48033","Possession of weapons","537","422","32","31.81","59.87","51.53","58.46","150.59","49.58","454","373","455","82","27"
"2014","Edmonton, Alberta, municipal","48033","Possession of weapons","693","579","37","24.84","74.75","74.46","78.38","132.33","34.92","616","558","630","72","19"
"2015","Edmonton, Alberta, municipal","48033","Possession of weapons","995","814","64","40.48","105","95.52","100.24","166.21","60.27","878","731","822","91","33"
"2016","Edmonton, Alberta, municipal","48033","Possession of weapons","998","808","61","-1.92","102.99","100.19","103.68","152.62","41.3","869","783","868","85","23"
"1998","Edmonton, Alberta, municipal","48033","Unauthorized importing or exporting of weapons","2","2","0","0","0.31","0","0","0","0","2","1","1","0","0"
"1999","Edmonton, Alberta, municipal","48033","Unauthorized importing or exporting of weapons","0","0","0","-100","0","0","0","0","0","0","0","0","0","0"
"2000","Edmonton, Alberta, municipal","48033","Unauthorized importing or exporting of weapons","0","0","0","0","0","0","0","0","0","0","0","0","0","0"
"2001","Edmonton, Alberta, municipal","48033","Unauthorized importing or exporting of weapons","0","0","0","0","0","0","0","0","0","0","0","0","0","0"
"2002","Edmonton, Alberta, municipal","48033","Unauthorized importing or exporting of weapons","2","1","0","0","0.29","0","0","0","0","1","1","1","0","0"
"2003","Edmonton, Alberta, municipal","48033","Unauthorized importing or exporting of weapons","0","0","0","-100","0","0","0","0","0","0","0","0","0","0"
"2004","Edmonton, Alberta, municipal","48033","Unauthorized importing or exporting of weapons","0","0","0","0","0","0","0","0","0","0","0","0","0","0"
"2005","Edmonton, Alberta, municipal","48033","Unauthorized importing or exporting of weapons","0","0","0","0","0","0","0","0","0","0","0","0","0","0"
"2006","Edmonton, Alberta, municipal","48033","Unauthorized importing or exporting of weapons","1","0","1","0","0.13","0","0","0","0","1","0","0","0","0"
"2007","Edmonton, Alberta, municipal","48033","Unauthorized importing or exporting of weapons","0","0","0","-100","0","0","0","0","0","0","0","0","0","0"
"2008","Edmonton, Alberta, municipal","48033","Unauthorized importing or exporting of weapons","0","0","0","0","0","0","0","0","0","0","0","0","0","0"
"2009","Edmonton, Alberta, municipal","48033","Unauthorized importing or exporting of weapons","1","0","0","0","0.12","0","0","0","0","0","0","0","0","0"
"2010","Edmonton, Alberta, municipal","48033","Unauthorized importing or exporting of weapons","2","1","2","96.8","0.24","0.15","0.14","0","1.83","3","1","1","0","1"
"2011","Edmonton, Alberta, municipal","48033","Unauthorized importing or exporting of weapons","1","0","0","-50.85","0.12","0","0","0","0","0","0","0","0","0"
"2012","Edmonton, Alberta, municipal","48033","Unauthorized importing or exporting of weapons","3","2","0","192.47","0.35","0.29","0.27","0","0","2","2","2","0","0"
"2013","Edmonton, Alberta, municipal","48033","Unauthorized importing or exporting of weapons","14","0","4","351.3","1.56","0","0","0","1.84","4","0","0","0","1"
"2014","Edmonton, Alberta, municipal","48033","Unauthorized importing or exporting of weapons","10","1","2","-30.9","1.08","0.13","0.12","0","0","3","1","1","0","0"
"2015","Edmonton, Alberta, municipal","48033","Unauthorized importing or exporting of weapons","11","0","0","7.62","1.16","0","0","0","0","0","0","0","0","0"
"2016","Edmonton, Alberta, municipal","48033","Unauthorized importing or exporting of weapons","3","0","1","-73.33","0.31","0","0","0","0","1","0","0","0","0"
"1998","Edmonton, Alberta, municipal","48033","Firearms documentation or administration","0","0","0","0","0","0","0","0","0","0","0","0","0","0"
"1999","Edmonton, Alberta, municipal","48033","Firearms documentation or administration","0","0","0","0","0","0","0","0","0","0","0","0","0","0"
"2000","Edmonton, Alberta, municipal","48033","Firearms documentation or administration","1","0","0","0","0.15","0","0","0","0","0","0","0","0","0"
"2001","Edmonton, Alberta, municipal","48033","Firearms documentation or administration","0","0","0","-100","0","0","0","0","0","0","0","0","0","0"
"2002","Edmonton, Alberta, municipal","48033","Firearms documentation or administration","1","1","0","0","0.14","0","0","0","0","1","1","1","0","0"
"2003","Edmonton, Alberta, municipal","48033","Firearms documentation or administration","1","1","0","-1.12","0.14","0","0","0","0","1","0","0","0","0"
"2004","Edmonton, Alberta, municipal","48033","Firearms documentation or administration","1","0","0","-2.47","0.14","0","0","0","0","0","0","0","0","0"
"2005","Edmonton, Alberta, municipal","48033","Firearms documentation or administration","0","0","0","-100","0","0","0","0","0","0","0","0","0","0"
"2006","Edmonton, Alberta, municipal","48033","Firearms documentation or administration","1","1","0","0","0.13","0","0","0","0","1","0","0","0","0"
"2007","Edmonton, Alberta, municipal","48033","Firearms documentation or administration","0","0","0","-100","0","0","0","0","0","0","0","0","0","0"
"2008","Edmonton, Alberta, municipal","48033","Firearms documentation or administration","1","1","0","0","0.13","0.16","0.14","0","0","1","1","1","0","0"
"2009","Edmonton, Alberta, municipal","48033","Firearms documentation or administration","0","0","0","-100","0","0","0","0","0","0","0","0","0","0"
"2010","Edmonton, Alberta, municipal","48033","Firearms documentation or administration","2","0","0","0","0.24","0","0","0","0","0","0","0","0","0"
"2011","Edmonton, Alberta, municipal","48033","Firearms documentation or administration","5","0","0","145.73","0.59","0","0","0","0","0","0","0","0","0"
"2012","Edmonton, Alberta, municipal","48033","Firearms documentation or administration","0","0","0","-100","0","0","0","0","0","0","0","0","0","0"
"2013","Edmonton, Alberta, municipal","48033","Firearms documentation or administration","8","0","0","0","0.89","0","0","0","0","0","0","0","0","0"
"2014","Edmonton, Alberta, municipal","48033","Firearms documentation or administration","1","0","0","-87.91","0.11","0","0","0","0","0","0","0","0","0"
"2015","Edmonton, Alberta, municipal","48033","Firearms documentation or administration","3","2","0","193.52","0.32","0.13","0.24","1.83","0","2","1","2","1","0"
"2016","Edmonton, Alberta, municipal","48033","Firearms documentation or administration","4","3","0","30.38","0.41","0.26","0.24","0","0","3","2","2","0","0"
"1998","Edmonton, Alberta, municipal","48033","Unsafe storage of firearms","1","0","0","0","0.15","0","0","0","0","0","0","0","0","0"
"1999","Edmonton, Alberta, municipal","48033","Unsafe storage of firearms","9","7","1","785.98","1.36","0","0","0","0","8","6","6","0","0"
"2000","Edmonton, Alberta, municipal","48033","Unsafe storage of firearms","12","12","0","31.33","1.78","0","0","0","0","12","10","11","1","0"
"2001","Edmonton, Alberta, municipal","48033","Unsafe storage of firearms","6","5","1","-50.68","0.88","0","0","0","0","6","5","5","0","4"
"2002","Edmonton, Alberta, municipal","48033","Unsafe storage of firearms","4","4","0","-34.48","0.58","0","0","0","0","4","3","3","0","0"
"2003","Edmonton, Alberta, municipal","48033","Unsafe storage of firearms","5","4","0","23.6","0.71","0","0","0","0","4","3","3","0","0"
"2004","Edmonton, Alberta, municipal","48033","Unsafe storage of firearms","9","7","0","75.55","1.25","0.7","0.64","0","0","7","4","4","0","0"
"2005","Edmonton, Alberta, municipal","48033","Unsafe storage of firearms","7","7","0","-23.99","0.95","1.37","1.25","0","0","7","8","8","0","0"
"2006","Edmonton, Alberta, municipal","48033","Unsafe storage of firearms","9","6","1","24.9","1.19","0.99","0.91","0","0","7","6","6","0","0"
"2007","Edmonton, Alberta, municipal","48033","Unsafe storage of firearms","14","12","0","51.52","1.8","1.93","1.77","0","0","12","12","12","0","0"
"2008","Edmonton, Alberta, municipal","48033","Unsafe storage of firearms","9","7","1","-37.2","1.13","0.31","0.29","0","0","8","2","2","0","0"
"2009","Edmonton, Alberta, municipal","48033","Unsafe storage of firearms","9","8","1","-2.48","1.1","1.07","0.98","0","0","9","7","7","0","0"
"2010","Edmonton, Alberta, municipal","48033","Unsafe storage of firearms","4","3","0","-56.27","0.48","0.3","0.28","0","0","3","2","2","0","0"
"2011","Edmonton, Alberta, municipal","48033","Unsafe storage of firearms","6","3","1","47.44","0.71","0.44","0.41","0","0","4","3","3","0","0"
"2012","Edmonton, Alberta, municipal","48033","Unsafe storage of firearms","5","3","0","-18.76","0.58","0.43","0.4","0","0","3","3","3","0","0"
"2013","Edmonton, Alberta, municipal","48033","Unsafe storage of firearms","1","1","0","-80.66","0.11","0.14","0.13","0","0","1","1","1","0","0"
"2014","Edmonton, Alberta, municipal","48033","Unsafe storage of firearms","2","2","0","93.48","0.22","0.27","0.25","0","0","2","2","2","0","0"
"2015","Edmonton, Alberta, municipal","48033","Unsafe storage of firearms","6","2","2","193.52","0.63","0.26","0.24","0","0","4","2","2","0","0"
"2016","Edmonton, Alberta, municipal","48033","Unsafe storage of firearms","5","3","1","-18.52","0.52","0.38","0.36","0","0","4","3","3","0","0"
"1998","Edmonton, Alberta, municipal","48033","Child pornography","0","0","0","0","0","0","0","0","0","0","0","0","0","0"
"1999","Edmonton, Alberta, municipal","48033","Child pornography","2","1","0","0","0.3","0","0","0","0","1","1","1","0","0"
"2000","Edmonton, Alberta, municipal","48033","Child pornography","4","2","0","97","0.59","0","0","0","0","2","1","1","0","0"
"2001","Edmonton, Alberta, municipal","48033","Child pornography","5","5","0","23.29","0.73","0","0","0","0","5","1","1","0","0"
"2002","Edmonton, Alberta, municipal","48033","Child pornography","1","0","0","-80.34","0.14","0","0","0","0","0","0","0","0","0"
"2003","Edmonton, Alberta, municipal","48033","Child pornography","3","1","0","196.64","0.43","0","0","0","0","1","1","1","0","0"
"2004","Edmonton, Alberta, municipal","48033","Child pornography","8","8","0","160.08","1.11","1.06","0.96","0","0","8","6","6","0","0"
"2005","Edmonton, Alberta, municipal","48033","Child pornography","12","9","0","46.6","1.63","1.2","1.09","0","0","9","7","7","0","0"
"2006","Edmonton, Alberta, municipal","48033","Child pornography","31","8","2","150.95","4.08","1.33","1.21","0","0","10","8","8","0","0"
"2007","Edmonton, Alberta, municipal","48033","Child pornography","41","10","3","28.82","5.26","1.61","1.47","0","0","13","10","10","0","0"
"2008","Edmonton, Alberta, municipal","48033","Child pornography","50","6","4","19.14","6.27","0.94","0.86","0","3.61","10","6","6","0","2"
"2009","Edmonton, Alberta, municipal","48033","Child pornography","28","7","7","-45.39","3.42","0.91","0.84","0","1.82","14","6","6","0","1"
"2010","Edmonton, Alberta, municipal","48033","Child pornography","45","7","9","58.14","5.41","1.05","0.97","0","21.99","16","7","7","0","12"
"2011","Edmonton, Alberta, municipal","48033","Child pornography","40","3","7","-12.63","4.73","0.44","0.41","0","19.98","10","3","3","0","11"
"2012","Edmonton, Alberta, municipal","48033","Child pornography","30","8","3","-26.88","3.46","0.72","0.66","0","7.33","11","5","5","0","4"
"2013","Edmonton, Alberta, municipal","48033","Child pornography","46","11","8","48.28","5.13","1.24","1.28","1.84","16.53","19","9","10","1","9"
"2014","Edmonton, Alberta, municipal","48033","Child pornography","76","23","5","59.83","8.2","1.33","1.49","3.68","12.87","28","10","12","2","7"
"2015","Edmonton, Alberta, municipal","48033","Child pornography","92","19","10","18.44","9.71","1.57","1.71","3.65","23.74","29","12","14","2","13"
"2016","Edmonton, Alberta, municipal","48033","Child pornography","68","14","14","-27.73","7.02","1.66","1.55","0","8.98","28","13","13","0","5"
"2012","Edmonton, Alberta, municipal","48033","Making, or distribution of child pornography","0","0","0","0","0","0","0","0","0","0","0","0","0","0"
"2013","Edmonton, Alberta, municipal","48033","Making, or distribution of child pornography","0","0","0","0","0","0","0","0","0","0","0","0","0","0"
"2014","Edmonton, Alberta, municipal","48033","Making, or distribution of child pornography","0","0","0","0","0","0","0","0","0","0","0","0","0","0"
"2015","Edmonton, Alberta, municipal","48033","Making, or distribution of child pornography","0","0","0","0","0","0","0","0","0","0","0","0","0","0"
"2016","Edmonton, Alberta, municipal","48033","Making, or distribution of child pornography","40","3","2","0","4.13","0.38","0.36","0","5.39","5","3","3","0","3"
"1998","Edmonton, Alberta, municipal","48033","Total prostitution","480","266","198","0","73.49","0","0","0","0","464","240","259","19","4"
"1999","Edmonton, Alberta, municipal","48033","Total prostitution","470","261","220","-3.61","70.84","0","0","0","0","481","241","245","4","1"
"2000","Edmonton, Alberta, municipal","48033","Total prostitution","680","430","247","42.51","100.95","0","0","0","0","677","417","419","2","1"
"2001","Edmonton, Alberta, municipal","48033","Total prostitution","861","542","317","24.89","126.08","0","0","0","0","859","529","530","1","1"
"2002","Edmonton, Alberta, municipal","48033","Total prostitution","611","433","176","-30.26","87.93","0","0","0","0","609","434","434","0","0"
"2003","Edmonton, Alberta, municipal","48033","Total prostitution","415","312","95","-32.84","59.05","0","0","0","0","407","313","313","0","0"
"2004","Edmonton, Alberta, municipal","48033","Total prostitution","355","262","90","-16.57","49.27","46.11","42.02","0","0","352","262","262","0","0"
"2005","Edmonton, Alberta, municipal","48033","Total prostitution","465","376","86","28.01","63.07","62.17","56.92","1.8","3.6","462","363","364","1","2"
"2006","Edmonton, Alberta, municipal","48033","Total prostitution","636","436","158","32.87","83.8","55.49","51.09","3.57","5.36","594","335","337","2","3"
"2007","Edmonton, Alberta, municipal","48033","Total prostitution","333","332","24","-49","42.74","51.9","47.93","3.59","1.79","356","323","325","2","1"
"2008","Edmonton, Alberta, municipal","48033","Total prostitution","439","421","12","28.79","55.04","64.48","59.48","1.81","1.81","433","412","413","1","1"
"2009","Edmonton, Alberta, municipal","48033","Total prostitution","303","288","9","-32.69","37.05","42.31","39.47","5.46","0","297","278","281","3","0"
"2010","Edmonton, Alberta, municipal","48033","Total prostitution","273","255","6","-11.34","32.85","37.27","34.45","0","0","261","249","249","0","0"
"2011","Edmonton, Alberta, municipal","48033","Total prostitution","210","188","3","-24.39","24.83","27.96","26","1.82","1.82","191","190","191","1","1"
"2012","Edmonton, Alberta, municipal","48033","Total prostitution","149","123","5","-30.83","17.18","18.32","17","0","1.83","128","128","128","0","1"
"2013","Edmonton, Alberta, municipal","48033","Total prostitution","226","183","13","46.68","25.2","25.42","23.9","3.67","0","196","184","186","2","0"
"2014","Edmonton, Alberta, municipal","48033","Total prostitution","99","57","3","-57.62","10.68","7.47","6.97","0","0","60","56","56","0","0"
"2015","Edmonton, Alberta, municipal","48033","Total prostitution","0","0","0","-100","0","0","0","0","0","0","0","0","0","0"
"2016","Edmonton, Alberta, municipal","48033","Total prostitution","29","28","0","0","2.99","3.71","3.46","0","0","28","29","29","0","0"
"1998","Edmonton, Alberta, municipal","48033","Bawdy house","1","1","0","0","0.15","0","0","0","0","1","1","1","0","0"
"1999","Edmonton, Alberta, municipal","48033","Bawdy house","0","0","0","-100","0","0","0","0","0","0","0","0","0","0"
"2000","Edmonton, Alberta, municipal","48033","Bawdy house","0","0","0","0","0","0","0","0","0","0","0","0","0","0"
"2001","Edmonton, Alberta, municipal","48033","Bawdy house","0","0","0","0","0","0","0","0","0","0","0","0","0","0"
"2002","Edmonton, Alberta, municipal","48033","Bawdy house","0","0","0","0","0","0","0","0","0","0","0","0","0","0"
"2003","Edmonton, Alberta, municipal","48033","Bawdy house","0","0","0","0","0","0","0","0","0","0","0","0","0","0"
"2004","Edmonton, Alberta, municipal","48033","Bawdy house","1","0","0","0","0.14","0","0","0","0","0","0","0","0","0"
"2005","Edmonton, Alberta, municipal","48033","Bawdy house","0","0","0","-100","0","0","0","0","0","0","0","0","0","0"
"2006","Edmonton, Alberta, municipal","48033","Bawdy house","0","0","0","0","0","0","0","0","0","0","0","0","0","0"
"2007","Edmonton, Alberta, municipal","48033","Bawdy house","1","0","0","0","0.13","0","0","0","0","0","0","0","0","0"
"2008","Edmonton, Alberta, municipal","48033","Bawdy house","1","1","0","-2.31","0.13","0","0","0","0","1","0","0","0","0"
"2009","Edmonton, Alberta, municipal","48033","Bawdy house","0","0","0","-100","0","0","0","0","0","0","0","0","0","0"
"2010","Edmonton, Alberta, municipal","48033","Bawdy house","1","1","0","0","0.12","0.15","0.14","0","0","1","1","1","0","0"
"2011","Edmonton, Alberta, municipal","48033","Bawdy house","2","0","0","96.59","0.24","0","0","0","0","0","0","0","0","0"
"2012","Edmonton, Alberta, municipal","48033","Bawdy house","3","2","0","46.24","0.35","1","0.93","0","0","2","7","7","0","0"
"2013","Edmonton, Alberta, municipal","48033","Bawdy house","1","0","0","-67.76","0.11","0","0","0","0","0","0","0","0","0"
"2014","Edmonton, Alberta, municipal","48033","Bawdy house","8","0","1","673.93","0.86","0","0","0","0","1","0","0","0","0"
"2015","Edmonton, Alberta, municipal","48033","Bawdy house","0","0","0","-100","0","0","0","0","0","0","0","0","0","0"
"2016","Edmonton, Alberta, municipal","48033","Bawdy house","0","0","0","0","0","0","0","0","0","0","0","0","0","0"
"1998","Edmonton, Alberta, municipal","48033","Living off the avails of prostitution of a person under age 18","0","0","0","0","0","0","0","0","0","0","0","0","0","0"
"1999","Edmonton, Alberta, municipal","48033","Living off the avails of prostitution of a person under age 18","3","3","0","0","0.45","0","0","0","0","3","1","1","0","0"
"2000","Edmonton, Alberta, municipal","48033","Living off the avails of prostitution of a person under age 18","1","1","0","-67.17","0.15","0","0","0","0","1","1","1","0","0"
"2001","Edmonton, Alberta, municipal","48033","Living off the avails of prostitution of a person under age 18","0","0","0","-100","0","0","0","0","0","0","0","0","0","0"
"2002","Edmonton, Alberta, municipal","48033","Living off the avails of prostitution of a person under age 18","0","0","0","0","0","0","0","0","0","0","0","0","0","0"
"2003","Edmonton, Alberta, municipal","48033","Living off the avails of prostitution of a person under age 18","0","0","0","0","0","0","0","0","0","0","0","0","0","0"
"2004","Edmonton, Alberta, municipal","48033","Living off the avails of prostitution of a person under age 18","0","0","0","0","0","0","0","0","0","0","0","0","0","0"
"2005","Edmonton, Alberta, municipal","48033","Living off the avails of prostitution of a person under age 18","0","0","0","0","0","0","0","0","0","0","0","0","0","0"
"2006","Edmonton, Alberta, municipal","48033","Living off the avails of prostitution of a person under age 18","0","0","0","0","0","0","0","0","0","0","0","0","0","0"
"2007","Edmonton, Alberta, municipal","48033","Living off the avails of prostitution of a person under age 18","0","0","0","0","0","0","0","0","0","0","0","0","0","0"
"2008","Edmonton, Alberta, municipal","48033","Living off the avails of prostitution of a person under age 18","0","0","0","0","0","0","0","0","0","0","0","0","0","0"
"2009","Edmonton, Alberta, municipal","48033","Living off the avails of prostitution of a person under age 18","0","0","0","0","0","0","0","0","0","0","0","0","0","0"
"2010","Edmonton, Alberta, municipal","48033","Living off the avails of prostitution of a person under age 18","1","0","0","0","0.12","0","0","0","0","0","0","0","0","0"
"2011","Edmonton, Alberta, municipal","48033","Living off the avails of prostitution of a person under age 18","1","1","0","-1.71","0.12","0.15","0.14","0","0","1","1","1","0","0"
"2012","Edmonton, Alberta, municipal","48033","Living off the avails of prostitution of a person under age 18","2","2","0","94.98","0.23","0.29","0.27","0","0","2","2","2","0","0"
"2013","Edmonton, Alberta, municipal","48033","Living off the avails of prostitution of a person under age 18","2","2","0","-3.29","0.22","0.14","0.13","0","0","2","1","1","0","0"
"2014","Edmonton, Alberta, municipal","48033","Living off the avails of prostitution of a person under age 18","0","1","0","-100","0","0","0","0","0","1","0","0","0","0"
"2015","Edmonton, Alberta, municipal","48033","Living off the avails of prostitution of a person under age 18","0","0","0","0","0","0","0","0","0","0","0","0","0","0"
"2016","Edmonton, Alberta, municipal","48033","Living off the avails of prostitution of a person under age 18","0","0","0","0","0","0","0","0","0","0","0","0","0","0"
"1998","Edmonton, Alberta, municipal","48033","Procuring","35","29","1","0","5.36","0","0","0","0","30","15","17","2","0"
"1999","Edmonton, Alberta, municipal","48033","Procuring","14","14","0","-60.62","2.11","0","0","0","0","14","9","10","1","0"
"2000","Edmonton, Alberta, municipal","48033","Procuring","13","10","1","-8.53","1.93","0","0","0","0","11","8","8","0","0"
"2001","Edmonton, Alberta, municipal","48033","Procuring","2","1","0","-84.83","0.29","0","0","0","0","1","1","1","0","0"
"2002","Edmonton, Alberta, municipal","48033","Procuring","1","1","0","-50.86","0.14","0","0","0","0","1","1","1","0","0"
"2003","Edmonton, Alberta, municipal","48033","Procuring","2","3","0","97.76","0.28","0","0","0","0","3","6","6","0","0"
"2004","Edmonton, Alberta, municipal","48033","Procuring","1","0","0","-51.24","0.14","0","0","0","0","0","0","0","0","0"
"2005","Edmonton, Alberta, municipal","48033","Procuring","2","0","1","95.46","0.27","0","0","0","0","1","0","0","0","0"
"2006","Edmonton, Alberta, municipal","48033","Procuring","10","3","5","385.71","1.32","0.5","0.45","0","0","8","3","3","0","0"
"2007","Edmonton, Alberta, municipal","48033","Procuring","2","1","0","-80.52","0.26","0.16","0.15","0","0","1","1","1","0","0"
"2008","Edmonton, Alberta, municipal","48033","Procuring","4","3","0","95.39","0.5","0.16","0.14","0","0","3","1","1","0","0"
"2009","Edmonton, Alberta, municipal","48033","Procuring","0","0","0","-100","0","0","0","0","0","0","0","0","0","0"
"2010","Edmonton, Alberta, municipal","48033","Procuring","4","0","0","0","0.48","0","0","0","0","0","0","0","0","0"
"2011","Edmonton, Alberta, municipal","48033","Procuring","7","4","0","72.01","0.83","1.18","1.09","0","0","4","8","8","0","0"
"1998","Edmonton, Alberta, municipal","48033","Obtains or communicates with a person under age 18 for purpose of sex","0","0","0","0","0","0","0","0","0","0","0","0","0","0"
"1999","Edmonton, Alberta, municipal","48033","Obtains or communicates with a person under age 18 for purpose of sex","15","15","1","0","2.26","0","0","0","0","16","9","9","0","0"
"2000","Edmonton, Alberta, municipal","48033","Obtains or communicates with a person under age 18 for purpose of sex","3","3","0","-80.3","0.45","0","0","0","0","3","3","3","0","0"
"2001","Edmonton, Alberta, municipal","48033","Obtains or communicates with a person under age 18 for purpose of sex","1","0","0","-67.12","0.15","0","0","0","0","0","0","0","0","0"
"2002","Edmonton, Alberta, municipal","48033","Obtains or communicates with a person under age 18 for purpose of sex","5","3","0","391.38","0.72","0","0","0","0","3","3","3","0","0"
"2003","Edmonton, Alberta, municipal","48033","Obtains or communicates with a person under age 18 for purpose of sex","1","1","0","-80.22","0.14","0","0","0","0","1","2","2","0","0"
"2004","Edmonton, Alberta, municipal","48033","Obtains or communicates with a person under age 18 for purpose of sex","0","0","0","-100","0","0","0","0","0","0","0","0","0","0"
"2005","Edmonton, Alberta, municipal","48033","Obtains or communicates with a person under age 18 for purpose of sex","1","0","0","0","0.14","0","0","0","0","0","0","0","0","0"
"2006","Edmonton, Alberta, municipal","48033","Obtains or communicates with a person under age 18 for purpose of sex","0","0","0","-100","0","0","0","0","0","0","0","0","0","0"
"2007","Edmonton, Alberta, municipal","48033","Obtains or communicates with a person under age 18 for purpose of sex","1","1","0","0","0.13","0.16","0.15","0","0","1","1","1","0","0"
"2008","Edmonton, Alberta, municipal","48033","Obtains or communicates with a person under age 18 for purpose of sex","0","0","0","-100","0","0","0","0","0","0","0","0","0","0"
"2009","Edmonton, Alberta, municipal","48033","Obtains or communicates with a person under age 18 for purpose of sex","0","0","0","0","0","0","0","0","0","0","0","0","0","0"
"2010","Edmonton, Alberta, municipal","48033","Obtains or communicates with a person under age 18 for purpose of sex","2","1","0","0","0.24","0.15","0.14","0","0","1","1","1","0","0"
"2011","Edmonton, Alberta, municipal","48033","Obtains or communicates with a person under age 18 for purpose of sex","3","2","0","47.44","0.35","0.29","0.27","0","0","2","2","2","0","0"
"2012","Edmonton, Alberta, municipal","48033","Obtains or communicates with a person under age 18 for purpose of sex","7","0","0","127.48","0.81","0","0","0","0","0","0","0","0","0"
"2013","Edmonton, Alberta, municipal","48033","Obtains or communicates with a person under age 18 for purpose of sex","4","0","0","-44.74","0.45","0","0","0","0","0","0","0","0","0"
"2014","Edmonton, Alberta, municipal","48033","Obtains or communicates with a person under age 18 for purpose of sex","3","0","0","-27.44","0.32","0","0","0","0","0","0","0","0","0"
"2015","Edmonton, Alberta, municipal","48033","Obtains or communicates with a person under age 18 for purpose of sex","0","0","0","-100","0","0","0","0","0","0","0","0","0","0"
"2016","Edmonton, Alberta, municipal","48033","Obtains or communicates with a person under age 18 for purpose of sex","0","0","0","0","0","0","0","0","0","0","0","0","0","0"
"1998","Edmonton, Alberta, municipal","48033","Other prostitution","444","236","197","0","67.98","0","0","0","0","433","224","241","17","4"
"1999","Edmonton, Alberta, municipal","48033","Other prostitution","438","229","219","-2.89","66.02","0","0","0","0","448","222","225","3","1"
"2000","Edmonton, Alberta, municipal","48033","Other prostitution","663","416","246","49.1","98.43","0","0","0","0","662","405","407","2","1"
"2001","Edmonton, Alberta, municipal","48033","Other prostitution","858","541","317","27.64","125.64","0","0","0","0","858","528","529","1","1"
"2002","Edmonton, Alberta, municipal","48033","Other prostitution","605","429","176","-30.7","87.07","0","0","0","0","605","430","430","0","0"
"2003","Edmonton, Alberta, municipal","48033","Other prostitution","412","308","95","-32.66","58.63","0","0","0","0","403","305","305","0","0"
"2004","Edmonton, Alberta, municipal","48033","Other prostitution","353","262","90","-16.44","48.99","46.11","42.02","0","0","352","262","262","0","0"
"2005","Edmonton, Alberta, municipal","48033","Other prostitution","462","376","85","27.91","62.66","62.17","56.92","1.8","3.6","461","363","364","1","2"
"2006","Edmonton, Alberta, municipal","48033","Other prostitution","626","433","153","31.63","82.48","55","50.63","3.57","5.36","586","332","334","2","3"
"2007","Edmonton, Alberta, municipal","48033","Other prostitution","329","330","24","-48.81","42.22","51.58","47.64","3.59","1.79","354","321","323","2","1"
"2008","Edmonton, Alberta, municipal","48033","Other prostitution","434","417","12","28.87","54.41","64.33","59.34","1.81","1.81","429","411","412","1","1"
"2009","Edmonton, Alberta, municipal","48033","Other prostitution","303","288","9","-31.91","37.05","42.31","39.47","5.46","0","297","278","281","3","0"
"2010","Edmonton, Alberta, municipal","48033","Other prostitution","265","253","6","-13.94","31.88","36.97","34.18","0","0","259","247","247","0","0"
"2011","Edmonton, Alberta, municipal","48033","Other prostitution","197","181","3","-26.93","23.3","26.34","24.5","1.82","1.82","184","179","180","1","1"
"2012","Edmonton, Alberta, municipal","48033","Other prostitution","130","112","5","-35.67","14.99","15.17","14.07","0","1.83","117","106","106","0","1"
"2013","Edmonton, Alberta, municipal","48033","Other prostitution","206","175","12","53.24","22.97","24.04","22.35","0","0","187","174","174","0","0"
"2014","Edmonton, Alberta, municipal","48033","Other prostitution","69","55","2","-67.6","7.44","7.34","6.84","0","0","57","55","55","0","0"
"2015","Edmonton, Alberta, municipal","48033","Other prostitution","0","0","0","-100","0","0","0","0","0","0","0","0","0","0"
"2016","Edmonton, Alberta, municipal","48033","Other prostitution","0","0","0","0","0","0","0","0","0","0","0","0","0","0"
"2012","Edmonton, Alberta, municipal","48033","Communicating to provide sexual services for consideration","0","0","0","0","0","0","0","0","0","0","0","0","0","0"
"2013","Edmonton, Alberta, municipal","48033","Communicating to provide sexual services for consideration","0","0","0","0","0","0","0","0","0","0","0","0","0","0"
"2014","Edmonton, Alberta, municipal","48033","Communicating to provide sexual services for consideration","0","0","0","0","0","0","0","0","0","0","0","0","0","0"
"2015","Edmonton, Alberta, municipal","48033","Communicating to provide sexual services for consideration","0","0","0","0","0","0","0","0","0","0","0","0","0","0"
"2016","Edmonton, Alberta, municipal","48033","Communicating to provide sexual services for consideration","28","27","0","0","2.89","3.58","3.34","0","0","27","28","28","0","0"
"2012","Edmonton, Alberta, municipal","48033","Stopping or impeding traffic for the purpose of offering, providing or obtaining sexual services for consideration","0","0","0","0","0","0","0","0","0","0","0","0","0","0"
"2013","Edmonton, Alberta, municipal","48033","Stopping or impeding traffic for the purpose of offering, providing or obtaining sexual services for consideration","0","0","0","0","0","0","0","0","0","0","0","0","0","0"
"2014","Edmonton, Alberta, municipal","48033","Stopping or impeding traffic for the purpose of offering, providing or obtaining sexual services for consideration","0","0","0","0","0","0","0","0","0","0","0","0","0","0"
"2015","Edmonton, Alberta, municipal","48033","Stopping or impeding traffic for the purpose of offering, providing or obtaining sexual services for consideration","0","0","0","0","0","0","0","0","0","0","0","0","0","0"
"2016","Edmonton, Alberta, municipal","48033","Stopping or impeding traffic for the purpose of offering, providing or obtaining sexual services for consideration","1","1","0","0","0.1","0.13","0.12","0","0","1","1","1","0","0"
"1998","Edmonton, Alberta, municipal","48033","Disturb the peace","250","231","5","0","38.28","0","0","0","0","236","244","261","17","1"
"1999","Edmonton, Alberta, municipal","48033","Disturb the peace","167","157","1","-34.24","25.17","0","0","0","0","158","163","180","17","0"
"2000","Edmonton, Alberta, municipal","48033","Disturb the peace","137","127","2","-19.19","20.34","0","0","0","0","129","119","134","15","2"
"2001","Edmonton, Alberta, municipal","48033","Disturb the peace","152","145","2","9.43","22.26","0","0","0","0","147","138","159","21","2"
"2002","Edmonton, Alberta, municipal","48033","Disturb the peace","106","100","1","-31.46","15.25","0","0","0","0","101","91","101","10","1"
"2003","Edmonton, Alberta, municipal","48033","Disturb the peace","72","65","4","-32.84","10.25","0","0","0","0","69","55","70","15","0"
"2004","Edmonton, Alberta, municipal","48033","Disturb the peace","63","60","0","-14.66","8.74","9.86","9.78","9.04","0","60","56","61","5","0"
"2005","Edmonton, Alberta, municipal","48033","Disturb the peace","63","52","2","-2.27","8.54","8.56","8.6","9","3.6","54","50","55","5","2"
"2006","Edmonton, Alberta, municipal","48033","Disturb the peace","54","42","7","-16.73","7.11","6.46","6.22","3.57","3.57","49","39","41","2","2"
"2007","Edmonton, Alberta, municipal","48033","Disturb the peace","33","31","1","-40.48","4.24","3.7","3.69","3.59","0","32","23","25","2","0"
"2008","Edmonton, Alberta, municipal","48033","Disturb the peace","72","33","21","113.15","9.03","4.38","4.18","1.81","7.22","54","28","29","1","4"
"2009","Edmonton, Alberta, municipal","48033","Disturb the peace","135","29","52","82.86","16.51","4.11","3.93","1.82","14.57","81","27","28","1","8"
"2010","Edmonton, Alberta, municipal","48033","Disturb the peace","362","32","124","163.86","43.55","3.44","3.32","1.83","40.32","156","23","24","1","22"
"2011","Edmonton, Alberta, municipal","48033","Disturb the peace","352","47","84","-4.42","41.63","5.59","5.31","1.82","34.51","131","38","39","1","19"
"2012","Edmonton, Alberta, municipal","48033","Disturb the peace","376","32","78","4.14","43.35","3.58","3.45","1.83","18.32","110","25","26","1","10"
"2013","Edmonton, Alberta, municipal","48033","Disturb the peace","325","40","79","-16.41","36.24","4.01","3.73","0","36.73","119","29","29","0","20"
"2014","Edmonton, Alberta, municipal","48033","Disturb the peace","363","34","92","8.05","39.15","3.34","3.48","5.51","40.44","126","25","28","3","22"
"2015","Edmonton, Alberta, municipal","48033","Disturb the peace","374","49","89","0.8","39.47","4.83","4.51","0","25.57","138","37","37","0","14"
"2016","Edmonton, Alberta, municipal","48033","Disturb the peace","320","47","77","-16.34","33.02","3.33","3.23","1.8","12.57","124","26","27","1","7"
"1998","Edmonton, Alberta, municipal","48033","Total administration of justice violations","6701","8240","11","0","1025.97","0","0","0","0","8251","5007","6097","1090","5"
"1999","Edmonton, Alberta, municipal","48033","Total administration of justice violations","6328","8407","11","-7.04","953.76","0","0","0","0","8418","5318","6242","924","4"
"2000","Edmonton, Alberta, municipal","48033","Total administration of justice violations","6428","9841","12","0.06","954.31","0","0","0","0","9853","6211","7309","1098","7"
"2001","Edmonton, Alberta, municipal","48033","Total administration of justice violations","10035","10027","8","53.98","1469.45","0","0","0","0","10035","7787","9084","1297","3"
"2002","Edmonton, Alberta, municipal","48033","Total administration of justice violations","10202","10164","13","-0.09","1468.16","0","0","0","0","10177","7977","9083","1106","1"
"2003","Edmonton, Alberta, municipal","48033","Total administration of justice violations","11027","11017","5","6.87","1569.09","0","0","0","0","11022","8919","10195","1276","3"
"2004","Edmonton, Alberta, municipal","48033","Total administration of justice violations","10579","10561","5","-6.43","1468.14","1535.66","1572.2","1947.77","3.62","10566","8726","9803","1077","2"
"2005","Edmonton, Alberta, municipal","48033","Total administration of justice violations","10281","10015","6","-5.02","1394.42","1269.04","1297.54","1597.16","0","10021","7410","8297","887","0"
"2006","Edmonton, Alberta, municipal","48033","Total administration of justice violations","9562","9394","13","-9.65","1259.85","656.48","678.68","917.99","8.93","9407","3963","4477","514","5"
"2007","Edmonton, Alberta, municipal","48033","Total administration of justice violations","8202","8643","15","-16.45","1052.61","1084.53","1102.15","1298.91","1.79","8658","6749","7473","724","1"
"2008","Edmonton, Alberta, municipal","48033","Total administration of justice violations","12584","12604","24","49.89","1577.72","1479.86","1521.53","2002.2","7.22","12628","9455","10564","1109","4"
"2009","Edmonton, Alberta, municipal","48033","Total administration of justice violations","12135","11995","47","-5.96","1483.74","1323.7","1358.16","1770.65","7.29","12042","8697","9669","972","4"
"2010","Edmonton, Alberta, municipal","48033","Total administration of justice violations","12454","12301","76","0.99","1498.39","1281.84","1297","1482.61","20.16","12377","8565","9374","809","11"
"2011","Edmonton, Alberta, municipal","48033","Total administration of justice violations","12937","12737","71","2.11","1529.95","1217.14","1226.8","1346.02","9.08","12808","8272","9013","741","5"
"2012","Edmonton, Alberta, municipal","48033","Total administration of justice violations","13058","12861","54","-1.6","1505.52","1220.63","1226.44","1300.77","20.15","12915","8527","9237","710","11"
"2013","Edmonton, Alberta, municipal","48033","Total administration of justice violations","13304","13009","137","-1.47","1483.36","1136.89","1148.18","1298.34","16.53","13146","8230","8937","707","9"
"2014","Edmonton, Alberta, municipal","48033","Total administration of justice violations","15132","14199","750","10.03","1632.19","1268.62","1275.93","1376.64","31.25","14949","9507","10256","749","17"
"2015","Edmonton, Alberta, municipal","48033","Total administration of justice violations","17034","15972","884","10.14","1797.64","1360.46","1370.6","1512.3","23.74","16856","10411","11239","828","13"
"2016","Edmonton, Alberta, municipal","48033","Total administration of justice violations","20811","19496","1156","19.46","2147.53","1697.66","1671.32","1301.76","10.77","20652","13267","13992","725","6"
"1998","Edmonton, Alberta, municipal","48033","Fail to comply with order","4672","5795","2","0","715.31","0","0","0","0","5797","3398","4165","767","0"
"1999","Edmonton, Alberta, municipal","48033","Fail to comply with order","4596","5912","2","-3.16","692.71","0","0","0","0","5914","3594","4219","625","0"
"2000","Edmonton, Alberta, municipal","48033","Fail to comply with order","4338","6842","2","-7.03","644.03","0","0","0","0","6844","4191","4976","785","0"
"2001","Edmonton, Alberta, municipal","48033","Fail to comply with order","7297","7308","1","65.91","1068.52","0","0","0","0","7309","5548","6575","1027","0"
"2002","Edmonton, Alberta, municipal","48033","Fail to comply with order","6920","6915","0","-6.8","995.85","0","0","0","0","6915","5271","6122","851","0"
"2003","Edmonton, Alberta, municipal","48033","Fail to comply with order","7532","7537","1","7.62","1071.77","0","0","0","0","7538","6085","7066","981","1"
"2004","Edmonton, Alberta, municipal","48033","Fail to comply with order","7209","7215","0","-6.65","1000.45","1066.48","1109.51","1551.71","0","7215","6060","6918","858","0"
"2005","Edmonton, Alberta, municipal","48033","Fail to comply with order","6651","6558","1","-9.83","902.08","872.57","910.48","1309.06","0","6559","5095","5822","727","0"
"2006","Edmonton, Alberta, municipal","48033","Fail to comply with order","4718","4599","3","-31.09","621.62","384.81","411.42","698.31","5.36","4602","2323","2714","391","3"
"2007","Edmonton, Alberta, municipal","48033","Fail to comply with order","5829","6120","9","20.34","748.07","747.39","775.92","1094.39","0","6129","4651","5261","610","0"
"2008","Edmonton, Alberta, municipal","48033","Fail to comply with order","9002","9044","9","50.87","1128.62","1021.42","1065.39","1572.51","0","9053","6526","7397","871","0"
"2009","Edmonton, Alberta, municipal","48033","Fail to comply with order","8766","8699","19","-5.03","1071.81","891.45","934.1","1444.58","1.82","8718","5857","6650","793","1"
"2010","Edmonton, Alberta, municipal","48033","Fail to comply with order","9039","8995","28","1.47","1087.52","849.62","874.17","1174.72","3.67","9023","5677","6318","641","2"
"2011","Edmonton, Alberta, municipal","48033","Fail to comply with order","9541","9460","26","3.75","1128.33","802.94","821.72","1053.57","7.27","9486","5457","6037","580","4"
"2012","Edmonton, Alberta, municipal","48033","Fail to comply with order","9390","9302","31","-4.05","1082.62","776.3","795.59","1042.45","9.16","9333","5423","5992","569","5"
"2013","Edmonton, Alberta, municipal","48033","Fail to comply with order","9624","9440","103","-0.88","1073.05","708.79","729.1","999.01","1.84","9543","5131","5675","544","1"
"2014","Edmonton, Alberta, municipal","48033","Fail to comply with order","10996","10153","729","10.53","1186.06","802.25","822.09","1095.43","18.38","10882","6012","6608","596","10"
"2015","Edmonton, Alberta, municipal","48033","Fail to comply with order","12250","11266","858","9","1292.78","831.49","855.11","1185.37","18.26","12124","6363","7012","649","10"
"2016","Edmonton, Alberta, municipal","48033","Fail to comply with order","15216","14028","1118","21.46","1570.17","1088.31","1084.11","1025.25","5.39","15146","8505","9076","571","3"
"1998","Edmonton, Alberta, municipal","48033","Escape or helps to escape from lawful custody","11","19","0","0","1.68","0","0","0","0","19","16","17","1","0"
"1999","Edmonton, Alberta, municipal","48033","Escape or helps to escape from lawful custody","16","17","0","43.19","2.41","0","0","0","0","17","14","14","0","0"
"2000","Edmonton, Alberta, municipal","48033","Escape or helps to escape from lawful custody","11","12","0","-32.28","1.63","0","0","0","0","12","8","10","2","0"
"2001","Edmonton, Alberta, municipal","48033","Escape or helps to escape from lawful custody","17","17","0","52.43","2.49","0","0","0","0","17","18","19","1","0"
"2002","Edmonton, Alberta, municipal","48033","Escape or helps to escape from lawful custody","12","12","0","-30.63","1.73","0","0","0","0","12","11","12","1","0"
"2003","Edmonton, Alberta, municipal","48033","Escape or helps to escape from lawful custody","15","16","0","23.6","2.13","0","0","0","0","16","13","13","0","0"
"2004","Edmonton, Alberta, municipal","48033","Escape or helps to escape from lawful custody","18","19","0","17.03","2.5","2.82","2.89","3.62","0","19","16","18","2","0"
"2005","Edmonton, Alberta, municipal","48033","Escape or helps to escape from lawful custody","15","14","0","-18.56","2.03","1.88","2.03","3.6","0","14","11","13","2","0"
"2006","Edmonton, Alberta, municipal","48033","Escape or helps to escape from lawful custody","23","24","0","48.95","3.03","1.33","1.36","1.79","0","24","8","9","1","0"
"2007","Edmonton, Alberta, municipal","48033","Escape or helps to escape from lawful custody","12","12","0","-49.18","1.54","1.29","1.33","1.79","0","12","8","9","1","0"
"2008","Edmonton, Alberta, municipal","48033","Escape or helps to escape from lawful custody","27","25","0","119.81","3.39","2.19","3.31","16.25","3.61","25","14","23","9","2"
"2009","Edmonton, Alberta, municipal","48033","Escape or helps to escape from lawful custody","20","20","0","-27.76","2.45","1.83","1.83","1.82","0","20","12","13","1","0"
"2010","Edmonton, Alberta, municipal","48033","Escape or helps to escape from lawful custody","14","13","0","-31.12","1.68","1.35","1.25","0","0","13","9","9","0","0"
"2011","Edmonton, Alberta, municipal","48033","Escape or helps to escape from lawful custody","17","16","1","19.36","2.01","0.88","0.95","1.82","0","17","6","7","1","0"
"2012","Edmonton, Alberta, municipal","48033","Escape or helps to escape from lawful custody","17","16","0","-2.51","1.96","0.72","0.8","1.83","0","16","5","6","1","0"
"2013","Edmonton, Alberta, municipal","48033","Escape or helps to escape from lawful custody","18","18","0","2.39","2.01","1.24","1.28","1.84","0","18","9","10","1","0"
"2014","Edmonton, Alberta, municipal","48033","Escape or helps to escape from lawful custody","20","19","0","7.49","2.16","0.8","0.75","0","0","19","6","6","0","0"
"2015","Edmonton, Alberta, municipal","48033","Escape or helps to escape from lawful custody","13","13","0","-36.4","1.37","0.39","0.49","1.83","0","13","3","4","1","0"
"2016","Edmonton, Alberta, municipal","48033","Escape or helps to escape from lawful custody","15","14","1","12.83","1.55","0.77","0.72","0","0","15","6","6","0","0"
"1998","Edmonton, Alberta, municipal","48033","Prisoner unlawfully at large","284","309","0","0","43.48","0","0","0","0","309","217","293","76","0"
"1999","Edmonton, Alberta, municipal","48033","Prisoner unlawfully at large","284","312","0","-1.56","42.8","0","0","0","0","312","235","297","62","0"
"2000","Edmonton, Alberta, municipal","48033","Prisoner unlawfully at large","369","368","0","27.98","54.78","0","0","0","0","368","316","360","44","0"
"2001","Edmonton, Alberta, municipal","48033","Prisoner unlawfully at large","385","383","0","2.91","56.38","0","0","0","0","383","326","378","52","0"
"2002","Edmonton, Alberta, municipal","48033","Prisoner unlawfully at large","361","364","0","-7.85","51.95","0","0","0","0","364","326","360","34","0"
"2003","Edmonton, Alberta, municipal","48033","Prisoner unlawfully at large","409","409","0","12.03","58.2","0","0","0","0","409","371","399","28","0"
"2004","Edmonton, Alberta, municipal","48033","Prisoner unlawfully at large","454","453","0","8.26","63.01","72.68","72.01","65.11","0","453","413","449","36","0"
"2005","Edmonton, Alberta, municipal","48033","Prisoner unlawfully at large","413","410","0","-11.09","56.02","65.76","63.18","36.01","0","410","384","404","20","0"
"2006","Edmonton, Alberta, municipal","48033","Prisoner unlawfully at large","403","365","5","-5.21","53.1","51.85","50.03","30.36","0","370","313","330","17","0"
"2007","Edmonton, Alberta, municipal","48033","Prisoner unlawfully at large","340","345","2","-17.82","43.63","52.23","50","25.12","0","347","325","339","14","0"
"2008","Edmonton, Alberta, municipal","48033","Prisoner unlawfully at large","305","292","2","-12.36","38.24","42.42","41.48","30.69","0","294","271","288","17","0"
"2009","Edmonton, Alberta, municipal","48033","Prisoner unlawfully at large","277","270","3","-11.43","33.87","37.14","37.22","38.25","0","273","244","265","21","0"
"2010","Edmonton, Alberta, municipal","48033","Prisoner unlawfully at large","284","271","2","0.89","34.17","35.77","37.08","53.15","0","273","239","268","29","0"
"2011","Edmonton, Alberta, municipal","48033","Prisoner unlawfully at large","313","300","1","8.33","37.02","39.73","39.88","41.78","0","301","270","293","23","0"
"2012","Edmonton, Alberta, municipal","48033","Prisoner unlawfully at large","304","298","1","-5.31","35.05","40.22","38.9","21.98","1.83","299","281","293","12","1"
"2013","Edmonton, Alberta, municipal","48033","Prisoner unlawfully at large","147","144","1","-53.24","16.39","19.48","18.37","3.67","0","145","141","143","2","0"
"2014","Edmonton, Alberta, municipal","48033","Prisoner unlawfully at large","97","93","0","-36.16","10.46","12.41","11.57","0","0","93","93","93","0","0"
"2015","Edmonton, Alberta, municipal","48033","Prisoner unlawfully at large","85","81","2","-14.26","8.97","10.32","10","5.48","0","83","79","82","3","0"
"2016","Edmonton, Alberta, municipal","48033","Prisoner unlawfully at large","84","82","0","-3.37","8.67","10.24","9.68","1.8","0","82","80","81","1","0"
"1998","Edmonton, Alberta, municipal","48033","Fail to appear","1361","1815","0","0","208.38","0","0","0","0","1815","1152","1373","221","0"
"1999","Edmonton, Alberta, municipal","48033","Fail to appear","1152","1895","0","-16.68","173.63","0","0","0","0","1895","1251","1458","207","0"
"2000","Edmonton, Alberta, municipal","48033","Fail to appear","1329","2256","0","13.64","197.31","0","0","0","0","2256","1437","1662","225","0"
"2001","Edmonton, Alberta, municipal","48033","Fail to appear","2042","2042","0","51.55","299.02","0","0","0","0","2042","1665","1868","203","0"
"2002","Edmonton, Alberta, municipal","48033","Fail to appear","2578","2577","0","24.07","371","0","0","0","0","2577","2140","2350","210","0"
"2003","Edmonton, Alberta, municipal","48033","Fail to appear","2791","2790","1","7.05","397.15","0","0","0","0","2791","2216","2477","261","0"
"2004","Edmonton, Alberta, municipal","48033","Fail to appear","2659","2659","0","-7.08","369.01","361.3","357.81","321.92","0","2659","2053","2231","178","0"
"2005","Edmonton, Alberta, municipal","48033","Fail to appear","2897","2789","0","6.48","392.92","292.86","287.59","232.28","0","2789","1710","1839","129","0"
"2006","Edmonton, Alberta, municipal","48033","Fail to appear","4100","4100","0","37.48","540.2","185.53","184.94","178.6","0","4100","1120","1220","100","0"
"2007","Edmonton, Alberta, municipal","48033","Fail to appear","1664","1792","0","-60.47","213.55","236.7","229.93","154.29","0","1792","1473","1559","86","0"
"2008","Edmonton, Alberta, municipal","48033","Fail to appear","2793","2814","0","63.98","350.17","367.5","366.7","357.47","0","2814","2348","2546","198","0"
"2009","Edmonton, Alberta, municipal","48033","Fail to appear","2562","2537","12","-10.54","313.25","334.84","330.66","280.54","1.82","2549","2200","2354","154","1"
"2010","Edmonton, Alberta, municipal","48033","Fail to appear","2478","2436","17","-4.83","298.14","320.27","314.36","241.91","3.67","2453","2140","2272","132","2"
"2011","Edmonton, Alberta, municipal","48033","Fail to appear","2470","2425","17","-2.02","292.11","304.14","299.32","239.78","0","2442","2067","2199","132","0"
"2012","Edmonton, Alberta, municipal","48033","Fail to appear","2585","2527","9","2.03","298.04","307.34","301.66","229.01","0","2536","2147","2272","125","0"
"2013","Edmonton, Alberta, municipal","48033","Fail to appear","2893","2834","12","8.23","322.56","337.2","333.91","290.15","1.84","2846","2441","2599","158","1"
"2014","Edmonton, Alberta, municipal","48033","Fail to appear","3395","3387","2","13.53","366.2","394.58","386.66","277.53","0","3389","2957","3108","151","0"
"2015","Edmonton, Alberta, municipal","48033","Fail to appear","3983","3982","0","14.78","420.34","450.7","441.34","310.5","0","3982","3449","3619","170","0"
"2016","Edmonton, Alberta, municipal","48033","Fail to appear","4844","4821","5","18.92","499.86","537.31","519.48","269.33","1.8","4826","4199","4349","150","1"
"1998","Edmonton, Alberta, municipal","48033","Breach of probation","275","221","0","0","42.1","0","0","0","0","221","167","183","16","0"
"1999","Edmonton, Alberta, municipal","48033","Breach of probation","197","197","0","-29.48","29.69","0","0","0","0","197","160","181","21","0"
"2000","Edmonton, Alberta, municipal","48033","Breach of probation","321","314","7","60.5","47.66","0","0","0","0","321","223","260","37","3"
"2001","Edmonton, Alberta, municipal","48033","Breach of probation","224","214","0","-31.17","32.8","0","0","0","0","214","176","185","9","0"
"2002","Edmonton, Alberta, municipal","48033","Breach of probation","240","231","0","5.3","34.54","0","0","0","0","231","170","172","2","0"
"2003","Edmonton, Alberta, municipal","48033","Breach of probation","187","181","1","-22.96","26.61","0","0","0","0","182","171","174","3","0"
"2004","Edmonton, Alberta, municipal","48033","Breach of probation","181","165","0","-5.6","25.12","25.34","23.42","3.62","0","165","144","146","2","0"
"2005","Edmonton, Alberta, municipal","48033","Breach of probation","186","145","0","0.43","25.23","21.75","20.02","1.8","0","145","127","128","1","0"
"2006","Edmonton, Alberta, municipal","48033","Breach of probation","217","216","1","13.33","28.59","22.86","21.37","5.36","0","217","138","141","3","0"
"2007","Edmonton, Alberta, municipal","48033","Breach of probation","230","257","2","3.24","29.52","31.17","29.79","14.35","1.79","259","194","202","8","1"
"2008","Edmonton, Alberta, municipal","48033","Breach of probation","271","265","1","15.11","33.98","33.65","32.41","18.05","0","266","215","225","10","0"
"2009","Edmonton, Alberta, municipal","48033","Breach of probation","390","376","3","40.35","47.69","44.75","41.58","3.64","1.82","379","294","296","2","1"
"2010","Edmonton, Alberta, municipal","48033","Breach of probation","494","470","12","24.64","59.44","58.67","54.38","1.83","7.33","482","392","393","1","4"
"2011","Edmonton, Alberta, municipal","48033","Breach of probation","441","418","4","-12.25","52.15","54.88","50.77","0","1.82","422","373","373","0","1"
"2012","Edmonton, Alberta, municipal","48033","Breach of probation","578","559","7","27.78","66.64","75.44","69.97","0","7.33","566","527","527","0","4"
"2013","Edmonton, Alberta, municipal","48033","Breach of probation","470","450","7","-21.36","52.4","54.57","50.75","0","1.84","457","395","395","0","1"
"2014","Edmonton, Alberta, municipal","48033","Breach of probation","452","420","9","-6.96","48.75","44.17","41.18","0","5.51","429","331","331","0","3"
"2015","Edmonton, Alberta, municipal","48033","Breach of probation","513","486","8","11.04","54.14","50.31","46.95","0","1.83","494","385","385","0","1"
"2016","Edmonton, Alberta, municipal","48033","Breach of probation","384","341","14","-26.81","39.63","36.21","33.8","0","1.8","355","283","283","0","1"
"2005","Edmonton, Alberta, municipal","48033","Gaming house","0","0","0","0","0","0","0","0","0","0","0","0","0","0"
"2006","Edmonton, Alberta, municipal","48033","Gaming house","1","1","0","0","0.13","1.99","1.82","0","0","1","12","12","0","0"
"2007","Edmonton, Alberta, municipal","48033","Gaming house","0","0","0","-100","0","0","0","0","0","0","0","0","0","0"
"2008","Edmonton, Alberta, municipal","48033","Gaming house","0","0","0","0","0","0","0","0","0","0","0","0","0","0"
"2009","Edmonton, Alberta, municipal","48033","Gaming house","0","0","0","0","0","0","0","0","0","0","0","0","0","0"
"2010","Edmonton, Alberta, municipal","48033","Gaming house","0","0","0","0","0","0","0","0","0","0","0","0","0","0"
"2011","Edmonton, Alberta, municipal","48033","Gaming house","0","0","0","0","0","0","0","0","0","0","0","0","0","0"
"2012","Edmonton, Alberta, municipal","48033","Gaming house","0","0","0","0","0","0","0","0","0","0","0","0","0","0"
"2013","Edmonton, Alberta, municipal","48033","Gaming house","0","0","0","0","0","0","0","0","0","0","0","0","0","0"
"2014","Edmonton, Alberta, municipal","48033","Gaming house","0","0","0","0","0","0","0","0","0","0","0","0","0","0"
"2015","Edmonton, Alberta, municipal","48033","Gaming house","0","0","0","0","0","0","0","0","0","0","0","0","0","0"
"2016","Edmonton, Alberta, municipal","48033","Gaming house","0","0","0","0","0","0","0","0","0","0","0","0","0","0"
"1998","Edmonton, Alberta, municipal","48033","Gaming house","0","0","0","0","0","0","0","0","0","0","0","0","0","0"
"1999","Edmonton, Alberta, municipal","48033","Gaming house","1","0","0","0","0.15","0","0","0","0","0","0","0","0","0"
"2000","Edmonton, Alberta, municipal","48033","Gaming house","4","17","22","294","0.59","0","0","0","0","39","19","19","0","0"
"2001","Edmonton, Alberta, municipal","48033","Gaming house","0","0","0","-100","0","0","0","0","0","0","0","0","0","0"
"2002","Edmonton, Alberta, municipal","48033","Gaming house","0","0","0","0","0","0","0","0","0","0","0","0","0","0"
"2003","Edmonton, Alberta, municipal","48033","Gaming house","0","0","0","0","0","0","0","0","0","0","0","0","0","0"
"2004","Edmonton, Alberta, municipal","48033","Gaming house","0","0","0","0","0","0","0","0","0","0","0","0","0","0"
"1998","Edmonton, Alberta, municipal","48033","Other violations related to gaming and betting","5","2","1","0","0.77","0","0","0","0","3","2","2","0","0"
"1999","Edmonton, Alberta, municipal","48033","Other violations related to gaming and betting","3","0","4","-40.93","0.45","0","0","0","0","4","0","0","0","0"
"2000","Edmonton, Alberta, municipal","48033","Other violations related to gaming and betting","3","1","2","-1.5","0.45","0","0","0","0","3","1","1","0","0"
"2001","Edmonton, Alberta, municipal","48033","Other violations related to gaming and betting","2","1","0","-34.24","0.29","0","0","0","0","1","1","1","0","0"
"2002","Edmonton, Alberta, municipal","48033","Other violations related to gaming and betting","3","1","0","47.42","0.43","0","0","0","0","1","2","2","0","0"
"2003","Edmonton, Alberta, municipal","48033","Other violations related to gaming and betting","2","1","0","-34.08","0.28","0","0","0","0","1","1","1","0","0"
"2004","Edmonton, Alberta, municipal","48033","Other violations related to gaming and betting","2","0","0","-2.47","0.28","0","0","0","0","0","0","0","0","0"
"2005","Edmonton, Alberta, municipal","48033","Other violations related to gaming and betting","1","2","0","-51.13","0.14","0.51","0.47","0","0","2","3","3","0","0"
"2006","Edmonton, Alberta, municipal","48033","Other violations related to gaming and betting","0","0","0","-100","0","0","0","0","0","0","0","0","0","0"
"2007","Edmonton, Alberta, municipal","48033","Other violations related to gaming and betting","1","0","1","0","0.13","0","0","0","0","1","0","0","0","0"
"2008","Edmonton, Alberta, municipal","48033","Other violations related to gaming and betting","4","0","2","290.77","0.5","0","0","0","0","2","0","0","0","0"
"2009","Edmonton, Alberta, municipal","48033","Other violations related to gaming and betting","3","0","0","-26.86","0.37","0","0","0","0","0","0","0","0","0"
"2010","Edmonton, Alberta, municipal","48033","Other violations related to gaming and betting","0","0","0","-100","0","0","0","0","0","0","0","0","0","0"
"2011","Edmonton, Alberta, municipal","48033","Other violations related to gaming and betting","1","0","0","0","0.12","0","0","0","0","0","0","0","0","0"
"2012","Edmonton, Alberta, municipal","48033","Other violations related to gaming and betting","0","0","0","-100","0","0","0","0","0","0","0","0","0","0"
"2013","Edmonton, Alberta, municipal","48033","Other violations related to gaming and betting","0","0","0","0","0","0","0","0","0","0","0","0","0","0"
"2014","Edmonton, Alberta, municipal","48033","Other violations related to gaming and betting","2","1","0","0","0.22","0.13","0.12","0","0","1","1","1","0","0"
"2015","Edmonton, Alberta, municipal","48033","Other violations related to gaming and betting","1","0","0","-51.08","0.11","0","0","0","0","0","0","0","0","0"
"2016","Edmonton, Alberta, municipal","48033","Other violations related to gaming and betting","1","0","0","-2.22","0.1","0","0","0","0","0","0","0","0","0"
"2012","Edmonton, Alberta, municipal","48033","Common Bawdy House","0","0","0","0","0","0","0","0","0","0","0","0","0","0"
"2013","Edmonton, Alberta, municipal","48033","Common Bawdy House","0","0","0","0","0","0","0","0","0","0","0","0","0","0"
"2014","Edmonton, Alberta, municipal","48033","Common Bawdy House","0","0","0","0","0","0","0","0","0","0","0","0","0","0"
"2015","Edmonton, Alberta, municipal","48033","Common Bawdy House","0","0","0","0","0","0","0","0","0","0","0","0","0","0"
"2016","Edmonton, Alberta, municipal","48033","Common Bawdy House","0","0","0","0","0","0","0","0","0","0","0","0","0","0"
"1998","Edmonton, Alberta, municipal","48033","Indecent acts","247","57","11","0","37.82","0","0","0","0","68","47","48","1","2"
"1999","Edmonton, Alberta, municipal","48033","Indecent acts","227","48","9","-9.53","34.21","0","0","0","0","57","43","46","3","3"
"2000","Edmonton, Alberta, municipal","48033","Indecent acts","254","42","4","10.22","37.71","0","0","0","0","46","36","37","1","0"
"2001","Edmonton, Alberta, municipal","48033","Indecent acts","184","41","17","-28.55","26.94","0","0","0","0","58","30","32","2","4"
"2002","Edmonton, Alberta, municipal","48033","Indecent acts","146","36","3","-22.02","21.01","0","0","0","0","39","28","32","4","0"
"2003","Edmonton, Alberta, municipal","48033","Indecent acts","129","32","4","-12.63","18.36","0","0","0","0","36","32","32","0","1"
"2004","Edmonton, Alberta, municipal","48033","Indecent acts","156","32","11","17.94","21.65","5.81","5.29","0","3.62","43","33","33","0","2"
"2005","Edmonton, Alberta, municipal","48033","Indecent acts","135","34","15","-15.42","18.31","5.48","5.32","3.6","1.8","49","32","34","2","1"
"2006","Edmonton, Alberta, municipal","48033","Indecent acts","127","21","4","-8.61","16.73","2.82","2.58","0","0","25","17","17","0","0"
"2007","Edmonton, Alberta, municipal","48033","Indecent acts","168","29","13","28.85","21.56","3.37","3.24","1.79","0","42","21","22","1","0"
"2008","Edmonton, Alberta, municipal","48033","Indecent acts","133","29","11","-22.66","16.67","4.23","4.03","1.81","7.22","40","27","28","1","4"
"2009","Edmonton, Alberta, municipal","48033","Indecent acts","201","33","23","47.38","24.58","4.57","4.21","0","7.29","56","30","30","0","4"
"2010","Edmonton, Alberta, municipal","48033","Indecent acts","143","44","14","-29.99","17.2","6.14","5.67","0","7.33","58","41","41","0","4"
"2011","Edmonton, Alberta, municipal","48033","Indecent acts","165","37","11","13.42","19.51","3.24","3.13","1.82","3.63","48","22","23","1","2"
"2012","Edmonton, Alberta, municipal","48033","Indecent acts","198","47","15","16.99","22.83","5.87","5.58","1.83","1.83","62","41","42","1","1"
"2013","Edmonton, Alberta, municipal","48033","Indecent acts","153","39","17","-25.27","17.06","4.28","4.24","3.67","11.02","56","31","33","2","6"
"1998","Edmonton, Alberta, municipal","48033","Other violations against the administration of law and justice (Part IV Criminal Code)","98","81","9","0","15","0","0","0","0","90","57","66","9","5"
"2014","Edmonton, Alberta, municipal","48033","Indecent acts","151","32","9","-4.52","16.29","3.47","3.36","1.84","1.84","41","26","27","1","1"
"1999","Edmonton, Alberta, municipal","48033","Other violations against the administration of law and justice (Part IV Criminal Code)","83","74","9","-16.63","12.51","0","0","0","0","83","64","73","9","4"
"2015","Edmonton, Alberta, municipal","48033","Indecent acts","179","41","18","15.98","18.89","4.7","4.63","3.65","1.83","59","36","38","2","1"
"2000","Edmonton, Alberta, municipal","48033","Other violations against the administration of law and justice (Part IV Criminal Code)","60","49","3","-28.79","8.91","0","0","0","0","52","36","41","5","4"
"2016","Edmonton, Alberta, municipal","48033","Indecent acts","181","49","10","-1.13","18.68","4.61","4.54","3.59","3.59","59","36","38","2","2"
"2001","Edmonton, Alberta, municipal","48033","Other violations against the administration of law and justice (Part IV Criminal Code)","70","63","7","15.07","10.25","0","0","0","0","70","54","59","5","3"
"2002","Edmonton, Alberta, municipal","48033","Other violations against the administration of law and justice (Part IV Criminal Code)","91","65","13","27.76","13.1","0","0","0","0","78","59","67","8","1"
"2003","Edmonton, Alberta, municipal","48033","Other violations against the administration of law and justice (Part IV Criminal Code)","93","84","2","1.05","13.23","0","0","0","0","86","63","66","3","2"
"2004","Edmonton, Alberta, municipal","48033","Other violations against the administration of law and justice (Part IV Criminal Code)","58","50","5","-39.18","8.05","7.04","6.58","1.81","3.62","55","40","41","1","2"
"2005","Edmonton, Alberta, municipal","48033","Other violations against the administration of law and justice (Part IV Criminal Code)","119","99","5","100.52","16.14","14.21","14.23","14.41","0","104","83","91","8","0"
"2006","Edmonton, Alberta, municipal","48033","Other violations against the administration of law and justice (Part IV Criminal Code)","101","90","4","-17.55","13.31","10.1","9.55","3.57","3.57","94","61","63","2","2"
"2007","Edmonton, Alberta, municipal","48033","Other violations against the administration of law and justice (Part IV Criminal Code)","127","117","2","22.48","16.3","15.75","15.19","8.97","0","119","98","103","5","0"
"2008","Edmonton, Alberta, municipal","48033","Other violations against the administration of law and justice (Part IV Criminal Code)","186","164","12","43.08","23.32","12.68","12.24","7.22","3.61","176","81","85","4","2"
"2009","Edmonton, Alberta, municipal","48033","Other violations against the administration of law and justice (Part IV Criminal Code)","120","93","10","-37.08","14.67","13.7","12.78","1.82","1.82","103","90","91","1","1"
"2010","Edmonton, Alberta, municipal","48033","Other violations against the administration of law and justice (Part IV Criminal Code)","145","116","17","18.9","17.45","16.16","15.77","11","5.5","133","108","114","6","3"
"2011","Edmonton, Alberta, municipal","48033","Other violations against the administration of law and justice (Part IV Criminal Code)","155","118","22","5.07","18.33","14.57","14.16","9.08","0","140","99","104","5","0"
"2012","Edmonton, Alberta, municipal","48033","Other violations against the administration of law and justice (Part IV Criminal Code)","184","159","6","15.73","21.21","20.61","19.52","5.5","1.83","165","144","147","3","1"
"2013","Edmonton, Alberta, municipal","48033","Other violations against the administration of law and justice (Part IV Criminal Code)","152","123","14","-20.11","16.95","15.61","14.77","3.67","11.02","137","113","115","2","6"
"2014","Edmonton, Alberta, municipal","48033","Other violations against the administration of law and justice (Part IV Criminal Code)","172","127","10","9.47","18.55","14.41","13.68","3.68","7.35","137","108","110","2","4"
"2015","Edmonton, Alberta, municipal","48033","Other violations against the administration of law and justice (Part IV Criminal Code)","190","144","16","8.08","20.05","17.25","16.71","9.13","3.65","160","132","137","5","2"
"2016","Edmonton, Alberta, municipal","48033","Other violations against the administration of law and justice (Part IV Criminal Code)","268","210","18","37.92","27.66","24.82","23.53","5.39","1.8","228","194","197","3","1"
"1998","Edmonton, Alberta, municipal","48033","Corrupting morals","3","2","0","0","0.46","0","0","0","0","2","2","2","0","0"
"1999","Edmonton, Alberta, municipal","48033","Corrupting morals","3","1","0","-1.56","0.45","0","0","0","0","1","1","1","0","0"
"2000","Edmonton, Alberta, municipal","48033","Corrupting morals","6","2","0","97","0.89","0","0","0","0","2","2","2","0","0"
"2001","Edmonton, Alberta, municipal","48033","Corrupting morals","6","6","1","-1.37","0.88","0","0","0","0","7","4","4","0","0"
"2002","Edmonton, Alberta, municipal","48033","Corrupting morals","1","0","0","-83.62","0.14","0","0","0","0","0","0","0","0","0"
"2003","Edmonton, Alberta, municipal","48033","Corrupting morals","6","0","0","493.27","0.85","0","0","0","0","0","0","0","0","0"
"2004","Edmonton, Alberta, municipal","48033","Corrupting morals","1","1","0","-83.75","0.14","0.18","0.16","0","0","1","1","1","0","0"
"2005","Edmonton, Alberta, municipal","48033","Corrupting morals","1","0","0","-2.27","0.14","0","0","0","0","0","0","0","0","0"
"2006","Edmonton, Alberta, municipal","48033","Corrupting morals","3","0","1","191.43","0.4","0","0","0","0","1","0","0","0","0"
"2007","Edmonton, Alberta, municipal","48033","Corrupting morals","0","0","0","-100","0","0","0","0","0","0","0","0","0","0"
"2008","Edmonton, Alberta, municipal","48033","Corrupting morals","0","0","0","0","0","0","0","0","0","0","0","0","0","0"
"2009","Edmonton, Alberta, municipal","48033","Corrupting morals","0","0","0","0","0","0","0","0","0","0","0","0","0","0"
"2010","Edmonton, Alberta, municipal","48033","Corrupting morals","0","0","0","0","0","0","0","0","0","0","0","0","0","0"
"2011","Edmonton, Alberta, municipal","48033","Corrupting morals","0","0","0","0","0","0","0","0","0","0","0","0","0","0"
"2012","Edmonton, Alberta, municipal","48033","Corrupting morals","1","0","0","0","0.12","0","0","0","0","0","0","0","0","0"
"2013","Edmonton, Alberta, municipal","48033","Corrupting morals","1","1","0","-3.29","0.11","0","0","0","0","1","0","0","0","0"
"2014","Edmonton, Alberta, municipal","48033","Corrupting morals","0","0","0","-100","0","0","0","0","0","0","0","0","0","0"
"2015","Edmonton, Alberta, municipal","48033","Corrupting morals","2","1","0","0","0.21","0","0","0","0","1","0","0","0","0"
"2016","Edmonton, Alberta, municipal","48033","Corrupting morals","0","0","0","-100","0","0","0","0","0","0","0","0","0","0"
"1998","Edmonton, Alberta, municipal","48033","Total other violations","1343","846","67","0","205.62","0","0","0","0","913","646","759","113","17"
"1999","Edmonton, Alberta, municipal","48033","Total other violations","870","559","33","-36.23","131.13","0","0","0","0","592","465","526","61","12"
"2000","Edmonton, Alberta, municipal","48033","Total other violations","784","499","37","-11.24","116.39","0","0","0","0","536","398","477","79","7"
"2001","Edmonton, Alberta, municipal","48033","Total other violations","696","505","27","-12.44","101.92","0","0","0","0","532","404","490","86","10"
"2002","Edmonton, Alberta, municipal","48033","Total other violations","571","406","12","-19.37","82.17","0","0","0","0","418","326","391","65","14"
"2003","Edmonton, Alberta, municipal","48033","Total other violations","519","368","7","-10.13","73.85","0","0","0","0","375","286","349","63","7"
"2004","Edmonton, Alberta, municipal","48033","Total other violations","490","318","19","-7.92","68","48.75","53.25","99.47","27.13","337","277","332","55","15"
"2005","Edmonton, Alberta, municipal","48033","Total other violations","483","351","18","-3.66","65.51","51.89","53.95","75.63","3.6","369","303","345","42","2"
"2006","Edmonton, Alberta, municipal","48033","Total other violations","522","338","16","4.99","68.78","37.6","38.35","46.44","7.14","354","227","253","26","4"
"2007","Edmonton, Alberta, municipal","48033","Total other violations","566","317","30","5.61","72.64","38.73","39.53","48.44","8.97","347","241","268","27","5"
"2008","Edmonton, Alberta, municipal","48033","Total other violations","534","309","39","-7.83","66.95","41.95","42.78","52.36","21.66","348","268","297","29","12"
"2009","Edmonton, Alberta, municipal","48033","Total other violations","666","311","60","21.63","81.43","37.59","37.36","34.61","21.86","371","247","266","19","12"
"2010","Edmonton, Alberta, municipal","48033","Total other violations","630","349","67","-6.92","75.8","42.65","42.06","34.82","40.32","416","285","304","19","22"
"2011","Edmonton, Alberta, municipal","48033","Total other violations","755","427","54","17.8","89.29","44.14","44.24","45.41","9.08","481","300","325","25","5"
"2012","Edmonton, Alberta, municipal","48033","Total other violations","876","495","69","13.12","101","51.1","52.45","69.62","32.98","564","357","395","38","18"
"2013","Edmonton, Alberta, municipal","48033","Total other violations","849","522","53","-6.27","94.66","50.7","50.23","44.07","22.04","575","367","391","24","12"
"2014","Edmonton, Alberta, municipal","48033","Total other violations","982","594","48","11.9","105.92","51.51","52","58.81","5.51","642","386","418","32","3"
"2015","Edmonton, Alberta, municipal","48033","Total other violations","1078","705","52","7.4","113.76","63.25","62.56","52.97","12.79","757","484","513","29","7"
"2016","Edmonton, Alberta, municipal","48033","Total other violations","1118","718","49","1.41","115.37","61.17","59.72","39.5","12.57","767","478","500","22","7"
"1998","Edmonton, Alberta, municipal","48033","Obstruct public or peace officer","460","454","1","0","70.43","0","0","0","0","455","370","423","53","0"
"1998","Edmonton, Alberta, municipal","48033","Betting house","0","0","0","0","0","0","0","0","0","0","0","0","0","0"
"1999","Edmonton, Alberta, municipal","48033","Obstruct public or peace officer","387","386","1","-17.18","58.33","0","0","0","0","387","327","365","38","1"
"1999","Edmonton, Alberta, municipal","48033","Betting house","0","0","0","0","0","0","0","0","0","0","0","0","0","0"
"2000","Edmonton, Alberta, municipal","48033","Obstruct public or peace officer","356","352","0","-9.39","52.85","0","0","0","0","352","279","342","63","0"
"2000","Edmonton, Alberta, municipal","48033","Betting house","0","0","0","0","0","0","0","0","0","0","0","0","0","0"
"2001","Edmonton, Alberta, municipal","48033","Obstruct public or peace officer","335","343","0","-7.18","49.05","0","0","0","0","343","269","313","44","0"
"2001","Edmonton, Alberta, municipal","48033","Betting house","0","0","0","0","0","0","0","0","0","0","0","0","0","0"
"2002","Edmonton, Alberta, municipal","48033","Obstruct public or peace officer","257","256","0","-24.61","36.98","0","0","0","0","256","212","234","22","0"
"2002","Edmonton, Alberta, municipal","48033","Betting house","0","0","0","0","0","0","0","0","0","0","0","0","0","0"
"2003","Edmonton, Alberta, municipal","48033","Obstruct public or peace officer","176","173","0","-32.29","25.04","0","0","0","0","173","141","160","19","0"
"2003","Edmonton, Alberta, municipal","48033","Betting house","0","0","0","0","0","0","0","0","0","0","0","0","0","0"
"2004","Edmonton, Alberta, municipal","48033","Obstruct public or peace officer","135","131","1","-25.19","18.74","21.47","21.33","19.89","0","132","122","133","11","0"
"2004","Edmonton, Alberta, municipal","48033","Betting house","0","0","0","0","0","0","0","0","0","0","0","0","0","0"
"2005","Edmonton, Alberta, municipal","48033","Obstruct public or peace officer","122","125","1","-11.68","16.55","18.67","18.45","16.21","0","126","109","118","9","0"
"2005","Edmonton, Alberta, municipal","48033","Betting house","0","0","0","0","0","0","0","0","0","0","0","0","0","0"
"2006","Edmonton, Alberta, municipal","48033","Obstruct public or peace officer","151","143","2","20.23","19.9","14.58","14.4","12.5","1.79","145","88","95","7","1"
"2006","Edmonton, Alberta, municipal","48033","Betting house","0","0","0","0","0","0","0","0","0","0","0","0","0","0"
"2007","Edmonton, Alberta, municipal","48033","Obstruct public or peace officer","154","147","3","-0.66","19.76","18.8","17.99","8.97","0","150","117","122","5","0"
"2007","Edmonton, Alberta, municipal","48033","Betting house","0","0","0","0","0","0","0","0","0","0","0","0","0","0"
"2008","Edmonton, Alberta, municipal","48033","Obstruct public or peace officer","150","144","3","-4.84","18.81","16.59","16.42","14.44","0","147","106","114","8","0"
"2008","Edmonton, Alberta, municipal","48033","Betting house","0","0","0","0","0","0","0","0","0","0","0","0","0","0"
"2009","Edmonton, Alberta, municipal","48033","Obstruct public or peace officer","173","163","5","12.48","21.15","16.59","16.43","14.57","1.82","168","109","117","8","1"
"2009","Edmonton, Alberta, municipal","48033","Betting house","0","0","0","0","0","0","0","0","0","0","0","0","0","0"
"2010","Edmonton, Alberta, municipal","48033","Obstruct public or peace officer","182","174","6","3.52","21.9","16.01","15.91","14.66","0","180","107","115","8","0"
"2010","Edmonton, Alberta, municipal","48033","Betting house","0","0","0","0","0","0","0","0","0","0","0","0","0","0"
"2011","Edmonton, Alberta, municipal","48033","Obstruct public or peace officer","232","224","5","25.3","27.44","19.28","18.92","14.53","1.82","229","131","139","8","1"
"2011","Edmonton, Alberta, municipal","48033","Betting house","0","0","0","0","0","0","0","0","0","0","0","0","0","0"
"2012","Edmonton, Alberta, municipal","48033","Obstruct public or peace officer","280","258","15","17.66","32.28","22.19","21.78","16.49","7.33","273","155","164","9","4"
"2012","Edmonton, Alberta, municipal","48033","Betting house","0","0","0","0","0","0","0","0","0","0","0","0","0","0"
"2013","Edmonton, Alberta, municipal","48033","Obstruct public or peace officer","304","289","9","5","33.9","22.79","22.1","12.85","3.67","298","165","172","7","2"
"2013","Edmonton, Alberta, municipal","48033","Betting house","0","0","0","0","0","0","0","0","0","0","0","0","0","0"
"2014","Edmonton, Alberta, municipal","48033","Obstruct public or peace officer","360","345","8","14.56","38.83","23.49","23.64","25.73","0","353","176","190","14","0"
"2014","Edmonton, Alberta, municipal","48033","Betting house","0","0","0","0","0","0","0","0","0","0","0","0","0","0"
"2015","Edmonton, Alberta, municipal","48033","Obstruct public or peace officer","407","383","14","10.61","42.95","27.57","27.44","25.57","3.65","397","211","225","14","2"
"2015","Edmonton, Alberta, municipal","48033","Betting house","0","0","0","0","0","0","0","0","0","0","0","0","0","0"
"2016","Edmonton, Alberta, municipal","48033","Obstruct public or peace officer","449","420","11","7.87","46.33","29.81","29.15","19.75","3.59","431","233","244","11","2"
"2016","Edmonton, Alberta, municipal","48033","Betting house","0","0","0","0","0","0","0","0","0","0","0","0","0","0"
"1998","Edmonton, Alberta, municipal","48033","Trespass at night","30","16","0","0","4.59","0","0","0","0","16","12","16","4","0"
"1999","Edmonton, Alberta, municipal","48033","Trespass at night","22","10","2","-27.81","3.32","0","0","0","0","12","9","9","0","3"
"2000","Edmonton, Alberta, municipal","48033","Trespass at night","27","15","0","20.89","4.01","0","0","0","0","15","9","11","2","0"
"2001","Edmonton, Alberta, municipal","48033","Trespass at night","23","17","0","-15.98","3.37","0","0","0","0","17","14","24","10","0"
"2002","Edmonton, Alberta, municipal","48033","Trespass at night","14","9","3","-40.18","2.01","0","0","0","0","12","6","7","1","3"
"2003","Edmonton, Alberta, municipal","48033","Trespass at night","21","15","1","48.32","2.99","0","0","0","0","16","12","16","4","0"
"2004","Edmonton, Alberta, municipal","48033","Trespass at night","11","5","0","-48.91","1.53","0.7","0.8","1.81","0","5","4","5","1","0"
"2005","Edmonton, Alberta, municipal","48033","Trespass at night","11","5","0","-2.27","1.49","0.86","0.78","0","0","5","5","5","0","0"
"2006","Edmonton, Alberta, municipal","48033","Trespass at night","20","7","3","76.62","2.64","0.99","0.91","0","0","10","6","6","0","0"
"2007","Edmonton, Alberta, municipal","48033","Trespass at night","13","12","2","-36.69","1.67","1.12","1.47","5.38","1.79","14","7","10","3","1"
"2008","Edmonton, Alberta, municipal","48033","Trespass at night","10","3","5","-24.85","1.25","0.16","0.58","5.42","3.61","8","1","4","3","2"
"2009","Edmonton, Alberta, municipal","48033","Trespass at night","17","5","3","65.79","2.08","0.46","0.7","3.64","1.82","8","3","5","2","1"
"2010","Edmonton, Alberta, municipal","48033","Trespass at night","29","6","6","67.86","3.49","0.3","0.97","9.16","16.49","12","2","7","5","9"
"2011","Edmonton, Alberta, municipal","48033","Trespass at night","24","6","3","-18.65","2.84","0.29","0.27","0","0","9","2","2","0","0"
"2012","Edmonton, Alberta, municipal","48033","Trespass at night","35","11","7","42.17","4.04","0.86","1.06","3.66","0","18","6","8","2","0"
"2013","Edmonton, Alberta, municipal","48033","Trespass at night","21","7","5","-41.98","2.34","0.83","0.77","0","5.51","12","6","6","0","3"
"2014","Edmonton, Alberta, municipal","48033","Trespass at night","35","14","7","61.23","3.78","1.2","1.12","0","1.84","21","9","9","0","1"
"2015","Edmonton, Alberta, municipal","48033","Trespass at night","31","10","2","-13.34","3.27","1.18","1.22","1.83","0","12","9","10","1","0"
"2016","Edmonton, Alberta, municipal","48033","Trespass at night","27","9","2","-14.84","2.79","1.02","0.96","0","0","11","8","8","0","0"
"2005","Edmonton, Alberta, municipal","48033","Utter threats to property or animal","0","0","0","0","0","0","0","0","0","0","0","0","0","0"
"2006","Edmonton, Alberta, municipal","48033","Utter threats to property or animal","0","0","0","0","0","0","0","0","0","0","0","0","0","0"
"2007","Edmonton, Alberta, municipal","48033","Utter threats to property or animal","0","0","0","0","0","0","0","0","0","0","0","0","0","0"
"2008","Edmonton, Alberta, municipal","48033","Utter threats to property or animal","3","1","1","0","0.38","0.16","0.14","0","1.81","2","1","1","0","1"
"2009","Edmonton, Alberta, municipal","48033","Utter threats to property or animal","9","3","2","192.57","1.1","0.46","0.42","0","0","5","3","3","0","0"
"2010","Edmonton, Alberta, municipal","48033","Utter threats to property or animal","13","2","8","42.13","1.56","0.15","0.14","0","0","10","1","1","0","0"
"2011","Edmonton, Alberta, municipal","48033","Utter threats to property or animal","31","3","9","134.39","3.67","0.29","0.41","1.82","0","12","2","3","1","0"
"2012","Edmonton, Alberta, municipal","48033","Utter threats to property or animal","17","2","2","-46.54","1.96","0.14","0.13","0","5.5","4","1","1","0","3"
"2013","Edmonton, Alberta, municipal","48033","Utter threats to property or animal","24","8","8","36.53","2.68","0.69","0.64","0","1.84","16","5","5","0","1"
"2014","Edmonton, Alberta, municipal","48033","Utter threats to property or animal","26","2","7","4.8","2.8","0.13","0.12","0","0","9","1","1","0","0"
"2015","Edmonton, Alberta, municipal","48033","Utter threats to property or animal","16","1","3","-39.79","1.69","0","0","0","0","4","0","0","0","0"
"2016","Edmonton, Alberta, municipal","48033","Utter threats to property or animal","32","6","6","95.56","3.3","0.38","0.48","1.8","1.8","12","3","4","1","1"
"2005","Edmonton, Alberta, municipal","48033","Advocating genocide","0","0","0","0","0","0","0","0","0","0","0","0","0","0"
"2006","Edmonton, Alberta, municipal","48033","Advocating genocide","0","0","0","0","0","0","0","0","0","0","0","0","0","0"
"2007","Edmonton, Alberta, municipal","48033","Advocating genocide","0","0","0","0","0","0","0","0","0","0","0","0","0","0"
"2008","Edmonton, Alberta, municipal","48033","Advocating genocide","0","0","0","0","0","0","0","0","0","0","0","0","0","0"
"2009","Edmonton, Alberta, municipal","48033","Advocating genocide","0","0","0","0","0","0","0","0","0","0","0","0","0","0"
"2010","Edmonton, Alberta, municipal","48033","Advocating genocide","0","0","0","0","0","0","0","0","0","0","0","0","0","0"
"2011","Edmonton, Alberta, municipal","48033","Advocating genocide","0","0","0","0","0","0","0","0","0","0","0","0","0","0"
"2012","Edmonton, Alberta, municipal","48033","Advocating genocide","0","0","0","0","0","0","0","0","0","0","0","0","0","0"
"2013","Edmonton, Alberta, municipal","48033","Advocating genocide","0","0","0","0","0","0","0","0","0","0","0","0","0","0"
"2014","Edmonton, Alberta, municipal","48033","Advocating genocide","0","0","0","0","0","0","0","0","0","0","0","0","0","0"
"2015","Edmonton, Alberta, municipal","48033","Advocating genocide","0","0","0","0","0","0","0","0","0","0","0","0","0","0"
"2016","Edmonton, Alberta, municipal","48033","Advocating genocide","0","0","0","0","0","0","0","0","0","0","0","0","0","0"
"2005","Edmonton, Alberta, municipal","48033","Public incitement of hatred","0","0","0","0","0","0","0","0","0","0","0","0","0","0"
"2006","Edmonton, Alberta, municipal","48033","Public incitement of hatred","0","0","0","0","0","0","0","0","0","0","0","0","0","0"
"2007","Edmonton, Alberta, municipal","48033","Public incitement of hatred","0","0","0","0","0","0","0","0","0","0","0","0","0","0"
"2008","Edmonton, Alberta, municipal","48033","Public incitement of hatred","0","0","0","0","0","0","0","0","0","0","0","0","0","0"
"2009","Edmonton, Alberta, municipal","48033","Public incitement of hatred","1","0","0","0","0.12","0","0","0","0","0","0","0","0","0"
"2010","Edmonton, Alberta, municipal","48033","Public incitement of hatred","0","0","0","-100","0","0","0","0","0","0","0","0","0","0"
"2011","Edmonton, Alberta, municipal","48033","Public incitement of hatred","0","0","0","0","0","0","0","0","0","0","0","0","0","0"
"2012","Edmonton, Alberta, municipal","48033","Public incitement of hatred","1","0","0","0","0.12","0","0","0","0","0","0","0","0","0"
"2013","Edmonton, Alberta, municipal","48033","Public incitement of hatred","1","0","0","-3.29","0.11","0","0","0","0","0","0","0","0","0"
"2014","Edmonton, Alberta, municipal","48033","Public incitement of hatred","1","0","0","-3.26","0.11","0","0","0","0","0","0","0","0","0"
"2015","Edmonton, Alberta, municipal","48033","Public incitement of hatred","3","0","0","193.52","0.32","0","0","0","0","0","0","0","0","0"
"2016","Edmonton, Alberta, municipal","48033","Public incitement of hatred","3","0","0","-2.22","0.31","0","0","0","0","0","0","0","0","0"
"2005","Edmonton, Alberta, municipal","48033","Unauthorized recording of a movie","0","0","0","0","0","0","0","0","0","0","0","0","0","0"
"2006","Edmonton, Alberta, municipal","48033","Unauthorized recording of a movie","0","0","0","0","0","0","0","0","0","0","0","0","0","0"
"2007","Edmonton, Alberta, municipal","48033","Unauthorized recording of a movie","0","0","0","0","0","0","0","0","0","0","0","0","0","0"
"2008","Edmonton, Alberta, municipal","48033","Unauthorized recording of a movie","1","0","0","0","0.13","0","0","0","0","0","0","0","0","0"
"2009","Edmonton, Alberta, municipal","48033","Unauthorized recording of a movie","0","0","0","-100","0","0","0","0","0","0","0","0","0","0"
"2010","Edmonton, Alberta, municipal","48033","Unauthorized recording of a movie","0","0","0","0","0","0","0","0","0","0","0","0","0","0"
"2011","Edmonton, Alberta, municipal","48033","Unauthorized recording of a movie","0","0","0","0","0","0","0","0","0","0","0","0","0","0"
"2012","Edmonton, Alberta, municipal","48033","Unauthorized recording of a movie","0","0","0","0","0","0","0","0","0","0","0","0","0","0"
"2013","Edmonton, Alberta, municipal","48033","Unauthorized recording of a movie","0","0","0","0","0","0","0","0","0","0","0","0","0","0"
"2014","Edmonton, Alberta, municipal","48033","Unauthorized recording of a movie","0","0","0","0","0","0","0","0","0","0","0","0","0","0"
"2015","Edmonton, Alberta, municipal","48033","Unauthorized recording of a movie","0","0","0","0","0","0","0","0","0","0","0","0","0","0"
"2016","Edmonton, Alberta, municipal","48033","Unauthorized recording of a movie","0","0","0","0","0","0","0","0","0","0","0","0","0","0"
"1998","Edmonton, Alberta, municipal","48033","Offences against public order (Part II Criminal Code)","20","20","0","0","3.06","0","0","0","0","20","14","15","1","0"
"1999","Edmonton, Alberta, municipal","48033","Offences against public order (Part II Criminal Code)","17","17","0","-16.32","2.56","0","0","0","0","17","13","14","1","0"
"2000","Edmonton, Alberta, municipal","48033","Offences against public order (Part II Criminal Code)","13","6","1","-24.68","1.93","0","0","0","0","7","5","6","1","1"
"2001","Edmonton, Alberta, municipal","48033","Offences against public order (Part II Criminal Code)","13","12","0","-1.37","1.9","0","0","0","0","12","13","16","3","0"
"2002","Edmonton, Alberta, municipal","48033","Offences against public order (Part II Criminal Code)","3","3","0","-77.32","0.43","0","0","0","0","3","3","7","4","0"
"2003","Edmonton, Alberta, municipal","48033","Offences against public order (Part II Criminal Code)","12","10","0","295.52","1.71","0","0","0","0","10","8","8","0","0"
"2004","Edmonton, Alberta, municipal","48033","Offences against public order (Part II Criminal Code)","9","9","0","-26.85","1.25","1.23","1.28","1.81","0","9","7","8","1","0"
"2005","Edmonton, Alberta, municipal","48033","Offences against public order (Part II Criminal Code)","9","9","0","-2.27","1.22","1.37","1.25","0","0","9","8","8","0","0"
"2006","Edmonton, Alberta, municipal","48033","Offences against public order (Part II Criminal Code)","23","22","0","148.25","3.03","1.99","1.97","1.79","0","22","12","13","1","0"
"2007","Edmonton, Alberta, municipal","48033","Offences against public order (Part II Criminal Code)","12","11","0","-49.18","1.54","1.61","1.47","0","0","11","10","10","0","0"
"2008","Edmonton, Alberta, municipal","48033","Offences against public order (Part II Criminal Code)","5","3","0","-59.29","0.63","0.47","0.43","0","0","3","3","3","0","0"
"2009","Edmonton, Alberta, municipal","48033","Offences against public order (Part II Criminal Code)","11","11","0","114.55","1.34","1.67","1.55","0","0","11","11","11","0","0"
"2010","Edmonton, Alberta, municipal","48033","Offences against public order (Part II Criminal Code)","7","7","0","-37.38","0.84","1.05","0.97","0","0","7","7","7","0","0"
"2011","Edmonton, Alberta, municipal","48033","Offences against public order (Part II Criminal Code)","16","16","0","124.67","1.89","2.21","2.31","3.63","0","16","15","17","2","0"
"2012","Edmonton, Alberta, municipal","48033","Offences against public order (Part II Criminal Code)","10","10","0","-39.07","1.15","1.43","1.33","0","0","10","10","10","0","0"
"2013","Edmonton, Alberta, municipal","48033","Offences against public order (Part II Criminal Code)","7","6","1","-32.31","0.78","0.83","0.77","0","0","7","6","6","0","0"
"2014","Edmonton, Alberta, municipal","48033","Offences against public order (Part II Criminal Code)","4","3","0","-44.72","0.43","0.27","0.37","1.84","0","3","2","3","1","0"
"2015","Edmonton, Alberta, municipal","48033","Offences against public order (Part II Criminal Code)","12","10","0","193.52","1.27","1.31","1.22","0","0","10","10","10","0","0"
"2016","Edmonton, Alberta, municipal","48033","Offences against public order (Part II Criminal Code)","13","7","4","5.93","1.34","0.77","0.84","1.8","0","11","6","7","1","0"
"2002","Edmonton, Alberta, municipal","48033","Property or service for terrorist activity","0","0","0","0","0","0","0","0","0","0","0","0","0","0"
"2003","Edmonton, Alberta, municipal","48033","Property or service for terrorist activity","0","0","0","0","0","0","0","0","0","0","0","0","0","0"
"2004","Edmonton, Alberta, municipal","48033","Property or service for terrorist activity","0","0","0","0","0","0","0","0","0","0","0","0","0","0"
"2005","Edmonton, Alberta, municipal","48033","Property or service for terrorist activity","0","0","0","0","0","0","0","0","0","0","0","0","0","0"
"2006","Edmonton, Alberta, municipal","48033","Property or service for terrorist activity","0","0","0","0","0","0","0","0","0","0","0","0","0","0"
"2007","Edmonton, Alberta, municipal","48033","Property or service for terrorist activity","0","0","0","0","0","0","0","0","0","0","0","0","0","0"
"2008","Edmonton, Alberta, municipal","48033","Property or service for terrorist activity","0","0","0","0","0","0","0","0","0","0","0","0","0","0"
"2009","Edmonton, Alberta, municipal","48033","Property or service for terrorist activity","0","0","0","0","0","0","0","0","0","0","0","0","0","0"
"2010","Edmonton, Alberta, municipal","48033","Property or service for terrorist activity","0","0","0","0","0","0","0","0","0","0","0","0","0","0"
"2011","Edmonton, Alberta, municipal","48033","Property or service for terrorist activity","0","0","0","0","0","0","0","0","0","0","0","0","0","0"
"2012","Edmonton, Alberta, municipal","48033","Property or service for terrorist activity","0","0","0","0","0","0","0","0","0","0","0","0","0","0"
"2013","Edmonton, Alberta, municipal","48033","Property or service for terrorist activity","0","0","0","0","0","0","0","0","0","0","0","0","0","0"
"2014","Edmonton, Alberta, municipal","48033","Property or service for terrorist activity","0","0","0","0","0","0","0","0","0","0","0","0","0","0"
"2015","Edmonton, Alberta, municipal","48033","Property or service for terrorist activity","2","0","0","0","0.21","0","0","0","0","0","0","0","0","0"
"2016","Edmonton, Alberta, municipal","48033","Property or service for terrorist activity","2","0","0","-2.22","0.21","0","0","0","0","0","0","0","0","0"
"2002","Edmonton, Alberta, municipal","48033","Freezing of property, disclosure or audit","0","0","0","0","0","0","0","0","0","0","0","0","0","0"
"2003","Edmonton, Alberta, municipal","48033","Freezing of property, disclosure or audit","0","0","0","0","0","0","0","0","0","0","0","0","0","0"
"2004","Edmonton, Alberta, municipal","48033","Freezing of property, disclosure or audit","0","0","0","0","0","0","0","0","0","0","0","0","0","0"
"2005","Edmonton, Alberta, municipal","48033","Freezing of property, disclosure or audit","0","0","0","0","0","0","0","0","0","0","0","0","0","0"
"2006","Edmonton, Alberta, municipal","48033","Freezing of property, disclosure or audit","0","0","0","0","0","0","0","0","0","0","0","0","0","0"
"2007","Edmonton, Alberta, municipal","48033","Freezing of property, disclosure or audit","0","0","0","0","0","0","0","0","0","0","0","0","0","0"
"2008","Edmonton, Alberta, municipal","48033","Freezing of property, disclosure or audit","0","0","0","0","0","0","0","0","0","0","0","0","0","0"
"2009","Edmonton, Alberta, municipal","48033","Freezing of property, disclosure or audit","0","0","0","0","0","0","0","0","0","0","0","0","0","0"
"2010","Edmonton, Alberta, municipal","48033","Freezing of property, disclosure or audit","0","0","0","0","0","0","0","0","0","0","0","0","0","0"
"2011","Edmonton, Alberta, municipal","48033","Freezing of property, disclosure or audit","0","0","0","0","0","0","0","0","0","0","0","0","0","0"
"2012","Edmonton, Alberta, municipal","48033","Freezing of property, disclosure or audit","0","0","0","0","0","0","0","0","0","0","0","0","0","0"
"2013","Edmonton, Alberta, municipal","48033","Freezing of property, disclosure or audit","0","0","0","0","0","0","0","0","0","0","0","0","0","0"
"2014","Edmonton, Alberta, municipal","48033","Freezing of property, disclosure or audit","0","0","0","0","0","0","0","0","0","0","0","0","0","0"
"2015","Edmonton, Alberta, municipal","48033","Freezing of property, disclosure or audit","0","0","0","0","0","0","0","0","0","0","0","0","0","0"
"2016","Edmonton, Alberta, municipal","48033","Freezing of property, disclosure or audit","0","0","0","0","0","0","0","0","0","0","0","0","0","0"
"2002","Edmonton, Alberta, municipal","48033","Participate in activity of terrorist group","0","0","0","0","0","0","0","0","0","0","0","0","0","0"
"2003","Edmonton, Alberta, municipal","48033","Participate in activity of terrorist group","0","0","0","0","0","0","0","0","0","0","0","0","0","0"
"2004","Edmonton, Alberta, municipal","48033","Participate in activity of terrorist group","0","0","0","0","0","0","0","0","0","0","0","0","0","0"
"2005","Edmonton, Alberta, municipal","48033","Participate in activity of terrorist group","0","0","0","0","0","0","0","0","0","0","0","0","0","0"
"2006","Edmonton, Alberta, municipal","48033","Participate in activity of terrorist group","0","0","0","0","0","0","0","0","0","0","0","0","0","0"
"2007","Edmonton, Alberta, municipal","48033","Participate in activity of terrorist group","0","0","0","0","0","0","0","0","0","0","0","0","0","0"
"2008","Edmonton, Alberta, municipal","48033","Participate in activity of terrorist group","0","0","0","0","0","0","0","0","0","0","0","0","0","0"
"2009","Edmonton, Alberta, municipal","48033","Participate in activity of terrorist group","0","0","0","0","0","0","0","0","0","0","0","0","0","0"
"2010","Edmonton, Alberta, municipal","48033","Participate in activity of terrorist group","0","0","0","0","0","0","0","0","0","0","0","0","0","0"
"2011","Edmonton, Alberta, municipal","48033","Participate in activity of terrorist group","0","0","0","0","0","0","0","0","0","0","0","0","0","0"
"2012","Edmonton, Alberta, municipal","48033","Participate in activity of terrorist group","1","0","0","0","0.12","0","0","0","0","0","0","0","0","0"
"2013","Edmonton, Alberta, municipal","48033","Participate in activity of terrorist group","1","0","0","-3.29","0.11","0","0","0","0","0","0","0","0","0"
"2014","Edmonton, Alberta, municipal","48033","Participate in activity of terrorist group","1","0","0","-3.26","0.11","0","0","0","0","0","0","0","0","0"
"2015","Edmonton, Alberta, municipal","48033","Participate in activity of terrorist group","2","0","0","95.68","0.21","0","0","0","0","0","0","0","0","0"
"2016","Edmonton, Alberta, municipal","48033","Participate in activity of terrorist group","3","0","0","46.67","0.31","0","0","0","0","0","0","0","0","0"
"2002","Edmonton, Alberta, municipal","48033","Facilitate terrorist activity","0","0","0","0","0","0","0","0","0","0","0","0","0","0"
"2003","Edmonton, Alberta, municipal","48033","Facilitate terrorist activity","0","0","0","0","0","0","0","0","0","0","0","0","0","0"
"2004","Edmonton, Alberta, municipal","48033","Facilitate terrorist activity","0","0","0","0","0","0","0","0","0","0","0","0","0","0"
"2005","Edmonton, Alberta, municipal","48033","Facilitate terrorist activity","0","0","0","0","0","0","0","0","0","0","0","0","0","0"
"2006","Edmonton, Alberta, municipal","48033","Facilitate terrorist activity","0","0","0","0","0","0","0","0","0","0","0","0","0","0"
"2007","Edmonton, Alberta, municipal","48033","Facilitate terrorist activity","0","0","0","0","0","0","0","0","0","0","0","0","0","0"
"2008","Edmonton, Alberta, municipal","48033","Facilitate terrorist activity","0","0","0","0","0","0","0","0","0","0","0","0","0","0"
"2009","Edmonton, Alberta, municipal","48033","Facilitate terrorist activity","0","0","0","0","0","0","0","0","0","0","0","0","0","0"
"2010","Edmonton, Alberta, municipal","48033","Facilitate terrorist activity","0","0","0","0","0","0","0","0","0","0","0","0","0","0"
"2011","Edmonton, Alberta, municipal","48033","Facilitate terrorist activity","0","0","0","0","0","0","0","0","0","0","0","0","0","0"
"2012","Edmonton, Alberta, municipal","48033","Facilitate terrorist activity","0","0","0","0","0","0","0","0","0","0","0","0","0","0"
"2013","Edmonton, Alberta, municipal","48033","Facilitate terrorist activity","0","0","0","0","0","0","0","0","0","0","0","0","0","0"
"2014","Edmonton, Alberta, municipal","48033","Facilitate terrorist activity","2","0","0","0","0.22","0","0","0","0","0","0","0","0","0"
"2015","Edmonton, Alberta, municipal","48033","Facilitate terrorist activity","1","0","0","-51.08","0.11","0","0","0","0","0","0","0","0","0"
"2016","Edmonton, Alberta, municipal","48033","Facilitate terrorist activity","1","0","0","-2.22","0.1","0","0","0","0","0","0","0","0","0"
"2002","Edmonton, Alberta, municipal","48033","Commission or instructing to carry out terrorist activity","0","0","0","0","0","0","0","0","0","0","0","0","0","0"
"2003","Edmonton, Alberta, municipal","48033","Commission or instructing to carry out terrorist activity","0","0","0","0","0","0","0","0","0","0","0","0","0","0"
"2004","Edmonton, Alberta, municipal","48033","Commission or instructing to carry out terrorist activity","0","0","0","0","0","0","0","0","0","0","0","0","0","0"
"2005","Edmonton, Alberta, municipal","48033","Commission or instructing to carry out terrorist activity","0","0","0","0","0","0","0","0","0","0","0","0","0","0"
"2006","Edmonton, Alberta, municipal","48033","Commission or instructing to carry out terrorist activity","0","0","0","0","0","0","0","0","0","0","0","0","0","0"
"2007","Edmonton, Alberta, municipal","48033","Commission or instructing to carry out terrorist activity","0","0","0","0","0","0","0","0","0","0","0","0","0","0"
"2008","Edmonton, Alberta, municipal","48033","Commission or instructing to carry out terrorist activity","0","0","0","0","0","0","0","0","0","0","0","0","0","0"
"2009","Edmonton, Alberta, municipal","48033","Commission or instructing to carry out terrorist activity","0","0","0","0","0","0","0","0","0","0","0","0","0","0"
"2010","Edmonton, Alberta, municipal","48033","Commission or instructing to carry out terrorist activity","0","0","0","0","0","0","0","0","0","0","0","0","0","0"
"2011","Edmonton, Alberta, municipal","48033","Commission or instructing to carry out terrorist activity","0","0","0","0","0","0","0","0","0","0","0","0","0","0"
"2012","Edmonton, Alberta, municipal","48033","Commission or instructing to carry out terrorist activity","0","0","0","0","0","0","0","0","0","0","0","0","0","0"
"2013","Edmonton, Alberta, municipal","48033","Commission or instructing to carry out terrorist activity","0","0","0","0","0","0","0","0","0","0","0","0","0","0"
"2014","Edmonton, Alberta, municipal","48033","Commission or instructing to carry out terrorist activity","0","0","0","0","0","0","0","0","0","0","0","0","0","0"
"2015","Edmonton, Alberta, municipal","48033","Commission or instructing to carry out terrorist activity","0","0","0","0","0","0","0","0","0","0","0","0","0","0"
"2016","Edmonton, Alberta, municipal","48033","Commission or instructing to carry out terrorist activity","1","0","0","0","0.1","0","0","0","0","0","0","0","0","0"
"2002","Edmonton, Alberta, municipal","48033","Harbour or conceal terrorist","0","0","0","0","0","0","0","0","0","0","0","0","0","0"
"2003","Edmonton, Alberta, municipal","48033","Harbour or conceal terrorist","0","0","0","0","0","0","0","0","0","0","0","0","0","0"
"2004","Edmonton, Alberta, municipal","48033","Harbour or conceal terrorist","0","0","0","0","0","0","0","0","0","0","0","0","0","0"
"2005","Edmonton, Alberta, municipal","48033","Harbour or conceal terrorist","0","0","0","0","0","0","0","0","0","0","0","0","0","0"
"2006","Edmonton, Alberta, municipal","48033","Harbour or conceal terrorist","0","0","0","0","0","0","0","0","0","0","0","0","0","0"
"2007","Edmonton, Alberta, municipal","48033","Harbour or conceal terrorist","0","0","0","0","0","0","0","0","0","0","0","0","0","0"
"2008","Edmonton, Alberta, municipal","48033","Harbour or conceal terrorist","0","0","0","0","0","0","0","0","0","0","0","0","0","0"
"2009","Edmonton, Alberta, municipal","48033","Harbour or conceal terrorist","0","0","0","0","0","0","0","0","0","0","0","0","0","0"
"2010","Edmonton, Alberta, municipal","48033","Harbour or conceal terrorist","0","0","0","0","0","0","0","0","0","0","0","0","0","0"
"2011","Edmonton, Alberta, municipal","48033","Harbour or conceal terrorist","0","0","0","0","0","0","0","0","0","0","0","0","0","0"
"2012","Edmonton, Alberta, municipal","48033","Harbour or conceal terrorist","0","0","0","0","0","0","0","0","0","0","0","0","0","0"
"2013","Edmonton, Alberta, municipal","48033","Harbour or conceal terrorist","0","0","0","0","0","0","0","0","0","0","0","0","0","0"
"2014","Edmonton, Alberta, municipal","48033","Harbour or conceal terrorist","0","0","0","0","0","0","0","0","0","0","0","0","0","0"
"2015","Edmonton, Alberta, municipal","48033","Harbour or conceal terrorist","0","0","0","0","0","0","0","0","0","0","0","0","0","0"
"2016","Edmonton, Alberta, municipal","48033","Harbour or conceal terrorist","0","0","0","0","0","0","0","0","0","0","0","0","0","0"
"2005","Edmonton, Alberta, municipal","48033","Hoax terrorism","0","0","0","0","0","0","0","0","0","0","0","0","0","0"
"2006","Edmonton, Alberta, municipal","48033","Hoax terrorism","0","0","0","0","0","0","0","0","0","0","0","0","0","0"
"2007","Edmonton, Alberta, municipal","48033","Hoax terrorism","0","0","0","0","0","0","0","0","0","0","0","0","0","0"
"2008","Edmonton, Alberta, municipal","48033","Hoax terrorism","0","0","0","0","0","0","0","0","0","0","0","0","0","0"
"2009","Edmonton, Alberta, municipal","48033","Hoax terrorism","0","0","0","0","0","0","0","0","0","0","0","0","0","0"
"2010","Edmonton, Alberta, municipal","48033","Hoax terrorism","0","0","0","0","0","0","0","0","0","0","0","0","0","0"
"2011","Edmonton, Alberta, municipal","48033","Hoax terrorism","0","0","0","0","0","0","0","0","0","0","0","0","0","0"
"2012","Edmonton, Alberta, municipal","48033","Hoax terrorism","0","0","0","0","0","0","0","0","0","0","0","0","0","0"
"2013","Edmonton, Alberta, municipal","48033","Hoax terrorism","0","0","0","0","0","0","0","0","0","0","0","0","0","0"
"2014","Edmonton, Alberta, municipal","48033","Hoax terrorism","2","0","0","0","0.22","0","0","0","0","0","0","0","0","0"
"2015","Edmonton, Alberta, municipal","48033","Hoax terrorism","2","1","1","-2.16","0.21","0.13","0.12","0","1.83","2","1","1","0","1"
"2016","Edmonton, Alberta, municipal","48033","Hoax terrorism","1","2","0","-51.11","0.1","0.26","0.24","0","0","2","2","2","0","0"
"2012","Edmonton, Alberta, municipal","48033","Advocating/Promoting terrorism offence","0","0","0","0","0","0","0","0","0","0","0","0","0","0"
"2013","Edmonton, Alberta, municipal","48033","Advocating/Promoting terrorism offence","0","0","0","0","0","0","0","0","0","0","0","0","0","0"
"2014","Edmonton, Alberta, municipal","48033","Advocating/Promoting terrorism offence","0","0","0","0","0","0","0","0","0","0","0","0","0","0"
"2015","Edmonton, Alberta, municipal","48033","Advocating/Promoting terrorism offence","0","0","0","0","0","0","0","0","0","0","0","0","0","0"
"2016","Edmonton, Alberta, municipal","48033","Advocating/Promoting terrorism offence","4","0","1","0","0.41","0","0","0","0","1","0","0","0","0"
"1998","Edmonton, Alberta, municipal","48033","Firearms and other offensive weapons (Part III Criminal Code)","0","0","0","0","0","0","0","0","0","0","0","0","0","0"
"1999","Edmonton, Alberta, municipal","48033","Firearms and other offensive weapons (Part III Criminal Code)","0","0","0","0","0","0","0","0","0","0","0","0","0","0"
"2000","Edmonton, Alberta, municipal","48033","Firearms and other offensive weapons (Part III Criminal Code)","2","1","0","0","0.3","0","0","0","0","1","1","1","0","0"
"2001","Edmonton, Alberta, municipal","48033","Firearms and other offensive weapons (Part III Criminal Code)","0","0","0","-100","0","0","0","0","0","0","0","0","0","0"
"2002","Edmonton, Alberta, municipal","48033","Firearms and other offensive weapons (Part III Criminal Code)","0","0","0","0","0","0","0","0","0","0","0","0","0","0"
"2003","Edmonton, Alberta, municipal","48033","Firearms and other offensive weapons (Part III Criminal Code)","1","0","0","0","0.14","0","0","0","0","0","0","0","0","0"
"2004","Edmonton, Alberta, municipal","48033","Firearms and other offensive weapons (Part III Criminal Code)","0","0","0","-100","0","0","0","0","0","0","0","0","0","0"
"2005","Edmonton, Alberta, municipal","48033","Firearms and other offensive weapons (Part III Criminal Code)","0","0","0","0","0","0","0","0","0","0","0","0","0","0"
"2006","Edmonton, Alberta, municipal","48033","Firearms and other offensive weapons (Part III Criminal Code)","1","0","1","0","0.13","0","0","0","0","1","0","0","0","0"
"2007","Edmonton, Alberta, municipal","48033","Firearms and other offensive weapons (Part III Criminal Code)","4","3","0","289.62","0.51","0","0","0","0","3","0","0","0","0"
"2008","Edmonton, Alberta, municipal","48033","Firearms and other offensive weapons (Part III Criminal Code)","35","4","4","754.81","4.39","0.47","0.43","0","0","8","3","3","0","0"
"2009","Edmonton, Alberta, municipal","48033","Firearms and other offensive weapons (Part III Criminal Code)","64","3","13","78.33","7.83","0.15","0.14","0","10.93","16","1","1","0","6"
"2010","Edmonton, Alberta, municipal","48033","Firearms and other offensive weapons (Part III Criminal Code)","61","6","9","-6.21","7.34","0.75","0.69","0","11","15","5","5","0","6"
"2011","Edmonton, Alberta, municipal","48033","Firearms and other offensive weapons (Part III Criminal Code)","60","8","5","-3.32","7.1","0.88","0.82","0","1.82","13","6","6","0","1"
"2012","Edmonton, Alberta, municipal","48033","Firearms and other offensive weapons (Part III Criminal Code)","63","4","9","2.37","7.26","0.43","0.53","1.83","5.5","13","3","4","1","3"
"2013","Edmonton, Alberta, municipal","48033","Firearms and other offensive weapons (Part III Criminal Code)","49","4","2","-24.78","5.46","0.55","0.51","0","0","6","4","4","0","0"
"2014","Edmonton, Alberta, municipal","48033","Firearms and other offensive weapons (Part III Criminal Code)","65","3","4","28.33","7.01","0.13","0.25","1.84","1.84","7","1","2","1","1"
"2015","Edmonton, Alberta, municipal","48033","Firearms and other offensive weapons (Part III Criminal Code)","76","3","4","14.4","8.02","0.39","0.37","0","1.83","7","3","3","0","1"
"2016","Edmonton, Alberta, municipal","48033","Firearms and other offensive weapons (Part III Criminal Code)","79","3","6","1.64","8.15","0.26","0.24","0","3.59","9","2","2","0","2"
"2012","Edmonton, Alberta, municipal","48033","Leaving Canada to participate in activity of terrorist group","0","0","0","0","0","0","0","0","0","0","0","0","0","0"
"2013","Edmonton, Alberta, municipal","48033","Leaving Canada to participate in activity of terrorist group","0","0","0","0","0","0","0","0","0","0","0","0","0","0"
"2014","Edmonton, Alberta, municipal","48033","Leaving Canada to participate in activity of terrorist group","0","0","0","0","0","0","0","0","0","0","0","0","0","0"
"2015","Edmonton, Alberta, municipal","48033","Leaving Canada to participate in activity of terrorist group","1","0","0","0","0.11","0","0","0","0","0","0","0","0","0"
"2016","Edmonton, Alberta, municipal","48033","Leaving Canada to participate in activity of terrorist group","3","0","0","193.35","0.31","0","0","0","0","0","0","0","0","0"
"2012","Edmonton, Alberta, municipal","48033","Leaving Canada to facilitate terrorist activity","0","0","0","0","0","0","0","0","0","0","0","0","0","0"
"2013","Edmonton, Alberta, municipal","48033","Leaving Canada to facilitate terrorist activity","0","0","0","0","0","0","0","0","0","0","0","0","0","0"
"2014","Edmonton, Alberta, municipal","48033","Leaving Canada to facilitate terrorist activity","0","0","0","0","0","0","0","0","0","0","0","0","0","0"
"2015","Edmonton, Alberta, municipal","48033","Leaving Canada to facilitate terrorist activity","0","0","0","0","0","0","0","0","0","0","0","0","0","0"
"2016","Edmonton, Alberta, municipal","48033","Leaving Canada to facilitate terrorist activity","0","0","0","0","0","0","0","0","0","0","0","0","0","0"
"2012","Edmonton, Alberta, municipal","48033","Leaving Canada to commit offence for terrorist group","0","0","0","0","0","0","0","0","0","0","0","0","0","0"
"2013","Edmonton, Alberta, municipal","48033","Leaving Canada to commit offence for terrorist group","0","0","0","0","0","0","0","0","0","0","0","0","0","0"
"2014","Edmonton, Alberta, municipal","48033","Leaving Canada to commit offence for terrorist group","0","0","0","0","0","0","0","0","0","0","0","0","0","0"
"2015","Edmonton, Alberta, municipal","48033","Leaving Canada to commit offence for terrorist group","0","0","0","0","0","0","0","0","0","0","0","0","0","0"
"2016","Edmonton, Alberta, municipal","48033","Leaving Canada to commit offence for terrorist group","0","0","0","0","0","0","0","0","0","0","0","0","0","0"
"2012","Edmonton, Alberta, municipal","48033","Leaving Canada to commit offence that is terrorist activity","0","0","0","0","0","0","0","0","0","0","0","0","0","0"
"2013","Edmonton, Alberta, municipal","48033","Leaving Canada to commit offence that is terrorist activity","0","0","0","0","0","0","0","0","0","0","0","0","0","0"
"2014","Edmonton, Alberta, municipal","48033","Leaving Canada to commit offence that is terrorist activity","0","0","0","0","0","0","0","0","0","0","0","0","0","0"
"2015","Edmonton, Alberta, municipal","48033","Leaving Canada to commit offence that is terrorist activity","0","0","0","0","0","0","0","0","0","0","0","0","0","0"
"2016","Edmonton, Alberta, municipal","48033","Leaving Canada to commit offence that is terrorist activity","0","0","0","0","0","0","0","0","0","0","0","0","0","0"
"2012","Edmonton, Alberta, municipal","48033","Concealing person who carried out terrorist activity that is a terrorism offence for which that person is liable to imprisonment for life","0","0","0","0","0","0","0","0","0","0","0","0","0","0"
"2013","Edmonton, Alberta, municipal","48033","Concealing person who carried out terrorist activity that is a terrorism offence for which that person is liable to imprisonment for life","0","0","0","0","0","0","0","0","0","0","0","0","0","0"
"2014","Edmonton, Alberta, municipal","48033","Concealing person who carried out terrorist activity that is a terrorism offence for which that person is liable to imprisonment for life","0","0","0","0","0","0","0","0","0","0","0","0","0","0"
"2015","Edmonton, Alberta, municipal","48033","Concealing person who carried out terrorist activity that is a terrorism offence for which that person is liable to imprisonment for life","0","0","0","0","0","0","0","0","0","0","0","0","0","0"
"2016","Edmonton, Alberta, municipal","48033","Concealing person who carried out terrorist activity that is a terrorism offence for which that person is liable to imprisonment for life","0","0","0","0","0","0","0","0","0","0","0","0","0","0"
"2012","Edmonton, Alberta, municipal","48033","Concealing person who carried out terrorist activity that is a terrorism offence for which that person is liable to any punishment other than life","0","0","0","0","0","0","0","0","0","0","0","0","0","0"
"2013","Edmonton, Alberta, municipal","48033","Concealing person who carried out terrorist activity that is a terrorism offence for which that person is liable to any punishment other than life","0","0","0","0","0","0","0","0","0","0","0","0","0","0"
"2014","Edmonton, Alberta, municipal","48033","Concealing person who carried out terrorist activity that is a terrorism offence for which that person is liable to any punishment other than life","0","0","0","0","0","0","0","0","0","0","0","0","0","0"
"2015","Edmonton, Alberta, municipal","48033","Concealing person who carried out terrorist activity that is a terrorism offence for which that person is liable to any punishment other than life","0","0","0","0","0","0","0","0","0","0","0","0","0","0"
"2016","Edmonton, Alberta, municipal","48033","Concealing person who carried out terrorist activity that is a terrorism offence for which that person is liable to any punishment other than life","0","0","0","0","0","0","0","0","0","0","0","0","0","0"
"2012","Edmonton, Alberta, municipal","48033","Concealing person who is likely to carry out terrorist activity","0","0","0","0","0","0","0","0","0","0","0","0","0","0"
"2013","Edmonton, Alberta, municipal","48033","Concealing person who is likely to carry out terrorist activity","0","0","0","0","0","0","0","0","0","0","0","0","0","0"
"2014","Edmonton, Alberta, municipal","48033","Concealing person who is likely to carry out terrorist activity","0","0","0","0","0","0","0","0","0","0","0","0","0","0"
"2015","Edmonton, Alberta, municipal","48033","Concealing person who is likely to carry out terrorist activity","0","0","0","0","0","0","0","0","0","0","0","0","0","0"
"2016","Edmonton, Alberta, municipal","48033","Concealing person who is likely to carry out terrorist activity","0","0","0","0","0","0","0","0","0","0","0","0","0","0"
"1998","Edmonton, Alberta, municipal","48033","Sexual offences, public morals and disorderly conduct (Part V Criminal Code)","2","2","0","0","0.31","0","0","0","0","2","1","2","1","0"
"1999","Edmonton, Alberta, municipal","48033","Sexual offences, public morals and disorderly conduct (Part V Criminal Code)","1","1","0","-50.78","0.15","0","0","0","0","1","1","1","0","0"
"2000","Edmonton, Alberta, municipal","48033","Sexual offences, public morals and disorderly conduct (Part V Criminal Code)","2","1","0","97","0.3","0","0","0","0","1","0","0","0","0"
"2001","Edmonton, Alberta, municipal","48033","Sexual offences, public morals and disorderly conduct (Part V Criminal Code)","0","0","0","-100","0","0","0","0","0","0","0","0","0","0"
"2002","Edmonton, Alberta, municipal","48033","Sexual offences, public morals and disorderly conduct (Part V Criminal Code)","1","0","0","0","0.14","0","0","0","0","0","0","0","0","0"
"2003","Edmonton, Alberta, municipal","48033","Sexual offences, public morals and disorderly conduct (Part V Criminal Code)","0","0","0","-100","0","0","0","0","0","0","0","0","0","0"
"2004","Edmonton, Alberta, municipal","48033","Sexual offences, public morals and disorderly conduct (Part V Criminal Code)","0","0","0","0","0","0","0","0","0","0","0","0","0","0"
"2005","Edmonton, Alberta, municipal","48033","Sexual offences, public morals and disorderly conduct (Part V Criminal Code)","0","0","0","0","0","0","0","0","0","0","0","0","0","0"
"2006","Edmonton, Alberta, municipal","48033","Sexual offences, public morals and disorderly conduct (Part V Criminal Code)","0","0","0","0","0","0","0","0","0","0","0","0","0","0"
"2007","Edmonton, Alberta, municipal","48033","Sexual offences, public morals and disorderly conduct (Part V Criminal Code)","0","0","0","0","0","0","0","0","0","0","0","0","0","0"
"2008","Edmonton, Alberta, municipal","48033","Sexual offences, public morals and disorderly conduct (Part V Criminal Code)","0","0","0","0","0","0","0","0","0","0","0","0","0","0"
"2009","Edmonton, Alberta, municipal","48033","Sexual offences, public morals and disorderly conduct (Part V Criminal Code)","1","0","0","0","0.12","0","0","0","0","0","0","0","0","0"
"2010","Edmonton, Alberta, municipal","48033","Sexual offences, public morals and disorderly conduct (Part V Criminal Code)","6","1","1","490.41","0.72","0.15","0.14","0","0","2","1","1","0","0"
"2011","Edmonton, Alberta, municipal","48033","Sexual offences, public morals and disorderly conduct (Part V Criminal Code)","6","0","2","-1.71","0.71","0","0","0","1.82","2","0","0","0","1"
"2012","Edmonton, Alberta, municipal","48033","Sexual offences, public morals and disorderly conduct (Part V Criminal Code)","9","1","1","46.24","1.04","0.14","0.13","0","0","2","1","1","0","0"
"2013","Edmonton, Alberta, municipal","48033","Sexual offences, public morals and disorderly conduct (Part V Criminal Code)","9","0","2","-3.29","1","0","0","0","0","2","0","0","0","0"
"2014","Edmonton, Alberta, municipal","48033","Sexual offences, public morals and disorderly conduct (Part V Criminal Code)","9","0","2","-3.26","0.97","0","0","0","0","2","0","0","0","0"
"2015","Edmonton, Alberta, municipal","48033","Sexual offences, public morals and disorderly conduct (Part V Criminal Code)","5","0","2","-45.64","0.53","0","0","0","0","2","0","0","0","0"
"2016","Edmonton, Alberta, municipal","48033","Sexual offences, public morals and disorderly conduct (Part V Criminal Code)","7","1","0","36.89","0.72","0","0","0","0","1","0","0","0","0"
"1998","Edmonton, Alberta, municipal","48033","Invasion of privacy (Part VI Criminal Code)","0","0","0","0","0","0","0","0","0","0","0","0","0","0"
"1999","Edmonton, Alberta, municipal","48033","Invasion of privacy (Part VI Criminal Code)","0","0","0","0","0","0","0","0","0","0","0","0","0","0"
"2000","Edmonton, Alberta, municipal","48033","Invasion of privacy (Part VI Criminal Code)","0","0","0","0","0","0","0","0","0","0","0","0","0","0"
"2001","Edmonton, Alberta, municipal","48033","Invasion of privacy (Part VI Criminal Code)","0","0","0","0","0","0","0","0","0","0","0","0","0","0"
"2002","Edmonton, Alberta, municipal","48033","Invasion of privacy (Part VI Criminal Code)","0","0","0","0","0","0","0","0","0","0","0","0","0","0"
"2003","Edmonton, Alberta, municipal","48033","Invasion of privacy (Part VI Criminal Code)","0","0","0","0","0","0","0","0","0","0","0","0","0","0"
"2004","Edmonton, Alberta, municipal","48033","Invasion of privacy (Part VI Criminal Code)","0","0","0","0","0","0","0","0","0","0","0","0","0","0"
"2005","Edmonton, Alberta, municipal","48033","Invasion of privacy (Part VI Criminal Code)","0","0","0","0","0","0","0","0","0","0","0","0","0","0"
"2006","Edmonton, Alberta, municipal","48033","Invasion of privacy (Part VI Criminal Code)","0","0","0","0","0","0","0","0","0","0","0","0","0","0"
"2007","Edmonton, Alberta, municipal","48033","Invasion of privacy (Part VI Criminal Code)","0","0","0","0","0","0","0","0","0","0","0","0","0","0"
"2008","Edmonton, Alberta, municipal","48033","Invasion of privacy (Part VI Criminal Code)","1","0","0","0","0.13","0","0","0","0","0","0","0","0","0"
"2009","Edmonton, Alberta, municipal","48033","Invasion of privacy (Part VI Criminal Code)","0","0","0","-100","0","0","0","0","0","0","0","0","0","0"
"2010","Edmonton, Alberta, municipal","48033","Invasion of privacy (Part VI Criminal Code)","0","0","0","0","0","0","0","0","0","0","0","0","0","0"
"2011","Edmonton, Alberta, municipal","48033","Invasion of privacy (Part VI Criminal Code)","1","0","0","0","0.12","0","0","0","0","0","0","0","0","0"
"2012","Edmonton, Alberta, municipal","48033","Invasion of privacy (Part VI Criminal Code)","0","0","0","-100","0","0","0","0","0","0","0","0","0","0"
"2013","Edmonton, Alberta, municipal","48033","Invasion of privacy (Part VI Criminal Code)","1","0","0","0","0.11","0","0","0","0","0","0","0","0","0"
"2014","Edmonton, Alberta, municipal","48033","Invasion of privacy (Part VI Criminal Code)","0","0","0","-100","0","0","0","0","0","0","0","0","0","0"
"2015","Edmonton, Alberta, municipal","48033","Invasion of privacy (Part VI Criminal Code)","0","0","1","0","0","0","0","0","0","1","0","0","0","0"
"2016","Edmonton, Alberta, municipal","48033","Invasion of privacy (Part VI Criminal Code)","0","0","0","0","0","0","0","0","0","0","0","0","0","0"
"1998","Edmonton, Alberta, municipal","48033","Disorderly houses, gaming and betting","0","0","0","0","0","0","0","0","0","0","0","0","0","0"
"1999","Edmonton, Alberta, municipal","48033","Disorderly houses, gaming and betting","0","0","0","0","0","0","0","0","0","0","0","0","0","0"
"2000","Edmonton, Alberta, municipal","48033","Disorderly houses, gaming and betting","0","0","0","0","0","0","0","0","0","0","0","0","0","0"
"2001","Edmonton, Alberta, municipal","48033","Disorderly houses, gaming and betting","0","0","0","0","0","0","0","0","0","0","0","0","0","0"
"2002","Edmonton, Alberta, municipal","48033","Disorderly houses, gaming and betting","0","0","0","0","0","0","0","0","0","0","0","0","0","0"
"2003","Edmonton, Alberta, municipal","48033","Disorderly houses, gaming and betting","0","0","0","0","0","0","0","0","0","0","0","0","0","0"
"2004","Edmonton, Alberta, municipal","48033","Disorderly houses, gaming and betting","0","0","0","0","0","0","0","0","0","0","0","0","0","0"
"2005","Edmonton, Alberta, municipal","48033","Disorderly houses, gaming and betting","0","0","0","0","0","0","0","0","0","0","0","0","0","0"
"2006","Edmonton, Alberta, municipal","48033","Disorderly houses, gaming and betting","0","0","0","0","0","0","0","0","0","0","0","0","0","0"
"2007","Edmonton, Alberta, municipal","48033","Disorderly houses, gaming and betting","0","0","0","0","0","0","0","0","0","0","0","0","0","0"
"2008","Edmonton, Alberta, municipal","48033","Disorderly houses, gaming and betting","0","0","0","0","0","0","0","0","0","0","0","0","0","0"
"2009","Edmonton, Alberta, municipal","48033","Disorderly houses, gaming and betting","0","0","0","0","0","0","0","0","0","0","0","0","0","0"
"2010","Edmonton, Alberta, municipal","48033","Disorderly houses, gaming and betting","0","0","0","0","0","0","0","0","0","0","0","0","0","0"
"2011","Edmonton, Alberta, municipal","48033","Disorderly houses, gaming and betting","0","0","0","0","0","0","0","0","0","0","0","0","0","0"
"2012","Edmonton, Alberta, municipal","48033","Disorderly houses, gaming and betting","0","0","0","0","0","0","0","0","0","0","0","0","0","0"
"2013","Edmonton, Alberta, municipal","48033","Disorderly houses, gaming and betting","0","0","0","0","0","0","0","0","0","0","0","0","0","0"
"2014","Edmonton, Alberta, municipal","48033","Disorderly houses, gaming and betting","0","0","0","0","0","0","0","0","0","0","0","0","0","0"
"2015","Edmonton, Alberta, municipal","48033","Disorderly houses, gaming and betting","0","0","0","0","0","0","0","0","0","0","0","0","0","0"
"2016","Edmonton, Alberta, municipal","48033","Disorderly houses, gaming and betting","0","0","0","0","0","0","0","0","0","0","0","0","0","0"
"1998","Edmonton, Alberta, municipal","48033","Offences against the person and reputation (Part VIII Criminal Code)","443","175","53","0","67.83","0","0","0","0","228","115","128","13","13"
"1999","Edmonton, Alberta, municipal","48033","Offences against the person and reputation (Part VIII Criminal Code)","134","32","14","-70.22","20.2","0","0","0","0","46","18","23","5","1"
"2000","Edmonton, Alberta, municipal","48033","Offences against the person and reputation (Part VIII Criminal Code)","39","8","4","-71.33","5.79","0","0","0","0","12","4","4","0","2"
"2001","Edmonton, Alberta, municipal","48033","Offences against the person and reputation (Part VIII Criminal Code)","32","0","3","-19.07","4.69","0","0","0","0","3","0","0","0","0"
"2002","Edmonton, Alberta, municipal","48033","Offences against the person and reputation (Part VIII Criminal Code)","24","1","2","-26.29","3.45","0","0","0","0","3","1","1","0","5"
"2003","Edmonton, Alberta, municipal","48033","Offences against the person and reputation (Part VIII Criminal Code)","26","2","0","7.12","3.7","0","0","0","0","2","1","1","0","0"
"2004","Edmonton, Alberta, municipal","48033","Offences against the person and reputation (Part VIII Criminal Code)","24","1","1","-9.97","3.33","0.18","0.16","0","5.43","2","1","1","0","3"
"2005","Edmonton, Alberta, municipal","48033","Offences against the person and reputation (Part VIII Criminal Code)","15","2","0","-38.92","2.03","0.34","0.31","0","0","2","2","2","0","0"
"2006","Edmonton, Alberta, municipal","48033","Offences against the person and reputation (Part VIII Criminal Code)","24","1","3","55.43","3.16","0.17","0.15","0","0","4","1","1","0","0"
"2007","Edmonton, Alberta, municipal","48033","Offences against the person and reputation (Part VIII Criminal Code)","56","0","6","127.28","7.19","0","0","0","3.59","6","0","0","0","2"
"2008","Edmonton, Alberta, municipal","48033","Offences against the person and reputation (Part VIII Criminal Code)","19","0","3","-66.85","2.38","0","0","0","9.03","3","0","0","0","5"
"2009","Edmonton, Alberta, municipal","48033","Offences against the person and reputation (Part VIII Criminal Code)","21","1","1","7.79","2.57","0.15","0.14","0","0","2","1","1","0","0"
"2010","Edmonton, Alberta, municipal","48033","Offences against the person and reputation (Part VIII Criminal Code)","10","0","1","-53.14","1.2","0","0","0","3.67","1","0","0","0","2"
"2011","Edmonton, Alberta, municipal","48033","Offences against the person and reputation (Part VIII Criminal Code)","0","1","0","-100","0","0.15","0.14","0","0","1","1","1","0","0"
"2012","Edmonton, Alberta, municipal","48033","Offences against the person and reputation (Part VIII Criminal Code)","1","1","0","0","0.12","0.14","0.13","0","0","1","1","1","0","0"
"2013","Edmonton, Alberta, municipal","48033","Offences against the person and reputation (Part VIII Criminal Code)","2","0","0","93.41","0.22","0","0","0","0","0","0","0","0","0"
"2014","Edmonton, Alberta, municipal","48033","Offences against the person and reputation (Part VIII Criminal Code)","2","1","0","-3.26","0.22","0.27","0.25","0","0","1","2","2","0","0"
"2015","Edmonton, Alberta, municipal","48033","Offences against the person and reputation (Part VIII Criminal Code)","2","3","0","-2.16","0.21","0.26","0.24","0","0","3","2","2","0","0"
"2016","Edmonton, Alberta, municipal","48033","Offences against the person and reputation (Part VIII Criminal Code)","1","1","0","-51.11","0.1","0.13","0.12","0","0","1","1","1","0","0"
"2012","Edmonton, Alberta, municipal","48033","Failure to comply with the regulations/obligations for medical assistance in dying","0","0","0","0","0","0","0","0","0","0","0","0","0","0"
"2013","Edmonton, Alberta, municipal","48033","Failure to comply with the regulations/obligations for medical assistance in dying","0","0","0","0","0","0","0","0","0","0","0","0","0","0"
"2014","Edmonton, Alberta, municipal","48033","Failure to comply with the regulations/obligations for medical assistance in dying","0","0","0","0","0","0","0","0","0","0","0","0","0","0"
"2015","Edmonton, Alberta, municipal","48033","Failure to comply with the regulations/obligations for medical assistance in dying","0","0","0","0","0","0","0","0","0","0","0","0","0","0"
"2016","Edmonton, Alberta, municipal","48033","Failure to comply with the regulations/obligations for medical assistance in dying","0","0","0","0","0","0","0","0","0","0","0","0","0","0"
"1998","Edmonton, Alberta, municipal","48033","Offences against rights of property (Part IX Criminal Code)","99","99","0","0","15.16","0","0","0","0","99","65","104","39","1"
"1999","Edmonton, Alberta, municipal","48033","Offences against rights of property (Part IX Criminal Code)","55","55","0","-45.31","8.29","0","0","0","0","55","44","56","12","2"
"2000","Edmonton, Alberta, municipal","48033","Offences against rights of property (Part IX Criminal Code)","23","23","0","-58.81","3.41","0","0","0","0","23","21","29","8","1"
"2001","Edmonton, Alberta, municipal","48033","Offences against rights of property (Part IX Criminal Code)","77","71","2","230.21","11.28","0","0","0","0","73","63","87","24","2"
"2002","Edmonton, Alberta, municipal","48033","Offences against rights of property (Part IX Criminal Code)","91","89","0","16.15","13.1","0","0","0","0","89","66","100","34","2"
"2003","Edmonton, Alberta, municipal","48033","Offences against rights of property (Part IX Criminal Code)","131","128","0","42.34","18.64","0","0","0","0","128","86","125","39","2"
"2004","Edmonton, Alberta, municipal","48033","Offences against rights of property (Part IX Criminal Code)","132","127","2","-1.73","18.32","17.42","22.29","72.34","10.85","129","99","139","40","6"
"2005","Edmonton, Alberta, municipal","48033","Offences against rights of property (Part IX Criminal Code)","175","164","2","29.57","23.74","22.95","25.65","54.02","1.8","166","134","164","30","1"
"2006","Edmonton, Alberta, municipal","48033","Offences against rights of property (Part IX Criminal Code)","122","119","1","-32.28","16.07","12.42","14.1","32.15","3.57","120","75","93","18","2"
"2007","Edmonton, Alberta, municipal","48033","Offences against rights of property (Part IX Criminal Code)","101","104","0","-19.36","12.96","12.53","13.86","28.71","0","104","78","94","16","0"
"2008","Edmonton, Alberta, municipal","48033","Offences against rights of property (Part IX Criminal Code)","96","95","1","-7.14","12.04","14.56","15.56","27.08","0","96","93","108","15","0"
"2009","Edmonton, Alberta, municipal","48033","Offences against rights of property (Part IX Criminal Code)","67","64","0","-31.94","8.19","9.44","9.97","16.39","0","64","62","71","9","0"
"2010","Edmonton, Alberta, municipal","48033","Offences against rights of property (Part IX Criminal Code)","73","73","1","7.21","8.78","11.67","11.48","9.16","1.83","74","78","83","5","1"
"2011","Edmonton, Alberta, municipal","48033","Offences against rights of property (Part IX Criminal Code)","105","104","0","41.38","12.42","14.27","14.7","19.98","0","104","97","108","11","0"
"2012","Edmonton, Alberta, municipal","48033","Offences against rights of property (Part IX Criminal Code)","106","106","0","-1.58","12.22","13.03","14.74","36.64","0","106","91","111","20","0"
"2013","Edmonton, Alberta, municipal","48033","Offences against rights of property (Part IX Criminal Code)","117","115","0","6.74","13.05","12.71","13.62","25.71","0","115","92","106","14","0"
"2014","Edmonton, Alberta, municipal","48033","Offences against rights of property (Part IX Criminal Code)","145","145","0","19.89","15.64","16.68","16.67","16.54","0","145","125","134","9","0"
"2015","Edmonton, Alberta, municipal","48033","Offences against rights of property (Part IX Criminal Code)","177","176","0","19.43","18.68","20.12","19.15","5.48","0","176","154","157","3","0"
"2016","Edmonton, Alberta, municipal","48033","Offences against rights of property (Part IX Criminal Code)","166","165","0","-8.29","17.13","17.27","16.48","5.39","0","165","135","138","3","0"
"1998","Edmonton, Alberta, municipal","48033","Fraudulent transactions relating to contracts and trade (Part X Criminal Code)","3","3","0","0","0.46","0","0","0","0","3","3","3","0","0"
"1999","Edmonton, Alberta, municipal","48033","Fraudulent transactions relating to contracts and trade (Part X Criminal Code)","0","0","0","-100","0","0","0","0","0","0","0","0","0","0"
"2000","Edmonton, Alberta, municipal","48033","Fraudulent transactions relating to contracts and trade (Part X Criminal Code)","6","1","0","0","0.89","0","0","0","0","1","0","0","0","0"
"2001","Edmonton, Alberta, municipal","48033","Fraudulent transactions relating to contracts and trade (Part X Criminal Code)","3","2","0","-50.68","0.44","0","0","0","0","2","0","1","1","0"
"2002","Edmonton, Alberta, municipal","48033","Fraudulent transactions relating to contracts and trade (Part X Criminal Code)","7","0","0","129.31","1.01","0","0","0","0","0","0","0","0","0"
"2003","Edmonton, Alberta, municipal","48033","Fraudulent transactions relating to contracts and trade (Part X Criminal Code)","0","0","0","-100","0","0","0","0","0","0","0","0","0","0"
"2004","Edmonton, Alberta, municipal","48033","Fraudulent transactions relating to contracts and trade (Part X Criminal Code)","1","1","0","0","0.14","0","0","0","0","1","0","0","0","0"
"2005","Edmonton, Alberta, municipal","48033","Fraudulent transactions relating to contracts and trade (Part X Criminal Code)","2","2","0","95.46","0.27","0.34","0.31","0","0","2","2","2","0","0"
"2006","Edmonton, Alberta, municipal","48033","Fraudulent transactions relating to contracts and trade (Part X Criminal Code)","3","0","0","45.71","0.4","0","0","0","0","0","0","0","0","0"
"2007","Edmonton, Alberta, municipal","48033","Fraudulent transactions relating to contracts and trade (Part X Criminal Code)","6","1","0","94.81","0.77","0.16","0.15","0","0","1","1","1","0","0"
"2008","Edmonton, Alberta, municipal","48033","Fraudulent transactions relating to contracts and trade (Part X Criminal Code)","2","0","0","-67.44","0.25","0","0","0","0","0","0","0","0","0"
"2009","Edmonton, Alberta, municipal","48033","Fraudulent transactions relating to contracts and trade (Part X Criminal Code)","8","0","2","290.09","0.98","0","0","0","0","2","0","0","0","0"
"2010","Edmonton, Alberta, municipal","48033","Fraudulent transactions relating to contracts and trade (Part X Criminal Code)","9","0","0","10.7","1.08","0","0","0","0","0","0","0","0","0"
"2011","Edmonton, Alberta, municipal","48033","Fraudulent transactions relating to contracts and trade (Part X Criminal Code)","17","0","2","85.67","2.01","0","0","0","0","2","0","0","0","0"
"2012","Edmonton, Alberta, municipal","48033","Fraudulent transactions relating to contracts and trade (Part X Criminal Code)","15","1","3","-13.98","1.73","0","0.13","1.83","7.33","4","0","1","1","4"
"2013","Edmonton, Alberta, municipal","48033","Fraudulent transactions relating to contracts and trade (Part X Criminal Code)","23","0","0","48.28","2.56","0","0","0","0","0","0","0","0","0"
"2014","Edmonton, Alberta, municipal","48033","Fraudulent transactions relating to contracts and trade (Part X Criminal Code)","28","2","2","17.77","3.02","0.13","0.25","1.84","0","4","1","2","1","0"
"2015","Edmonton, Alberta, municipal","48033","Fraudulent transactions relating to contracts and trade (Part X Criminal Code)","13","4","1","-54.57","1.37","0.52","0.49","0","0","5","4","4","0","0"
"2016","Edmonton, Alberta, municipal","48033","Fraudulent transactions relating to contracts and trade (Part X Criminal Code)","14","2","2","5.3","1.44","0.26","0.24","0","0","4","2","2","0","0"
"1998","Edmonton, Alberta, municipal","48033","Willful and forbidden acts in respect of certain property (Part XI Criminal Code)","21","9","1","0","3.22","0","0","0","0","10","7","8","1","1"
"1999","Edmonton, Alberta, municipal","48033","Willful and forbidden acts in respect of certain property (Part XI Criminal Code)","13","4","3","-39.06","1.96","0","0","0","0","7","2","4","2","2"
"2000","Edmonton, Alberta, municipal","48033","Willful and forbidden acts in respect of certain property (Part XI Criminal Code)","9","5","0","-31.81","1.34","0","0","0","0","5","3","4","1","1"
"2001","Edmonton, Alberta, municipal","48033","Willful and forbidden acts in respect of certain property (Part XI Criminal Code)","12","4","3","31.51","1.76","0","0","0","0","7","3","5","2","4"
"2002","Edmonton, Alberta, municipal","48033","Willful and forbidden acts in respect of certain property (Part XI Criminal Code)","12","4","4","-1.72","1.73","0","0","0","0","8","1","1","0","4"
"2003","Edmonton, Alberta, municipal","48033","Willful and forbidden acts in respect of certain property (Part XI Criminal Code)","13","6","2","7.12","1.85","0","0","0","0","8","4","5","1","4"
"2004","Edmonton, Alberta, municipal","48033","Willful and forbidden acts in respect of certain property (Part XI Criminal Code)","13","6","4","-2.47","1.8","1.06","1.28","3.62","7.23","10","6","8","2","4"
"2005","Edmonton, Alberta, municipal","48033","Willful and forbidden acts in respect of certain property (Part XI Criminal Code)","9","7","0","-32.34","1.22","1.2","1.09","0","0","7","7","7","0","0"
"2006","Edmonton, Alberta, municipal","48033","Willful and forbidden acts in respect of certain property (Part XI Criminal Code)","17","9","1","83.49","2.24","1.16","1.06","0","1.79","10","7","7","0","1"
"2007","Edmonton, Alberta, municipal","48033","Willful and forbidden acts in respect of certain property (Part XI Criminal Code)","29","3","3","66.16","3.72","0.48","0.44","0","3.59","6","3","3","0","2"
"2008","Edmonton, Alberta, municipal","48033","Willful and forbidden acts in respect of certain property (Part XI Criminal Code)","29","5","4","-2.31","3.64","0.78","0.72","0","0","9","5","5","0","0"
"2009","Edmonton, Alberta, municipal","48033","Willful and forbidden acts in respect of certain property (Part XI Criminal Code)","31","7","3","4.25","3.79","1.07","0.98","0","0","10","7","7","0","0"
"2010","Edmonton, Alberta, municipal","48033","Willful and forbidden acts in respect of certain property (Part XI Criminal Code)","48","8","5","52.36","5.78","1.2","1.11","0","0","13","8","8","0","0"
"2011","Edmonton, Alberta, municipal","48033","Willful and forbidden acts in respect of certain property (Part XI Criminal Code)","59","10","13","20.82","6.98","1.32","1.36","1.82","0","23","9","10","1","0"
"2012","Edmonton, Alberta, municipal","48033","Willful and forbidden acts in respect of certain property (Part XI Criminal Code)","78","18","14","28.89","8.99","2.43","2.52","3.66","3.66","32","17","19","2","2"
"2013","Edmonton, Alberta, municipal","48033","Willful and forbidden acts in respect of certain property (Part XI Criminal Code)","78","19","8","-3.29","8.7","2.62","2.44","0","0","27","19","19","0","0"
"2014","Edmonton, Alberta, municipal","48033","Willful and forbidden acts in respect of certain property (Part XI Criminal Code)","96","20","9","19.07","10.35","2.27","2.61","7.35","0","29","17","21","4","0"
"2015","Edmonton, Alberta, municipal","48033","Willful and forbidden acts in respect of certain property (Part XI Criminal Code)","92","32","5","-6.24","9.71","2.87","3.41","10.96","3.65","37","22","28","6","2"
"2016","Edmonton, Alberta, municipal","48033","Willful and forbidden acts in respect of certain property (Part XI Criminal Code)","75","17","6","-20.29","7.74","1.79","1.91","3.59","0","23","14","16","2","0"
"1998","Edmonton, Alberta, municipal","48033","Offences relating to currency (Part XII Criminal Code)","0","0","0","0","0","0","0","0","0","0","0","0","0","0"
"1999","Edmonton, Alberta, municipal","48033","Offences relating to currency (Part XII Criminal Code)","2","0","0","0","0.3","0","0","0","0","0","0","0","0","0"
"2000","Edmonton, Alberta, municipal","48033","Offences relating to currency (Part XII Criminal Code)","2","0","0","-1.5","0.3","0","0","0","0","0","0","0","0","0"
"2001","Edmonton, Alberta, municipal","48033","Offences relating to currency (Part XII Criminal Code)","0","0","0","-100","0","0","0","0","0","0","0","0","0","0"
"2002","Edmonton, Alberta, municipal","48033","Offences relating to currency (Part XII Criminal Code)","4","0","0","0","0.58","0","0","0","0","0","0","0","0","0"
"2003","Edmonton, Alberta, municipal","48033","Offences relating to currency (Part XII Criminal Code)","2","1","0","-50.56","0.28","0","0","0","0","1","1","1","0","0"
"2004","Edmonton, Alberta, municipal","48033","Offences relating to currency (Part XII Criminal Code)","0","0","0","-100","0","0","0","0","0","0","0","0","0","0"
"2005","Edmonton, Alberta, municipal","48033","Offences relating to currency (Part XII Criminal Code)","0","0","0","0","0","0","0","0","0","0","0","0","0","0"
"2006","Edmonton, Alberta, municipal","48033","Offences relating to currency (Part XII Criminal Code)","0","0","0","0","0","0","0","0","0","0","0","0","0","0"
"2007","Edmonton, Alberta, municipal","48033","Offences relating to currency (Part XII Criminal Code)","1","0","0","0","0.13","0","0","0","0","0","0","0","0","0"
"2008","Edmonton, Alberta, municipal","48033","Offences relating to currency (Part XII Criminal Code)","0","0","0","-100","0","0","0","0","0","0","0","0","0","0"
"2009","Edmonton, Alberta, municipal","48033","Offences relating to currency (Part XII Criminal Code)","0","0","0","0","0","0","0","0","0","0","0","0","0","0"
"2010","Edmonton, Alberta, municipal","48033","Offences relating to currency (Part XII Criminal Code)","0","0","0","0","0","0","0","0","0","0","0","0","0","0"
"2011","Edmonton, Alberta, municipal","48033","Offences relating to currency (Part XII Criminal Code)","1","1","0","0","0.12","0","0","0","0","1","0","0","0","0"
"2012","Edmonton, Alberta, municipal","48033","Offences relating to currency (Part XII Criminal Code)","1","0","0","-2.51","0.12","0","0","0","0","0","0","0","0","0"
"2013","Edmonton, Alberta, municipal","48033","Offences relating to currency (Part XII Criminal Code)","1","1","0","-3.29","0.11","0.14","0.13","0","0","1","1","1","0","0"
"2014","Edmonton, Alberta, municipal","48033","Offences relating to currency (Part XII Criminal Code)","1","0","0","-3.26","0.11","0","0","0","0","0","0","0","0","0"
"2015","Edmonton, Alberta, municipal","48033","Offences relating to currency (Part XII Criminal Code)","0","1","0","-100","0","0","0","0","0","1","0","0","0","0"
"2016","Edmonton, Alberta, municipal","48033","Offences relating to currency (Part XII Criminal Code)","0","0","0","0","0","0","0","0","0","0","0","0","0","0"
"1998","Edmonton, Alberta, municipal","48033","Proceeds of crime (Part XII.2 Criminal Code)","0","0","0","0","0","0","0","0","0","0","0","0","0","0"
"1999","Edmonton, Alberta, municipal","48033","Proceeds of crime (Part XII.2 Criminal Code)","1","1","0","0","0.15","0","0","0","0","1","1","1","0","0"
"2000","Edmonton, Alberta, municipal","48033","Proceeds of crime (Part XII.2 Criminal Code)","0","0","0","-100","0","0","0","0","0","0","0","0","0","0"
"2001","Edmonton, Alberta, municipal","48033","Proceeds of crime (Part XII.2 Criminal Code)","0","0","0","0","0","0","0","0","0","0","0","0","0","0"
"2002","Edmonton, Alberta, municipal","48033","Proceeds of crime (Part XII.2 Criminal Code)","4","4","0","0","0.58","0","0","0","0","4","4","4","0","0"
"2003","Edmonton, Alberta, municipal","48033","Proceeds of crime (Part XII.2 Criminal Code)","0","0","0","-100","0","0","0","0","0","0","0","0","0","0"
"2004","Edmonton, Alberta, municipal","48033","Proceeds of crime (Part XII.2 Criminal Code)","0","0","0","0","0","0","0","0","0","0","0","0","0","0"
"2005","Edmonton, Alberta, municipal","48033","Proceeds of crime (Part XII.2 Criminal Code)","1","0","0","0","0.14","0","0","0","0","0","0","0","0","0"
"2006","Edmonton, Alberta, municipal","48033","Proceeds of crime (Part XII.2 Criminal Code)","25","12","0","2328.57","3.29","0.99","0.91","0","0","12","6","6","0","0"
"2007","Edmonton, Alberta, municipal","48033","Proceeds of crime (Part XII.2 Criminal Code)","18","6","1","-29.87","2.31","0.64","0.74","1.79","0","7","4","5","1","0"
"2008","Edmonton, Alberta, municipal","48033","Proceeds of crime (Part XII.2 Criminal Code)","23","2","5","24.83","2.88","0.16","0.29","1.81","0","7","1","2","1","0"
"2009","Edmonton, Alberta, municipal","48033","Proceeds of crime (Part XII.2 Criminal Code)","37","2","7","56.88","4.52","0.61","0.56","0","0","9","4","4","0","0"
"2010","Edmonton, Alberta, municipal","48033","Proceeds of crime (Part XII.2 Criminal Code)","16","0","16","-57.45","1.93","0","0","0","0","16","0","0","0","0"
"2011","Edmonton, Alberta, municipal","48033","Proceeds of crime (Part XII.2 Criminal Code)","7","0","3","-57","0.83","0","0","0","0","3","0","0","0","0"
"2012","Edmonton, Alberta, municipal","48033","Proceeds of crime (Part XII.2 Criminal Code)","8","3","0","11.42","0.92","0.29","0.4","1.83","0","3","2","3","1","0"
"2013","Edmonton, Alberta, municipal","48033","Proceeds of crime (Part XII.2 Criminal Code)","7","0","0","-15.38","0.78","0","0","0","0","0","0","0","0","0"
"2014","Edmonton, Alberta, municipal","48033","Proceeds of crime (Part XII.2 Criminal Code)","2","0","0","-72.36","0.22","0","0","0","0","0","0","0","0","0"
"2015","Edmonton, Alberta, municipal","48033","Proceeds of crime (Part XII.2 Criminal Code)","3","2","0","46.76","0.32","0.13","0.12","0","0","2","1","1","0","0"
"2016","Edmonton, Alberta, municipal","48033","Proceeds of crime (Part XII.2 Criminal Code)","3","1","0","-2.22","0.31","0","0","0","0","1","0","0","0","0"
"1998","Edmonton, Alberta, municipal","48033","Attempts, conspiracies, accessories (Part XIII Criminal Code)","1","1","0","0","0.15","0","0","0","0","1","1","1","0","0"
"1999","Edmonton, Alberta, municipal","48033","Attempts, conspiracies, accessories (Part XIII Criminal Code)","0","0","0","-100","0","0","0","0","0","0","0","0","0","0"
"2000","Edmonton, Alberta, municipal","48033","Attempts, conspiracies, accessories (Part XIII Criminal Code)","11","10","0","0","1.63","0","0","0","0","10","7","9","2","0"
"2001","Edmonton, Alberta, municipal","48033","Attempts, conspiracies, accessories (Part XIII Criminal Code)","1","1","0","-91.03","0.15","0","0","0","0","1","1","1","0","0"
"2002","Edmonton, Alberta, municipal","48033","Attempts, conspiracies, accessories (Part XIII Criminal Code)","1","0","0","-1.72","0.14","0","0","0","0","0","0","0","0","0"
"2003","Edmonton, Alberta, municipal","48033","Attempts, conspiracies, accessories (Part XIII Criminal Code)","0","0","0","-100","0","0","0","0","0","0","0","0","0","0"
"2004","Edmonton, Alberta, municipal","48033","Attempts, conspiracies, accessories (Part XIII Criminal Code)","4","4","0","0","0.56","0.53","0.48","0","0","4","3","3","0","0"
"2005","Edmonton, Alberta, municipal","48033","Attempts, conspiracies, accessories (Part XIII Criminal Code)","1","1","0","-75.57","0.14","0.17","0.31","1.8","0","1","1","2","1","0"
"2006","Edmonton, Alberta, municipal","48033","Attempts, conspiracies, accessories (Part XIII Criminal Code)","2","1","0","94.29","0.26","0.17","0.15","0","0","1","1","1","0","0"
"2007","Edmonton, Alberta, municipal","48033","Attempts, conspiracies, accessories (Part XIII Criminal Code)","3","1","0","46.11","0.39","0","0.15","1.79","0","1","0","1","1","0"
"2008","Edmonton, Alberta, municipal","48033","Attempts, conspiracies, accessories (Part XIII Criminal Code)","2","3","0","-34.87","0.25","1.41","1.3","0","0","3","9","9","0","0"
"2009","Edmonton, Alberta, municipal","48033","Attempts, conspiracies, accessories (Part XIII Criminal Code)","0","1","0","-100","0","0.15","0.14","0","0","1","1","1","0","0"
"2010","Edmonton, Alberta, municipal","48033","Attempts, conspiracies, accessories (Part XIII Criminal Code)","2","2","0","0","0.24","0.75","0.69","0","0","2","5","5","0","0"
"2011","Edmonton, Alberta, municipal","48033","Attempts, conspiracies, accessories (Part XIII Criminal Code)","2","2","0","-1.71","0.24","0.15","0.27","1.82","0","2","1","2","1","0"
"2012","Edmonton, Alberta, municipal","48033","Attempts, conspiracies, accessories (Part XIII Criminal Code)","4","2","0","94.98","0.46","0.14","0.13","0","0","2","1","1","0","0"
"2013","Edmonton, Alberta, municipal","48033","Attempts, conspiracies, accessories (Part XIII Criminal Code)","4","2","0","-3.29","0.45","1.52","1.41","0","0","2","11","11","0","0"
"2014","Edmonton, Alberta, municipal","48033","Attempts, conspiracies, accessories (Part XIII Criminal Code)","5","5","0","20.93","0.54","0.8","0.75","0","0","5","6","6","0","0"
"2015","Edmonton, Alberta, municipal","48033","Attempts, conspiracies, accessories (Part XIII Criminal Code)","1","1","0","-80.43","0.11","0.13","0.12","0","0","1","1","1","0","0"
"2016","Edmonton, Alberta, municipal","48033","Attempts, conspiracies, accessories (Part XIII Criminal Code)","5","5","0","388.91","0.52","0.51","0.72","3.59","0","5","4","6","2","0"
"2002","Edmonton, Alberta, municipal","48033","Instruct offence for criminal organization","0","0","0","0","0","0","0","0","0","0","0","0","0","0"
"2003","Edmonton, Alberta, municipal","48033","Instruct offence for criminal organization","0","0","0","0","0","0","0","0","0","0","0","0","0","0"
"2004","Edmonton, Alberta, municipal","48033","Instruct offence for criminal organization","0","0","0","0","0","0","0","0","0","0","0","0","0","0"
"2005","Edmonton, Alberta, municipal","48033","Instruct offence for criminal organization","0","0","0","0","0","0","0","0","0","0","0","0","0","0"
"2006","Edmonton, Alberta, municipal","48033","Instruct offence for criminal organization","0","0","0","0","0","0","0","0","0","0","0","0","0","0"
"2007","Edmonton, Alberta, municipal","48033","Instruct offence for criminal organization","0","0","0","0","0","0","0","0","0","0","0","0","0","0"
"2008","Edmonton, Alberta, municipal","48033","Instruct offence for criminal organization","1","1","0","0","0.13","0.31","0.29","0","0","1","2","2","0","0"
"2009","Edmonton, Alberta, municipal","48033","Instruct offence for criminal organization","0","0","0","-100","0","0","0","0","0","0","0","0","0","0"
"2010","Edmonton, Alberta, municipal","48033","Instruct offence for criminal organization","0","1","0","0","0","0.6","0.55","0","0","1","4","4","0","0"
"2011","Edmonton, Alberta, municipal","48033","Instruct offence for criminal organization","0","0","0","0","0","0","0","0","0","0","0","0","0","0"
"2012","Edmonton, Alberta, municipal","48033","Instruct offence for criminal organization","0","0","0","0","0","0","0","0","0","0","0","0","0","0"
"2013","Edmonton, Alberta, municipal","48033","Instruct offence for criminal organization","0","0","0","0","0","0","0","0","0","0","0","0","0","0"
"2014","Edmonton, Alberta, municipal","48033","Instruct offence for criminal organization","0","0","0","0","0","0","0","0","0","0","0","0","0","0"
"2015","Edmonton, Alberta, municipal","48033","Instruct offence for criminal organization","0","0","0","0","0","0","0","0","0","0","0","0","0","0"
"2016","Edmonton, Alberta, municipal","48033","Instruct offence for criminal organization","1","1","0","0","0.1","0.38","0.36","0","0","1","3","3","0","0"
"2002","Edmonton, Alberta, municipal","48033","Commit offence for criminal organization","0","0","0","0","0","0","0","0","0","0","0","0","0","0"
"2003","Edmonton, Alberta, municipal","48033","Commit offence for criminal organization","0","0","0","0","0","0","0","0","0","0","0","0","0","0"
"2004","Edmonton, Alberta, municipal","48033","Commit offence for criminal organization","1","0","0","0","0.14","0","0","0","0","0","0","0","0","0"
"2005","Edmonton, Alberta, municipal","48033","Commit offence for criminal organization","0","0","0","-100","0","0","0","0","0","0","0","0","0","0"
"2006","Edmonton, Alberta, municipal","48033","Commit offence for criminal organization","0","0","0","0","0","0","0","0","0","0","0","0","0","0"
"2007","Edmonton, Alberta, municipal","48033","Commit offence for criminal organization","0","0","0","0","0","0","0","0","0","0","0","0","0","0"
"2008","Edmonton, Alberta, municipal","48033","Commit offence for criminal organization","0","0","0","0","0","0","0","0","0","0","0","0","0","0"
"2009","Edmonton, Alberta, municipal","48033","Commit offence for criminal organization","0","0","0","0","0","0","0","0","0","0","0","0","0","0"
"2010","Edmonton, Alberta, municipal","48033","Commit offence for criminal organization","1","1","0","0","0.12","0.75","0.69","0","0","1","5","5","0","0"
"2011","Edmonton, Alberta, municipal","48033","Commit offence for criminal organization","0","0","0","-100","0","0","0","0","0","0","0","0","0","0"
"2012","Edmonton, Alberta, municipal","48033","Commit offence for criminal organization","0","0","0","0","0","0","0","0","0","0","0","0","0","0"
"2013","Edmonton, Alberta, municipal","48033","Commit offence for criminal organization","0","0","0","0","0","0","0","0","0","0","0","0","0","0"
"2014","Edmonton, Alberta, municipal","48033","Commit offence for criminal organization","1","1","0","0","0.11","0.13","0.12","0","0","1","1","1","0","0"
"2015","Edmonton, Alberta, municipal","48033","Commit offence for criminal organization","1","0","0","-2.16","0.11","0","0","0","0","0","0","0","0","0"
"2016","Edmonton, Alberta, municipal","48033","Commit offence for criminal organization","1","0","0","-2.22","0.1","0","0","0","0","0","0","0","0","0"
"2002","Edmonton, Alberta, municipal","48033","Participate in activities of criminal organization","0","0","0","0","0","0","0","0","0","0","0","0","0","0"
"2003","Edmonton, Alberta, municipal","48033","Participate in activities of criminal organization","0","0","0","0","0","0","0","0","0","0","0","0","0","0"
"2004","Edmonton, Alberta, municipal","48033","Participate in activities of criminal organization","0","0","0","0","0","0","0","0","0","0","0","0","0","0"
"2005","Edmonton, Alberta, municipal","48033","Participate in activities of criminal organization","0","0","0","0","0","0","0","0","0","0","0","0","0","0"
"2006","Edmonton, Alberta, municipal","48033","Participate in activities of criminal organization","0","0","0","0","0","0","0","0","0","0","0","0","0","0"
"2007","Edmonton, Alberta, municipal","48033","Participate in activities of criminal organization","0","0","0","0","0","0","0","0","0","0","0","0","0","0"
"2008","Edmonton, Alberta, municipal","48033","Participate in activities of criminal organization","0","0","0","0","0","0","0","0","0","0","0","0","0","0"
"2009","Edmonton, Alberta, municipal","48033","Participate in activities of criminal organization","0","0","0","0","0","0","0","0","0","0","0","0","0","0"
"2010","Edmonton, Alberta, municipal","48033","Participate in activities of criminal organization","0","0","0","0","0","0","0","0","0","0","0","0","0","0"
"2011","Edmonton, Alberta, municipal","48033","Participate in activities of criminal organization","0","0","0","0","0","0","0","0","0","0","0","0","0","0"
"2012","Edmonton, Alberta, municipal","48033","Participate in activities of criminal organization","2","0","0","0","0.23","0","0","0","0","0","0","0","0","0"
"2013","Edmonton, Alberta, municipal","48033","Participate in activities of criminal organization","0","0","0","-100","0","0","0","0","0","0","0","0","0","0"
"2014","Edmonton, Alberta, municipal","48033","Participate in activities of criminal organization","0","0","0","0","0","0","0","0","0","0","0","0","0","0"
"2015","Edmonton, Alberta, municipal","48033","Participate in activities of criminal organization","0","0","0","0","0","0","0","0","0","0","0","0","0","0"
"2016","Edmonton, Alberta, municipal","48033","Participate in activities of criminal organization","0","0","0","0","0","0","0","0","0","0","0","0","0","0"
"2012","Edmonton, Alberta, municipal","48033","Recruitment of members by a criminal organization","0","0","0","0","0","0","0","0","0","0","0","0","0","0"
"2013","Edmonton, Alberta, municipal","48033","Recruitment of members by a criminal organization","0","0","0","0","0","0","0","0","0","0","0","0","0","0"
"2014","Edmonton, Alberta, municipal","48033","Recruitment of members by a criminal organization","0","0","0","0","0","0","0","0","0","0","0","0","0","0"
"2015","Edmonton, Alberta, municipal","48033","Recruitment of members by a criminal organization","0","0","0","0","0","0","0","0","0","0","0","0","0","0"
"2016","Edmonton, Alberta, municipal","48033","Recruitment of members by a criminal organization","0","0","0","0","0","0","0","0","0","0","0","0","0","0"
"1998","Edmonton, Alberta, municipal","48033","All other Criminal Code (includes Part XII.1 Criminal Code)","9","6","0","0","1.38","0","0","0","0","6","7","7","0","0"
"1999","Edmonton, Alberta, municipal","48033","All other Criminal Code (includes Part XII.1 Criminal Code)","4","4","0","-56.25","0.6","0","0","0","0","4","6","6","0","0"
"2000","Edmonton, Alberta, municipal","48033","All other Criminal Code (includes Part XII.1 Criminal Code)","27","15","4","564.88","4.01","0","0","0","0","19","11","12","1","2"
"2001","Edmonton, Alberta, municipal","48033","All other Criminal Code (includes Part XII.1 Criminal Code)","8","7","1","-70.78","1.17","0","0","0","0","8","6","6","0","0"
"2002","Edmonton, Alberta, municipal","48033","All other Criminal Code (includes Part XII.1 Criminal Code)","3","3","0","-63.15","0.43","0","0","0","0","3","3","3","0","0"
"2003","Edmonton, Alberta, municipal","48033","All other Criminal Code (includes Part XII.1 Criminal Code)","0","0","0","-100","0","0","0","0","0","0","0","0","0","0"
"2004","Edmonton, Alberta, municipal","48033","All other Criminal Code (includes Part XII.1 Criminal Code)","1","1","0","0","0.14","0.18","0.16","0","0","1","1","1","0","0"
"2005","Edmonton, Alberta, municipal","48033","All other Criminal Code (includes Part XII.1 Criminal Code)","1","0","0","-2.27","0.14","0","0","0","0","0","0","0","0","0"
"2006","Edmonton, Alberta, municipal","48033","All other Criminal Code (includes Part XII.1 Criminal Code)","3","2","0","191.43","0.4","0.33","0.3","0","0","2","2","2","0","0"
"2007","Edmonton, Alberta, municipal","48033","All other Criminal Code (includes Part XII.1 Criminal Code)","0","0","1","-100","0","0","0","0","0","1","0","0","0","0"
"2008","Edmonton, Alberta, municipal","48033","All other Criminal Code (includes Part XII.1 Criminal Code)","20","19","0","0","2.51","2.66","2.59","1.81","0","19","17","18","1","0"
"2009","Edmonton, Alberta, municipal","48033","All other Criminal Code (includes Part XII.1 Criminal Code)","22","18","1","7.28","2.69","2.28","2.11","0","0","19","15","15","0","0"
"2010","Edmonton, Alberta, municipal","48033","All other Criminal Code (includes Part XII.1 Criminal Code)","30","24","0","34.18","3.61","3.14","3.04","1.83","0","24","21","22","1","0"
"2011","Edmonton, Alberta, municipal","48033","All other Criminal Code (includes Part XII.1 Criminal Code)","28","15","1","-8.26","3.31","2.06","1.91","0","0","16","14","14","0","0"
"2012","Edmonton, Alberta, municipal","48033","All other Criminal Code (includes Part XII.1 Criminal Code)","46","31","3","60.16","5.3","4.01","3.85","1.83","1.83","34","28","29","1","1"
"2013","Edmonton, Alberta, municipal","48033","All other Criminal Code (includes Part XII.1 Criminal Code)","46","31","1","-3.29","5.13","3.73","3.6","1.84","0","32","27","28","1","0"
"2014","Edmonton, Alberta, municipal","48033","All other Criminal Code (includes Part XII.1 Criminal Code)","44","20","0","-7.47","4.75","2.4","2.36","1.84","0","20","18","19","1","0"
"2015","Edmonton, Alberta, municipal","48033","All other Criminal Code (includes Part XII.1 Criminal Code)","49","36","1","8.96","5.17","3.92","4.02","5.48","0","37","30","33","3","0"
"2016","Edmonton, Alberta, municipal","48033","All other Criminal Code (includes Part XII.1 Criminal Code)","45","29","1","-10.2","4.64","3.71","3.46","0","0","30","29","29","0","0"
"1998","Edmonton, Alberta, municipal","48033","Total Criminal Code traffic violations","3272","3256","0","0","500.97","0","0","0","0","3256","3018","3018","0","0"
"1999","Edmonton, Alberta, municipal","48033","Total Criminal Code traffic violations","3056","3066","1","-8.06","460.6","0","0","0","0","3067","3070","3070","0","0"
"2000","Edmonton, Alberta, municipal","48033","Total Criminal Code traffic violations","3101","2887","1","-0.05","460.38","0","0","0","0","2888","2881","2882","1","0"
"2001","Edmonton, Alberta, municipal","48033","Total Criminal Code traffic violations","2735","2740","1","-13.01","400.49","0","0","0","0","2741","2731","2731","0","0"
"2002","Edmonton, Alberta, municipal","48033","Total Criminal Code traffic violations","2621","2622","0","-5.82","377.19","0","0","0","0","2622","2609","2609","0","0"
"2003","Edmonton, Alberta, municipal","48033","Total Criminal Code traffic violations","2629","2631","0","-0.82","374.1","0","0","0","0","2631","2619","2619","0","0"
"2004","Edmonton, Alberta, municipal","48033","Total Criminal Code traffic violations","2661","2665","3","-1.28","369.29","466.01","424.69","0","0","2668","2648","2648","0","0"
"2005","Edmonton, Alberta, municipal","48033","Total Criminal Code traffic violations","2524","2510","1","-7.3","342.33","428.49","391.28","0","0","2511","2502","2502","0","0"
"2006","Edmonton, Alberta, municipal","48033","Total Criminal Code traffic violations","2792","2577","30","7.46","367.86","418.61","383.07","0","0","2607","2527","2527","0","0"
"2007","Edmonton, Alberta, municipal","48033","Total Criminal Code traffic violations","3060","2958","39","6.75","392.71","462.32","434.93","129.17","3.59","2997","2877","2949","72","2"
"2008","Edmonton, Alberta, municipal","48033","Total Criminal Code traffic violations","3241","3122","64","3.47","406.34","479.88","447.07","68.61","1.81","3186","3066","3104","38","1"
"2009","Edmonton, Alberta, municipal","48033","Total Criminal Code traffic violations","3216","3045","32","-3.23","393.22","458.28","426.88","51.01","0","3077","3011","3039","28","0"
"2010","Edmonton, Alberta, municipal","48033","Total Criminal Code traffic violations","3167","3077","49","-3.1","381.03","451.83","423.11","71.47","1.83","3126","3019","3058","39","1"
"2011","Edmonton, Alberta, municipal","48033","Total Criminal Code traffic violations","3106","3030","31","-3.6","367.32","439.36","409.98","47.23","3.63","3061","2986","3012","26","2"
"2012","Edmonton, Alberta, municipal","48033","Total Criminal Code traffic violations","3151","3027","65","-1.1","363.29","427.73","400.98","58.63","0","3092","2988","3020","32","0"
"2013","Edmonton, Alberta, municipal","48033","Total Criminal Code traffic violations","2981","2862","43","-8.51","332.37","386.24","364.48","75.29","0","2905","2796","2837","41","0"
"2014","Edmonton, Alberta, municipal","48033","Total Criminal Code traffic violations","3124","2946","47","1.38","336.96","386.71","365.26","69.84","1.84","2993","2898","2936","38","1"
"2015","Edmonton, Alberta, municipal","48033","Total Criminal Code traffic violations","3005","2816","52","-5.89","317.13","360.66","341.83","78.54","1.83","2868","2760","2803","43","1"
"2016","Edmonton, Alberta, municipal","48033","Total Criminal Code traffic violations","2945","2633","55","-4.17","303.9","330.52","312","52.07","3.59","2688","2583","2612","29","2"
"1998","Edmonton, Alberta, municipal","48033","Total impaired driving","2227","2229","0","0","340.97","0","0","0","0","2229","2000","2000","0","0"
"1999","Edmonton, Alberta, municipal","48033","Total impaired driving","2064","2067","1","-8.76","311.09","0","0","0","0","2068","2052","2052","0","0"
"2000","Edmonton, Alberta, municipal","48033","Total impaired driving","2027","2023","1","-3.26","300.93","0","0","0","0","2024","2023","2023","0","0"
"2001","Edmonton, Alberta, municipal","48033","Total impaired driving","1714","1723","1","-16.6","250.99","0","0","0","0","1724","1724","1724","0","0"
"2002","Edmonton, Alberta, municipal","48033","Total impaired driving","1628","1621","0","-6.65","234.28","0","0","0","0","1621","1622","1622","0","0"
"2003","Edmonton, Alberta, municipal","48033","Total impaired driving","1550","1557","0","-5.86","220.56","0","0","0","0","1557","1553","1553","0","0"
"2004","Edmonton, Alberta, municipal","48033","Total impaired driving","1534","1533","0","-3.48","212.89","269.44","245.54","0","0","1533","1531","1531","0","0"
"2005","Edmonton, Alberta, municipal","48033","Total impaired driving","1468","1466","1","-6.47","199.11","251.41","229.58","0","0","1467","1468","1468","0","0"
"2006","Edmonton, Alberta, municipal","48033","Total impaired driving","1523","1494","7","0.78","200.66","243.01","222.39","0","0","1501","1467","1467","0","0"
"2007","Edmonton, Alberta, municipal","48033","Total impaired driving","1865","1825","9","19.28","239.35","289.25","268.57","37.68","0","1834","1800","1821","21","0"
"2008","Edmonton, Alberta, municipal","48033","Total impaired driving","2036","2022","15","6.65","255.26","311.78","290.22","41.52","0","2037","1992","2015","23","0"
"2009","Edmonton, Alberta, municipal","48033","Total impaired driving","2070","2006","19","-0.85","253.1","303.8","281.49","14.57","0","2025","1996","2004","8","0"
"2010","Edmonton, Alberta, municipal","48033","Total impaired driving","2143","2080","34","1.87","257.83","308.45","287.79","34.82","1.83","2114","2061","2080","19","1"
"2011","Edmonton, Alberta, municipal","48033","Total impaired driving","2130","2079","27","-2.3","251.9","304.58","282.71","12.72","0","2106","2070","2077","7","0"
"2012","Edmonton, Alberta, municipal","48033","Total impaired driving","2160","2069","51","-1.14","249.04","295.17","275.37","21.98","0","2120","2062","2074","12","0"
"2013","Edmonton, Alberta, municipal","48033","Total impaired driving","1883","1802","35","-15.7","209.95","248.1","231.51","11.02","0","1837","1796","1802","6","0"
"2014","Edmonton, Alberta, municipal","48033","Total impaired driving","1831","1736","39","-5.93","197.5","231.65","216.84","12.87","1.84","1775","1736","1743","7","1"
"2015","Edmonton, Alberta, municipal","48033","Total impaired driving","1633","1555","39","-12.74","172.33","201.37","189.51","23.74","1.83","1594","1541","1554","13","1"
"2016","Edmonton, Alberta, municipal","48033","Total impaired driving","1486","1414","36","-11.02","153.34","180.04","168.9","12.57","1.8","1450","1407","1414","7","1"
"1998","Edmonton, Alberta, municipal","48033","Impaired operation, causing death","0","0","0","0","0","0","0","0","0","0","0","0","0","0"
"1999","Edmonton, Alberta, municipal","48033","Impaired operation, causing death","0","0","0","0","0","0","0","0","0","0","0","0","0","0"
"2000","Edmonton, Alberta, municipal","48033","Impaired operation, causing death","1","1","0","0","0.15","0","0","0","0","1","1","1","0","0"
"2001","Edmonton, Alberta, municipal","48033","Impaired operation, causing death","1","1","0","-1.37","0.15","0","0","0","0","1","1","1","0","0"
"2002","Edmonton, Alberta, municipal","48033","Impaired operation, causing death","0","0","0","-100","0","0","0","0","0","0","0","0","0","0"
"2003","Edmonton, Alberta, municipal","48033","Impaired operation, causing death","3","3","0","0","0.43","0","0","0","0","3","3","3","0","0"
"2004","Edmonton, Alberta, municipal","48033","Impaired operation, causing death","3","3","0","-2.47","0.42","0.53","0.48","0","0","3","3","3","0","0"
"2005","Edmonton, Alberta, municipal","48033","Impaired operation, causing death","2","2","0","-34.85","0.27","0.34","0.31","0","0","2","2","2","0","0"
"2006","Edmonton, Alberta, municipal","48033","Impaired operation, causing death","1","1","0","-51.43","0.13","0.17","0.15","0","0","1","1","1","0","0"
"2007","Edmonton, Alberta, municipal","48033","Impaired operation, causing death","1","1","0","-2.6","0.13","0.16","0.15","0","0","1","1","1","0","0"
"2008","Edmonton, Alberta, municipal","48033","Impaired operation, causing death","1","1","0","-2.31","0.13","0.16","0.14","0","0","1","1","1","0","0"
"2009","Edmonton, Alberta, municipal","48033","Impaired operation, causing death","3","3","0","192.57","0.37","0.46","0.42","0","0","3","3","3","0","0"
"2010","Edmonton, Alberta, municipal","48033","Impaired operation, causing death","2","2","0","-34.4","0.24","0.15","0.28","1.83","0","2","1","2","1","0"
"2011","Edmonton, Alberta, municipal","48033","Impaired operation, causing death","3","3","0","47.44","0.35","0.44","0.41","0","0","3","3","3","0","0"
"2012","Edmonton, Alberta, municipal","48033","Impaired operation, causing death","1","1","0","-67.5","0.12","0.14","0.13","0","0","1","1","1","0","0"
"2013","Edmonton, Alberta, municipal","48033","Impaired operation, causing death","5","4","1","383.53","0.56","0.55","0.51","0","0","5","4","4","0","0"
"2014","Edmonton, Alberta, municipal","48033","Impaired operation, causing death","7","6","1","35.44","0.76","0.8","0.75","0","0","7","6","6","0","0"
"2015","Edmonton, Alberta, municipal","48033","Impaired operation, causing death","0","0","0","-100","0","0","0","0","0","0","0","0","0","0"
"2016","Edmonton, Alberta, municipal","48033","Impaired operation, causing death","3","3","0","0","0.31","0.38","0.36","0","0","3","3","3","0","0"
"2005","Edmonton, Alberta, municipal","48033","Impaired operation (drugs), causing death","0","0","0","0","0","0","0","0","0","0","0","0","0","0"
"2006","Edmonton, Alberta, municipal","48033","Impaired operation (drugs), causing death","0","0","0","0","0","0","0","0","0","0","0","0","0","0"
"2007","Edmonton, Alberta, municipal","48033","Impaired operation (drugs), causing death","0","0","0","0","0","0","0","0","0","0","0","0","0","0"
"2008","Edmonton, Alberta, municipal","48033","Impaired operation (drugs), causing death","0","0","0","0","0","0","0","0","0","0","0","0","0","0"
"2009","Edmonton, Alberta, municipal","48033","Impaired operation (drugs), causing death","0","0","0","0","0","0","0","0","0","0","0","0","0","0"
"2010","Edmonton, Alberta, municipal","48033","Impaired operation (drugs), causing death","0","0","0","0","0","0","0","0","0","0","0","0","0","0"
"2011","Edmonton, Alberta, municipal","48033","Impaired operation (drugs), causing death","0","0","0","0","0","0","0","0","0","0","0","0","0","0"
"2012","Edmonton, Alberta, municipal","48033","Impaired operation (drugs), causing death","0","0","0","0","0","0","0","0","0","0","0","0","0","0"
"2013","Edmonton, Alberta, municipal","48033","Impaired operation (drugs), causing death","0","0","0","0","0","0","0","0","0","0","0","0","0","0"
"2014","Edmonton, Alberta, municipal","48033","Impaired operation (drugs), causing death","0","0","0","0","0","0","0","0","0","0","0","0","0","0"
"2015","Edmonton, Alberta, municipal","48033","Impaired operation (drugs), causing death","0","0","0","0","0","0","0","0","0","0","0","0","0","0"
"2016","Edmonton, Alberta, municipal","48033","Impaired operation (drugs), causing death","0","0","0","0","0","0","0","0","0","0","0","0","0","0"
"1998","Edmonton, Alberta, municipal","48033","Impaired operation, causing bodily harm","25","26","0","0","3.83","0","0","0","0","26","27","27","0","0"
"1999","Edmonton, Alberta, municipal","48033","Impaired operation, causing bodily harm","15","15","0","-40.93","2.26","0","0","0","0","15","16","16","0","0"
"2000","Edmonton, Alberta, municipal","48033","Impaired operation, causing bodily harm","18","17","0","18.2","2.67","0","0","0","0","17","17","17","0","0"
"2001","Edmonton, Alberta, municipal","48033","Impaired operation, causing bodily harm","22","23","0","20.55","3.22","0","0","0","0","23","23","23","0","0"
"2002","Edmonton, Alberta, municipal","48033","Impaired operation, causing bodily harm","16","16","0","-28.53","2.3","0","0","0","0","16","16","16","0","0"
"2003","Edmonton, Alberta, municipal","48033","Impaired operation, causing bodily harm","16","16","0","-1.12","2.28","0","0","0","0","16","16","16","0","0"
"2004","Edmonton, Alberta, municipal","48033","Impaired operation, causing bodily harm","16","16","0","-2.47","2.22","2.82","2.57","0","0","16","16","16","0","0"
"2005","Edmonton, Alberta, municipal","48033","Impaired operation, causing bodily harm","9","9","0","-45.03","1.22","1.54","1.41","0","0","9","9","9","0","0"
"2006","Edmonton, Alberta, municipal","48033","Impaired operation, causing bodily harm","12","11","0","29.52","1.58","1.82","1.67","0","0","11","11","11","0","0"
"2007","Edmonton, Alberta, municipal","48033","Impaired operation, causing bodily harm","21","21","0","70.46","2.7","3.37","3.1","0","0","21","21","21","0","0"
"2008","Edmonton, Alberta, municipal","48033","Impaired operation, causing bodily harm","19","18","0","-11.61","2.38","2.82","2.59","0","0","18","18","18","0","0"
"2009","Edmonton, Alberta, municipal","48033","Impaired operation, causing bodily harm","14","13","0","-28.14","1.71","1.83","1.83","1.82","0","13","12","13","1","0"
"2010","Edmonton, Alberta, municipal","48033","Impaired operation, causing bodily harm","18","18","0","26.52","2.17","2.69","2.63","1.83","0","18","18","19","1","0"
"2011","Edmonton, Alberta, municipal","48033","Impaired operation, causing bodily harm","19","19","0","3.75","2.25","2.8","2.59","0","0","19","19","19","0","0"
"2012","Edmonton, Alberta, municipal","48033","Impaired operation, causing bodily harm","20","20","0","2.62","2.31","2.86","2.66","0","0","20","20","20","0","0"
"2013","Edmonton, Alberta, municipal","48033","Impaired operation, causing bodily harm","12","13","0","-41.98","1.34","1.8","1.67","0","0","13","13","13","0","0"
"2014","Edmonton, Alberta, municipal","48033","Impaired operation, causing bodily harm","6","4","0","-51.63","0.65","0.53","0.5","0","0","4","4","4","0","0"
"2015","Edmonton, Alberta, municipal","48033","Impaired operation, causing bodily harm","5","5","0","-18.47","0.53","0.65","0.61","0","0","5","5","5","0","0"
"2016","Edmonton, Alberta, municipal","48033","Impaired operation, causing bodily harm","9","8","0","76.01","0.93","0.9","0.96","1.8","0","8","7","8","1","0"
"2005","Edmonton, Alberta, municipal","48033","Impaired operation (drugs), causing bodily harm","0","0","0","0","0","0","0","0","0","0","0","0","0","0"
"2006","Edmonton, Alberta, municipal","48033","Impaired operation (drugs), causing bodily harm","0","0","0","0","0","0","0","0","0","0","0","0","0","0"
"2007","Edmonton, Alberta, municipal","48033","Impaired operation (drugs), causing bodily harm","0","0","0","0","0","0","0","0","0","0","0","0","0","0"
"2008","Edmonton, Alberta, municipal","48033","Impaired operation (drugs), causing bodily harm","0","0","0","0","0","0","0","0","0","0","0","0","0","0"
"2009","Edmonton, Alberta, municipal","48033","Impaired operation (drugs), causing bodily harm","1","1","0","0","0.12","0.15","0.14","0","0","1","1","1","0","0"
"2010","Edmonton, Alberta, municipal","48033","Impaired operation (drugs), causing bodily harm","0","0","0","-100","0","0","0","0","0","0","0","0","0","0"
"2011","Edmonton, Alberta, municipal","48033","Impaired operation (drugs), causing bodily harm","0","0","0","0","0","0","0","0","0","0","0","0","0","0"
"2012","Edmonton, Alberta, municipal","48033","Impaired operation (drugs), causing bodily harm","0","0","0","0","0","0","0","0","0","0","0","0","0","0"
"2013","Edmonton, Alberta, municipal","48033","Impaired operation (drugs), causing bodily harm","1","1","0","0","0.11","0.14","0.13","0","0","1","1","1","0","0"
"2014","Edmonton, Alberta, municipal","48033","Impaired operation (drugs), causing bodily harm","1","1","0","-3.26","0.11","0.13","0.12","0","0","1","1","1","0","0"
"2015","Edmonton, Alberta, municipal","48033","Impaired operation (drugs), causing bodily harm","1","1","0","-2.16","0.11","0.13","0.12","0","0","1","1","1","0","0"
"2016","Edmonton, Alberta, municipal","48033","Impaired operation (drugs), causing bodily harm","0","0","0","-100","0","0","0","0","0","0","0","0","0","0"
"1998","Edmonton, Alberta, municipal","48033","Impaired operation of motor vehicle, vessel or aircraft","2154","2155","0","0","329.79","0","0","0","0","2155","1933","1933","0","0"
"1999","Edmonton, Alberta, municipal","48033","Impaired operation of motor vehicle, vessel or aircraft","2011","2014","1","-8.09","303.1","0","0","0","0","2015","1998","1998","0","0"
"2000","Edmonton, Alberta, municipal","48033","Impaired operation of motor vehicle, vessel or aircraft","1982","1979","1","-2.92","294.25","0","0","0","0","1980","1979","1979","0","0"
"2001","Edmonton, Alberta, municipal","48033","Impaired operation of motor vehicle, vessel or aircraft","1668","1676","1","-16.99","244.25","0","0","0","0","1677","1677","1677","0","0"
"2002","Edmonton, Alberta, municipal","48033","Impaired operation of motor vehicle, vessel or aircraft","1594","1588","0","-6.08","229.39","0","0","0","0","1588","1589","1589","0","0"
"2003","Edmonton, Alberta, municipal","48033","Impaired operation of motor vehicle, vessel or aircraft","1507","1513","0","-6.52","214.44","0","0","0","0","1513","1509","1509","0","0"
"2004","Edmonton, Alberta, municipal","48033","Impaired operation of motor vehicle, vessel or aircraft","1485","1484","0","-3.9","206.09","260.81","237.68","0","0","1484","1482","1482","0","0"
"2005","Edmonton, Alberta, municipal","48033","Impaired operation of motor vehicle, vessel or aircraft","1411","1409","1","-7.14","191.37","241.65","220.66","0","0","1410","1411","1411","0","0"
"2006","Edmonton, Alberta, municipal","48033","Impaired operation of motor vehicle, vessel or aircraft","1476","1448","7","1.62","194.47","235.56","215.56","0","0","1455","1422","1422","0","0"
"2007","Edmonton, Alberta, municipal","48033","Impaired operation of motor vehicle, vessel or aircraft","1788","1750","9","17.99","229.46","277.2","257.51","37.68","0","1759","1725","1746","21","0"
"2008","Edmonton, Alberta, municipal","48033","Impaired operation of motor vehicle, vessel or aircraft","1938","1925","15","5.89","242.98","296.91","276.25","37.91","0","1940","1897","1918","21","0"
"2009","Edmonton, Alberta, municipal","48033","Impaired operation of motor vehicle, vessel or aircraft","1922","1880","17","-3.28","235","284.62","263.65","12.75","0","1897","1870","1877","7","0"
"2010","Edmonton, Alberta, municipal","48033","Impaired operation of motor vehicle, vessel or aircraft","1954","1902","25","0.04","235.09","281.96","262.89","29.32","0","1927","1884","1900","16","0"
"2011","Edmonton, Alberta, municipal","48033","Impaired operation of motor vehicle, vessel or aircraft","1927","1891","22","-3.06","227.89","277.06","257.12","10.9","0","1913","1883","1889","6","0"
"2012","Edmonton, Alberta, municipal","48033","Impaired operation of motor vehicle, vessel or aircraft","1929","1858","45","-2.41","222.4","265.26","247.36","18.32","0","1903","1853","1863","10","0"
"2013","Edmonton, Alberta, municipal","48033","Impaired operation of motor vehicle, vessel or aircraft","1659","1584","31","-16.83","184.97","218.12","203.63","11.02","0","1615","1579","1585","6","0"
"2014","Edmonton, Alberta, municipal","48033","Impaired operation of motor vehicle, vessel or aircraft","1592","1519","31","-7.17","171.72","202.56","189.72","12.87","0","1550","1518","1525","7","0"
"2015","Edmonton, Alberta, municipal","48033","Impaired operation of motor vehicle, vessel or aircraft","1436","1384","28","-11.75","151.54","179.16","168.66","21.92","0","1412","1371","1383","12","0"
"2016","Edmonton, Alberta, municipal","48033","Impaired operation of motor vehicle, vessel or aircraft","1284","1235","24","-12.57","132.5","157.78","147.76","7.18","0","1259","1233","1237","4","0"
"2005","Edmonton, Alberta, municipal","48033","Impaired operation (drugs) vehicle, vessel, aircraft","0","0","0","0","0","0","0","0","0","0","0","0","0","0"
"2006","Edmonton, Alberta, municipal","48033","Impaired operation (drugs) vehicle, vessel, aircraft","0","0","0","0","0","0","0","0","0","0","0","0","0","0"
"2007","Edmonton, Alberta, municipal","48033","Impaired operation (drugs) vehicle, vessel, aircraft","0","0","0","0","0","0","0","0","0","0","0","0","0","0"
"2008","Edmonton, Alberta, municipal","48033","Impaired operation (drugs) vehicle, vessel, aircraft","11","10","0","0","1.38","1.41","1.44","1.81","0","10","9","10","1","0"
"2009","Edmonton, Alberta, municipal","48033","Impaired operation (drugs) vehicle, vessel, aircraft","46","26","2","307.82","5.62","4.11","3.79","0","0","28","27","27","0","0"
"2010","Edmonton, Alberta, municipal","48033","Impaired operation (drugs) vehicle, vessel, aircraft","58","48","9","24.07","6.98","7.18","6.64","0","1.83","57","48","48","0","1"
"2011","Edmonton, Alberta, municipal","48033","Impaired operation (drugs) vehicle, vessel, aircraft","56","41","4","-5.1","6.62","6.03","5.58","0","0","45","41","41","0","0"
"2012","Edmonton, Alberta, municipal","48033","Impaired operation (drugs) vehicle, vessel, aircraft","69","50","5","20.12","7.96","6.87","6.64","3.66","0","55","48","50","2","0"
"2013","Edmonton, Alberta, municipal","48033","Impaired operation (drugs) vehicle, vessel, aircraft","40","34","3","-43.94","4.46","4.7","4.37","0","0","37","34","34","0","0"
"2014","Edmonton, Alberta, municipal","48033","Impaired operation (drugs) vehicle, vessel, aircraft","68","51","6","64.46","7.33","6.81","6.34","0","1.84","57","51","51","0","1"
"2015","Edmonton, Alberta, municipal","48033","Impaired operation (drugs) vehicle, vessel, aircraft","72","46","11","3.59","7.6","5.88","5.61","1.83","1.83","57","45","46","1","1"
"2016","Edmonton, Alberta, municipal","48033","Impaired operation (drugs) vehicle, vessel, aircraft","79","58","12","7.29","8.15","7.04","6.69","1.8","1.8","70","55","56","1","1"
"1998","Edmonton, Alberta, municipal","48033","Impaired operation, failure to provide breath sample","48","48","0","0","7.35","0","0","0","0","48","40","40","0","0"
"1999","Edmonton, Alberta, municipal","48033","Impaired operation, failure to provide breath sample","38","38","0","-22.07","5.73","0","0","0","0","38","38","38","0","0"
"2000","Edmonton, Alberta, municipal","48033","Impaired operation, failure to provide breath sample","26","26","0","-32.6","3.86","0","0","0","0","26","26","26","0","0"
"2001","Edmonton, Alberta, municipal","48033","Impaired operation, failure to provide breath sample","23","23","0","-12.75","3.37","0","0","0","0","23","23","23","0","0"
"2002","Edmonton, Alberta, municipal","48033","Impaired operation, failure to provide breath sample","18","17","0","-23.09","2.59","0","0","0","0","17","17","17","0","0"
"2003","Edmonton, Alberta, municipal","48033","Impaired operation, failure to provide breath sample","24","25","0","31.84","3.42","0","0","0","0","25","25","25","0","0"
"2004","Edmonton, Alberta, municipal","48033","Impaired operation, failure to provide breath sample","30","30","0","21.91","4.16","5.28","4.81","0","0","30","30","30","0","0"
"2005","Edmonton, Alberta, municipal","48033","Impaired operation, failure to provide breath sample","46","46","0","49.86","6.24","7.88","7.19","0","0","46","46","46","0","0"
"2006","Edmonton, Alberta, municipal","48033","Impaired operation, failure to provide breath sample","34","34","0","-28.2","4.48","5.47","5","0","0","34","33","33","0","0"
"2007","Edmonton, Alberta, municipal","48033","Impaired operation, failure to provide breath sample","54","52","0","54.7","6.93","8.36","7.67","0","0","52","52","52","0","0"
"2008","Edmonton, Alberta, municipal","48033","Impaired operation, failure to provide breath sample","67","68","0","21.21","8.4","10.49","9.79","1.81","0","68","67","68","1","0"
"2009","Edmonton, Alberta, municipal","48033","Impaired operation, failure to provide breath sample","83","82","0","20.81","10.15","12.48","11.52","0","0","82","82","82","0","0"
"2010","Edmonton, Alberta, municipal","48033","Impaired operation, failure to provide breath sample","111","110","0","31.6","13.35","16.46","15.36","1.83","0","110","110","111","1","0"
"2011","Edmonton, Alberta, municipal","48033","Impaired operation, failure to provide breath sample","124","124","1","9.81","14.66","18.1","16.88","1.82","0","125","123","124","1","0"
"2012","Edmonton, Alberta, municipal","48033","Impaired operation, failure to provide breath sample","139","138","1","9.28","16.03","19.75","18.32","0","0","139","138","138","0","0"
"2013","Edmonton, Alberta, municipal","48033","Impaired operation, failure to provide breath sample","166","166","0","15.49","18.51","22.79","21.2","0","0","166","165","165","0","0"
"2014","Edmonton, Alberta, municipal","48033","Impaired operation, failure to provide breath sample","157","155","1","-8.5","16.93","20.82","19.41","0","0","156","156","156","0","0"
"2015","Edmonton, Alberta, municipal","48033","Impaired operation, failure to provide breath sample","117","117","0","-27.09","12.35","15.29","14.27","0","0","117","117","117","0","0"
"2016","Edmonton, Alberta, municipal","48033","Impaired operation, failure to provide breath sample","109","108","0","-8.9","11.25","13.69","12.9","1.8","0","108","107","108","1","0"
"2005","Edmonton, Alberta, municipal","48033","Failure to comply or refusal (drugs)","0","0","0","0","0","0","0","0","0","0","0","0","0","0"
"2006","Edmonton, Alberta, municipal","48033","Failure to comply or refusal (drugs)","0","0","0","0","0","0","0","0","0","0","0","0","0","0"
"2007","Edmonton, Alberta, municipal","48033","Failure to comply or refusal (drugs)","0","0","0","0","0","0","0","0","0","0","0","0","0","0"
"2008","Edmonton, Alberta, municipal","48033","Failure to comply or refusal (drugs)","0","0","0","0","0","0","0","0","0","0","0","0","0","0"
"2009","Edmonton, Alberta, municipal","48033","Failure to comply or refusal (drugs)","0","0","0","0","0","0","0","0","0","0","0","0","0","0"
"2010","Edmonton, Alberta, municipal","48033","Failure to comply or refusal (drugs)","0","0","0","0","0","0","0","0","0","0","0","0","0","0"
"2011","Edmonton, Alberta, municipal","48033","Failure to comply or refusal (drugs)","1","1","0","0","0.12","0.15","0.14","0","0","1","1","1","0","0"
"2012","Edmonton, Alberta, municipal","48033","Failure to comply or refusal (drugs)","1","1","0","-2.51","0.12","0.14","0.13","0","0","1","1","1","0","0"
"2013","Edmonton, Alberta, municipal","48033","Failure to comply or refusal (drugs)","0","0","0","-100","0","0","0","0","0","0","0","0","0","0"
"2014","Edmonton, Alberta, municipal","48033","Failure to comply or refusal (drugs)","0","0","0","0","0","0","0","0","0","0","0","0","0","0"
"2015","Edmonton, Alberta, municipal","48033","Failure to comply or refusal (drugs)","1","1","0","0","0.11","0.13","0.12","0","0","1","1","1","0","0"
"2016","Edmonton, Alberta, municipal","48033","Failure to comply or refusal (drugs)","0","0","0","-100","0","0","0","0","0","0","0","0","0","0"
"1998","Edmonton, Alberta, municipal","48033","Impaired operation, failure to provide blood sample","0","0","0","0","0","0","0","0","0","0","0","0","0","0"
"1999","Edmonton, Alberta, municipal","48033","Impaired operation, failure to provide blood sample","0","0","0","0","0","0","0","0","0","0","0","0","0","0"
"2000","Edmonton, Alberta, municipal","48033","Impaired operation, failure to provide blood sample","0","0","0","0","0","0","0","0","0","0","0","0","0","0"
"2001","Edmonton, Alberta, municipal","48033","Impaired operation, failure to provide blood sample","0","0","0","0","0","0","0","0","0","0","0","0","0","0"
"2002","Edmonton, Alberta, municipal","48033","Impaired operation, failure to provide blood sample","0","0","0","0","0","0","0","0","0","0","0","0","0","0"
"2003","Edmonton, Alberta, municipal","48033","Impaired operation, failure to provide blood sample","0","0","0","0","0","0","0","0","0","0","0","0","0","0"
"2004","Edmonton, Alberta, municipal","48033","Impaired operation, failure to provide blood sample","0","0","0","0","0","0","0","0","0","0","0","0","0","0"
"2005","Edmonton, Alberta, municipal","48033","Impaired operation, failure to provide blood sample","0","0","0","0","0","0","0","0","0","0","0","0","0","0"
"2006","Edmonton, Alberta, municipal","48033","Impaired operation, failure to provide blood sample","0","0","0","0","0","0","0","0","0","0","0","0","0","0"
"2007","Edmonton, Alberta, municipal","48033","Impaired operation, failure to provide blood sample","1","1","0","0","0.13","0.16","0.15","0","0","1","1","1","0","0"
"2008","Edmonton, Alberta, municipal","48033","Impaired operation, failure to provide blood sample","0","0","0","-100","0","0","0","0","0","0","0","0","0","0"
"2009","Edmonton, Alberta, municipal","48033","Impaired operation, failure to provide blood sample","0","0","0","0","0","0","0","0","0","0","0","0","0","0"
"2010","Edmonton, Alberta, municipal","48033","Impaired operation, failure to provide blood sample","0","0","0","0","0","0","0","0","0","0","0","0","0","0"
"2011","Edmonton, Alberta, municipal","48033","Impaired operation, failure to provide blood sample","0","0","0","0","0","0","0","0","0","0","0","0","0","0"
"2012","Edmonton, Alberta, municipal","48033","Impaired operation, failure to provide blood sample","1","1","0","0","0.12","0.14","0.13","0","0","1","1","1","0","0"
"2013","Edmonton, Alberta, municipal","48033","Impaired operation, failure to provide blood sample","0","0","0","-100","0","0","0","0","0","0","0","0","0","0"
"2014","Edmonton, Alberta, municipal","48033","Impaired operation, failure to provide blood sample","0","0","0","0","0","0","0","0","0","0","0","0","0","0"
"2015","Edmonton, Alberta, municipal","48033","Impaired operation, failure to provide blood sample","1","1","0","0","0.11","0.13","0.12","0","0","1","1","1","0","0"
"2016","Edmonton, Alberta, municipal","48033","Impaired operation, failure to provide blood sample","2","2","0","95.56","0.21","0.26","0.24","0","0","2","2","2","0","0"
"2005","Edmonton, Alberta, municipal","48033","Failure to provide blood sample (drugs)","0","0","0","0","0","0","0","0","0","0","0","0","0","0"
"2006","Edmonton, Alberta, municipal","48033","Failure to provide blood sample (drugs)","0","0","0","0","0","0","0","0","0","0","0","0","0","0"
"2007","Edmonton, Alberta, municipal","48033","Failure to provide blood sample (drugs)","0","0","0","0","0","0","0","0","0","0","0","0","0","0"
"2008","Edmonton, Alberta, municipal","48033","Failure to provide blood sample (drugs)","0","0","0","0","0","0","0","0","0","0","0","0","0","0"
"2009","Edmonton, Alberta, municipal","48033","Failure to provide blood sample (drugs)","1","1","0","0","0.12","0.15","0.14","0","0","1","1","1","0","0"
"2010","Edmonton, Alberta, municipal","48033","Failure to provide blood sample (drugs)","0","0","0","-100","0","0","0","0","0","0","0","0","0","0"
"2011","Edmonton, Alberta, municipal","48033","Failure to provide blood sample (drugs)","0","0","0","0","0","0","0","0","0","0","0","0","0","0"
"2012","Edmonton, Alberta, municipal","48033","Failure to provide blood sample (drugs)","0","0","0","0","0","0","0","0","0","0","0","0","0","0"
"2013","Edmonton, Alberta, municipal","48033","Failure to provide blood sample (drugs)","0","0","0","0","0","0","0","0","0","0","0","0","0","0"
"2014","Edmonton, Alberta, municipal","48033","Failure to provide blood sample (drugs)","0","0","0","0","0","0","0","0","0","0","0","0","0","0"
"2015","Edmonton, Alberta, municipal","48033","Failure to provide blood sample (drugs)","0","0","0","0","0","0","0","0","0","0","0","0","0","0"
"2016","Edmonton, Alberta, municipal","48033","Failure to provide blood sample (drugs)","0","0","0","0","0","0","0","0","0","0","0","0","0","0"
"1998","Edmonton, Alberta, municipal","48033","Total other Criminal Code traffic violations","1045","1027","0","0","160","0","0","0","0","1027","1018","1018","0","0"
"1999","Edmonton, Alberta, municipal","48033","Total other Criminal Code traffic violations","992","999","0","-6.55","149.52","0","0","0","0","999","1018","1018","0","0"
"2000","Edmonton, Alberta, municipal","48033","Total other Criminal Code traffic violations","1074","864","0","6.64","159.45","0","0","0","0","864","858","859","1","0"
"2001","Edmonton, Alberta, municipal","48033","Total other Criminal Code traffic violations","1021","1017","0","-6.23","149.51","0","0","0","0","1017","1007","1007","0","0"
"2002","Edmonton, Alberta, municipal","48033","Total other Criminal Code traffic violations","993","1001","0","-4.42","142.9","0","0","0","0","1001","987","987","0","0"
"2003","Edmonton, Alberta, municipal","48033","Total other Criminal Code traffic violations","1079","1074","0","7.44","153.54","0","0","0","0","1074","1066","1066","0","0"
"2004","Edmonton, Alberta, municipal","48033","Total other Criminal Code traffic violations","1127","1132","3","1.87","156.4","196.58","179.14","0","0","1135","1117","1117","0","0"
"2005","Edmonton, Alberta, municipal","48033","Total other Criminal Code traffic violations","1056","1044","0","-8.43","143.23","177.08","161.7","0","0","1044","1034","1034","0","0"
"2006","Edmonton, Alberta, municipal","48033","Total other Criminal Code traffic violations","1269","1083","23","16.74","167.2","175.59","160.69","0","0","1106","1060","1060","0","0"
"2007","Edmonton, Alberta, municipal","48033","Total other Criminal Code traffic violations","1195","1133","30","-8.28","153.36","173.07","166.36","91.5","3.59","1163","1077","1128","51","2"
"2008","Edmonton, Alberta, municipal","48033","Total other Criminal Code traffic violations","1205","1100","49","-1.49","151.08","168.1","156.85","27.08","1.81","1149","1074","1089","15","1"
"2009","Edmonton, Alberta, municipal","48033","Total other Criminal Code traffic violations","1146","1039","13","-7.25","140.12","154.48","145.38","36.43","0","1052","1015","1035","20","0"
"2010","Edmonton, Alberta, municipal","48033","Total other Criminal Code traffic violations","1024","997","15","-12.07","123.2","143.37","135.32","36.65","0","1012","958","978","20","0"
"2011","Edmonton, Alberta, municipal","48033","Total other Criminal Code traffic violations","976","951","4","-6.31","115.42","134.78","127.27","34.51","3.63","955","916","935","19","2"
"2012","Edmonton, Alberta, municipal","48033","Total other Criminal Code traffic violations","991","958","14","-1.01","114.26","132.56","125.6","36.64","0","972","926","946","20","0"
"2013","Edmonton, Alberta, municipal","48033","Total other Criminal Code traffic violations","1098","1060","8","7.15","122.42","138.14","132.97","64.27","0","1068","1000","1035","35","0"
"2014","Edmonton, Alberta, municipal","48033","Total other Criminal Code traffic violations","1293","1210","8","13.92","139.47","155.06","148.42","56.98","0","1218","1162","1193","31","0"
"2015","Edmonton, Alberta, municipal","48033","Total other Criminal Code traffic violations","1372","1261","13","3.82","144.79","159.29","152.32","54.79","0","1274","1219","1249","30","0"
"2016","Edmonton, Alberta, municipal","48033","Total other Criminal Code traffic violations","1459","1219","19","3.98","150.56","150.48","143.1","39.5","1.8","1238","1176","1198","22","1"
"1998","Edmonton, Alberta, municipal","48033","Dangerous operation, causing death","2","2","0","0","0.31","0","0","0","0","2","2","2","0","0"
"1999","Edmonton, Alberta, municipal","48033","Dangerous operation, causing death","3","3","0","47.66","0.45","0","0","0","0","3","3","3","0","0"
"2000","Edmonton, Alberta, municipal","48033","Dangerous operation, causing death","4","3","0","31.33","0.59","0","0","0","0","3","3","3","0","0"
"2001","Edmonton, Alberta, municipal","48033","Dangerous operation, causing death","2","2","0","-50.68","0.29","0","0","0","0","2","2","2","0","0"
"2002","Edmonton, Alberta, municipal","48033","Dangerous operation, causing death","3","3","0","47.42","0.43","0","0","0","0","3","3","3","0","0"
"2003","Edmonton, Alberta, municipal","48033","Dangerous operation, causing death","1","2","0","-67.04","0.14","0","0","0","0","2","2","2","0","0"
"2004","Edmonton, Alberta, municipal","48033","Dangerous operation, causing death","2","2","0","95.06","0.28","0.35","0.32","0","0","2","2","2","0","0"
"2005","Edmonton, Alberta, municipal","48033","Dangerous operation, causing death","1","1","0","-51.13","0.14","0.17","0.16","0","0","1","1","1","0","0"
"2006","Edmonton, Alberta, municipal","48033","Dangerous operation, causing death","3","3","0","191.43","0.4","0.5","0.45","0","0","3","3","3","0","0"
"2007","Edmonton, Alberta, municipal","48033","Dangerous operation, causing death","5","1","0","62.34","0.64","0.32","0.29","0","0","1","2","2","0","0"
"2008","Edmonton, Alberta, municipal","48033","Dangerous operation, causing death","0","4","0","-100","0","0.63","0.58","0","0","4","4","4","0","0"
"2009","Edmonton, Alberta, municipal","48033","Dangerous operation, causing death","4","2","0","0","0.49","0.15","0.28","1.82","0","2","1","2","1","0"
"2010","Edmonton, Alberta, municipal","48033","Dangerous operation, causing death","0","2","0","-100","0","0.3","0.28","0","0","2","2","2","0","0"
"2011","Edmonton, Alberta, municipal","48033","Dangerous operation, causing death","1","1","0","0","0.12","0.15","0.14","0","0","1","1","1","0","0"
"2012","Edmonton, Alberta, municipal","48033","Dangerous operation, causing death","1","0","0","-2.51","0.12","0","0","0","0","0","0","0","0","0"
"2013","Edmonton, Alberta, municipal","48033","Dangerous operation, causing death","1","2","0","-3.29","0.11","0.28","0.26","0","0","2","2","2","0","0"
"2014","Edmonton, Alberta, municipal","48033","Dangerous operation, causing death","1","1","0","-3.26","0.11","0.13","0.12","0","0","1","1","1","0","0"
"2015","Edmonton, Alberta, municipal","48033","Dangerous operation, causing death","0","0","0","-100","0","0","0","0","0","0","0","0","0","0"
"2016","Edmonton, Alberta, municipal","48033","Dangerous operation, causing death","0","0","0","0","0","0","0","0","0","0","0","0","0","0"
"1998","Edmonton, Alberta, municipal","48033","Dangerous operation, causing bodily harm","21","24","0","0","3.22","0","0","0","0","24","17","17","0","0"
"1999","Edmonton, Alberta, municipal","48033","Dangerous operation, causing bodily harm","21","20","0","-1.56","3.17","0","0","0","0","20","22","22","0","0"
"2000","Edmonton, Alberta, municipal","48033","Dangerous operation, causing bodily harm","7","7","0","-67.17","1.04","0","0","0","0","7","8","8","0","0"
"2001","Edmonton, Alberta, municipal","48033","Dangerous operation, causing bodily harm","15","13","0","111.36","2.2","0","0","0","0","13","14","14","0","0"
"2002","Edmonton, Alberta, municipal","48033","Dangerous operation, causing bodily harm","18","19","0","17.93","2.59","0","0","0","0","19","19","19","0","0"
"2003","Edmonton, Alberta, municipal","48033","Dangerous operation, causing bodily harm","17","17","0","-6.61","2.42","0","0","0","0","17","18","18","0","0"
"2004","Edmonton, Alberta, municipal","48033","Dangerous operation, causing bodily harm","12","11","0","-31.16","1.67","1.94","1.76","0","0","11","11","11","0","0"
"2005","Edmonton, Alberta, municipal","48033","Dangerous operation, causing bodily harm","7","10","0","-42.99","0.95","1.71","1.56","0","0","10","10","10","0","0"
"2006","Edmonton, Alberta, municipal","48033","Dangerous operation, causing bodily harm","21","21","0","191.43","2.77","3.48","3.18","0","0","21","21","21","0","0"
"2007","Edmonton, Alberta, municipal","48033","Dangerous operation, causing bodily harm","14","13","0","-35.06","1.8","1.93","1.92","1.79","0","13","12","13","1","0"
"2008","Edmonton, Alberta, municipal","48033","Dangerous operation, causing bodily harm","17","17","0","18.63","2.13","2.5","2.45","1.81","0","17","16","17","1","0"
"2009","Edmonton, Alberta, municipal","48033","Dangerous operation, causing bodily harm","13","11","0","-25.42","1.59","1.67","1.55","0","0","11","11","11","0","0"
"2010","Edmonton, Alberta, municipal","48033","Dangerous operation, causing bodily harm","8","7","0","-39.45","0.96","1.2","1.25","1.83","0","7","8","9","1","0"
"2011","Edmonton, Alberta, municipal","48033","Dangerous operation, causing bodily harm","12","13","0","47.44","1.42","1.91","1.77","0","0","13","13","13","0","0"
"2012","Edmonton, Alberta, municipal","48033","Dangerous operation, causing bodily harm","5","7","0","-59.38","0.58","1.15","1.06","0","0","7","8","8","0","0"
"2013","Edmonton, Alberta, municipal","48033","Dangerous operation, causing bodily harm","5","5","0","-3.29","0.56","0.69","0.64","0","0","5","5","5","0","0"
"2014","Edmonton, Alberta, municipal","48033","Dangerous operation, causing bodily harm","8","5","0","54.79","0.86","0.93","0.87","0","0","5","7","7","0","0"
"2015","Edmonton, Alberta, municipal","48033","Dangerous operation, causing bodily harm","6","8","0","-26.62","0.63","1.05","0.98","0","0","8","8","8","0","0"
"2016","Edmonton, Alberta, municipal","48033","Dangerous operation, causing bodily harm","9","9","0","46.67","0.93","1.15","1.08","0","0","9","9","9","0","0"
"1998","Edmonton, Alberta, municipal","48033","Dangerous operation of motor vehicle, vessel or aircraft","242","230","0","0","37.05","0","0","0","0","230","246","246","0","0"
"1999","Edmonton, Alberta, municipal","48033","Dangerous operation of motor vehicle, vessel or aircraft","279","284","0","13.49","42.05","0","0","0","0","284","294","294","0","0"
"2000","Edmonton, Alberta, municipal","48033","Dangerous operation of motor vehicle, vessel or aircraft","253","255","0","-10.68","37.56","0","0","0","0","255","261","261","0","0"
"2001","Edmonton, Alberta, municipal","48033","Dangerous operation of motor vehicle, vessel or aircraft","247","244","0","-3.71","36.17","0","0","0","0","244","249","249","0","0"
"2002","Edmonton, Alberta, municipal","48033","Dangerous operation of motor vehicle, vessel or aircraft","247","252","0","-1.72","35.55","0","0","0","0","252","251","251","0","0"
"2003","Edmonton, Alberta, municipal","48033","Dangerous operation of motor vehicle, vessel or aircraft","251","248","0","0.48","35.72","0","0","0","0","248","259","259","0","0"
"2004","Edmonton, Alberta, municipal","48033","Dangerous operation of motor vehicle, vessel or aircraft","273","278","1","6.08","37.89","48.57","44.26","0","0","279","276","276","0","0"
"2005","Edmonton, Alberta, municipal","48033","Dangerous operation of motor vehicle, vessel or aircraft","225","222","0","-19.45","30.52","39.22","35.81","0","0","222","229","229","0","0"
"2006","Edmonton, Alberta, municipal","48033","Dangerous operation of motor vehicle, vessel or aircraft","180","180","0","-22.29","23.72","30.15","27.59","0","0","180","182","182","0","0"
"2007","Edmonton, Alberta, municipal","48033","Dangerous operation of motor vehicle, vessel or aircraft","161","161","0","-12.88","20.66","22.82","24.19","39.47","0","161","142","164","22","0"
"2008","Edmonton, Alberta, municipal","48033","Dangerous operation of motor vehicle, vessel or aircraft","163","159","0","-1.09","20.44","23.79","23.19","16.25","0","159","152","161","9","0"
"2009","Edmonton, Alberta, municipal","48033","Dangerous operation of motor vehicle, vessel or aircraft","148","144","5","-11.45","18.1","21.16","20.23","9.11","0","149","139","144","5","0"
"2010","Edmonton, Alberta, municipal","48033","Dangerous operation of motor vehicle, vessel or aircraft","126","117","5","-16.23","15.16","16.01","16.05","16.49","0","122","107","116","9","0"
"2011","Edmonton, Alberta, municipal","48033","Dangerous operation of motor vehicle, vessel or aircraft","132","119","2","2.97","15.61","16.48","16.2","12.72","3.63","121","112","119","7","2"
"2012","Edmonton, Alberta, municipal","48033","Dangerous operation of motor vehicle, vessel or aircraft","133","130","2","-1.77","15.33","18.04","17.39","9.16","0","132","126","131","5","0"
"2013","Edmonton, Alberta, municipal","48033","Dangerous operation of motor vehicle, vessel or aircraft","156","147","1","13.43","17.39","18.79","19.01","22.04","0","148","136","148","12","0"
"2014","Edmonton, Alberta, municipal","48033","Dangerous operation of motor vehicle, vessel or aircraft","198","179","4","22.79","21.36","21.88","22.39","29.41","0","183","164","180","16","0"
"2015","Edmonton, Alberta, municipal","48033","Dangerous operation of motor vehicle, vessel or aircraft","208","188","8","2.78","21.95","22.61","22.68","23.74","0","196","173","186","13","0"
"2016","Edmonton, Alberta, municipal","48033","Dangerous operation of motor vehicle, vessel or aircraft","194","179","5","-8.8","20.02","22.27","21.38","8.98","1.8","184","174","179","5","1"
"2000","Edmonton, Alberta, municipal","48033","Dangerous operation evading police, causing death","0","0","0","0","0","0","0","0","0","0","0","0","0","0"
"2001","Edmonton, Alberta, municipal","48033","Dangerous operation evading police, causing death","0","0","0","0","0","0","0","0","0","0","0","0","0","0"
"2002","Edmonton, Alberta, municipal","48033","Dangerous operation evading police, causing death","0","0","0","0","0","0","0","0","0","0","0","0","0","0"
"2003","Edmonton, Alberta, municipal","48033","Dangerous operation evading police, causing death","0","0","0","0","0","0","0","0","0","0","0","0","0","0"
"2004","Edmonton, Alberta, municipal","48033","Dangerous operation evading police, causing death","0","0","0","0","0","0","0","0","0","0","0","0","0","0"
"2005","Edmonton, Alberta, municipal","48033","Dangerous operation evading police, causing death","0","0","0","0","0","0","0","0","0","0","0","0","0","0"
"2006","Edmonton, Alberta, municipal","48033","Dangerous operation evading police, causing death","0","0","0","0","0","0","0","0","0","0","0","0","0","0"
"2007","Edmonton, Alberta, municipal","48033","Dangerous operation evading police, causing death","1","1","0","0","0.13","0.16","0.15","0","0","1","1","1","0","0"
"2008","Edmonton, Alberta, municipal","48033","Dangerous operation evading police, causing death","0","0","0","-100","0","0","0","0","0","0","0","0","0","0"
"2009","Edmonton, Alberta, municipal","48033","Dangerous operation evading police, causing death","0","0","0","0","0","0","0","0","0","0","0","0","0","0"
"2010","Edmonton, Alberta, municipal","48033","Dangerous operation evading police, causing death","0","0","0","0","0","0","0","0","0","0","0","0","0","0"
"2011","Edmonton, Alberta, municipal","48033","Dangerous operation evading police, causing death","0","0","0","0","0","0","0","0","0","0","0","0","0","0"
"2012","Edmonton, Alberta, municipal","48033","Dangerous operation evading police, causing death","1","1","0","0","0.12","0.14","0.13","0","0","1","1","1","0","0"
"2013","Edmonton, Alberta, municipal","48033","Dangerous operation evading police, causing death","0","0","0","-100","0","0","0","0","0","0","0","0","0","0"
"2014","Edmonton, Alberta, municipal","48033","Dangerous operation evading police, causing death","0","0","0","0","0","0","0","0","0","0","0","0","0","0"
"2015","Edmonton, Alberta, municipal","48033","Dangerous operation evading police, causing death","1","1","0","0","0.11","0.13","0.12","0","0","1","1","1","0","0"
"2016","Edmonton, Alberta, municipal","48033","Dangerous operation evading police, causing death","0","0","0","-100","0","0","0","0","0","0","0","0","0","0"
"2000","Edmonton, Alberta, municipal","48033","Dangerous operation evading police, causing bodily harm","0","0","0","0","0","0","0","0","0","0","0","0","0","0"
"2001","Edmonton, Alberta, municipal","48033","Dangerous operation evading police, causing bodily harm","2","2","0","0","0.29","0","0","0","0","2","2","2","0","0"
"2002","Edmonton, Alberta, municipal","48033","Dangerous operation evading police, causing bodily harm","2","2","0","-1.72","0.29","0","0","0","0","2","2","2","0","0"
"2003","Edmonton, Alberta, municipal","48033","Dangerous operation evading police, causing bodily harm","6","6","0","196.64","0.85","0","0","0","0","6","6","6","0","0"
"2004","Edmonton, Alberta, municipal","48033","Dangerous operation evading police, causing bodily harm","1","1","0","-83.75","0.14","0.18","0.16","0","0","1","1","1","0","0"
"2005","Edmonton, Alberta, municipal","48033","Dangerous operation evading police, causing bodily harm","3","3","0","193.2","0.41","0.51","0.47","0","0","3","3","3","0","0"
"2006","Edmonton, Alberta, municipal","48033","Dangerous operation evading police, causing bodily harm","6","6","0","94.29","0.79","0.83","0.76","0","0","6","5","5","0","0"
"2007","Edmonton, Alberta, municipal","48033","Dangerous operation evading police, causing bodily harm","2","2","0","-67.53","0.26","0.32","0.29","0","0","2","2","2","0","0"
"2008","Edmonton, Alberta, municipal","48033","Dangerous operation evading police, causing bodily harm","1","1","0","-51.15","0.13","0.16","0.14","0","0","1","1","1","0","0"
"2009","Edmonton, Alberta, municipal","48033","Dangerous operation evading police, causing bodily harm","2","2","0","95.05","0.24","0.3","0.28","0","0","2","2","2","0","0"
"2010","Edmonton, Alberta, municipal","48033","Dangerous operation evading police, causing bodily harm","1","1","0","-50.8","0.12","0.15","0.14","0","0","1","1","1","0","0"
"2011","Edmonton, Alberta, municipal","48033","Dangerous operation evading police, causing bodily harm","1","1","0","-1.71","0.12","0.15","0.14","0","0","1","1","1","0","0"
"2012","Edmonton, Alberta, municipal","48033","Dangerous operation evading police, causing bodily harm","1","1","0","-2.51","0.12","0.14","0.13","0","0","1","1","1","0","0"
"2013","Edmonton, Alberta, municipal","48033","Dangerous operation evading police, causing bodily harm","2","2","0","93.41","0.22","0.28","0.26","0","0","2","2","2","0","0"
"2014","Edmonton, Alberta, municipal","48033","Dangerous operation evading police, causing bodily harm","0","0","0","-100","0","0","0","0","0","0","0","0","0","0"
"2015","Edmonton, Alberta, municipal","48033","Dangerous operation evading police, causing bodily harm","2","2","0","0","0.21","0.26","0.24","0","0","2","2","2","0","0"
"2016","Edmonton, Alberta, municipal","48033","Dangerous operation evading police, causing bodily harm","2","2","0","-2.22","0.21","0.26","0.24","0","0","2","2","2","0","0"
"2000","Edmonton, Alberta, municipal","48033","Dangerous operation of motor vehicle evading police","14","14","0","0","2.08","0","0","0","0","14","13","13","0","0"
"2001","Edmonton, Alberta, municipal","48033","Dangerous operation of motor vehicle evading police","74","72","0","421.35","10.84","0","0","0","0","72","72","72","0","0"
"2002","Edmonton, Alberta, municipal","48033","Dangerous operation of motor vehicle evading police","57","57","0","-24.3","8.2","0","0","0","0","57","59","59","0","0"
"2003","Edmonton, Alberta, municipal","48033","Dangerous operation of motor vehicle evading police","53","51","0","-8.06","7.54","0","0","0","0","51","43","43","0","0"
"2004","Edmonton, Alberta, municipal","48033","Dangerous operation of motor vehicle evading police","40","39","1","-26.39","5.55","7.39","6.74","0","0","40","42","42","0","0"
"2005","Edmonton, Alberta, municipal","48033","Dangerous operation of motor vehicle evading police","58","57","0","41.71","7.87","9.25","8.44","0","0","57","54","54","0","0"
"2006","Edmonton, Alberta, municipal","48033","Dangerous operation of motor vehicle evading police","80","72","2","33.99","10.54","11.76","10.76","0","0","74","71","71","0","0"
"2007","Edmonton, Alberta, municipal","48033","Dangerous operation of motor vehicle evading police","93","83","0","13.23","11.94","12.21","12.24","12.56","0","83","76","83","7","0"
"2008","Edmonton, Alberta, municipal","48033","Dangerous operation of motor vehicle evading police","78","70","1","-18.06","9.78","10.33","9.79","3.61","0","71","66","68","2","0"
"2009","Edmonton, Alberta, municipal","48033","Dangerous operation of motor vehicle evading police","85","70","0","6.28","10.39","9.59","9.69","10.93","0","70","63","69","6","0"
"2010","Edmonton, Alberta, municipal","48033","Dangerous operation of motor vehicle evading police","79","68","1","-8.55","9.5","9.58","9.13","3.67","0","69","64","66","2","0"
"2011","Edmonton, Alberta, municipal","48033","Dangerous operation of motor vehicle evading police","77","63","0","-4.19","9.11","8.39","8.44","9.08","0","63","57","62","5","0"
"2012","Edmonton, Alberta, municipal","48033","Dangerous operation of motor vehicle evading police","75","64","1","-5.04","8.65","7.87","8.76","20.15","0","65","55","66","11","0"
"2013","Edmonton, Alberta, municipal","48033","Dangerous operation of motor vehicle evading police","115","100","0","48.28","12.82","11.05","12.59","33.06","0","100","80","98","18","0"
"2014","Edmonton, Alberta, municipal","48033","Dangerous operation of motor vehicle evading police","144","100","2","21.14","15.53","12.14","12.07","11.03","0","102","91","97","6","0"
"2015","Edmonton, Alberta, municipal","48033","Dangerous operation of motor vehicle evading police","199","126","2","35.21","21","16.47","16.1","10.96","0","128","126","132","6","0"
"2016","Edmonton, Alberta, municipal","48033","Dangerous operation of motor vehicle evading police","352","156","6","72.96","36.32","18.04","18.28","21.55","0","162","141","153","12","0"
"1998","Edmonton, Alberta, municipal","48033","Total fail to stop or remain","39","39","0","0","5.97","0","0","0","0","39","21","21","0","0"
"1999","Edmonton, Alberta, municipal","48033","Total fail to stop or remain","25","27","0","-36.9","3.77","0","0","0","0","27","23","23","0","0"
"2000","Edmonton, Alberta, municipal","48033","Total fail to stop or remain","27","26","0","6.38","4.01","0","0","0","0","26","22","22","0","0"
"2001","Edmonton, Alberta, municipal","48033","Total fail to stop or remain","42","43","0","53.43","6.15","0","0","0","0","43","35","35","0","0"
"2002","Edmonton, Alberta, municipal","48033","Total fail to stop or remain","36","36","0","-15.76","5.18","0","0","0","0","36","29","29","0","0"
"2003","Edmonton, Alberta, municipal","48033","Total fail to stop or remain","40","38","0","9.87","5.69","0","0","0","0","38","32","32","0","0"
"2004","Edmonton, Alberta, municipal","48033","Total fail to stop or remain","34","34","1","-17.1","4.72","4.05","3.69","0","0","35","23","23","0","0"
"2005","Edmonton, Alberta, municipal","48033","Total fail to stop or remain","23","21","0","-33.89","3.12","3.94","3.6","0","0","21","23","23","0","0"
"2006","Edmonton, Alberta, municipal","48033","Total fail to stop or remain","266","85","17","1023.48","35.05","11.6","10.61","0","0","102","70","70","0","0"
"2007","Edmonton, Alberta, municipal","48033","Total fail to stop or remain","126","96","21","-53.86","16.17","11.25","12.24","23.32","1.79","117","70","83","13","1"
"2008","Edmonton, Alberta, municipal","48033","Total fail to stop or remain","135","35","42","4.67","16.93","4.23","4.18","3.61","1.81","77","27","29","2","1"
"2009","Edmonton, Alberta, municipal","48033","Total fail to stop or remain","110","33","3","-20.54","13.45","3.81","4.21","9.11","0","36","25","30","5","0"
"2010","Edmonton, Alberta, municipal","48033","Total fail to stop or remain","45","48","4","-59.75","5.41","5.54","5.53","5.5","0","52","37","40","3","0"
"2011","Edmonton, Alberta, municipal","48033","Total fail to stop or remain","43","40","1","-6.07","5.09","4.41","4.36","3.63","0","41","30","32","2","0"
"2012","Edmonton, Alberta, municipal","48033","Total fail to stop or remain","52","46","0","17.9","6","5.58","5.71","7.33","0","46","39","43","4","0"
"2013","Edmonton, Alberta, municipal","48033","Total fail to stop or remain","47","49","0","-12.59","5.24","4.7","4.63","3.67","0","49","34","36","2","0"
"2014","Edmonton, Alberta, municipal","48033","Total fail to stop or remain","54","48","0","11.15","5.82","4.67","4.73","5.51","0","48","35","38","3","0"
"2015","Edmonton, Alberta, municipal","48033","Total fail to stop or remain","65","57","1","17.77","6.86","6.66","6.59","5.48","0","58","51","54","3","0"
"2016","Edmonton, Alberta, municipal","48033","Total fail to stop or remain","65","57","1","-2.22","6.71","6.27","6.09","3.59","0","58","49","51","2","0"
"1998","Edmonton, Alberta, municipal","48033","Driving while prohibited","741","732","0","0","113.45","0","0","0","0","732","732","732","0","0"
"1999","Edmonton, Alberta, municipal","48033","Driving while prohibited","664","665","0","-11.79","100.08","0","0","0","0","665","676","676","0","0"
"2000","Edmonton, Alberta, municipal","48033","Driving while prohibited","761","553","0","12.89","112.98","0","0","0","0","553","548","548","0","0"
"2001","Edmonton, Alberta, municipal","48033","Driving while prohibited","639","641","0","-17.18","93.57","0","0","0","0","641","633","633","0","0"
"2002","Edmonton, Alberta, municipal","48033","Driving while prohibited","630","632","0","-3.11","90.66","0","0","0","0","632","624","624","0","0"
"2003","Edmonton, Alberta, municipal","48033","Driving while prohibited","711","712","0","11.59","101.17","0","0","0","0","712","706","706","0","0"
"2004","Edmonton, Alberta, municipal","48033","Driving while prohibited","765","767","0","4.94","106.17","134.1","122.21","0","0","767","762","762","0","0"
"2005","Edmonton, Alberta, municipal","48033","Driving while prohibited","739","730","0","-5.59","100.23","122.28","111.66","0","0","730","714","714","0","0"
"2006","Edmonton, Alberta, municipal","48033","Driving while prohibited","713","716","4","-6.27","93.94","117.28","107.33","0","0","720","708","708","0","0"
"2007","Edmonton, Alberta, municipal","48033","Driving while prohibited","792","775","9","8.2","101.64","123.9","114.89","14.35","1.79","784","771","779","8","1"
"2008","Edmonton, Alberta, municipal","48033","Driving while prohibited","811","814","6","0.04","101.68","126.46","116.52","1.81","0","820","808","809","1","0"
"2009","Edmonton, Alberta, municipal","48033","Driving while prohibited","782","776","5","-5.96","95.61","117.65","109","5.46","0","781","773","776","3","0"
"2010","Edmonton, Alberta, municipal","48033","Driving while prohibited","764","752","5","-3.86","91.92","110.15","102.53","9.16","0","757","736","741","5","0"
"2011","Edmonton, Alberta, municipal","48033","Driving while prohibited","706","710","1","-9.17","83.49","102.56","95.28","5.45","0","711","697","700","3","0"
"2012","Edmonton, Alberta, municipal","48033","Driving while prohibited","721","708","11","-0.44","83.13","99.49","92.28","0","0","719","695","695","0","0"
"2013","Edmonton, Alberta, municipal","48033","Driving while prohibited","772","755","7","3.55","86.08","102.36","95.59","5.51","0","762","741","744","3","0"
"2014","Edmonton, Alberta, municipal","48033","Driving while prohibited","887","876","2","11.15","95.67","115.03","107.99","11.03","0","878","862","868","6","0"
"2015","Edmonton, Alberta, municipal","48033","Driving while prohibited","890","879","2","-1.83","93.92","112.12","105.61","14.61","0","881","858","866","8","0"
"2016","Edmonton, Alberta, municipal","48033","Driving while prohibited","835","814","7","-8.26","86.17","102.24","95.8","5.39","0","821","799","802","3","0"
"1998","Edmonton, Alberta, municipal","48033","Other Criminal Code traffic violations","0","0","0","0","0","0","0","0","0","0","0","0","0","0"
"1999","Edmonton, Alberta, municipal","48033","Other Criminal Code traffic violations","0","0","0","0","0","0","0","0","0","0","0","0","0","0"
"2000","Edmonton, Alberta, municipal","48033","Other Criminal Code traffic violations","8","6","0","0","1.19","0","0","0","0","6","3","4","1","0"
"2001","Edmonton, Alberta, municipal","48033","Other Criminal Code traffic violations","0","0","0","-100","0","0","0","0","0","0","0","0","0","0"
"2002","Edmonton, Alberta, municipal","48033","Other Criminal Code traffic violations","0","0","0","0","0","0","0","0","0","0","0","0","0","0"
"2003","Edmonton, Alberta, municipal","48033","Other Criminal Code traffic violations","0","0","0","0","0","0","0","0","0","0","0","0","0","0"
"2004","Edmonton, Alberta, municipal","48033","Other Criminal Code traffic violations","0","0","0","0","0","0","0","0","0","0","0","0","0","0"
"2005","Edmonton, Alberta, municipal","48033","Other Criminal Code traffic violations","0","0","0","0","0","0","0","0","0","0","0","0","0","0"
"2006","Edmonton, Alberta, municipal","48033","Other Criminal Code traffic violations","0","0","0","0","0","0","0","0","0","0","0","0","0","0"
"2007","Edmonton, Alberta, municipal","48033","Other Criminal Code traffic violations","1","1","0","0","0.13","0.16","0.15","0","0","1","1","1","0","0"
"2008","Edmonton, Alberta, municipal","48033","Other Criminal Code traffic violations","0","0","0","-100","0","0","0","0","0","0","0","0","0","0"
"2009","Edmonton, Alberta, municipal","48033","Other Criminal Code traffic violations","0","0","0","0","0","0","0","0","0","0","0","0","0","0"
"2010","Edmonton, Alberta, municipal","48033","Other Criminal Code traffic violations","0","0","0","0","0","0","0","0","0","0","0","0","0","0"
"2011","Edmonton, Alberta, municipal","48033","Other Criminal Code traffic violations","1","1","0","0","0.12","0.15","0.14","0","0","1","1","1","0","0"
"2012","Edmonton, Alberta, municipal","48033","Other Criminal Code traffic violations","0","0","0","-100","0","0","0","0","0","0","0","0","0","0"
"2013","Edmonton, Alberta, municipal","48033","Other Criminal Code traffic violations","0","0","0","0","0","0","0","0","0","0","0","0","0","0"
"2014","Edmonton, Alberta, municipal","48033","Other Criminal Code traffic violations","0","0","0","0","0","0","0","0","0","0","0","0","0","0"
"2015","Edmonton, Alberta, municipal","48033","Other Criminal Code traffic violations","0","0","0","0","0","0","0","0","0","0","0","0","0","0"
"2016","Edmonton, Alberta, municipal","48033","Other Criminal Code traffic violations","0","0","0","0","0","0","0","0","0","0","0","0","0","0"
"2005","Edmonton, Alberta, municipal","48033","Causing death by criminal negligence while street racing","0","0","0","0","0","0","0","0","0","0","0","0","0","0"
"2006","Edmonton, Alberta, municipal","48033","Causing death by criminal negligence while street racing","0","0","0","0","0","0","0","0","0","0","0","0","0","0"
"2007","Edmonton, Alberta, municipal","48033","Causing death by criminal negligence while street racing","0","0","0","0","0","0","0","0","0","0","0","0","0","0"
"2008","Edmonton, Alberta, municipal","48033","Causing death by criminal negligence while street racing","0","0","0","0","0","0","0","0","0","0","0","0","0","0"
"2009","Edmonton, Alberta, municipal","48033","Causing death by criminal negligence while street racing","0","0","0","0","0","0","0","0","0","0","0","0","0","0"
"2010","Edmonton, Alberta, municipal","48033","Causing death by criminal negligence while street racing","0","0","0","0","0","0","0","0","0","0","0","0","0","0"
"2011","Edmonton, Alberta, municipal","48033","Causing death by criminal negligence while street racing","0","0","0","0","0","0","0","0","0","0","0","0","0","0"
"2012","Edmonton, Alberta, municipal","48033","Causing death by criminal negligence while street racing","0","0","0","0","0","0","0","0","0","0","0","0","0","0"
"2013","Edmonton, Alberta, municipal","48033","Causing death by criminal negligence while street racing","0","0","0","0","0","0","0","0","0","0","0","0","0","0"
"2014","Edmonton, Alberta, municipal","48033","Causing death by criminal negligence while street racing","0","0","0","0","0","0","0","0","0","0","0","0","0","0"
"2015","Edmonton, Alberta, municipal","48033","Causing death by criminal negligence while street racing","0","0","0","0","0","0","0","0","0","0","0","0","0","0"
"2016","Edmonton, Alberta, municipal","48033","Causing death by criminal negligence while street racing","0","0","0","0","0","0","0","0","0","0","0","0","0","0"
"2005","Edmonton, Alberta, municipal","48033","Causing bodily harm by criminal negligence while street racing","0","0","0","0","0","0","0","0","0","0","0","0","0","0"
"2006","Edmonton, Alberta, municipal","48033","Causing bodily harm by criminal negligence while street racing","0","0","0","0","0","0","0","0","0","0","0","0","0","0"
"2007","Edmonton, Alberta, municipal","48033","Causing bodily harm by criminal negligence while street racing","0","0","0","0","0","0","0","0","0","0","0","0","0","0"
"2008","Edmonton, Alberta, municipal","48033","Causing bodily harm by criminal negligence while street racing","0","0","0","0","0","0","0","0","0","0","0","0","0","0"
"2009","Edmonton, Alberta, municipal","48033","Causing bodily harm by criminal negligence while street racing","0","0","0","0","0","0","0","0","0","0","0","0","0","0"
"2010","Edmonton, Alberta, municipal","48033","Causing bodily harm by criminal negligence while street racing","0","0","0","0","0","0","0","0","0","0","0","0","0","0"
"2011","Edmonton, Alberta, municipal","48033","Causing bodily harm by criminal negligence while street racing","0","0","0","0","0","0","0","0","0","0","0","0","0","0"
"2012","Edmonton, Alberta, municipal","48033","Causing bodily harm by criminal negligence while street racing","1","1","0","0","0.12","0.14","0.13","0","0","1","1","1","0","0"
"2013","Edmonton, Alberta, municipal","48033","Causing bodily harm by criminal negligence while street racing","0","0","0","-100","0","0","0","0","0","0","0","0","0","0"
"2014","Edmonton, Alberta, municipal","48033","Causing bodily harm by criminal negligence while street racing","0","0","0","0","0","0","0","0","0","0","0","0","0","0"
"2015","Edmonton, Alberta, municipal","48033","Causing bodily harm by criminal negligence while street racing","0","0","0","0","0","0","0","0","0","0","0","0","0","0"
"2016","Edmonton, Alberta, municipal","48033","Causing bodily harm by criminal negligence while street racing","1","1","0","0","0.1","0.13","0.12","0","0","1","1","1","0","0"
"2005","Edmonton, Alberta, municipal","48033","Dangerous operation causing death while street racing","0","0","0","0","0","0","0","0","0","0","0","0","0","0"
"2006","Edmonton, Alberta, municipal","48033","Dangerous operation causing death while street racing","0","0","0","0","0","0","0","0","0","0","0","0","0","0"
"2007","Edmonton, Alberta, municipal","48033","Dangerous operation causing death while street racing","0","0","0","0","0","0","0","0","0","0","0","0","0","0"
"2008","Edmonton, Alberta, municipal","48033","Dangerous operation causing death while street racing","0","0","0","0","0","0","0","0","0","0","0","0","0","0"
"2009","Edmonton, Alberta, municipal","48033","Dangerous operation causing death while street racing","0","0","0","0","0","0","0","0","0","0","0","0","0","0"
"2010","Edmonton, Alberta, municipal","48033","Dangerous operation causing death while street racing","1","1","0","0","0.12","0.3","0.28","0","0","1","2","2","0","0"
"2011","Edmonton, Alberta, municipal","48033","Dangerous operation causing death while street racing","1","1","0","-1.71","0.12","0.29","0.41","1.82","0","1","2","3","1","0"
"2012","Edmonton, Alberta, municipal","48033","Dangerous operation causing death while street racing","0","0","0","-100","0","0","0","0","0","0","0","0","0","0"
"2013","Edmonton, Alberta, municipal","48033","Dangerous operation causing death while street racing","0","0","0","0","0","0","0","0","0","0","0","0","0","0"
"2014","Edmonton, Alberta, municipal","48033","Dangerous operation causing death while street racing","0","0","0","0","0","0","0","0","0","0","0","0","0","0"
"2015","Edmonton, Alberta, municipal","48033","Dangerous operation causing death while street racing","0","0","0","0","0","0","0","0","0","0","0","0","0","0"
"2016","Edmonton, Alberta, municipal","48033","Dangerous operation causing death while street racing","0","0","0","0","0","0","0","0","0","0","0","0","0","0"
"2005","Edmonton, Alberta, municipal","48033","Dangerous operation causing bodily harm while street racing","0","0","0","0","0","0","0","0","0","0","0","0","0","0"
"2006","Edmonton, Alberta, municipal","48033","Dangerous operation causing bodily harm while street racing","0","0","0","0","0","0","0","0","0","0","0","0","0","0"
"2007","Edmonton, Alberta, municipal","48033","Dangerous operation causing bodily harm while street racing","0","0","0","0","0","0","0","0","0","0","0","0","0","0"
"2008","Edmonton, Alberta, municipal","48033","Dangerous operation causing bodily harm while street racing","0","0","0","0","0","0","0","0","0","0","0","0","0","0"
"2009","Edmonton, Alberta, municipal","48033","Dangerous operation causing bodily harm while street racing","1","1","0","0","0.12","0.15","0.14","0","0","1","1","1","0","0"
"2010","Edmonton, Alberta, municipal","48033","Dangerous operation causing bodily harm while street racing","0","0","0","-100","0","0","0","0","0","0","0","0","0","0"
"2011","Edmonton, Alberta, municipal","48033","Dangerous operation causing bodily harm while street racing","0","0","0","0","0","0","0","0","0","0","0","0","0","0"
"2012","Edmonton, Alberta, municipal","48033","Dangerous operation causing bodily harm while street racing","0","0","0","0","0","0","0","0","0","0","0","0","0","0"
"2013","Edmonton, Alberta, municipal","48033","Dangerous operation causing bodily harm while street racing","0","0","0","0","0","0","0","0","0","0","0","0","0","0"
"2014","Edmonton, Alberta, municipal","48033","Dangerous operation causing bodily harm while street racing","0","0","0","0","0","0","0","0","0","0","0","0","0","0"
"2015","Edmonton, Alberta, municipal","48033","Dangerous operation causing bodily harm while street racing","0","0","0","0","0","0","0","0","0","0","0","0","0","0"
"2016","Edmonton, Alberta, municipal","48033","Dangerous operation causing bodily harm while street racing","0","0","0","0","0","0","0","0","0","0","0","0","0","0"
"2005","Edmonton, Alberta, municipal","48033","Dangerous operation of motor vehicle while street racing","0","0","0","0","0","0","0","0","0","0","0","0","0","0"
"2006","Edmonton, Alberta, municipal","48033","Dangerous operation of motor vehicle while street racing","0","0","0","0","0","0","0","0","0","0","0","0","0","0"
"2007","Edmonton, Alberta, municipal","48033","Dangerous operation of motor vehicle while street racing","0","0","0","0","0","0","0","0","0","0","0","0","0","0"
"2008","Edmonton, Alberta, municipal","48033","Dangerous operation of motor vehicle while street racing","0","0","0","0","0","0","0","0","0","0","0","0","0","0"
"2009","Edmonton, Alberta, municipal","48033","Dangerous operation of motor vehicle while street racing","1","0","0","0","0.12","0","0","0","0","0","0","0","0","0"
"2010","Edmonton, Alberta, municipal","48033","Dangerous operation of motor vehicle while street racing","0","1","0","-100","0","0.15","0.14","0","0","1","1","1","0","0"
"2011","Edmonton, Alberta, municipal","48033","Dangerous operation of motor vehicle while street racing","2","2","0","0","0.24","0.29","0.41","1.82","0","2","2","3","1","0"
"2012","Edmonton, Alberta, municipal","48033","Dangerous operation of motor vehicle while street racing","1","0","0","-51.25","0.12","0","0","0","0","0","0","0","0","0"
"2013","Edmonton, Alberta, municipal","48033","Dangerous operation of motor vehicle while street racing","0","0","0","-100","0","0","0","0","0","0","0","0","0","0"
"2014","Edmonton, Alberta, municipal","48033","Dangerous operation of motor vehicle while street racing","1","1","0","0","0.11","0.27","0.25","0","0","1","2","2","0","0"
"2015","Edmonton, Alberta, municipal","48033","Dangerous operation of motor vehicle while street racing","1","0","0","-2.16","0.11","0","0","0","0","0","0","0","0","0"
"2016","Edmonton, Alberta, municipal","48033","Dangerous operation of motor vehicle while street racing","1","1","0","-2.22","0.1","0.13","0.12","0","0","1","1","1","0","0"
"1998","Edmonton, Alberta, municipal","48033","Total Federal Statute violations","1467","1246","132","0","224.61","0","0","0","0","1378","1213","1472","259","39"
"1999","Edmonton, Alberta, municipal","48033","Total Federal Statute violations","1526","1391","74","2.4","230","0","0","0","0","1465","1440","1725","285","21"
"2000","Edmonton, Alberta, municipal","48033","Total Federal Statute violations","1741","1424","70","12.38","258.47","0","0","0","0","1494","1499","1808","309","20"
"2001","Edmonton, Alberta, municipal","48033","Total Federal Statute violations","1273","1145","63","-27.88","186.41","0","0","0","0","1208","1218","1489","271","30"
"2002","Edmonton, Alberta, municipal","48033","Total Federal Statute violations","1117","1039","61","-13.77","160.75","0","0","0","0","1100","1038","1275","237","24"
"2003","Edmonton, Alberta, municipal","48033","Total Federal Statute violations","1179","1088","42","4.37","167.77","0","0","0","0","1130","1081","1277","196","33"
"2004","Edmonton, Alberta, municipal","48033","Total Federal Statute violations","1155","1043","39","-4.46","160.29","189.54","201.12","320.11","65.11","1082","1077","1254","177","36"
"2005","Edmonton, Alberta, municipal","48033","Total Federal Statute violations","1082","991","43","-8.45","146.75","174.34","178.91","226.88","68.42","1034","1018","1144","126","38"
"2006","Edmonton, Alberta, municipal","48033","Total Federal Statute violations","1207","1136","45","8.37","159.03","189.84","195.1","251.82","69.65","1181","1146","1287","141","39"
"2007","Edmonton, Alberta, municipal","48033","Total Federal Statute violations","1184","1072","59","-4.45","151.95","167.12","177.72","296.02","69.97","1131","1040","1205","165","39"
"2008","Edmonton, Alberta, municipal","48033","Total Federal Statute violations","1279","1148","62","5.53","160.35","167.32","182.34","355.67","57.77","1210","1069","1266","197","32"
"2009","Edmonton, Alberta, municipal","48033","Total Federal Statute violations","1452","1261","92","10.71","177.53","182.64","194.69","338.83","83.8","1353","1200","1386","186","46"
"2010","Edmonton, Alberta, municipal","48033","Total Federal Statute violations","1835","1648","101","24.36","220.78","235.12","249.6","427.01","38.49","1749","1571","1804","233","21"
"2011","Edmonton, Alberta, municipal","48033","Total Federal Statute violations","1717","1604","76","-8.03","203.05","229.24","245.69","448.67","70.84","1680","1558","1805","247","39"
"2012","Edmonton, Alberta, municipal","48033","Total Federal Statute violations","1786","1629","96","1.41","205.92","226.46","239.92","412.22","80.61","1725","1582","1807","225","44"
"2013","Edmonton, Alberta, municipal","48033","Total Federal Statute violations","1975","1865","74","6.94","220.21","265.5","275.32","405.85","91.82","1939","1922","2143","221","50"
"2014","Edmonton, Alberta, municipal","48033","Total Federal Statute violations","2396","2257","83","17.36","258.44","303.44","310.52","408.03","31.25","2340","2274","2496","222","17"
"2015","Edmonton, Alberta, municipal","48033","Total Federal Statute violations","2338","2220","75","-4.53","246.74","293.37","295.36","323.28","40.18","2295","2245","2422","177","22"
"2016","Edmonton, Alberta, municipal","48033","Total Federal Statute violations","2702","2508","103","13.01","278.82","342.68","336.61","251.37","55.66","2611","2678","2818","140","31"
"1998","Edmonton, Alberta, municipal","48033","Total Drug violations","1173","1093","30","0","179.59","0","0","0","0","1123","1135","1338","203","39"
"1999","Edmonton, Alberta, municipal","48033","Total Drug violations","1285","1219","34","7.84","193.68","0","0","0","0","1253","1318","1535","217","18"
"2000","Edmonton, Alberta, municipal","48033","Total Drug violations","1572","1301","35","20.5","233.38","0","0","0","0","1336","1414","1654","240","20"
"2001","Edmonton, Alberta, municipal","48033","Total Drug violations","1075","1009","35","-32.55","157.42","0","0","0","0","1044","1149","1352","203","29"
"2002","Edmonton, Alberta, municipal","48033","Total Drug violations","967","930","23","-11.6","139.16","0","0","0","0","953","1001","1174","173","20"
"2003","Edmonton, Alberta, municipal","48033","Total Drug violations","1083","1025","28","10.74","154.11","0","0","0","0","1053","1058","1217","159","33"
"2004","Edmonton, Alberta, municipal","48033","Total Drug violations","1035","972","30","-6.79","143.64","183.2","189.41","253.19","63.3","1002","1041","1181","140","35"
"2005","Edmonton, Alberta, municipal","48033","Total Drug violations","1018","945","37","-3.87","138.07","171.09","171.71","178.26","68.42","982","999","1098","99","38"
"2006","Edmonton, Alberta, municipal","48033","Total Drug violations","1129","1091","34","7.74","148.75","187.85","189.04","201.81","69.65","1125","1134","1247","113","39"
"2007","Edmonton, Alberta, municipal","48033","Total Drug violations","1091","998","49","-5.87","140.01","162.94","167.4","217.08","69.97","1047","1014","1135","121","39"
"2008","Edmonton, Alberta, municipal","48033","Total Drug violations","1132","1020","51","1.36","141.92","163.25","171.11","261.78","57.77","1071","1043","1188","145","32"
"2009","Edmonton, Alberta, municipal","48033","Total Drug violations","1202","1052","85","3.55","146.97","178.99","181.48","211.31","83.8","1137","1176","1292","116","46"
"2010","Edmonton, Alberta, municipal","48033","Total Drug violations","1451","1286","78","18.79","174.58","228.53","229.68","243.74","38.49","1364","1527","1660","133","21"
"2011","Edmonton, Alberta, municipal","48033","Total Drug violations","1428","1332","68","-3.26","168.88","223.65","227.72","277.92","65.39","1400","1520","1673","153","36"
"2012","Edmonton, Alberta, municipal","48033","Total Drug violations","1501","1376","80","2.48","173.06","221.31","221.07","218.02","80.61","1456","1546","1665","119","44"
"2013","Edmonton, Alberta, municipal","48033","Total Drug violations","1748","1656","64","12.62","194.9","261.77","261.96","264.44","86.31","1720","1895","2039","144","47"
"2014","Edmonton, Alberta, municipal","48033","Total Drug violations","2136","2026","72","18.21","230.4","300.78","297.71","255.48","27.57","2098","2254","2393","139","15"
"2015","Edmonton, Alberta, municipal","48033","Total Drug violations","2130","2026","66","-2.44","224.78","291.27","284.63","191.78","38.36","2092","2229","2334","105","21"
"2016","Edmonton, Alberta, municipal","48033","Total Drug violations","2550","2378","94","17.06","263.14","339.99","328.72","170.57","55.66","2472","2657","2752","95","31"
"1998","Edmonton, Alberta, municipal","48033","Possession, cannabis","272","243","23","0","41.65","0","0","0","0","266","234","269","35","38"
"1999","Edmonton, Alberta, municipal","48033","Possession, cannabis","263","238","21","-4.82","39.64","0","0","0","0","259","246","284","38","16"
"2000","Edmonton, Alberta, municipal","48033","Possession, cannabis","534","315","28","100","79.28","0","0","0","0","343","292","360","68","16"
"2001","Edmonton, Alberta, municipal","48033","Possession, cannabis","302","254","28","-44.22","44.22","0","0","0","0","282","231","279","48","28"
"2002","Edmonton, Alberta, municipal","48033","Possession, cannabis","255","233","18","-17.02","36.7","0","0","0","0","251","204","259","55","18"
"2003","Edmonton, Alberta, municipal","48033","Possession, cannabis","200","175","25","-22.45","28.46","0","0","0","0","200","167","194","27","28"
"2004","Edmonton, Alberta, municipal","48033","Possession, cannabis","205","184","23","-0.03","28.45","28.51","32.24","70.53","61.49","207","162","201","39","34"
"2005","Edmonton, Alberta, municipal","48033","Possession, cannabis","156","127","26","-25.63","21.16","18.32","21.11","50.42","59.42","153","107","135","28","33"
"2006","Edmonton, Alberta, municipal","48033","Possession, cannabis","180","157","22","12.09","23.72","22.36","24.56","48.22","60.72","179","135","162","27","34"
"2007","Edmonton, Alberta, municipal","48033","Possession, cannabis","203","165","33","9.85","26.05","21.69","23.89","48.44","61","198","135","162","27","34"
"2008","Edmonton, Alberta, municipal","48033","Possession, cannabis","248","211","33","19.35","31.09","27.86","32.26","83.05","50.55","244","178","224","46","28"
"2009","Edmonton, Alberta, municipal","48033","Possession, cannabis","308","252","53","21.12","37.66","33.64","37.64","85.62","69.22","305","221","268","47","38"
"2010","Edmonton, Alberta, municipal","48033","Possession, cannabis","419","372","45","33.86","50.41","52.38","56.59","108.13","32.99","417","350","409","59","18"
"2011","Edmonton, Alberta, municipal","48033","Possession, cannabis","509","446","53","19.41","60.2","62.83","68.33","136.24","59.94","499","427","502","75","33"
"2012","Edmonton, Alberta, municipal","48033","Possession, cannabis","508","457","45","-2.7","58.57","62.27","67.72","137.41","80.61","502","435","510","75","44"
"2013","Edmonton, Alberta, municipal","48033","Possession, cannabis","594","532","54","13.08","66.23","74.32","78.76","137.73","86.31","586","538","613","75","47"
"2014","Edmonton, Alberta, municipal","48033","Possession, cannabis","691","627","59","12.54","74.53","82.33","86.46","143.36","22.06","686","617","695","78","12"
"2015","Edmonton, Alberta, municipal","48033","Possession, cannabis","563","495","57","-20.28","59.41","65.34","66.22","78.54","29.22","552","500","543","43","16"
"2016","Edmonton, Alberta, municipal","48033","Possession, cannabis","546","464","71","-5.17","56.34","59.76","60.08","64.64","43.09","535","467","503","36","24"
"1998","Edmonton, Alberta, municipal","48033","Possession, cocaine","120","117","2","0","18.37","0","0","0","0","119","117","136","19","0"
"1999","Edmonton, Alberta, municipal","48033","Possession, cocaine","106","99","1","-13.04","15.98","0","0","0","0","100","100","106","6","0"
"2000","Edmonton, Alberta, municipal","48033","Possession, cocaine","102","97","0","-5.22","15.14","0","0","0","0","97","97","102","5","0"
"2001","Edmonton, Alberta, municipal","48033","Possession, cocaine","83","79","0","-19.74","12.15","0","0","0","0","79","78","85","7","0"
"2002","Edmonton, Alberta, municipal","48033","Possession, cocaine","92","93","0","8.93","13.24","0","0","0","0","93","104","108","4","0"
"2003","Edmonton, Alberta, municipal","48033","Possession, cocaine","104","103","0","11.78","14.8","0","0","0","0","103","101","111","10","0"
"2004","Edmonton, Alberta, municipal","48033","Possession, cocaine","118","116","2","10.66","16.38","17.95","18.12","19.89","0","118","102","113","11","0"
"2005","Edmonton, Alberta, municipal","48033","Possession, cocaine","135","129","2","11.81","18.31","23.12","22.68","18.01","0","131","135","145","10","0"
"2006","Edmonton, Alberta, municipal","48033","Possession, cocaine","216","214","3","55.43","28.46","35.95","35.17","26.79","0","217","217","232","15","0"
"2007","Edmonton, Alberta, municipal","48033","Possession, cocaine","219","217","2","-1.24","28.11","33.42","32.15","17.94","0","219","208","218","10","0"
"2008","Edmonton, Alberta, municipal","48033","Possession, cocaine","180","173","4","-19.7","22.57","25.83","26.21","30.69","1.81","177","165","182","17","1"
"2009","Edmonton, Alberta, municipal","48033","Possession, cocaine","146","139","3","-20.9","17.85","22.98","21.35","1.82","0","142","151","152","1","0"
"2010","Edmonton, Alberta, municipal","48033","Possession, cocaine","174","165","3","17.27","20.93","26.64","25.18","7.33","0","168","178","182","4","0"
"2011","Edmonton, Alberta, municipal","48033","Possession, cocaine","167","162","5","-5.66","19.75","24.57","23.41","9.08","0","167","167","172","5","0"
"2012","Edmonton, Alberta, municipal","48033","Possession, cocaine","188","184","2","9.75","21.68","28.06","26.42","5.5","0","186","196","199","3","0"
"2013","Edmonton, Alberta, municipal","48033","Possession, cocaine","195","187","1","0.31","21.74","26.94","26.08","14.69","0","188","195","203","8","0"
"2014","Edmonton, Alberta, municipal","48033","Possession, cocaine","227","226","3","12.62","24.48","30.16","29.48","20.22","0","229","226","237","11","0"
"2015","Edmonton, Alberta, municipal","48033","Possession, cocaine","202","198","2","-12.94","21.32","26","25","10.96","0","200","199","205","6","0"
"2016","Edmonton, Alberta, municipal","48033","Possession, cocaine","240","234","4","16.18","24.77","31.48","29.5","1.8","0","238","246","247","1","0"
"1998","Edmonton, Alberta, municipal","48033","Total, possession, other Controlled Drugs and Substances Act drugs","77","78","0","0","11.79","0","0","0","0","78","82","86","4","0"
"1999","Edmonton, Alberta, municipal","48033","Total, possession, other Controlled Drugs and Substances Act drugs","65","62","0","-16.9","9.8","0","0","0","0","62","60","62","2","0"
"2000","Edmonton, Alberta, municipal","48033","Total, possession, other Controlled Drugs and Substances Act drugs","145","89","2","119.73","21.53","0","0","0","0","91","81","97","16","3"
"2001","Edmonton, Alberta, municipal","48033","Total, possession, other Controlled Drugs and Substances Act drugs","83","79","1","-43.54","12.15","0","0","0","0","80","65","79","14","0"
"2002","Edmonton, Alberta, municipal","48033","Total, possession, other Controlled Drugs and Substances Act drugs","74","74","1","-12.38","10.65","0","0","0","0","75","68","76","8","1"
"2003","Edmonton, Alberta, municipal","48033","Total, possession, other Controlled Drugs and Substances Act drugs","104","105","0","38.96","14.8","0","0","0","0","105","98","106","8","0"
"2004","Edmonton, Alberta, municipal","48033","Total, possession, other Controlled Drugs and Substances Act drugs","98","96","2","-8.1","13.6","16.19","15.56","9.04","1.81","98","92","97","5","1"
"2005","Edmonton, Alberta, municipal","48033","Total, possession, other Controlled Drugs and Substances Act drugs","118","116","2","17.68","16","17.47","17.05","12.6","9","118","102","109","7","5"
"2006","Edmonton, Alberta, municipal","48033","Total, possession, other Controlled Drugs and Substances Act drugs","145","134","6","19.37","19.1","17.39","18.19","26.79","8.93","140","105","120","15","5"
"2007","Edmonton, Alberta, municipal","48033","Total, possession, other Controlled Drugs and Substances Act drugs","101","94","6","-32.15","12.96","10.28","11.21","21.53","7.18","100","64","76","12","4"
"2008","Edmonton, Alberta, municipal","48033","Total, possession, other Controlled Drugs and Substances Act drugs","122","110","4","18.01","15.3","15.18","16.42","30.69","5.42","114","97","114","17","3"
"2009","Edmonton, Alberta, municipal","48033","Total, possession, other Controlled Drugs and Substances Act drugs","105","93","7","-16.07","12.84","11.87","13.34","30.97","5.46","100","78","95","17","3"
"2010","Edmonton, Alberta, municipal","48033","Total, possession, other Controlled Drugs and Substances Act drugs","164","145","9","53.69","19.73","22.9","22.55","18.33","1.83","154","153","163","10","1"
"2011","Edmonton, Alberta, municipal","48033","Total, possession, other Controlled Drugs and Substances Act drugs","130","126","1","-22.08","15.37","19.57","18.78","9.08","0","127","133","138","5","0"
"2012","Edmonton, Alberta, municipal","48033","Total, possession, other Controlled Drugs and Substances Act drugs","220","217","2","64.99","25.36","31.64","30.01","9.16","0","219","221","226","5","0"
"2013","Edmonton, Alberta, municipal","48033","Total, possession, other Controlled Drugs and Substances Act drugs","284","279","2","24.84","31.67","38.13","36.23","11.02","0","281","276","282","6","0"
"2014","Edmonton, Alberta, municipal","48033","Total, possession, other Controlled Drugs and Substances Act drugs","474","470","2","61.46","51.13","63.38","60.84","25.73","1.84","472","475","489","14","1"
"2015","Edmonton, Alberta, municipal","48033","Total, possession, other Controlled Drugs and Substances Act drugs","641","633","3","32.31","67.65","78.67","76.22","42.01","3.65","636","602","625","23","2"
"2016","Edmonton, Alberta, municipal","48033","Total, possession, other Controlled Drugs and Substances Act drugs","934","923","7","42.48","96.38","119.64","115.27","53.87","0","930","935","965","30","0"
"1998","Edmonton, Alberta, municipal","48033","Heroin, possession","3","3","0","0","0.46","0","0","0","0","3","3","3","0","0"
"1999","Edmonton, Alberta, municipal","48033","Heroin, possession","5","4","0","64.07","0.75","0","0","0","0","4","3","3","0","0"
"2000","Edmonton, Alberta, municipal","48033","Heroin, possession","6","4","1","18.2","0.89","0","0","0","0","5","4","4","0","3"
"2001","Edmonton, Alberta, municipal","48033","Heroin, possession","0","0","0","-100","0","0","0","0","0","0","0","0","0","0"
"2002","Edmonton, Alberta, municipal","48033","Heroin, possession","0","0","0","0","0","0","0","0","0","0","0","0","0","0"
"2003","Edmonton, Alberta, municipal","48033","Heroin, possession","1","1","0","0","0.14","0","0","0","0","1","1","1","0","0"
"2004","Edmonton, Alberta, municipal","48033","Heroin, possession","0","0","0","-100","0","0","0","0","0","0","0","0","0","0"
"2005","Edmonton, Alberta, municipal","48033","Heroin, possession","0","0","0","0","0","0","0","0","0","0","0","0","0","0"
"2006","Edmonton, Alberta, municipal","48033","Heroin, possession","11","11","0","0","1.45","1.82","1.82","1.79","0","11","11","12","1","0"
"2007","Edmonton, Alberta, municipal","48033","Heroin, possession","1","1","0","-91.15","0.13","0","0.15","1.79","0","1","0","1","1","0"
"2008","Edmonton, Alberta, municipal","48033","Heroin, possession","2","2","0","95.39","0.25","0.31","0.29","0","0","2","2","2","0","0"
"2009","Edmonton, Alberta, municipal","48033","Heroin, possession","2","2","0","-2.48","0.24","0.46","0.42","0","0","2","3","3","0","0"
"2010","Edmonton, Alberta, municipal","48033","Heroin, possession","0","0","0","-100","0","0","0","0","0","0","0","0","0","0"
"2011","Edmonton, Alberta, municipal","48033","Heroin, possession","0","0","0","0","0","0","0","0","0","0","0","0","0","0"
"2012","Edmonton, Alberta, municipal","48033","Heroin, possession","5","5","0","0","0.58","0.72","0.66","0","0","5","5","5","0","0"
"2013","Edmonton, Alberta, municipal","48033","Heroin, possession","1","1","0","-80.66","0.11","0","0.13","1.84","0","1","0","1","1","0"
"2014","Edmonton, Alberta, municipal","48033","Heroin, possession","10","8","1","867.41","1.08","1.2","1.12","0","0","9","9","9","0","0"
"2015","Edmonton, Alberta, municipal","48033","Heroin, possession","25","24","0","144.6","2.64","3.4","3.29","1.83","0","24","26","27","1","0"
"2016","Edmonton, Alberta, municipal","48033","Heroin, possession","37","37","1","44.72","3.82","5.12","4.78","0","0","38","40","40","0","0"
"1998","Edmonton, Alberta, municipal","48033","Other Controlled Drugs and Substances Act, possession","74","75","0","0","11.33","0","0","0","0","75","79","83","4","0"
"1999","Edmonton, Alberta, municipal","48033","Other Controlled Drugs and Substances Act, possession","60","58","0","-20.18","9.04","0","0","0","0","58","57","59","2","0"
"2000","Edmonton, Alberta, municipal","48033","Other Controlled Drugs and Substances Act, possession","139","85","1","128.19","20.64","0","0","0","0","86","77","93","16","0"
"2001","Edmonton, Alberta, municipal","48033","Other Controlled Drugs and Substances Act, possession","83","79","1","-41.1","12.15","0","0","0","0","80","65","79","14","0"
"2002","Edmonton, Alberta, municipal","48033","Other Controlled Drugs and Substances Act, possession","74","74","1","-12.38","10.65","0","0","0","0","75","68","76","8","1"
"2003","Edmonton, Alberta, municipal","48033","Other Controlled Drugs and Substances Act, possession","103","104","0","37.63","14.66","0","0","0","0","104","97","105","8","0"
"2004","Edmonton, Alberta, municipal","48033","Other Controlled Drugs and Substances Act, possession","98","96","2","-7.21","13.6","16.19","15.56","9.04","1.81","98","92","97","5","1"
"2005","Edmonton, Alberta, municipal","48033","Other Controlled Drugs and Substances Act, possession","118","116","2","17.68","16","17.47","17.05","12.6","9","118","102","109","7","5"
"2006","Edmonton, Alberta, municipal","48033","Other Controlled Drugs and Substances Act, possession","134","123","6","10.31","17.66","15.57","16.37","25","8.93","129","94","108","14","5"
"2007","Edmonton, Alberta, municipal","48033","Other Controlled Drugs and Substances Act, possession","100","93","6","-27.31","12.83","10.28","11.06","19.73","7.18","99","64","75","11","4"
"2008","Edmonton, Alberta, municipal","48033","Other Controlled Drugs and Substances Act, possession","102","91","4","-0.35","12.79","12.83","13.68","23.47","5.42","95","82","95","13","3"
"2009","Edmonton, Alberta, municipal","48033","Other Controlled Drugs and Substances Act, possession","63","51","7","-39.77","7.7","7.31","7.44","9.11","3.64","58","48","53","5","2"
"2010","Edmonton, Alberta, municipal","48033","Other Controlled Drugs and Substances Act, possession","81","68","6","26.52","9.75","10.48","10.52","11","1.83","74","70","76","6","1"
"2011","Edmonton, Alberta, municipal","48033","Other Controlled Drugs and Substances Act, possession","48","46","0","-41.75","5.68","7.06","6.67","1.82","0","46","48","49","1","0"
"2012","Edmonton, Alberta, municipal","48033","Other Controlled Drugs and Substances Act, possession","82","83","0","66.55","9.45","11.6","11.42","9.16","0","83","81","86","5","0"
"2013","Edmonton, Alberta, municipal","48033","Other Controlled Drugs and Substances Act, possession","85","84","0","0.24","9.48","11.6","11.31","7.35","0","84","84","88","4","0"
"2014","Edmonton, Alberta, municipal","48033","Other Controlled Drugs and Substances Act, possession","121","121","1","37.71","13.05","16.01","15.55","9.19","1.84","122","120","125","5","1"
"2015","Edmonton, Alberta, municipal","48033","Other Controlled Drugs and Substances Act, possession","113","111","0","-8.63","11.93","14.9","14.27","5.48","0","111","114","117","3","0"
"2016","Edmonton, Alberta, municipal","48033","Other Controlled Drugs and Substances Act, possession","192","192","0","66.14","19.81","26.49","25.56","12.57","0","192","207","214","7","0"
"2005","Edmonton, Alberta, municipal","48033","Methamphetamines (crystal meth), possession","0","0","0","0","0","0","0","0","0","0","0","0","0","0"
"2006","Edmonton, Alberta, municipal","48033","Methamphetamines (crystal meth), possession","0","0","0","0","0","0","0","0","0","0","0","0","0","0"
"2007","Edmonton, Alberta, municipal","48033","Methamphetamines (crystal meth), possession","0","0","0","0","0","0","0","0","0","0","0","0","0","0"
"2008","Edmonton, Alberta, municipal","48033","Methamphetamines (crystal meth), possession","9","8","0","0","1.13","1.25","1.15","0","0","8","8","8","0","0"
"2009","Edmonton, Alberta, municipal","48033","Methamphetamines (crystal meth), possession","19","19","0","105.88","2.32","2.74","2.53","0","0","19","18","18","0","0"
"2010","Edmonton, Alberta, municipal","48033","Methamphetamines (crystal meth), possession","67","63","2","246.99","8.06","10.48","9.96","3.67","0","65","70","72","2","0"
"2011","Edmonton, Alberta, municipal","48033","Methamphetamines (crystal meth), possession","75","74","0","10.03","8.87","11.92","11.3","3.63","0","74","81","83","2","0"
"2012","Edmonton, Alberta, municipal","48033","Methamphetamines (crystal meth), possession","127","124","1","65.09","14.64","18.47","17.13","0","0","125","129","129","0","0"
"2013","Edmonton, Alberta, municipal","48033","Methamphetamines (crystal meth), possession","189","185","2","43.92","21.07","25.28","23.64","1.84","0","187","183","184","1","0"
"2014","Edmonton, Alberta, municipal","48033","Methamphetamines (crystal meth), possession","337","335","0","72.5","36.35","45.5","43.54","16.54","0","335","341","350","9","0"
"2015","Edmonton, Alberta, municipal","48033","Methamphetamines (crystal meth), possession","493","488","3","43.13","52.03","59.07","57.44","34.7","3.65","491","452","471","19","2"
"2016","Edmonton, Alberta, municipal","48033","Methamphetamines (crystal meth), possession","696","688","4","38.05","71.82","87.53","84.45","41.3","0","692","684","707","23","0"
"2005","Edmonton, Alberta, municipal","48033","Methylenedioxyamphetamine (ecstasy), possession","0","0","0","0","0","0","0","0","0","0","0","0","0","0"
"2006","Edmonton, Alberta, municipal","48033","Methylenedioxyamphetamine (ecstasy), possession","0","0","0","0","0","0","0","0","0","0","0","0","0","0"
"2007","Edmonton, Alberta, municipal","48033","Methylenedioxyamphetamine (ecstasy), possession","0","0","0","0","0","0","0","0","0","0","0","0","0","0"
"2008","Edmonton, Alberta, municipal","48033","Methylenedioxyamphetamine (ecstasy), possession","9","9","0","0","1.13","0.78","1.3","7.22","0","9","5","9","4","0"
"2009","Edmonton, Alberta, municipal","48033","Methylenedioxyamphetamine (ecstasy), possession","21","21","0","127.55","2.57","1.37","2.95","21.86","1.82","21","9","21","12","1"
"2010","Edmonton, Alberta, municipal","48033","Methylenedioxyamphetamine (ecstasy), possession","16","14","1","-25.03","1.93","1.95","2.08","3.67","0","15","13","15","2","0"
"2011","Edmonton, Alberta, municipal","48033","Methylenedioxyamphetamine (ecstasy), possession","7","6","1","-57","0.83","0.59","0.82","3.63","0","7","4","6","2","0"
"2012","Edmonton, Alberta, municipal","48033","Methylenedioxyamphetamine (ecstasy), possession","6","5","1","-16.44","0.69","0.86","0.8","0","0","6","6","6","0","0"
"2013","Edmonton, Alberta, municipal","48033","Methylenedioxyamphetamine (ecstasy), possession","9","9","0","45.06","1","1.24","1.16","0","0","9","9","9","0","0"
"2014","Edmonton, Alberta, municipal","48033","Methylenedioxyamphetamine (ecstasy), possession","6","6","0","-35.51","0.65","0.67","0.62","0","0","6","5","5","0","0"
"2015","Edmonton, Alberta, municipal","48033","Methylenedioxyamphetamine (ecstasy), possession","10","10","0","63.07","1.06","1.31","1.22","0","0","10","10","10","0","0"
"2016","Edmonton, Alberta, municipal","48033","Methylenedioxyamphetamine (ecstasy), possession","9","6","2","-12","0.93","0.51","0.48","0","0","8","4","4","0","0"
"1998","Edmonton, Alberta, municipal","48033","Total cannabis, trafficking, production or distribution","158","141","2","0","24.19","0","0","0","0","143","151","166","15","1"
"1999","Edmonton, Alberta, municipal","48033","Total cannabis, trafficking, production or distribution","180","163","4","12.15","27.13","0","0","0","0","167","195","213","18","2"
"2000","Edmonton, Alberta, municipal","48033","Total cannabis, trafficking, production or distribution","260","203","2","42.28","38.6","0","0","0","0","205","244","273","29","1"
"2001","Edmonton, Alberta, municipal","48033","Total cannabis, trafficking, production or distribution","148","142","3","-43.85","21.67","0","0","0","0","145","187","229","42","0"
"2002","Edmonton, Alberta, municipal","48033","Total cannabis, trafficking, production or distribution","138","133","2","-8.36","19.86","0","0","0","0","135","157","178","21","1"
"2003","Edmonton, Alberta, municipal","48033","Total cannabis, trafficking, production or distribution","160","139","2","14.64","22.77","0","0","0","0","141","168","207","39","4"
"2004","Edmonton, Alberta, municipal","48033","Total cannabis, trafficking, production or distribution","161","143","0","-1.86","22.34","32.03","32.72","39.79","0","143","182","204","22","0"
"2005","Edmonton, Alberta, municipal","48033","Total cannabis, trafficking, production or distribution","111","108","1","-32.62","15.06","23.29","22.99","19.81","0","109","136","147","11","0"
"2006","Edmonton, Alberta, municipal","48033","Total cannabis, trafficking, production or distribution","83","73","1","-27.36","10.94","15.24","15.61","19.65","0","74","92","103","11","0"
"2007","Edmonton, Alberta, municipal","48033","Total cannabis, trafficking, production or distribution","67","65","2","-21.37","8.6","13.98","14.16","16.15","0","67","87","96","9","0"
"2008","Edmonton, Alberta, municipal","48033","Total cannabis, trafficking, production or distribution","108","89","3","57.48","13.54","17.69","19.16","36.11","0","92","113","133","20","0"
"2009","Edmonton, Alberta, municipal","48033","Total cannabis, trafficking, production or distribution","147","127","15","32.74","17.97","24.5","25.99","43.72","0","142","161","185","24","0"
"2010","Edmonton, Alberta, municipal","48033","Total cannabis, trafficking, production or distribution","184","153","13","23.17","22.14","29.03","31.41","60.48","3.67","166","194","227","33","2"
"2011","Edmonton, Alberta, municipal","48033","Total cannabis, trafficking, production or distribution","191","185","2","2.03","22.59","32.37","36.07","81.74","5.45","187","220","265","45","3"
"2012","Edmonton, Alberta, municipal","48033","Total cannabis, trafficking, production or distribution","121","114","2","-38.24","13.95","19.18","20.71","40.31","0","116","134","156","22","0"
"2013","Edmonton, Alberta, municipal","48033","Total cannabis, trafficking, production or distribution","132","124","3","5.5","14.72","21.69","23.13","42.24","0","127","157","180","23","0"
"2014","Edmonton, Alberta, municipal","48033","Total cannabis, trafficking, production or distribution","153","149","3","12.13","16.5","24.42","24.88","31.25","3.68","152","183","200","17","2"
"2015","Edmonton, Alberta, municipal","48033","Total cannabis, trafficking, production or distribution","108","100","2","-30.94","11.4","16.33","16.71","21.92","5.48","102","125","137","12","3"
"2016","Edmonton, Alberta, municipal","48033","Total cannabis, trafficking, production or distribution","107","105","2","-3.12","11.04","17.4","17.2","14.36","1.8","107","136","144","8","1"
"1998","Edmonton, Alberta, municipal","48033","Cannabis, trafficking","143","134","2","0","21.89","0","0","0","0","136","143","158","15","1"
"1999","Edmonton, Alberta, municipal","48033","Cannabis, trafficking","167","159","2","14.96","25.17","0","0","0","0","161","189","207","18","2"
"2000","Edmonton, Alberta, municipal","48033","Cannabis, trafficking","198","202","0","16.79","29.4","0","0","0","0","202","243","272","29","1"
"2001","Edmonton, Alberta, municipal","48033","Cannabis, trafficking","139","139","2","-30.76","20.35","0","0","0","0","141","184","225","41","0"
"2002","Edmonton, Alberta, municipal","48033","Cannabis, trafficking","135","131","1","-4.55","19.43","0","0","0","0","132","155","176","21","1"
"2003","Edmonton, Alberta, municipal","48033","Cannabis, trafficking","151","139","2","10.6","21.49","0","0","0","0","141","168","207","39","4"
"2004","Edmonton, Alberta, municipal","48033","Cannabis, trafficking","156","143","0","0.76","21.65","32.03","32.72","39.79","0","143","182","204","22","0"
"2005","Edmonton, Alberta, municipal","48033","Cannabis, trafficking","107","106","1","-32.97","14.51","22.95","22.68","19.81","0","107","134","145","11","0"
"2006","Edmonton, Alberta, municipal","48033","Cannabis, trafficking","70","67","0","-36.45","9.22","13.75","14.25","19.65","0","67","83","94","11","0"
"2007","Edmonton, Alberta, municipal","48033","Cannabis, trafficking","60","62","0","-16.51","7.7","13.34","13.57","16.15","0","62","83","92","9","0"
"2008","Edmonton, Alberta, municipal","48033","Cannabis, trafficking","90","85","0","46.54","11.28","16.9","18.44","36.11","0","85","108","128","20","0"
"2009","Edmonton, Alberta, municipal","48033","Cannabis, trafficking","127","122","4","37.62","15.53","23.59","25.14","43.72","0","126","155","179","24","0"
"2010","Edmonton, Alberta, municipal","48033","Cannabis, trafficking","158","149","3","22.42","19.01","27.54","30.02","60.48","3.67","152","184","217","33","2"
"2011","Edmonton, Alberta, municipal","48033","Cannabis, trafficking","184","180","2","14.47","21.76","31.49","35.25","81.74","5.45","182","214","259","45","3"
"2012","Edmonton, Alberta, municipal","48033","Cannabis, trafficking","113","111","1","-40.13","13.03","18.75","20.31","40.31","0","112","131","153","22","0"
"2013","Edmonton, Alberta, municipal","48033","Cannabis, trafficking","124","119","3","6.12","13.83","20.72","22.23","42.24","0","122","150","173","23","0"
"2014","Edmonton, Alberta, municipal","48033","Cannabis, trafficking","150","147","3","17.03","16.18","24.02","24.51","31.25","3.68","150","180","197","17","2"
"2015","Edmonton, Alberta, municipal","48033","Cannabis, trafficking","104","97","2","-32.16","10.98","15.94","16.34","21.92","5.48","99","122","134","12","3"
"2016","Edmonton, Alberta, municipal","48033","Cannabis, trafficking","105","103","1","-1.28","10.84","17.27","17.08","14.36","1.8","104","135","143","8","1"
"1998","Edmonton, Alberta, municipal","48033","Cannabis, importation and exportation","0","0","0","0","0","0","0","0","0","0","0","0","0","0"
"1999","Edmonton, Alberta, municipal","48033","Cannabis, importation and exportation","0","0","0","0","0","0","0","0","0","0","0","0","0","0"
"2000","Edmonton, Alberta, municipal","48033","Cannabis, importation and exportation","0","0","0","0","0","0","0","0","0","0","0","0","0","0"
"2001","Edmonton, Alberta, municipal","48033","Cannabis, importation and exportation","1","0","0","0","0.15","0","0","0","0","0","0","0","0","0"
"2002","Edmonton, Alberta, municipal","48033","Cannabis, importation and exportation","0","0","0","-100","0","0","0","0","0","0","0","0","0","0"
"2003","Edmonton, Alberta, municipal","48033","Cannabis, importation and exportation","6","0","0","0","0.85","0","0","0","0","0","0","0","0","0"
"2004","Edmonton, Alberta, municipal","48033","Cannabis, importation and exportation","0","0","0","-100","0","0","0","0","0","0","0","0","0","0"
"2005","Edmonton, Alberta, municipal","48033","Cannabis, importation and exportation","0","0","0","0","0","0","0","0","0","0","0","0","0","0"
"2006","Edmonton, Alberta, municipal","48033","Cannabis, importation and exportation","0","0","0","0","0","0","0","0","0","0","0","0","0","0"
"2007","Edmonton, Alberta, municipal","48033","Cannabis, importation and exportation","0","0","0","0","0","0","0","0","0","0","0","0","0","0"
"2008","Edmonton, Alberta, municipal","48033","Cannabis, importation and exportation","1","0","0","0","0.13","0","0","0","0","0","0","0","0","0"
"2009","Edmonton, Alberta, municipal","48033","Cannabis, importation and exportation","0","0","0","-100","0","0","0","0","0","0","0","0","0","0"
"2010","Edmonton, Alberta, municipal","48033","Cannabis, importation and exportation","0","0","0","0","0","0","0","0","0","0","0","0","0","0"
"2011","Edmonton, Alberta, municipal","48033","Cannabis, importation and exportation","1","0","0","0","0.12","0","0","0","0","0","0","0","0","0"
"2012","Edmonton, Alberta, municipal","48033","Cannabis, importation and exportation","4","0","1","289.97","0.46","0","0","0","0","1","0","0","0","0"
"2013","Edmonton, Alberta, municipal","48033","Cannabis, importation and exportation","2","0","0","-51.65","0.22","0","0","0","0","0","0","0","0","0"
"2014","Edmonton, Alberta, municipal","48033","Cannabis, importation and exportation","0","0","0","-100","0","0","0","0","0","0","0","0","0","0"
"2015","Edmonton, Alberta, municipal","48033","Cannabis, importation and exportation","1","0","0","0","0.11","0","0","0","0","0","0","0","0","0"
"2016","Edmonton, Alberta, municipal","48033","Cannabis, importation and exportation","0","0","0","-100","0","0","0","0","0","0","0","0","0","0"
"1998","Edmonton, Alberta, municipal","48033","Cannabis, production","15","7","0","0","2.3","0","0","0","0","7","8","8","0","0"
"1999","Edmonton, Alberta, municipal","48033","Cannabis, production","13","4","2","-14.68","1.96","0","0","0","0","6","6","6","0","0"
"2000","Edmonton, Alberta, municipal","48033","Cannabis, production","62","1","2","369.77","9.2","0","0","0","0","3","1","1","0","0"
"2001","Edmonton, Alberta, municipal","48033","Cannabis, production","8","3","1","-87.27","1.17","0","0","0","0","4","3","4","1","0"
"2002","Edmonton, Alberta, municipal","48033","Cannabis, production","3","2","1","-63.15","0.43","0","0","0","0","3","2","2","0","0"
"2003","Edmonton, Alberta, municipal","48033","Cannabis, production","3","0","0","-1.12","0.43","0","0","0","0","0","0","0","0","0"
"2004","Edmonton, Alberta, municipal","48033","Cannabis, production","5","0","0","62.55","0.69","0","0","0","0","0","0","0","0","0"
"2005","Edmonton, Alberta, municipal","48033","Cannabis, production","4","2","0","-21.81","0.54","0.34","0.31","0","0","2","2","2","0","0"
"2006","Edmonton, Alberta, municipal","48033","Cannabis, production","13","6","1","215.71","1.71","1.49","1.36","0","0","7","9","9","0","0"
"2007","Edmonton, Alberta, municipal","48033","Cannabis, production","7","3","2","-47.55","0.9","0.64","0.59","0","0","5","4","4","0","0"
"2008","Edmonton, Alberta, municipal","48033","Cannabis, production","17","4","3","137.25","2.13","0.78","0.72","0","0","7","5","5","0","0"
"2009","Edmonton, Alberta, municipal","48033","Cannabis, production","20","5","11","14.73","2.45","0.91","0.84","0","0","16","6","6","0","0"
"2010","Edmonton, Alberta, municipal","48033","Cannabis, production","26","4","10","27.92","3.13","1.5","1.38","0","0","14","10","10","0","0"
"2011","Edmonton, Alberta, municipal","48033","Cannabis, production","6","5","0","-77.32","0.71","0.88","0.82","0","0","5","6","6","0","0"
"2012","Edmonton, Alberta, municipal","48033","Cannabis, production","4","3","0","-35.01","0.46","0.43","0.4","0","0","3","3","3","0","0"
"2013","Edmonton, Alberta, municipal","48033","Cannabis, production","6","5","0","45.06","0.67","0.97","0.9","0","0","5","7","7","0","0"
"2014","Edmonton, Alberta, municipal","48033","Cannabis, production","3","2","0","-51.63","0.32","0.4","0.37","0","0","2","3","3","0","0"
"2015","Edmonton, Alberta, municipal","48033","Cannabis, production","3","3","0","-2.16","0.32","0.39","0.37","0","0","3","3","3","0","0"
"2016","Edmonton, Alberta, municipal","48033","Cannabis, production","2","2","1","-34.81","0.21","0.13","0.12","0","0","3","1","1","0","0"
"1998","Edmonton, Alberta, municipal","48033","Total cocaine, trafficking, production or distribution","427","407","2","0","65.38","0","0","0","0","409","430","534","104","0"
"1999","Edmonton, Alberta, municipal","48033","Total cocaine, trafficking, production or distribution","549","537","5","26.57","82.75","0","0","0","0","542","607","755","148","0"
"2000","Edmonton, Alberta, municipal","48033","Total cocaine, trafficking, production or distribution","414","475","2","-25.72","61.46","0","0","0","0","477","547","656","109","0"
"2001","Edmonton, Alberta, municipal","48033","Total cocaine, trafficking, production or distribution","327","329","1","-22.09","47.88","0","0","0","0","330","430","502","72","1"
"2002","Edmonton, Alberta, municipal","48033","Total cocaine, trafficking, production or distribution","323","320","2","-2.93","46.48","0","0","0","0","322","364","439","75","0"
"2003","Edmonton, Alberta, municipal","48033","Total cocaine, trafficking, production or distribution","387","382","1","18.47","55.07","0","0","0","0","383","355","416","61","1"
"2004","Edmonton, Alberta, municipal","48033","Total cocaine, trafficking, production or distribution","353","335","3","-11.04","48.99","68.63","72.17","108.51","0","338","390","450","60","0"
"2005","Edmonton, Alberta, municipal","48033","Total cocaine, trafficking, production or distribution","412","387","6","14.07","55.88","71.76","71.94","73.83","0","393","419","460","41","0"
"2006","Edmonton, Alberta, municipal","48033","Total cocaine, trafficking, production or distribution","420","428","2","-0.97","55.34","80.18","79.28","69.65","0","430","484","523","39","0"
"2007","Edmonton, Alberta, municipal","48033","Total cocaine, trafficking, production or distribution","451","414","4","4.59","57.88","76.17","77.28","89.7","0","418","474","524","50","0"
"2008","Edmonton, Alberta, municipal","48033","Total cocaine, trafficking, production or distribution","399","373","6","-13.57","50.02","63.39","63.66","66.8","0","379","405","442","37","0"
"2009","Edmonton, Alberta, municipal","48033","Total cocaine, trafficking, production or distribution","404","375","3","-1.25","49.4","71.53","68.69","34.61","0","378","470","489","19","0"
"2010","Edmonton, Alberta, municipal","48033","Total cocaine, trafficking, production or distribution","414","380","6","0.84","49.81","80.97","78.45","47.65","0","386","541","567","26","0"
"2011","Edmonton, Alberta, municipal","48033","Total cocaine, trafficking, production or distribution","353","348","3","-16.19","41.75","69.16","67.1","41.78","0","351","470","493","23","0"
"2012","Edmonton, Alberta, municipal","48033","Total cocaine, trafficking, production or distribution","373","329","20","3.02","43","63.42","60.41","21.98","0","349","443","455","12","0"
"2013","Edmonton, Alberta, municipal","48033","Total cocaine, trafficking, production or distribution","378","381","2","-2","42.15","67.96","65.78","36.73","0","383","492","512","20","0"
"2014","Edmonton, Alberta, municipal","48033","Total cocaine, trafficking, production or distribution","314","294","1","-19.64","33.87","53.51","51.75","27.57","0","295","401","416","15","0"
"2015","Edmonton, Alberta, municipal","48033","Total cocaine, trafficking, production or distribution","285","278","1","-11.2","30.08","50.7","48.54","18.26","0","279","388","398","10","0"
"2016","Edmonton, Alberta, municipal","48033","Total cocaine, trafficking, production or distribution","319","292","4","9.45","32.92","48.11","46.35","21.55","0","296","376","388","12","0"
"1998","Edmonton, Alberta, municipal","48033","Cocaine, trafficking","424","407","1","0","64.92","0","0","0","0","408","430","534","104","0"
"1999","Edmonton, Alberta, municipal","48033","Cocaine, trafficking","549","537","5","27.46","82.75","0","0","0","0","542","607","755","148","0"
"2000","Edmonton, Alberta, municipal","48033","Cocaine, trafficking","413","474","2","-25.9","61.31","0","0","0","0","476","546","654","108","0"
"2001","Edmonton, Alberta, municipal","48033","Cocaine, trafficking","327","329","1","-21.91","47.88","0","0","0","0","330","430","502","72","1"
"2002","Edmonton, Alberta, municipal","48033","Cocaine, trafficking","323","320","2","-2.93","46.48","0","0","0","0","322","364","439","75","0"
"2003","Edmonton, Alberta, municipal","48033","Cocaine, trafficking","387","382","1","18.47","55.07","0","0","0","0","383","355","416","61","1"
"2004","Edmonton, Alberta, municipal","48033","Cocaine, trafficking","352","335","3","-11.29","48.85","68.63","72.17","108.51","0","338","390","450","60","0"
"2005","Edmonton, Alberta, municipal","48033","Cocaine, trafficking","412","387","6","14.39","55.88","71.76","71.94","73.83","0","393","419","460","41","0"
"2006","Edmonton, Alberta, municipal","48033","Cocaine, trafficking","420","428","2","-0.97","55.34","80.18","79.28","69.65","0","430","484","523","39","0"
"2007","Edmonton, Alberta, municipal","48033","Cocaine, trafficking","450","414","4","4.36","57.75","76.17","77.28","89.7","0","418","474","524","50","0"
"2008","Edmonton, Alberta, municipal","48033","Cocaine, trafficking","399","373","6","-13.38","50.02","63.39","63.66","66.8","0","379","405","442","37","0"
"2009","Edmonton, Alberta, municipal","48033","Cocaine, trafficking","401","374","3","-1.99","49.03","71.23","68.41","34.61","0","377","468","487","19","0"
"2010","Edmonton, Alberta, municipal","48033","Cocaine, trafficking","412","378","6","1.1","49.57","79.92","77.48","47.65","0","384","534","560","26","0"
"2011","Edmonton, Alberta, municipal","48033","Cocaine, trafficking","348","344","2","-16.98","41.15","68.42","66.42","41.78","0","346","465","488","23","0"
"2012","Edmonton, Alberta, municipal","48033","Cocaine, trafficking","370","327","20","3.65","42.66","63.13","60.15","21.98","0","347","441","453","12","0"
"2013","Edmonton, Alberta, municipal","48033","Cocaine, trafficking","378","381","2","-1.2","42.15","67.96","65.78","36.73","0","383","492","512","20","0"
"2014","Edmonton, Alberta, municipal","48033","Cocaine, trafficking","311","292","1","-20.41","33.55","52.98","51.26","27.57","0","293","397","412","15","0"
"2015","Edmonton, Alberta, municipal","48033","Cocaine, trafficking","284","278","1","-10.65","29.97","50.7","48.54","18.26","0","279","388","398","10","0"
"2016","Edmonton, Alberta, municipal","48033","Cocaine, trafficking","319","292","4","9.83","32.92","48.11","46.35","21.55","0","296","376","388","12","0"
"1998","Edmonton, Alberta, municipal","48033","Cocaine, importation and exportation","3","0","1","0","0.46","0","0","0","0","1","0","0","0","0"
"1999","Edmonton, Alberta, municipal","48033","Cocaine, importation and exportation","0","0","0","-100","0","0","0","0","0","0","0","0","0","0"
"2000","Edmonton, Alberta, municipal","48033","Cocaine, importation and exportation","1","1","0","0","0.15","0","0","0","0","1","1","2","1","0"
"2001","Edmonton, Alberta, municipal","48033","Cocaine, importation and exportation","0","0","0","-100","0","0","0","0","0","0","0","0","0","0"
"2002","Edmonton, Alberta, municipal","48033","Cocaine, importation and exportation","0","0","0","0","0","0","0","0","0","0","0","0","0","0"
"2003","Edmonton, Alberta, municipal","48033","Cocaine, importation and exportation","0","0","0","0","0","0","0","0","0","0","0","0","0","0"
"2004","Edmonton, Alberta, municipal","48033","Cocaine, importation and exportation","1","0","0","0","0.14","0","0","0","0","0","0","0","0","0"
"2005","Edmonton, Alberta, municipal","48033","Cocaine, importation and exportation","0","0","0","-100","0","0","0","0","0","0","0","0","0","0"
"2006","Edmonton, Alberta, municipal","48033","Cocaine, importation and exportation","0","0","0","0","0","0","0","0","0","0","0","0","0","0"
"2007","Edmonton, Alberta, municipal","48033","Cocaine, importation and exportation","1","0","0","0","0.13","0","0","0","0","0","0","0","0","0"
"2008","Edmonton, Alberta, municipal","48033","Cocaine, importation and exportation","0","0","0","-100","0","0","0","0","0","0","0","0","0","0"
"2009","Edmonton, Alberta, municipal","48033","Cocaine, importation and exportation","1","0","0","0","0.12","0","0","0","0","0","0","0","0","0"
"2010","Edmonton, Alberta, municipal","48033","Cocaine, importation and exportation","1","0","0","-1.6","0.12","0","0","0","0","0","0","0","0","0"
"2011","Edmonton, Alberta, municipal","48033","Cocaine, importation and exportation","2","1","1","96.59","0.24","0.15","0.14","0","0","2","1","1","0","0"
"2012","Edmonton, Alberta, municipal","48033","Cocaine, importation and exportation","1","0","0","-51.25","0.12","0","0","0","0","0","0","0","0","0"
"2013","Edmonton, Alberta, municipal","48033","Cocaine, importation and exportation","0","0","0","-100","0","0","0","0","0","0","0","0","0","0"
"2014","Edmonton, Alberta, municipal","48033","Cocaine, importation and exportation","1","0","0","0","0.11","0","0","0","0","0","0","0","0","0"
"2015","Edmonton, Alberta, municipal","48033","Cocaine, importation and exportation","1","0","0","-2.16","0.11","0","0","0","0","0","0","0","0","0"
"2016","Edmonton, Alberta, municipal","48033","Cocaine, importation and exportation","0","0","0","-100","0","0","0","0","0","0","0","0","0","0"
"2005","Edmonton, Alberta, municipal","48033","Cocaine, production","0","0","0","0","0","0","0","0","0","0","0","0","0","0"
"2006","Edmonton, Alberta, municipal","48033","Cocaine, production","0","0","0","0","0","0","0","0","0","0","0","0","0","0"
"2007","Edmonton, Alberta, municipal","48033","Cocaine, production","0","0","0","0","0","0","0","0","0","0","0","0","0","0"
"2008","Edmonton, Alberta, municipal","48033","Cocaine, production","0","0","0","0","0","0","0","0","0","0","0","0","0","0"
"2009","Edmonton, Alberta, municipal","48033","Cocaine, production","2","1","0","0","0.24","0.3","0.28","0","0","1","2","2","0","0"
"2010","Edmonton, Alberta, municipal","48033","Cocaine, production","1","2","0","-50.8","0.12","1.05","0.97","0","0","2","7","7","0","0"
"2011","Edmonton, Alberta, municipal","48033","Cocaine, production","3","3","0","194.88","0.35","0.59","0.54","0","0","3","4","4","0","0"
"2012","Edmonton, Alberta, municipal","48033","Cocaine, production","2","2","0","-35.01","0.23","0.29","0.27","0","0","2","2","2","0","0"
"2013","Edmonton, Alberta, municipal","48033","Cocaine, production","0","0","0","-100","0","0","0","0","0","0","0","0","0","0"
"2014","Edmonton, Alberta, municipal","48033","Cocaine, production","2","2","0","0","0.22","0.53","0.5","0","0","2","4","4","0","0"
"2015","Edmonton, Alberta, municipal","48033","Cocaine, production","0","0","0","-100","0","0","0","0","0","0","0","0","0","0"
"2016","Edmonton, Alberta, municipal","48033","Cocaine, production","0","0","0","0","0","0","0","0","0","0","0","0","0","0"
"1998","Edmonton, Alberta, municipal","48033","Total other Controlled Drugs and Substances Act drugs, trafficking, production or distribution","119","107","1","0","18.22","0","0","0","0","108","121","147","26","0"
"1999","Edmonton, Alberta, municipal","48033","Total other Controlled Drugs and Substances Act drugs, trafficking, production or distribution","122","120","3","0.92","18.39","0","0","0","0","123","110","115","5","0"
"2000","Edmonton, Alberta, municipal","48033","Total other Controlled Drugs and Substances Act drugs, trafficking, production or distribution","117","122","1","-5.54","17.37","0","0","0","0","123","153","166","13","0"
"2001","Edmonton, Alberta, municipal","48033","Total other Controlled Drugs and Substances Act drugs, trafficking, production or distribution","132","126","2","11.28","19.33","0","0","0","0","128","158","178","20","0"
"2002","Edmonton, Alberta, municipal","48033","Total other Controlled Drugs and Substances Act drugs, trafficking, production or distribution","85","77","0","-36.72","12.23","0","0","0","0","77","104","114","10","0"
"2003","Edmonton, Alberta, municipal","48033","Total other Controlled Drugs and Substances Act drugs, trafficking, production or distribution","128","121","0","48.9","18.21","0","0","0","0","121","169","183","14","0"
"2004","Edmonton, Alberta, municipal","48033","Total other Controlled Drugs and Substances Act drugs, trafficking, production or distribution","100","98","0","-23.81","13.88","19.89","18.6","5.43","0","98","113","116","3","0"
"2005","Edmonton, Alberta, municipal","48033","Total other Controlled Drugs and Substances Act drugs, trafficking, production or distribution","86","78","0","-15.95","11.66","17.13","15.95","3.6","0","78","100","102","2","0"
"2006","Edmonton, Alberta, municipal","48033","Total other Controlled Drugs and Substances Act drugs, trafficking, production or distribution","85","85","0","-3.99","11.2","16.73","16.22","10.72","0","85","101","107","6","0"
"2007","Edmonton, Alberta, municipal","48033","Total other Controlled Drugs and Substances Act drugs, trafficking, production or distribution","50","43","2","-42.7","6.42","7.39","8.7","23.32","1.79","45","46","59","13","1"
"2008","Edmonton, Alberta, municipal","48033","Total other Controlled Drugs and Substances Act drugs, trafficking, production or distribution","75","64","1","46.54","9.4","13.3","13.39","14.44","0","65","85","93","8","0"
"2009","Edmonton, Alberta, municipal","48033","Total other Controlled Drugs and Substances Act drugs, trafficking, production or distribution","92","66","4","19.63","11.25","14.46","14.47","14.57","9.11","70","95","103","8","5"
"2010","Edmonton, Alberta, municipal","48033","Total other Controlled Drugs and Substances Act drugs, trafficking, production or distribution","96","71","2","2.68","11.55","16.61","15.5","1.83","0","73","111","112","1","0"
"2011","Edmonton, Alberta, municipal","48033","Total other Controlled Drugs and Substances Act drugs, trafficking, production or distribution","78","65","4","-20.14","9.22","15.16","14.02","0","0","69","103","103","0","0"
"2012","Edmonton, Alberta, municipal","48033","Total other Controlled Drugs and Substances Act drugs, trafficking, production or distribution","91","75","9","13.74","10.49","16.75","15.8","3.66","0","84","117","119","2","0"
"2013","Edmonton, Alberta, municipal","48033","Total other Controlled Drugs and Substances Act drugs, trafficking, production or distribution","164","153","2","74.28","18.29","32.74","31.99","22.04","0","155","237","249","12","0"
"2014","Edmonton, Alberta, municipal","48033","Total other Controlled Drugs and Substances Act drugs, trafficking, production or distribution","277","260","4","63.4","29.88","46.97","44.29","7.35","0","264","352","356","4","0"
"2015","Edmonton, Alberta, municipal","48033","Total other Controlled Drugs and Substances Act drugs, trafficking, production or distribution","330","322","1","16.56","34.83","54.23","51.95","20.09","0","323","415","426","11","0"
"2016","Edmonton, Alberta, municipal","48033","Total other Controlled Drugs and Substances Act drugs, trafficking, production or distribution","403","360","6","19.41","41.59","63.6","60.32","14.36","10.77","366","497","505","8","6"
"1998","Edmonton, Alberta, municipal","48033","Heroin, trafficking","12","7","0","0","1.84","0","0","0","0","7","10","11","1","0"
"1999","Edmonton, Alberta, municipal","48033","Heroin, trafficking","58","56","0","375.8","8.74","0","0","0","0","56","42","43","1","0"
"2000","Edmonton, Alberta, municipal","48033","Heroin, trafficking","15","18","0","-74.53","2.23","0","0","0","0","18","23","23","0","0"
"2001","Edmonton, Alberta, municipal","48033","Heroin, trafficking","9","8","0","-40.82","1.32","0","0","0","0","8","8","8","0","0"
"2002","Edmonton, Alberta, municipal","48033","Heroin, trafficking","2","3","0","-78.16","0.29","0","0","0","0","3","2","4","2","0"
"2003","Edmonton, Alberta, municipal","48033","Heroin, trafficking","0","0","0","-100","0","0","0","0","0","0","0","1","1","0"
"2004","Edmonton, Alberta, municipal","48033","Heroin, trafficking","0","0","0","0","0","0","0","0","0","0","0","0","0","0"
"2005","Edmonton, Alberta, municipal","48033","Heroin, trafficking","1","1","0","0","0.14","0.17","0.16","0","0","1","1","1","0","0"
"2006","Edmonton, Alberta, municipal","48033","Heroin, trafficking","10","10","0","871.43","1.32","2.32","2.43","3.57","0","10","14","16","2","0"
"2007","Edmonton, Alberta, municipal","48033","Heroin, trafficking","4","4","0","-61.04","0.51","1.45","1.62","3.59","0","4","9","11","2","0"
"2008","Edmonton, Alberta, municipal","48033","Heroin, trafficking","4","4","0","-2.31","0.5","0.94","0.86","0","0","4","6","6","0","0"
"2009","Edmonton, Alberta, municipal","48033","Heroin, trafficking","0","0","0","-100","0","0","0","0","0","0","0","0","0","0"
"2010","Edmonton, Alberta, municipal","48033","Heroin, trafficking","0","0","0","0","0","0","0","0","0","0","0","0","0","0"
"2011","Edmonton, Alberta, municipal","48033","Heroin, trafficking","1","1","0","0","0.12","0.15","0.14","0","0","1","1","1","0","0"
"2012","Edmonton, Alberta, municipal","48033","Heroin, trafficking","4","3","0","289.97","0.46","0.57","0.53","0","0","3","4","4","0","0"
"2013","Edmonton, Alberta, municipal","48033","Heroin, trafficking","11","10","0","165.94","1.23","1.93","1.93","1.84","0","10","14","15","1","0"
"2014","Edmonton, Alberta, municipal","48033","Heroin, trafficking","21","19","0","84.69","2.27","3.6","3.73","5.51","0","19","27","30","3","0"
"2015","Edmonton, Alberta, municipal","48033","Heroin, trafficking","48","47","0","123.63","5.07","9.15","8.54","0","0","47","70","70","0","0"
"2016","Edmonton, Alberta, municipal","48033","Heroin, trafficking","45","47","0","-8.33","4.64","10.11","9.56","1.8","0","47","79","80","1","0"
"1998","Edmonton, Alberta, municipal","48033","Other Controlled Drugs and Substances Act, trafficking","104","100","0","0","15.92","0","0","0","0","100","111","136","25","0"
"1999","Edmonton, Alberta, municipal","48033","Other Controlled Drugs and Substances Act, trafficking","64","63","2","-39.42","9.65","0","0","0","0","65","67","71","4","0"
"2000","Edmonton, Alberta, municipal","48033","Other Controlled Drugs and Substances Act, trafficking","101","103","1","55.45","14.99","0","0","0","0","104","128","141","13","0"
"2001","Edmonton, Alberta, municipal","48033","Other Controlled Drugs and Substances Act, trafficking","121","117","2","18.16","17.72","0","0","0","0","119","149","169","20","0"
"2002","Edmonton, Alberta, municipal","48033","Other Controlled Drugs and Substances Act, trafficking","81","74","0","-34.21","11.66","0","0","0","0","74","102","110","8","0"
"2003","Edmonton, Alberta, municipal","48033","Other Controlled Drugs and Substances Act, trafficking","127","120","0","55.03","18.07","0","0","0","0","120","165","178","13","0"
"2004","Edmonton, Alberta, municipal","48033","Other Controlled Drugs and Substances Act, trafficking","92","98","0","-29.35","12.77","19.89","18.6","5.43","0","98","113","116","3","0"
"2005","Edmonton, Alberta, municipal","48033","Other Controlled Drugs and Substances Act, trafficking","79","76","0","-16.08","10.71","16.61","15.48","3.6","0","76","97","99","2","0"
"2006","Edmonton, Alberta, municipal","48033","Other Controlled Drugs and Substances Act, trafficking","73","75","0","-10.24","9.62","14.41","13.79","7.14","0","75","87","91","4","0"
"2007","Edmonton, Alberta, municipal","48033","Other Controlled Drugs and Substances Act, trafficking","44","38","2","-41.29","5.65","5.79","6.93","19.73","1.79","40","36","47","11","1"
"2008","Edmonton, Alberta, municipal","48033","Other Controlled Drugs and Substances Act, trafficking","55","46","1","22.12","6.9","9.08","9.36","12.64","0","47","58","65","7","0"
"2009","Edmonton, Alberta, municipal","48033","Other Controlled Drugs and Substances Act, trafficking","40","28","3","-29.07","4.89","6.09","6.18","7.29","9.11","31","40","44","4","5"
"2010","Edmonton, Alberta, municipal","48033","Other Controlled Drugs and Substances Act, trafficking","30","23","1","-26.2","3.61","4.94","4.57","0","0","24","33","33","0","0"
"2011","Edmonton, Alberta, municipal","48033","Other Controlled Drugs and Substances Act, trafficking","13","14","0","-57.41","1.54","3.24","2.99","0","0","14","22","22","0","0"
"2012","Edmonton, Alberta, municipal","48033","Other Controlled Drugs and Substances Act, trafficking","31","29","0","132.48","3.57","5.44","5.05","0","0","29","38","38","0","0"
"2013","Edmonton, Alberta, municipal","48033","Other Controlled Drugs and Substances Act, trafficking","47","46","0","46.62","5.24","11.33","10.53","0","0","46","82","82","0","0"
"2014","Edmonton, Alberta, municipal","48033","Other Controlled Drugs and Substances Act, trafficking","77","72","1","58.49","8.31","11.34","10.57","0","0","73","85","85","0","0"
"2015","Edmonton, Alberta, municipal","48033","Other Controlled Drugs and Substances Act, trafficking","74","72","1","-5.97","7.81","13.2","12.44","1.83","0","73","101","102","1","0"
"2016","Edmonton, Alberta, municipal","48033","Other Controlled Drugs and Substances Act, trafficking","134","114","5","77.06","13.83","19.83","18.51","0","10.77","119","155","155","0","6"
"2005","Edmonton, Alberta, municipal","48033","Methamphetamines (crystal meth), trafficking","0","0","0","0","0","0","0","0","0","0","0","0","0","0"
"2006","Edmonton, Alberta, municipal","48033","Methamphetamines (crystal meth), trafficking","0","0","0","0","0","0","0","0","0","0","0","0","0","0"
"2007","Edmonton, Alberta, municipal","48033","Methamphetamines (crystal meth), trafficking","0","0","0","0","0","0","0","0","0","0","0","0","0","0"
"2008","Edmonton, Alberta, municipal","48033","Methamphetamines (crystal meth), trafficking","9","9","0","0","1.13","2.5","2.3","0","0","9","16","16","0","0"
"2009","Edmonton, Alberta, municipal","48033","Methamphetamines (crystal meth), trafficking","23","20","1","149.23","2.81","5.94","5.62","1.82","0","21","39","40","1","0"
"2010","Edmonton, Alberta, municipal","48033","Methamphetamines (crystal meth), trafficking","35","29","0","49.74","4.21","8.38","7.75","0","0","29","56","56","0","0"
"2011","Edmonton, Alberta, municipal","48033","Methamphetamines (crystal meth), trafficking","43","42","0","20.76","5.09","10.15","9.39","0","0","42","69","69","0","0"
"2012","Edmonton, Alberta, municipal","48033","Methamphetamines (crystal meth), trafficking","42","36","3","-4.78","4.84","9.02","8.63","3.66","0","39","63","65","2","0"
"2013","Edmonton, Alberta, municipal","48033","Methamphetamines (crystal meth), trafficking","95","93","1","118.74","10.59","18.93","18.89","18.36","0","94","137","147","10","0"
"2014","Edmonton, Alberta, municipal","48033","Methamphetamines (crystal meth), trafficking","167","161","2","70.06","18.01","30.56","28.61","1.84","0","163","229","230","1","0"
"2015","Edmonton, Alberta, municipal","48033","Methamphetamines (crystal meth), trafficking","203","200","0","18.93","21.42","31.23","30.37","18.26","0","200","239","249","10","0"
"2016","Edmonton, Alberta, municipal","48033","Methamphetamines (crystal meth), trafficking","218","196","0","5.01","22.5","33.27","31.89","12.57","0","196","260","267","7","0"
"2005","Edmonton, Alberta, municipal","48033","Methylenedioxyamphetamine (ecstasy), trafficking","0","0","0","0","0","0","0","0","0","0","0","0","0","0"
"2006","Edmonton, Alberta, municipal","48033","Methylenedioxyamphetamine (ecstasy), trafficking","0","0","0","0","0","0","0","0","0","0","0","0","0","0"
"2007","Edmonton, Alberta, municipal","48033","Methylenedioxyamphetamine (ecstasy), trafficking","0","0","0","0","0","0","0","0","0","0","0","0","0","0"
"2008","Edmonton, Alberta, municipal","48033","Methylenedioxyamphetamine (ecstasy), trafficking","3","3","0","0","0.38","0.31","0.43","1.81","0","3","2","3","1","0"
"2009","Edmonton, Alberta, municipal","48033","Methylenedioxyamphetamine (ecstasy), trafficking","14","13","0","355.11","1.71","1.67","1.97","5.46","0","13","11","14","3","0"
"2010","Edmonton, Alberta, municipal","48033","Methylenedioxyamphetamine (ecstasy), trafficking","14","14","0","-1.6","1.68","2.24","2.21","1.83","0","14","15","16","1","0"
"2011","Edmonton, Alberta, municipal","48033","Methylenedioxyamphetamine (ecstasy), trafficking","7","6","0","-50.85","0.83","1.18","1.09","0","0","6","8","8","0","0"
"2012","Edmonton, Alberta, municipal","48033","Methylenedioxyamphetamine (ecstasy), trafficking","5","6","0","-30.36","0.58","1.43","1.33","0","0","6","10","10","0","0"
"2013","Edmonton, Alberta, municipal","48033","Methylenedioxyamphetamine (ecstasy), trafficking","4","3","0","-22.63","0.45","0.28","0.39","1.84","0","3","2","3","1","0"
"2014","Edmonton, Alberta, municipal","48033","Methylenedioxyamphetamine (ecstasy), trafficking","5","5","0","20.93","0.54","0.67","0.62","0","0","5","5","5","0","0"
"2015","Edmonton, Alberta, municipal","48033","Methylenedioxyamphetamine (ecstasy), trafficking","2","2","0","-60.86","0.21","0.39","0.37","0","0","2","3","3","0","0"
"2016","Edmonton, Alberta, municipal","48033","Methylenedioxyamphetamine (ecstasy), trafficking","3","2","1","46.67","0.31","0.26","0.24","0","0","3","2","2","0","0"
"1998","Edmonton, Alberta, municipal","48033","Heroin, importation and exportation","0","0","0","0","0","0","0","0","0","0","0","0","0","0"
"1999","Edmonton, Alberta, municipal","48033","Heroin, importation and exportation","0","0","0","0","0","0","0","0","0","0","0","0","0","0"
"2000","Edmonton, Alberta, municipal","48033","Heroin, importation and exportation","0","0","0","0","0","0","0","0","0","0","0","0","0","0"
"2001","Edmonton, Alberta, municipal","48033","Heroin, importation and exportation","0","0","0","0","0","0","0","0","0","0","0","0","0","0"
"2002","Edmonton, Alberta, municipal","48033","Heroin, importation and exportation","0","0","0","0","0","0","0","0","0","0","0","0","0","0"
"2003","Edmonton, Alberta, municipal","48033","Heroin, importation and exportation","0","0","0","0","0","0","0","0","0","0","0","0","0","0"
"2004","Edmonton, Alberta, municipal","48033","Heroin, importation and exportation","0","0","0","0","0","0","0","0","0","0","0","0","0","0"
"2005","Edmonton, Alberta, municipal","48033","Heroin, importation and exportation","0","0","0","0","0","0","0","0","0","0","0","0","0","0"
"2006","Edmonton, Alberta, municipal","48033","Heroin, importation and exportation","0","0","0","0","0","0","0","0","0","0","0","0","0","0"
"2007","Edmonton, Alberta, municipal","48033","Heroin, importation and exportation","0","0","0","0","0","0","0","0","0","0","0","0","0","0"
"2008","Edmonton, Alberta, municipal","48033","Heroin, importation and exportation","0","0","0","0","0","0","0","0","0","0","0","0","0","0"
"2009","Edmonton, Alberta, municipal","48033","Heroin, importation and exportation","1","0","0","0","0.12","0","0","0","0","0","0","0","0","0"
"2010","Edmonton, Alberta, municipal","48033","Heroin, importation and exportation","1","0","0","-1.6","0.12","0","0","0","0","0","0","0","0","0"
"2011","Edmonton, Alberta, municipal","48033","Heroin, importation and exportation","0","0","0","-100","0","0","0","0","0","0","0","0","0","0"
"2012","Edmonton, Alberta, municipal","48033","Heroin, importation and exportation","0","0","0","0","0","0","0","0","0","0","0","0","0","0"
"2013","Edmonton, Alberta, municipal","48033","Heroin, importation and exportation","0","0","0","0","0","0","0","0","0","0","0","0","0","0"
"2014","Edmonton, Alberta, municipal","48033","Heroin, importation and exportation","1","0","0","0","0.11","0","0","0","0","0","0","0","0","0"
"2015","Edmonton, Alberta, municipal","48033","Heroin, importation and exportation","0","0","0","-100","0","0","0","0","0","0","0","0","0","0"
"2016","Edmonton, Alberta, municipal","48033","Heroin, importation and exportation","0","0","0","0","0","0","0","0","0","0","0","0","0","0"
"1998","Edmonton, Alberta, municipal","48033","Other Controlled Drugs and Substances Act, importation and exportation","3","0","1","0","0.46","0","0","0","0","1","0","0","0","0"
"1999","Edmonton, Alberta, municipal","48033","Other Controlled Drugs and Substances Act, importation and exportation","0","1","1","-100","0","0","0","0","0","2","1","1","0","0"
"2000","Edmonton, Alberta, municipal","48033","Other Controlled Drugs and Substances Act, importation and exportation","1","1","0","0","0.15","0","0","0","0","1","2","2","0","0"
"2001","Edmonton, Alberta, municipal","48033","Other Controlled Drugs and Substances Act, importation and exportation","2","1","0","97.27","0.29","0","0","0","0","1","1","1","0","0"
"2002","Edmonton, Alberta, municipal","48033","Other Controlled Drugs and Substances Act, importation and exportation","2","0","0","-1.72","0.29","0","0","0","0","0","0","0","0","0"
"2003","Edmonton, Alberta, municipal","48033","Other Controlled Drugs and Substances Act, importation and exportation","1","1","0","-50.56","0.14","0","0","0","0","1","4","4","0","0"
"2004","Edmonton, Alberta, municipal","48033","Other Controlled Drugs and Substances Act, importation and exportation","8","0","0","680.23","1.11","0","0","0","0","0","0","0","0","0"
"2005","Edmonton, Alberta, municipal","48033","Other Controlled Drugs and Substances Act, importation and exportation","6","1","0","-26.7","0.81","0.34","0.31","0","0","1","2","2","0","0"
"2006","Edmonton, Alberta, municipal","48033","Other Controlled Drugs and Substances Act, importation and exportation","2","0","0","-67.62","0.26","0","0","0","0","0","0","0","0","0"
"2007","Edmonton, Alberta, municipal","48033","Other Controlled Drugs and Substances Act, importation and exportation","2","1","0","-2.6","0.26","0.16","0.15","0","0","1","1","1","0","0"
"2008","Edmonton, Alberta, municipal","48033","Other Controlled Drugs and Substances Act, importation and exportation","3","1","0","46.54","0.38","0.31","0.29","0","0","1","2","2","0","0"
"2009","Edmonton, Alberta, municipal","48033","Other Controlled Drugs and Substances Act, importation and exportation","8","0","0","160.06","0.98","0","0","0","0","0","0","0","0","0"
"2010","Edmonton, Alberta, municipal","48033","Other Controlled Drugs and Substances Act, importation and exportation","4","0","1","-50.8","0.48","0","0","0","0","1","0","0","0","0"
"2011","Edmonton, Alberta, municipal","48033","Other Controlled Drugs and Substances Act, importation and exportation","7","0","3","72.01","0.83","0","0","0","0","3","0","0","0","0"
"2012","Edmonton, Alberta, municipal","48033","Other Controlled Drugs and Substances Act, importation and exportation","8","0","6","11.42","0.92","0","0","0","0","6","0","0","0","0"
"2013","Edmonton, Alberta, municipal","48033","Other Controlled Drugs and Substances Act, importation and exportation","3","0","1","-63.74","0.33","0","0","0","0","1","0","0","0","0"
"2014","Edmonton, Alberta, municipal","48033","Other Controlled Drugs and Substances Act, importation and exportation","1","0","1","-67.75","0.11","0","0","0","0","1","0","0","0","0"
"2015","Edmonton, Alberta, municipal","48033","Other Controlled Drugs and Substances Act, importation and exportation","2","0","0","95.68","0.21","0","0","0","0","0","0","0","0","0"
"2016","Edmonton, Alberta, municipal","48033","Other Controlled Drugs and Substances Act, importation and exportation","2","0","0","-2.22","0.21","0","0","0","0","0","0","0","0","0"
"2005","Edmonton, Alberta, municipal","48033","Methamphetamines (crystal meth), importation and exportation","0","0","0","0","0","0","0","0","0","0","0","0","0","0"
"2006","Edmonton, Alberta, municipal","48033","Methamphetamines (crystal meth), importation and exportation","0","0","0","0","0","0","0","0","0","0","0","0","0","0"
"2007","Edmonton, Alberta, municipal","48033","Methamphetamines (crystal meth), importation and exportation","0","0","0","0","0","0","0","0","0","0","0","0","0","0"
"2008","Edmonton, Alberta, municipal","48033","Methamphetamines (crystal meth), importation and exportation","0","0","0","0","0","0","0","0","0","0","0","0","0","0"
"2009","Edmonton, Alberta, municipal","48033","Methamphetamines (crystal meth), importation and exportation","0","0","0","0","0","0","0","0","0","0","0","0","0","0"
"2010","Edmonton, Alberta, municipal","48033","Methamphetamines (crystal meth), importation and exportation","1","1","0","0","0.12","0.15","0.14","0","0","1","1","1","0","0"
"2011","Edmonton, Alberta, municipal","48033","Methamphetamines (crystal meth), importation and exportation","0","0","0","-100","0","0","0","0","0","0","0","0","0","0"
"2012","Edmonton, Alberta, municipal","48033","Methamphetamines (crystal meth), importation and exportation","0","0","0","0","0","0","0","0","0","0","0","0","0","0"
"2013","Edmonton, Alberta, municipal","48033","Methamphetamines (crystal meth), importation and exportation","0","0","0","0","0","0","0","0","0","0","0","0","0","0"
"2014","Edmonton, Alberta, municipal","48033","Methamphetamines (crystal meth), importation and exportation","0","0","0","0","0","0","0","0","0","0","0","0","0","0"
"2015","Edmonton, Alberta, municipal","48033","Methamphetamines (crystal meth), importation and exportation","0","0","0","0","0","0","0","0","0","0","0","0","0","0"
"2016","Edmonton, Alberta, municipal","48033","Methamphetamines (crystal meth), importation and exportation","0","0","0","0","0","0","0","0","0","0","0","0","0","0"
"2005","Edmonton, Alberta, municipal","48033","Methylenedioxyamphetamine (ecstasy), importation and exportation","0","0","0","0","0","0","0","0","0","0","0","0","0","0"
"2006","Edmonton, Alberta, municipal","48033","Methylenedioxyamphetamine (ecstasy), importation and exportation","0","0","0","0","0","0","0","0","0","0","0","0","0","0"
"2007","Edmonton, Alberta, municipal","48033","Methylenedioxyamphetamine (ecstasy), importation and exportation","0","0","0","0","0","0","0","0","0","0","0","0","0","0"
"2008","Edmonton, Alberta, municipal","48033","Methylenedioxyamphetamine (ecstasy), importation and exportation","0","0","0","0","0","0","0","0","0","0","0","0","0","0"
"2009","Edmonton, Alberta, municipal","48033","Methylenedioxyamphetamine (ecstasy), importation and exportation","0","0","0","0","0","0","0","0","0","0","0","0","0","0"
"2010","Edmonton, Alberta, municipal","48033","Methylenedioxyamphetamine (ecstasy), importation and exportation","1","0","0","0","0.12","0","0","0","0","0","0","0","0","0"
"2011","Edmonton, Alberta, municipal","48033","Methylenedioxyamphetamine (ecstasy), importation and exportation","0","0","1","-100","0","0","0","0","0","1","0","0","0","0"
"2012","Edmonton, Alberta, municipal","48033","Methylenedioxyamphetamine (ecstasy), importation and exportation","0","0","0","0","0","0","0","0","0","0","0","0","0","0"
"2013","Edmonton, Alberta, municipal","48033","Methylenedioxyamphetamine (ecstasy), importation and exportation","0","0","0","0","0","0","0","0","0","0","0","0","0","0"
"2014","Edmonton, Alberta, municipal","48033","Methylenedioxyamphetamine (ecstasy), importation and exportation","0","0","0","0","0","0","0","0","0","0","0","0","0","0"
"2015","Edmonton, Alberta, municipal","48033","Methylenedioxyamphetamine (ecstasy), importation and exportation","0","0","0","0","0","0","0","0","0","0","0","0","0","0"
"2016","Edmonton, Alberta, municipal","48033","Methylenedioxyamphetamine (ecstasy), importation and exportation","0","0","0","0","0","0","0","0","0","0","0","0","0","0"
"2005","Edmonton, Alberta, municipal","48033","Heroin, production","0","0","0","0","0","0","0","0","0","0","0","0","0","0"
"2006","Edmonton, Alberta, municipal","48033","Heroin, production","0","0","0","0","0","0","0","0","0","0","0","0","0","0"
"2007","Edmonton, Alberta, municipal","48033","Heroin, production","0","0","0","0","0","0","0","0","0","0","0","0","0","0"
"2010","Edmonton, Alberta, municipal","48033","Precursor or equipment (crystal meth, ecstasy)","0","0","0","0","0","0","0","0","0","0","0","0","0","0"
"2008","Edmonton, Alberta, municipal","48033","Heroin, production","0","0","0","0","0","0","0","0","0","0","0","0","0","0"
"2011","Edmonton, Alberta, municipal","48033","Precursor or equipment (crystal meth, ecstasy)","0","0","0","0","0","0","0","0","0","0","0","0","0","0"
"2009","Edmonton, Alberta, municipal","48033","Heroin, production","0","0","0","0","0","0","0","0","0","0","0","0","0","0"
"2012","Edmonton, Alberta, municipal","48033","Precursor or equipment (crystal meth, ecstasy)","0","0","0","0","0","0","0","0","0","0","0","0","0","0"
"2010","Edmonton, Alberta, municipal","48033","Heroin, production","0","0","0","0","0","0","0","0","0","0","0","0","0","0"
"2013","Edmonton, Alberta, municipal","48033","Precursor or equipment (crystal meth, ecstasy)","1","0","0","0","0.11","0","0","0","0","0","0","0","0","0"
"2011","Edmonton, Alberta, municipal","48033","Heroin, production","0","0","0","0","0","0","0","0","0","0","0","0","0","0"
"2014","Edmonton, Alberta, municipal","48033","Precursor or equipment (crystal meth, ecstasy)","0","0","0","-100","0","0","0","0","0","0","0","0","0","0"
"2012","Edmonton, Alberta, municipal","48033","Heroin, production","0","0","0","0","0","0","0","0","0","0","0","0","0","0"
"2015","Edmonton, Alberta, municipal","48033","Precursor or equipment (crystal meth, ecstasy)","1","0","0","0","0.11","0","0","0","0","0","0","0","0","0"
"2013","Edmonton, Alberta, municipal","48033","Heroin, production","0","0","0","0","0","0","0","0","0","0","0","0","0","0"
"2016","Edmonton, Alberta, municipal","48033","Precursor or equipment (crystal meth, ecstasy)","1","0","0","-2.22","0.1","0","0","0","0","0","0","0","0","0"
"2014","Edmonton, Alberta, municipal","48033","Heroin, production","0","0","0","0","0","0","0","0","0","0","0","0","0","0"
"2015","Edmonton, Alberta, municipal","48033","Heroin, production","0","0","0","0","0","0","0","0","0","0","0","0","0","0"
"2005","Edmonton, Alberta, municipal","48033","Precursor or equipment (crystal meth, ecstasy)","0","0","0","0","0","0","0","0","0","0","0","0","0","0"
"2016","Edmonton, Alberta, municipal","48033","Heroin, production","0","0","0","0","0","0","0","0","0","0","0","0","0","0"
"2006","Edmonton, Alberta, municipal","48033","Precursor or equipment (crystal meth, ecstasy)","0","0","0","0","0","0","0","0","0","0","0","0","0","0"
"2007","Edmonton, Alberta, municipal","48033","Precursor or equipment (crystal meth, ecstasy)","0","0","0","0","0","0","0","0","0","0","0","0","0","0"
"2008","Edmonton, Alberta, municipal","48033","Precursor or equipment (crystal meth, ecstasy)","0","0","0","0","0","0","0","0","0","0","0","0","0","0"
"2009","Edmonton, Alberta, municipal","48033","Precursor or equipment (crystal meth, ecstasy)","0","0","0","0","0","0","0","0","0","0","0","0","0","0"
"1998","Edmonton, Alberta, municipal","48033","Youth Criminal Justice Act","97","66","7","0","14.85","0","0","0","0","73","4","54","50","0"
"1999","Edmonton, Alberta, municipal","48033","Youth Criminal Justice Act","86","87","0","-12.72","12.96","0","0","0","0","87","23","88","65","0"
"2000","Edmonton, Alberta, municipal","48033","Youth Criminal Justice Act","107","100","11","22.55","15.89","0","0","0","0","111","56","124","68","0"
"2001","Edmonton, Alberta, municipal","48033","Youth Criminal Justice Act","116","83","18","6.93","16.99","0","0","0","0","101","12","75","63","1"
"2002","Edmonton, Alberta, municipal","48033","Youth Criminal Justice Act","98","97","8","-16.97","14.1","0","0","0","0","105","21","84","63","4"
"2003","Edmonton, Alberta, municipal","48033","Youth Criminal Justice Act","45","50","0","-54.6","6.4","0","0","0","0","50","6","42","36","0"
"2004","Edmonton, Alberta, municipal","48033","Youth Criminal Justice Act","44","42","1","-4.64","6.11","2.11","7.38","61.49","1.81","43","12","46","34","1"
"2005","Edmonton, Alberta, municipal","48033","Youth Criminal Justice Act","39","36","0","-13.37","5.29","1.03","5.16","48.62","0","36","6","33","27","0"
"2005","Edmonton, Alberta, municipal","48033","Other Controlled Drugs and Substances Act, production","0","0","0","0","0","0","0","0","0","0","0","0","0","0"
"2006","Edmonton, Alberta, municipal","48033","Youth Criminal Justice Act","38","38","0","-5.35","5.01","0.83","5","50.01","0","38","5","33","28","0"
"2006","Edmonton, Alberta, municipal","48033","Other Controlled Drugs and Substances Act, production","0","0","0","0","0","0","0","0","0","0","0","0","0","0"
"2007","Edmonton, Alberta, municipal","48033","Youth Criminal Justice Act","60","67","0","53.8","7.7","1.12","7.52","78.94","0","67","7","51","44","0"
"2007","Edmonton, Alberta, municipal","48033","Other Controlled Drugs and Substances Act, production","0","0","0","0","0","0","0","0","0","0","0","0","0","0"
"2008","Edmonton, Alberta, municipal","48033","Youth Criminal Justice Act","124","126","0","101.9","15.55","3.76","10.95","93.88","0","126","24","76","52","0"
"2008","Edmonton, Alberta, municipal","48033","Other Controlled Drugs and Substances Act, production","1","1","0","0","0.13","0.16","0.14","0","0","1","1","1","0","0"
"2009","Edmonton, Alberta, municipal","48033","Youth Criminal Justice Act","220","204","0","73.02","26.9","2.89","12.5","127.52","0","204","19","89","70","0"
"2009","Edmonton, Alberta, municipal","48033","Other Controlled Drugs and Substances Act, production","5","5","0","387.62","0.61","0.76","0.7","0","0","5","5","5","0","0"
"2010","Edmonton, Alberta, municipal","48033","Youth Criminal Justice Act","347","361","2","55.21","41.75","6.59","19.92","183.26","0","363","44","144","100","0"
"2010","Edmonton, Alberta, municipal","48033","Other Controlled Drugs and Substances Act, production","7","4","0","37.76","0.84","0.9","0.83","0","0","4","6","6","0","0"
"2011","Edmonton, Alberta, municipal","48033","Youth Criminal Justice Act","270","269","1","-23.52","31.93","5.15","17.56","170.75","1.82","270","35","129","94","1"
"2011","Edmonton, Alberta, municipal","48033","Other Controlled Drugs and Substances Act, production","5","2","0","-29.79","0.59","0.44","0.41","0","0","2","3","3","0","0"
"2012","Edmonton, Alberta, municipal","48033","Youth Criminal Justice Act","257","253","0","-7.2","29.63","5.15","18.85","194.2","0","253","36","142","106","0"
"2012","Edmonton, Alberta, municipal","48033","Other Controlled Drugs and Substances Act, production","1","1","0","-80.5","0.12","0.29","0.27","0","0","1","2","2","0","0"
"2013","Edmonton, Alberta, municipal","48033","Youth Criminal Justice Act","204","207","1","-23.24","22.75","3.45","13.1","141.4","5.51","208","25","102","77","3"
"2013","Edmonton, Alberta, municipal","48033","Other Controlled Drugs and Substances Act, production","1","1","0","-3.29","0.11","0.28","0.26","0","0","1","2","2","0","0"
"2014","Edmonton, Alberta, municipal","48033","Youth Criminal Justice Act","233","229","2","10.49","25.13","2.27","12.44","152.55","1.84","231","17","100","83","1"
"2014","Edmonton, Alberta, municipal","48033","Other Controlled Drugs and Substances Act, production","3","3","0","190.22","0.32","0.8","0.75","0","0","3","6","6","0","0"
"2015","Edmonton, Alberta, municipal","48033","Youth Criminal Justice Act","192","190","4","-19.38","20.26","1.7","10.24","129.68","1.83","194","13","84","71","1"
"2015","Edmonton, Alberta, municipal","48033","Other Controlled Drugs and Substances Act, production","1","1","0","-67.39","0.11","0.26","0.24","0","0","1","2","2","0","0"
"2016","Edmonton, Alberta, municipal","48033","Youth Criminal Justice Act","129","126","2","-34.3","13.31","2.18","7.41","80.8","0","128","17","62","45","0"
"2016","Edmonton, Alberta, municipal","48033","Other Controlled Drugs and Substances Act, production","1","1","0","-2.22","0.1","0.13","0.12","0","0","1","1","1","0","0"
"2005","Edmonton, Alberta, municipal","48033","Methamphetamines (crystal meth), production","0","0","0","0","0","0","0","0","0","0","0","0","0","0"
"2006","Edmonton, Alberta, municipal","48033","Methamphetamines (crystal meth), production","0","0","0","0","0","0","0","0","0","0","0","0","0","0"
"2007","Edmonton, Alberta, municipal","48033","Methamphetamines (crystal meth), production","0","0","0","0","0","0","0","0","0","0","0","0","0","0"
"2008","Edmonton, Alberta, municipal","48033","Methamphetamines (crystal meth), production","0","0","0","0","0","0","0","0","0","0","0","0","0","0"
"2009","Edmonton, Alberta, municipal","48033","Methamphetamines (crystal meth), production","1","0","0","0","0.12","0","0","0","0","0","0","0","0","0"
"2010","Edmonton, Alberta, municipal","48033","Methamphetamines (crystal meth), production","2","0","0","96.8","0.24","0","0","0","0","0","0","0","0","0"
"2011","Edmonton, Alberta, municipal","48033","Methamphetamines (crystal meth), production","2","0","0","-1.71","0.24","0","0","0","0","0","0","0","0","0"
"2012","Edmonton, Alberta, municipal","48033","Methamphetamines (crystal meth), production","0","0","0","-100","0","0","0","0","0","0","0","0","0","0"
"2013","Edmonton, Alberta, municipal","48033","Methamphetamines (crystal meth), production","1","0","0","0","0.11","0","0","0","0","0","0","0","0","0"
"2014","Edmonton, Alberta, municipal","48033","Methamphetamines (crystal meth), production","2","0","0","93.48","0.22","0","0","0","0","0","0","0","0","0"
"2015","Edmonton, Alberta, municipal","48033","Methamphetamines (crystal meth), production","0","0","0","-100","0","0","0","0","0","0","0","0","0","0"
"2016","Edmonton, Alberta, municipal","48033","Methamphetamines (crystal meth), production","0","0","0","0","0","0","0","0","0","0","0","0","0","0"
"1998","Edmonton, Alberta, municipal","48033","Total other Federal Statutes","197","87","95","0","30.16","0","0","0","0","182","74","80","6","0"
"1999","Edmonton, Alberta, municipal","48033","Total other Federal Statutes","155","85","40","-22.55","23.36","0","0","0","0","125","99","102","3","3"
"2000","Edmonton, Alberta, municipal","48033","Total other Federal Statutes","62","23","24","-60.6","9.2","0","0","0","0","47","29","30","1","0"
"2001","Edmonton, Alberta, municipal","48033","Total other Federal Statutes","82","53","10","30.45","12.01","0","0","0","0","63","57","62","5","0"
"2002","Edmonton, Alberta, municipal","48033","Total other Federal Statutes","52","12","30","-37.68","7.48","0","0","0","0","42","16","17","1","0"
"2003","Edmonton, Alberta, municipal","48033","Total other Federal Statutes","51","13","14","-3.02","7.26","0","0","0","0","27","17","18","1","0"
"2004","Edmonton, Alberta, municipal","48033","Total other Federal Statutes","76","29","8","45.34","10.55","4.22","4.33","5.43","0","37","24","27","3","0"
"2005","Edmonton, Alberta, municipal","48033","Total other Federal Statutes","25","10","6","-67.85","3.39","2.23","2.03","0","0","16","13","13","0","0"
"2006","Edmonton, Alberta, municipal","48033","Total other Federal Statutes","40","7","11","55.43","5.27","1.16","1.06","0","0","18","7","7","0","0"
"2007","Edmonton, Alberta, municipal","48033","Total other Federal Statutes","33","7","10","-19.64","4.24","3.05","2.8","0","0","17","19","19","0","0"
"2008","Edmonton, Alberta, municipal","48033","Total other Federal Statutes","23","2","11","-31.91","2.88","0.31","0.29","0","0","13","2","2","0","0"
"2009","Edmonton, Alberta, municipal","48033","Total other Federal Statutes","30","5","7","27.2","3.67","0.76","0.7","0","0","12","5","5","0","0"
"2010","Edmonton, Alberta, municipal","48033","Total other Federal Statutes","37","1","21","21.36","4.45","0","0","0","0","22","0","0","0","0"
"2011","Edmonton, Alberta, municipal","48033","Total other Federal Statutes","19","3","7","-49.52","2.25","0.44","0.41","0","3.63","10","3","3","0","2"
"2012","Edmonton, Alberta, municipal","48033","Total other Federal Statutes","28","0","16","43.67","3.23","0","0","0","0","16","0","0","0","0"
"2013","Edmonton, Alberta, municipal","48033","Total other Federal Statutes","23","2","9","-20.56","2.56","0.28","0.26","0","0","11","2","2","0","0"
"2014","Edmonton, Alberta, municipal","48033","Total other Federal Statutes","27","2","9","13.57","2.91","0.4","0.37","0","1.84","11","3","3","0","1"
"2015","Edmonton, Alberta, municipal","48033","Total other Federal Statutes","16","4","5","-42.02","1.69","0.39","0.49","1.83","0","9","3","4","1","0"
"2016","Edmonton, Alberta, municipal","48033","Total other Federal Statutes","23","4","7","40.56","2.37","0.51","0.48","0","0","11","4","4","0","0"
"2005","Edmonton, Alberta, municipal","48033","Methylenedioxyamphetamine (ecstasy), production","0","0","0","0","0","0","0","0","0","0","0","0","0","0"
"2006","Edmonton, Alberta, municipal","48033","Methylenedioxyamphetamine (ecstasy), production","0","0","0","0","0","0","0","0","0","0","0","0","0","0"
"2007","Edmonton, Alberta, municipal","48033","Methylenedioxyamphetamine (ecstasy), production","0","0","0","0","0","0","0","0","0","0","0","0","0","0"
"2008","Edmonton, Alberta, municipal","48033","Methylenedioxyamphetamine (ecstasy), production","0","0","0","0","0","0","0","0","0","0","0","0","0","0"
"2009","Edmonton, Alberta, municipal","48033","Methylenedioxyamphetamine (ecstasy), production","0","0","0","0","0","0","0","0","0","0","0","0","0","0"
"2010","Edmonton, Alberta, municipal","48033","Methylenedioxyamphetamine (ecstasy), production","1","0","0","0","0.12","0","0","0","0","0","0","0","0","0"
"2011","Edmonton, Alberta, municipal","48033","Methylenedioxyamphetamine (ecstasy), production","0","0","0","-100","0","0","0","0","0","0","0","0","0","0"
"2012","Edmonton, Alberta, municipal","48033","Methylenedioxyamphetamine (ecstasy), production","0","0","0","0","0","0","0","0","0","0","0","0","0","0"
"2013","Edmonton, Alberta, municipal","48033","Methylenedioxyamphetamine (ecstasy), production","2","0","0","0","0.22","0","0","0","0","0","0","0","0","0"
"2014","Edmonton, Alberta, municipal","48033","Methylenedioxyamphetamine (ecstasy), production","0","0","0","-100","0","0","0","0","0","0","0","0","0","0"
"2015","Edmonton, Alberta, municipal","48033","Methylenedioxyamphetamine (ecstasy), production","0","0","0","0","0","0","0","0","0","0","0","0","0","0"
"2016","Edmonton, Alberta, municipal","48033","Methylenedioxyamphetamine (ecstasy), production","0","0","0","0","0","0","0","0","0","0","0","0","0","0"
"1998","Edmonton, Alberta, municipal","48033","Bankruptcy Act","18","19","17","0","2.76","0","0","0","0","36","5","5","0","0"
"1999","Edmonton, Alberta, municipal","48033","Bankruptcy Act","11","0","0","-39.84","1.66","0","0","0","0","0","0","0","0","0"
"2000","Edmonton, Alberta, municipal","48033","Bankruptcy Act","11","1","4","-1.5","1.63","0","0","0","0","5","1","1","0","0"
"2001","Edmonton, Alberta, municipal","48033","Bankruptcy Act","2","7","8","-82.07","0.29","0","0","0","0","15","1","1","0","0"
"2002","Edmonton, Alberta, municipal","48033","Bankruptcy Act","3","1","4","47.42","0.43","0","0","0","0","5","1","1","0","0"
"2003","Edmonton, Alberta, municipal","48033","Bankruptcy Act","6","3","4","97.76","0.85","0","0","0","0","7","7","7","0","0"
"2004","Edmonton, Alberta, municipal","48033","Bankruptcy Act","2","1","0","-67.49","0.28","0","0","0","0","1","0","0","0","0"
"2005","Edmonton, Alberta, municipal","48033","Bankruptcy Act","3","1","0","46.6","0.41","0.17","0.16","0","0","1","1","1","0","0"
"2006","Edmonton, Alberta, municipal","48033","Bankruptcy Act","0","0","0","-100","0","0","0","0","0","0","0","0","0","0"
"2007","Edmonton, Alberta, municipal","48033","Bankruptcy Act","0","2","0","0","0","0.32","0.29","0","0","2","2","2","0","0"
"2008","Edmonton, Alberta, municipal","48033","Bankruptcy Act","0","0","0","0","0","0","0","0","0","0","0","0","0","0"
"2009","Edmonton, Alberta, municipal","48033","Bankruptcy Act","0","1","1","0","0","0.15","0.14","0","0","2","1","1","0","0"
"2010","Edmonton, Alberta, municipal","48033","Bankruptcy Act","1","0","0","0","0.12","0","0","0","0","0","0","0","0","0"
"2011","Edmonton, Alberta, municipal","48033","Bankruptcy Act","1","1","0","-1.71","0.12","0.15","0.14","0","0","1","1","1","0","0"
"2012","Edmonton, Alberta, municipal","48033","Bankruptcy Act","2","0","0","94.98","0.23","0","0","0","0","0","0","0","0","0"
"2013","Edmonton, Alberta, municipal","48033","Bankruptcy Act","0","0","0","-100","0","0","0","0","0","0","0","0","0","0"
"2014","Edmonton, Alberta, municipal","48033","Bankruptcy Act","1","0","0","0","0.11","0","0","0","0","0","0","0","0","0"
"2015","Edmonton, Alberta, municipal","48033","Bankruptcy Act","0","2","0","-100","0","0.26","0.24","0","0","2","2","2","0","0"
"2016","Edmonton, Alberta, municipal","48033","Bankruptcy Act","1","0","0","0","0.1","0","0","0","0","0","0","0","0","0"
"1998","Edmonton, Alberta, municipal","48033","Income Tax Act","0","0","0","0","0","0","0","0","0","0","0","0","0","0"
"1999","Edmonton, Alberta, municipal","48033","Income Tax Act","0","0","0","0","0","0","0","0","0","0","0","0","0","0"
"2000","Edmonton, Alberta, municipal","48033","Income Tax Act","0","0","0","0","0","0","0","0","0","0","0","0","0","0"
"2001","Edmonton, Alberta, municipal","48033","Income Tax Act","0","0","0","0","0","0","0","0","0","0","0","0","0","0"
"2002","Edmonton, Alberta, municipal","48033","Income Tax Act","0","0","0","0","0","0","0","0","0","0","0","0","0","0"
"2003","Edmonton, Alberta, municipal","48033","Income Tax Act","0","0","0","0","0","0","0","0","0","0","0","0","0","0"
"2004","Edmonton, Alberta, municipal","48033","Income Tax Act","0","0","0","0","0","0","0","0","0","0","0","0","0","0"
"2005","Edmonton, Alberta, municipal","48033","Income Tax Act","0","0","0","0","0","0","0","0","0","0","0","0","0","0"
"2006","Edmonton, Alberta, municipal","48033","Income Tax Act","0","0","0","0","0","0","0","0","0","0","0","0","0","0"
"2007","Edmonton, Alberta, municipal","48033","Income Tax Act","0","0","0","0","0","0","0","0","0","0","0","0","0","0"
"2008","Edmonton, Alberta, municipal","48033","Income Tax Act","0","0","0","0","0","0","0","0","0","0","0","0","0","0"
"2009","Edmonton, Alberta, municipal","48033","Income Tax Act","0","0","0","0","0","0","0","0","0","0","0","0","0","0"
"2010","Edmonton, Alberta, municipal","48033","Income Tax Act","1","0","1","0","0.12","0","0","0","0","1","0","0","0","0"
"2011","Edmonton, Alberta, municipal","48033","Income Tax Act","0","0","0","-100","0","0","0","0","0","0","0","0","0","0"
"2012","Edmonton, Alberta, municipal","48033","Income Tax Act","0","0","0","0","0","0","0","0","0","0","0","0","0","0"
"2013","Edmonton, Alberta, municipal","48033","Income Tax Act","2","0","0","0","0.22","0","0","0","0","0","0","0","0","0"
"2014","Edmonton, Alberta, municipal","48033","Income Tax Act","0","0","0","-100","0","0","0","0","0","0","0","0","0","0"
"2015","Edmonton, Alberta, municipal","48033","Income Tax Act","0","0","0","0","0","0","0","0","0","0","0","0","0","0"
"2016","Edmonton, Alberta, municipal","48033","Income Tax Act","0","0","0","0","0","0","0","0","0","0","0","0","0","0"
"1998","Edmonton, Alberta, municipal","48033","Canada Shipping Act","0","0","0","0","0","0","0","0","0","0","0","0","0","0"
"1999","Edmonton, Alberta, municipal","48033","Canada Shipping Act","0","0","0","0","0","0","0","0","0","0","0","0","0","0"
"2000","Edmonton, Alberta, municipal","48033","Canada Shipping Act","0","0","0","0","0","0","0","0","0","0","0","0","0","0"
"2001","Edmonton, Alberta, municipal","48033","Canada Shipping Act","0","0","0","0","0","0","0","0","0","0","0","0","0","0"
"2002","Edmonton, Alberta, municipal","48033","Canada Shipping Act","0","0","0","0","0","0","0","0","0","0","0","0","0","0"
"2003","Edmonton, Alberta, municipal","48033","Canada Shipping Act","0","0","0","0","0","0","0","0","0","0","0","0","0","0"
"2004","Edmonton, Alberta, municipal","48033","Canada Shipping Act","0","0","0","0","0","0","0","0","0","0","0","0","0","0"
"2005","Edmonton, Alberta, municipal","48033","Canada Shipping Act","0","0","0","0","0","0","0","0","0","0","0","0","0","0"
"2006","Edmonton, Alberta, municipal","48033","Canada Shipping Act","0","0","0","0","0","0","0","0","0","0","0","0","0","0"
"2007","Edmonton, Alberta, municipal","48033","Canada Shipping Act","0","0","0","0","0","0","0","0","0","0","0","0","0","0"
"2008","Edmonton, Alberta, municipal","48033","Canada Shipping Act","0","0","0","0","0","0","0","0","0","0","0","0","0","0"
"2009","Edmonton, Alberta, municipal","48033","Canada Shipping Act","0","0","0","0","0","0","0","0","0","0","0","0","0","0"
"2010","Edmonton, Alberta, municipal","48033","Canada Shipping Act","0","0","0","0","0","0","0","0","0","0","0","0","0","0"
"2011","Edmonton, Alberta, municipal","48033","Canada Shipping Act","0","0","0","0","0","0","0","0","0","0","0","0","0","0"
"2012","Edmonton, Alberta, municipal","48033","Canada Shipping Act","0","0","0","0","0","0","0","0","0","0","0","0","0","0"
"2013","Edmonton, Alberta, municipal","48033","Canada Shipping Act","0","0","0","0","0","0","0","0","0","0","0","0","0","0"
"2014","Edmonton, Alberta, municipal","48033","Canada Shipping Act","0","0","0","0","0","0","0","0","0","0","0","0","0","0"
"2015","Edmonton, Alberta, municipal","48033","Canada Shipping Act","0","0","0","0","0","0","0","0","0","0","0","0","0","0"
"2016","Edmonton, Alberta, municipal","48033","Canada Shipping Act","0","0","0","0","0","0","0","0","0","0","0","0","0","0"
"1998","Edmonton, Alberta, municipal","48033","Canada Health Act","6","5","0","0","0.92","0","0","0","0","5","8","8","0","0"
"1999","Edmonton, Alberta, municipal","48033","Canada Health Act","17","19","0","178.92","2.56","0","0","0","0","19","26","26","0","0"
"2000","Edmonton, Alberta, municipal","48033","Canada Health Act","0","0","0","-100","0","0","0","0","0","0","0","0","0","0"
"2001","Edmonton, Alberta, municipal","48033","Canada Health Act","11","10","0","0","1.61","0","0","0","0","10","13","13","0","0"
"2002","Edmonton, Alberta, municipal","48033","Canada Health Act","0","0","0","-100","0","0","0","0","0","0","0","0","0","0"
"2003","Edmonton, Alberta, municipal","48033","Canada Health Act","3","3","0","0","0.43","0","0","0","0","3","3","3","0","0"
"2004","Edmonton, Alberta, municipal","48033","Canada Health Act","0","0","0","-100","0","0","0","0","0","0","0","0","0","0"
"2005","Edmonton, Alberta, municipal","48033","Canada Health Act","0","0","0","0","0","0","0","0","0","0","0","0","0","0"
"2006","Edmonton, Alberta, municipal","48033","Canada Health Act","0","0","0","0","0","0","0","0","0","0","0","0","0","0"
"2007","Edmonton, Alberta, municipal","48033","Canada Health Act","0","0","0","0","0","0","0","0","0","0","0","0","0","0"
"2008","Edmonton, Alberta, municipal","48033","Canada Health Act","0","0","0","0","0","0","0","0","0","0","0","0","0","0"
"2009","Edmonton, Alberta, municipal","48033","Canada Health Act","0","0","0","0","0","0","0","0","0","0","0","0","0","0"
"2010","Edmonton, Alberta, municipal","48033","Canada Health Act","0","0","0","0","0","0","0","0","0","0","0","0","0","0"
"2011","Edmonton, Alberta, municipal","48033","Canada Health Act","0","0","0","0","0","0","0","0","0","0","0","0","0","0"
"2012","Edmonton, Alberta, municipal","48033","Canada Health Act","0","0","0","0","0","0","0","0","0","0","0","0","0","0"
"2013","Edmonton, Alberta, municipal","48033","Canada Health Act","0","0","0","0","0","0","0","0","0","0","0","0","0","0"
"2014","Edmonton, Alberta, municipal","48033","Canada Health Act","0","0","0","0","0","0","0","0","0","0","0","0","0","0"
"2015","Edmonton, Alberta, municipal","48033","Canada Health Act","0","0","0","0","0","0","0","0","0","0","0","0","0","0"
"2016","Edmonton, Alberta, municipal","48033","Canada Health Act","0","0","0","0","0","0","0","0","0","0","0","0","0","0"
"1998","Edmonton, Alberta, municipal","48033","Customs Act","24","0","8","0","3.67","0","0","0","0","8","0","0","0","0"
"1999","Edmonton, Alberta, municipal","48033","Customs Act","17","0","5","-30.27","2.56","0","0","0","0","5","0","0","0","0"
"2000","Edmonton, Alberta, municipal","48033","Customs Act","7","0","0","-59.44","1.04","0","0","0","0","0","0","0","0","0"
"2001","Edmonton, Alberta, municipal","48033","Customs Act","3","0","0","-57.73","0.44","0","0","0","0","0","0","0","0","0"
"2002","Edmonton, Alberta, municipal","48033","Customs Act","6","0","1","96.55","0.86","0","0","0","0","1","0","0","0","0"
"2003","Edmonton, Alberta, municipal","48033","Customs Act","7","0","0","15.36","1","0","0","0","0","0","0","0","0","0"
"2004","Edmonton, Alberta, municipal","48033","Customs Act","4","0","0","-44.27","0.56","0","0","0","0","0","0","0","0","0"
"2005","Edmonton, Alberta, municipal","48033","Customs Act","4","1","2","-2.27","0.54","0.17","0.16","0","0","3","1","1","0","0"
"2006","Edmonton, Alberta, municipal","48033","Customs Act","23","4","7","458.57","3.03","0.66","0.61","0","0","11","4","4","0","0"
"2007","Edmonton, Alberta, municipal","48033","Customs Act","22","0","7","-6.83","2.82","0","0","0","0","7","0","0","0","0"
"2008","Edmonton, Alberta, municipal","48033","Customs Act","9","0","7","-60.03","1.13","0","0","0","0","7","0","0","0","0"
"2009","Edmonton, Alberta, municipal","48033","Customs Act","4","0","0","-56.66","0.49","0","0","0","0","0","0","0","0","0"
"2010","Edmonton, Alberta, municipal","48033","Customs Act","9","0","4","121.4","1.08","0","0","0","0","4","0","0","0","0"
"2011","Edmonton, Alberta, municipal","48033","Customs Act","8","1","4","-12.63","0.95","0.15","0.14","0","0","5","1","1","0","0"
"2012","Edmonton, Alberta, municipal","48033","Customs Act","11","0","11","34.05","1.27","0","0","0","0","11","0","0","0","0"
"2013","Edmonton, Alberta, municipal","48033","Customs Act","0","0","0","-100","0","0","0","0","0","0","0","0","0","0"
"2014","Edmonton, Alberta, municipal","48033","Customs Act","2","0","0","0","0.22","0","0","0","0","0","0","0","0","0"
"2015","Edmonton, Alberta, municipal","48033","Customs Act","0","0","0","-100","0","0","0","0","0","0","0","0","0","0"
"2016","Edmonton, Alberta, municipal","48033","Customs Act","0","0","0","0","0","0","0","0","0","0","0","0","0","0"
"1998","Edmonton, Alberta, municipal","48033","Competition Act","0","0","0","0","0","0","0","0","0","0","0","0","0","0"
"1999","Edmonton, Alberta, municipal","48033","Competition Act","0","0","0","0","0","0","0","0","0","0","0","0","0","0"
"2000","Edmonton, Alberta, municipal","48033","Competition Act","0","0","0","0","0","0","0","0","0","0","0","0","0","0"
"2001","Edmonton, Alberta, municipal","48033","Competition Act","0","0","0","0","0","0","0","0","0","0","0","0","0","0"
"2002","Edmonton, Alberta, municipal","48033","Competition Act","0","0","0","0","0","0","0","0","0","0","0","0","0","0"
"2003","Edmonton, Alberta, municipal","48033","Competition Act","0","0","0","0","0","0","0","0","0","0","0","0","0","0"
"2004","Edmonton, Alberta, municipal","48033","Competition Act","0","0","0","0","0","0","0","0","0","0","0","0","0","0"
"2005","Edmonton, Alberta, municipal","48033","Competition Act","0","0","0","0","0","0","0","0","0","0","0","0","0","0"
"2006","Edmonton, Alberta, municipal","48033","Competition Act","0","0","0","0","0","0","0","0","0","0","0","0","0","0"
"2007","Edmonton, Alberta, municipal","48033","Competition Act","0","0","0","0","0","0","0","0","0","0","0","0","0","0"
"2008","Edmonton, Alberta, municipal","48033","Competition Act","0","0","0","0","0","0","0","0","0","0","0","0","0","0"
"2009","Edmonton, Alberta, municipal","48033","Competition Act","1","0","0","0","0.12","0","0","0","0","0","0","0","0","0"
"2010","Edmonton, Alberta, municipal","48033","Competition Act","0","0","0","-100","0","0","0","0","0","0","0","0","0","0"
"2011","Edmonton, Alberta, municipal","48033","Competition Act","0","0","0","0","0","0","0","0","0","0","0","0","0","0"
"2012","Edmonton, Alberta, municipal","48033","Competition Act","0","0","0","0","0","0","0","0","0","0","0","0","0","0"
"2013","Edmonton, Alberta, municipal","48033","Competition Act","0","0","0","0","0","0","0","0","0","0","0","0","0","0"
"2014","Edmonton, Alberta, municipal","48033","Competition Act","0","0","0","0","0","0","0","0","0","0","0","0","0","0"
"2015","Edmonton, Alberta, municipal","48033","Competition Act","0","0","0","0","0","0","0","0","0","0","0","0","0","0"
"2016","Edmonton, Alberta, municipal","48033","Competition Act","0","0","0","0","0","0","0","0","0","0","0","0","0","0"
"1998","Edmonton, Alberta, municipal","48033","Excise Act","8","2","3","0","1.22","0","0","0","0","5","2","2","0","0"
"1999","Edmonton, Alberta, municipal","48033","Excise Act","8","3","4","-1.56","1.21","0","0","0","0","7","3","3","0","0"
"2000","Edmonton, Alberta, municipal","48033","Excise Act","2","0","0","-75.37","0.3","0","0","0","0","0","0","0","0","0"
"2001","Edmonton, Alberta, municipal","48033","Excise Act","2","0","0","-1.37","0.29","0","0","0","0","0","0","0","0","0"
"2002","Edmonton, Alberta, municipal","48033","Excise Act","3","0","0","47.42","0.43","0","0","0","0","0","0","0","0","0"
"2003","Edmonton, Alberta, municipal","48033","Excise Act","3","1","1","-1.12","0.43","0","0","0","0","2","1","1","0","0"
"2004","Edmonton, Alberta, municipal","48033","Excise Act","1","4","1","-67.49","0.14","0.7","0.64","0","0","5","4","4","0","0"
"2005","Edmonton, Alberta, municipal","48033","Excise Act","1","0","0","-2.27","0.14","0","0","0","0","0","0","0","0","0"
"2006","Edmonton, Alberta, municipal","48033","Excise Act","1","0","0","-2.86","0.13","0","0","0","0","0","0","0","0","0"
"2007","Edmonton, Alberta, municipal","48033","Excise Act","3","1","2","192.21","0.39","0.16","0.15","0","0","3","1","1","0","0"
"2008","Edmonton, Alberta, municipal","48033","Excise Act","3","1","1","-2.31","0.38","0.16","0.14","0","0","2","1","1","0","0"
"2009","Edmonton, Alberta, municipal","48033","Excise Act","10","2","1","225.08","1.22","0.46","0.42","0","0","3","3","3","0","0"
"2010","Edmonton, Alberta, municipal","48033","Excise Act","5","0","3","-50.8","0.6","0","0","0","0","3","0","0","0","0"
"2011","Edmonton, Alberta, municipal","48033","Excise Act","4","0","0","-21.36","0.47","0","0","0","0","0","0","0","0","0"
"2012","Edmonton, Alberta, municipal","48033","Excise Act","3","0","2","-26.88","0.35","0","0","0","0","2","0","0","0","0"
"2013","Edmonton, Alberta, municipal","48033","Excise Act","0","0","2","-100","0","0","0","0","0","2","0","0","0","0"
"2014","Edmonton, Alberta, municipal","48033","Excise Act","0","0","0","0","0","0","0","0","0","0","0","0","0","0"
"2015","Edmonton, Alberta, municipal","48033","Excise Act","0","0","0","0","0","0","0","0","0","0","0","0","0","0"
"2016","Edmonton, Alberta, municipal","48033","Excise Act","0","0","0","0","0","0","0","0","0","0","0","0","0","0"
"1998","Edmonton, Alberta, municipal","48033","Total Immigration and Refugee Protection Act","72","9","67","0","11.02","0","0","0","0","76","9","9","0","0"
"1999","Edmonton, Alberta, municipal","48033","Total Immigration and Refugee Protection Act","55","11","24","-24.8","8.29","0","0","0","0","35","7","7","0","0"
"2000","Edmonton, Alberta, municipal","48033","Total Immigration and Refugee Protection Act","21","6","15","-62.39","3.12","0","0","0","0","21","5","6","1","0"
"2001","Edmonton, Alberta, municipal","48033","Total Immigration and Refugee Protection Act","28","7","2","31.51","4.1","0","0","0","0","9","5","5","0","0"
"2002","Edmonton, Alberta, municipal","48033","Total Immigration and Refugee Protection Act","25","1","10","-12.25","3.6","0","0","0","0","11","2","2","0","0"
"2003","Edmonton, Alberta, municipal","48033","Total Immigration and Refugee Protection Act","29","2","7","14.7","4.13","0","0","0","0","9","4","4","0","0"
"2004","Edmonton, Alberta, municipal","48033","Total Immigration and Refugee Protection Act","55","16","7","84.97","7.63","2.82","2.57","0","0","23","16","16","0","0"
"2005","Edmonton, Alberta, municipal","48033","Total Immigration and Refugee Protection Act","8","2","3","-85.78","1.09","0.69","0.63","0","0","5","4","4","0","0"
"2006","Edmonton, Alberta, municipal","48033","Total Immigration and Refugee Protection Act","6","0","2","-27.14","0.79","0","0","0","0","2","0","0","0","0"
"2007","Edmonton, Alberta, municipal","48033","Total Immigration and Refugee Protection Act","2","0","0","-67.53","0.26","0","0","0","0","0","0","0","0","0"
"2008","Edmonton, Alberta, municipal","48033","Total Immigration and Refugee Protection Act","3","0","2","46.54","0.38","0","0","0","0","2","0","0","0","0"
"2009","Edmonton, Alberta, municipal","48033","Total Immigration and Refugee Protection Act","4","0","1","30.03","0.49","0","0","0","0","1","0","0","0","0"
"2010","Edmonton, Alberta, municipal","48033","Total Immigration and Refugee Protection Act","5","0","2","23","0.6","0","0","0","0","2","0","0","0","0"
"2011","Edmonton, Alberta, municipal","48033","Total Immigration and Refugee Protection Act","2","0","1","-60.68","0.24","0","0","0","0","1","0","0","0","0"
"2012","Edmonton, Alberta, municipal","48033","Total Immigration and Refugee Protection Act","2","0","0","-2.51","0.23","0","0","0","0","0","0","0","0","0"
"2013","Edmonton, Alberta, municipal","48033","Total Immigration and Refugee Protection Act","11","0","6","431.89","1.23","0","0","0","0","6","0","0","0","0"
"2014","Edmonton, Alberta, municipal","48033","Total Immigration and Refugee Protection Act","15","1","6","31.92","1.62","0.27","0.25","0","0","7","2","2","0","0"
"2015","Edmonton, Alberta, municipal","48033","Total Immigration and Refugee Protection Act","12","0","5","-21.73","1.27","0","0","0","0","5","0","0","0","0"
"2016","Edmonton, Alberta, municipal","48033","Total Immigration and Refugee Protection Act","10","1","5","-18.52","1.03","0.13","0.12","0","0","6","1","1","0","0"
"1998","Edmonton, Alberta, municipal","48033","Firearms Act","0","0","0","0","0","0","0","0","0","0","0","0","0","0"
"1999","Edmonton, Alberta, municipal","48033","Firearms Act","0","0","0","0","0","0","0","0","0","0","0","0","0","0"
"2000","Edmonton, Alberta, municipal","48033","Firearms Act","0","0","0","0","0","0","0","0","0","0","0","0","0","0"
"2001","Edmonton, Alberta, municipal","48033","Firearms Act","2","2","0","0","0.29","0","0","0","0","2","2","3","1","0"
"2002","Edmonton, Alberta, municipal","48033","Firearms Act","1","1","0","-50.86","0.14","0","0","0","0","1","2","2","0","0"
"2003","Edmonton, Alberta, municipal","48033","Firearms Act","0","0","0","-100","0","0","0","0","0","0","0","0","0","0"
"2004","Edmonton, Alberta, municipal","48033","Firearms Act","0","0","0","0","0","0","0","0","0","0","0","0","0","0"
"2005","Edmonton, Alberta, municipal","48033","Firearms Act","0","0","0","0","0","0","0","0","0","0","0","0","0","0"
"2006","Edmonton, Alberta, municipal","48033","Firearms Act","5","0","1","0","0.66","0","0","0","0","1","0","0","0","0"
"2007","Edmonton, Alberta, municipal","48033","Firearms Act","0","0","0","-100","0","0","0","0","0","0","0","0","0","0"
"2008","Edmonton, Alberta, municipal","48033","Firearms Act","0","0","0","0","0","0","0","0","0","0","0","0","0","0"
"2009","Edmonton, Alberta, municipal","48033","Firearms Act","0","0","0","0","0","0","0","0","0","0","0","0","0","0"
"2010","Edmonton, Alberta, municipal","48033","Firearms Act","2","0","1","0","0.24","0","0","0","0","1","0","0","0","0"
"2011","Edmonton, Alberta, municipal","48033","Firearms Act","2","1","1","-1.71","0.24","0.15","0.14","0","3.63","2","1","1","0","2"
"2012","Edmonton, Alberta, municipal","48033","Firearms Act","6","0","2","192.47","0.69","0","0","0","0","2","0","0","0","0"
"2013","Edmonton, Alberta, municipal","48033","Firearms Act","7","1","1","12.82","0.78","0.14","0.13","0","0","2","1","1","0","0"
"2014","Edmonton, Alberta, municipal","48033","Firearms Act","3","0","2","-58.54","0.32","0","0","0","1.84","2","0","0","0","1"
"2015","Edmonton, Alberta, municipal","48033","Firearms Act","0","0","0","-100","0","0","0","0","0","0","0","0","0","0"
"2016","Edmonton, Alberta, municipal","48033","Firearms Act","4","0","0","0","0.41","0","0","0","0","0","0","0","0","0"
"2002","Edmonton, Alberta, municipal","48033","National Defence Act","0","0","0","0","0","0","0","0","0","0","0","0","0","0"
"2003","Edmonton, Alberta, municipal","48033","National Defence Act","0","0","0","0","0","0","0","0","0","0","0","0","0","0"
"2004","Edmonton, Alberta, municipal","48033","National Defence Act","0","0","0","0","0","0","0","0","0","0","0","0","0","0"
"2005","Edmonton, Alberta, municipal","48033","National Defence Act","0","0","0","0","0","0","0","0","0","0","0","0","0","0"
"2006","Edmonton, Alberta, municipal","48033","National Defence Act","0","0","0","0","0","0","0","0","0","0","0","0","0","0"
"2007","Edmonton, Alberta, municipal","48033","National Defence Act","0","0","0","0","0","0","0","0","0","0","0","0","0","0"
"2008","Edmonton, Alberta, municipal","48033","National Defence Act","0","0","0","0","0","0","0","0","0","0","0","0","0","0"
"2009","Edmonton, Alberta, municipal","48033","National Defence Act","0","0","0","0","0","0","0","0","0","0","0","0","0","0"
"2010","Edmonton, Alberta, municipal","48033","National Defence Act","0","0","0","0","0","0","0","0","0","0","0","0","0","0"
"2011","Edmonton, Alberta, municipal","48033","National Defence Act","0","0","0","0","0","0","0","0","0","0","0","0","0","0"
"2012","Edmonton, Alberta, municipal","48033","National Defence Act","0","0","0","0","0","0","0","0","0","0","0","0","0","0"
"2013","Edmonton, Alberta, municipal","48033","National Defence Act","0","0","0","0","0","0","0","0","0","0","0","0","0","0"
"2014","Edmonton, Alberta, municipal","48033","National Defence Act","0","0","0","0","0","0","0","0","0","0","0","0","0","0"
"2015","Edmonton, Alberta, municipal","48033","National Defence Act","0","0","0","0","0","0","0","0","0","0","0","0","0","0"
"2016","Edmonton, Alberta, municipal","48033","National Defence Act","0","0","0","0","0","0","0","0","0","0","0","0","0","0"
"1998","Edmonton, Alberta, municipal","48033","Other federal statutes","69","52","0","0","10.56","0","0","0","0","52","50","56","6","0"
"1999","Edmonton, Alberta, municipal","48033","Other federal statutes","47","52","7","-32.95","7.08","0","0","0","0","59","63","66","3","3"
"2000","Edmonton, Alberta, municipal","48033","Other federal statutes","21","16","5","-55.99","3.12","0","0","0","0","21","23","23","0","0"
"2001","Edmonton, Alberta, municipal","48033","Other federal statutes","34","27","0","59.69","4.98","0","0","0","0","27","36","40","4","0"
"2002","Edmonton, Alberta, municipal","48033","Other federal statutes","14","9","15","-59.53","2.01","0","0","0","0","24","11","12","1","0"
"2003","Edmonton, Alberta, municipal","48033","Other federal statutes","3","4","2","-78.81","0.43","0","0","0","0","6","2","3","1","0"
"2004","Edmonton, Alberta, municipal","48033","Other federal statutes","14","8","0","355.13","1.94","0.7","1.12","5.43","0","8","4","7","3","0"
"2005","Edmonton, Alberta, municipal","48033","Other federal statutes","9","6","1","-37.17","1.22","1.2","1.09","0","0","7","7","7","0","0"
"2006","Edmonton, Alberta, municipal","48033","Other federal statutes","5","3","1","-46.03","0.66","0.5","0.45","0","0","4","3","3","0","0"
"2007","Edmonton, Alberta, municipal","48033","Other federal statutes","6","4","1","16.88","0.77","2.57","2.36","0","0","5","16","16","0","0"
"2008","Edmonton, Alberta, municipal","48033","Other federal statutes","8","1","1","30.26","1","0.16","0.14","0","0","2","1","1","0","0"
"2009","Edmonton, Alberta, municipal","48033","Other federal statutes","11","2","4","34.09","1.34","0.15","0.14","0","0","6","1","1","0","0"
"2010","Edmonton, Alberta, municipal","48033","Other federal statutes","14","1","10","25.24","1.68","0","0","0","0","11","0","0","0","0"
"2011","Edmonton, Alberta, municipal","48033","Other federal statutes","2","0","1","-85.96","0.24","0","0","0","0","1","0","0","0","0"
"2012","Edmonton, Alberta, municipal","48033","Other federal statutes","4","0","1","94.98","0.46","0","0","0","0","1","0","0","0","0"
"2013","Edmonton, Alberta, municipal","48033","Other federal statutes","3","1","0","-27.47","0.33","0.14","0.13","0","0","1","1","1","0","0"
"2014","Edmonton, Alberta, municipal","48033","Other federal statutes","6","1","1","93.48","0.65","0.13","0.12","0","0","2","1","1","0","0"
"2015","Edmonton, Alberta, municipal","48033","Other federal statutes","4","2","0","-34.77","0.42","0.13","0.24","1.83","0","2","1","2","1","0"
"2016","Edmonton, Alberta, municipal","48033","Other federal statutes","8","3","2","95.56","0.83","0.38","0.36","0","0","5","3","3","0","0"
"1998","Medicine Hat, Alberta, municipal","48062","Total, all violations","4434","1828","222","0","8921.89","0","0","0","0","2050","1343","2066","723","155"
"1999","Medicine Hat, Alberta, municipal","48062","Total, all violations","5047","2033","171","11.68","9963.68","0","0","0","0","2204","1460","2304","844","151"
"2000","Medicine Hat, Alberta, municipal","48062","Total, all violations","4485","1958","141","-13.13","8655.79","0","0","0","0","2099","1499","2198","699","153"
"2001","Medicine Hat, Alberta, municipal","48062","Total, all violations","4133","1742","234","-9.18","7861.6","0","0","0","0","1976","1365","1789","424","110"
"2002","Medicine Hat, Alberta, municipal","48062","Total, all violations","4481","1993","186","6.72","8390.29","0","0","0","0","2179","1605","2083","478","70"
"2003","Medicine Hat, Alberta, municipal","48062","Total, all violations","4560","2030","139","0.29","8414.84","0","0","0","0","2169","1640","2080","440","103"
"2004","Medicine Hat, Alberta, municipal","48062","Total, all violations","5159","2383","151","9.78","9237.74","4364.45","4606.02","6981.98","2319.82","2534","1906","2216","310","103"
"2005","Medicine Hat, Alberta, municipal","48062","Total, all violations","4602","2406","157","-13.22","8016.58","4569.18","4929.02","8525.75","2464.48","2563","2057","2441","384","111"
"2006","Medicine Hat, Alberta, municipal","48062","Total, all violations","4702","2176","111","-0.5","7976.66","4182.29","4502.42","7806.94","1379","2287","1941","2292","351","62"
"2007","Medicine Hat, Alberta, municipal","48062","Total, all violations","5129","2633","166","6.53","8497.77","5176.11","5353.72","7238.31","2049","2799","2466","2791","325","92"
"2008","Medicine Hat, Alberta, municipal","48062","Total, all violations","4924","2847","182","-5.53","8027.91","5257.95","5679.16","10269.66","2202.25","3029","2550","3007","457","98"
"2009","Medicine Hat, Alberta, municipal","48062","Total, all violations","5198","3011","206","4.44","8384.28","5558.38","5939.09","10210.14","2078.57","3217","2730","3177","447","91"
"2010","Medicine Hat, Alberta, municipal","48062","Total, all violations","5031","3079","157","-3.23","8113.86","5919.14","6038.5","7381.93","1444.29","3236","2906","3228","322","63"
"2011","Medicine Hat, Alberta, municipal","48062","Total, all violations","5150","3070","128","2.38","8306.85","5523.77","5823.28","9197.25","848.62","3198","2713","3114","401","37"
"2012","Medicine Hat, Alberta, municipal","48062","Total, all violations","4564","2872","133","-12.44","7273.42","5298.92","5535.33","8221.06","1324.5","3005","2636","2996","360","58"
"2013","Medicine Hat, Alberta, municipal","48062","Total, all violations","4219","2690","179","-8.7","6640.85","5027.78","5134.85","6371.76","1329.36","2869","2534","2812","278","58"
"2014","Medicine Hat, Alberta, municipal","48062","Total, all violations","4604","2394","407","8.19","7184.43","4303.84","4411.82","5681.29","2609.7","2801","2191","2437","246","113"
"2015","Medicine Hat, Alberta, municipal","48062","Total, all violations","5025","2590","396","8.32","7781.89","4775.01","4753.08","4494.12","3295.69","2986","2447","2642","195","143"
"2016","Medicine Hat, Alberta, municipal","48062","Total, all violations","5903","2922","324","16.75","9085.73","5411.34","5359.41","4746.62","1880.3","3246","2785","2992","207","82"
"1998","Medicine Hat, Alberta, municipal","48062","Total, all Criminal Code violations (including traffic)","4184","1576","217","0","8418.85","0","0","0","0","1793","1243","1797","554","149"
"1999","Medicine Hat, Alberta, municipal","48062","Total, all Criminal Code violations (including traffic)","4779","1785","163","12.07","9434.6","0","0","0","0","1948","1373","2028","655","148"
"2000","Medicine Hat, Alberta, municipal","48062","Total, all Criminal Code violations (including traffic)","4284","1781","139","-12.37","8267.88","0","0","0","0","1920","1418","2010","592","152"
"2001","Medicine Hat, Alberta, municipal","48062","Total, all Criminal Code violations (including traffic)","3963","1593","228","-8.83","7538.23","0","0","0","0","1821","1265","1625","360","103"
"2002","Medicine Hat, Alberta, municipal","48062","Total, all Criminal Code violations (including traffic)","4298","1825","182","6.76","8047.63","0","0","0","0","2007","1513","1894","381","67"
"2003","Medicine Hat, Alberta, municipal","48062","Total, all Criminal Code violations (including traffic)","4305","1813","133","-1.28","7944.27","0","0","0","0","1946","1479","1842","363","100"
"2004","Medicine Hat, Alberta, municipal","48062","Total, all Criminal Code violations (including traffic)","5002","2245","143","12.74","8956.61","4094.25","4283.84","6148.65","2139.64","2388","1788","2061","273","95"
"2005","Medicine Hat, Alberta, municipal","48062","Total, all Criminal Code violations (including traffic)","4356","2173","149","-15.28","7588.06","4053.84","4357.57","7393.43","2375.67","2322","1825","2158","333","107"
"2006","Medicine Hat, Alberta, municipal","48062","Total, all Criminal Code violations (including traffic)","4519","2020","109","1.03","7666.21","3775.05","4080.07","7228.65","1290.04","2129","1752","2077","325","58"
"2007","Medicine Hat, Alberta, municipal","48062","Total, all Criminal Code violations (including traffic)","4879","2402","154","5.44","8083.57","4582.09","4760.99","6659.24","1959.91","2556","2183","2482","299","88"
"2008","Medicine Hat, Alberta, municipal","48062","Total, all Criminal Code violations (including traffic)","4634","2597","149","-6.54","7555.11","4740.4","5054.02","8471.91","1977.53","2746","2299","2676","377","88"
"2009","Medicine Hat, Alberta, municipal","48062","Total, all Criminal Code violations (including traffic)","4911","2769","177","4.85","7921.35","5047.34","5320.32","8382.82","1758.79","2946","2479","2846","367","77"
"2010","Medicine Hat, Alberta, municipal","48062","Total, all Criminal Code violations (including traffic)","4707","2811","119","-4.17","7591.32","5259.19","5342.61","6281.52","1054.56","2930","2582","2856","274","46"
"2011","Medicine Hat, Alberta, municipal","48062","Total, all Criminal Code violations (including traffic)","4804","2772","101","2.07","7748.76","4853.91","5084.62","7683.49","733.94","2873","2384","2719","335","32"
"2012","Medicine Hat, Alberta, municipal","48062","Total, all Criminal Code violations (including traffic)","4219","2575","111","-13.23","6723.61","4609.42","4805.54","7033.57","1096.14","2686","2293","2601","308","48"
"2013","Medicine Hat, Alberta, municipal","48062","Total, all Criminal Code violations (including traffic)","3924","2446","156","-8.14","6176.51","4351.19","4411.74","5111.16","1168.92","2602","2193","2416","223","51"
"2014","Medicine Hat, Alberta, municipal","48062","Total, all Criminal Code violations (including traffic)","4304","2160","344","8.74","6716.29","3875.62","3881.39","3949.19","2217.09","2504","1973","2144","171","96"
"2015","Medicine Hat, Alberta, municipal","48062","Total, all Criminal Code violations (including traffic)","4737","2384","331","9.23","7335.88","4328.14","4256.54","3410.92","2396.87","2715","2218","2366","148","104"
"2016","Medicine Hat, Alberta, municipal","48062","Total, all Criminal Code violations (including traffic)","5618","2696","280","17.87","8647.07","4859.52","4813.08","4265.08","1444.62","2976","2501","2687","186","63"
"1998","Medicine Hat, Alberta, municipal","48062","Total, all Criminal Code violations (excluding traffic)","3965","1371","216","0","7978.19","0","0","0","0","1587","1033","1587","554","149"
"1999","Medicine Hat, Alberta, municipal","48062","Total, all Criminal Code violations (excluding traffic)","4580","1577","163","13.33","9041.73","0","0","0","0","1740","1162","1817","655","148"
"2000","Medicine Hat, Alberta, municipal","48062","Total, all Criminal Code violations (excluding traffic)","4068","1581","138","-13.17","7851.01","0","0","0","0","1719","1212","1804","592","152"
"2001","Medicine Hat, Alberta, municipal","48062","Total, all Criminal Code violations (excluding traffic)","3750","1392","228","-9.14","7133.07","0","0","0","0","1620","1063","1423","360","103"
"2002","Medicine Hat, Alberta, municipal","48062","Total, all Criminal Code violations (excluding traffic)","4044","1576","181","6.15","7572.04","0","0","0","0","1757","1260","1640","380","67"
"2003","Medicine Hat, Alberta, municipal","48062","Total, all Criminal Code violations (excluding traffic)","4082","1606","133","-0.52","7532.76","0","0","0","0","1739","1273","1636","363","100"
"2004","Medicine Hat, Alberta, municipal","48062","Total, all Criminal Code violations (excluding traffic)","4773","2005","140","13.46","8546.56","3544.69","3785","6148.65","2139.64","2145","1548","1821","273","95"
"2005","Medicine Hat, Alberta, municipal","48062","Total, all Criminal Code violations (excluding traffic)","4108","1954","147","-16.27","7156.05","3558.5","3907.28","7393.43","2375.67","2101","1602","1935","333","107"
"2006","Medicine Hat, Alberta, municipal","48062","Total, all Criminal Code violations (excluding traffic)","4277","1801","107","1.39","7255.67","3290.24","3638.08","7228.65","1290.04","1908","1527","1852","325","58"
"2007","Medicine Hat, Alberta, municipal","48062","Total, all Criminal Code violations (excluding traffic)","4517","2047","153","3.14","7483.8","3845.35","4072.35","6481.07","1959.91","2200","1832","2123","291","88"
"2008","Medicine Hat, Alberta, municipal","48062","Total, all Criminal Code violations (excluding traffic)","4266","2234","147","-7.06","6955.13","4008.41","4366.55","8269.66","1977.53","2381","1944","2312","368","88"
"2009","Medicine Hat, Alberta, municipal","48062","Total, all Criminal Code violations (excluding traffic)","4486","2346","176","4.04","7235.83","4194.24","4523.96","8222.93","1758.79","2522","2060","2420","360","77"
"2010","Medicine Hat, Alberta, municipal","48062","Total, all Criminal Code violations (excluding traffic)","4194","2302","117","-6.52","6763.97","4230.57","4384.83","6121.05","1054.56","2419","2077","2344","267","46"
"2011","Medicine Hat, Alberta, municipal","48062","Total, all Criminal Code violations (excluding traffic)","4330","2315","99","3.26","6984.21","3933.63","4228.14","7545.87","733.94","2414","1932","2261","329","32"
"2012","Medicine Hat, Alberta, municipal","48062","Total, all Criminal Code violations (excluding traffic)","3855","2213","110","-12.04","6143.52","3899.81","4133.03","6782.37","1096.14","2323","1940","2237","297","48"
"2013","Medicine Hat, Alberta, municipal","48062","Total, all Criminal Code violations (excluding traffic)","3653","2204","135","-6.41","5749.95","3869.05","3966.18","5088.24","1123.08","2339","1950","2172","222","49"
"2014","Medicine Hat, Alberta, municipal","48062","Total, all Criminal Code violations (excluding traffic)","4068","1939","330","10.4","6348.02","3449.36","3481.3","3856.81","2217.09","2269","1756","1923","167","96"
"2015","Medicine Hat, Alberta, municipal","48062","Total, all Criminal Code violations (excluding traffic)","4532","2187","327","10.56","7018.41","3949.58","3902.13","3341.78","2396.87","2514","2024","2169","145","104"
"2016","Medicine Hat, Alberta, municipal","48062","Total, all Criminal Code violations (excluding traffic)","5467","2548","280","19.89","8414.65","4581.67","4553.35","4219.22","1444.62","2828","2358","2542","184","63"
"1998","Medicine Hat, Alberta, municipal","48062","Total violent Criminal Code violations","407","267","32","0","818.95","0","0","0","0","299","207","260","53","11"
"1999","Medicine Hat, Alberta, municipal","48062","Total violent Criminal Code violations","438","303","26","5.59","864.69","0","0","0","0","329","244","302","58","12"
"2000","Medicine Hat, Alberta, municipal","48062","Total violent Criminal Code violations","486","307","23","8.47","937.95","0","0","0","0","330","232","306","74","15"
"2001","Medicine Hat, Alberta, municipal","48062","Total violent Criminal Code violations","515","353","62","4.44","979.61","0","0","0","0","415","268","327","59","14"
"2002","Medicine Hat, Alberta, municipal","48062","Total violent Criminal Code violations","550","422","53","5.13","1029.83","0","0","0","0","475","351","433","82","7"
"2003","Medicine Hat, Alberta, municipal","48062","Total violent Criminal Code violations","528","357","34","-5.39","974.35","0","0","0","0","391","304","339","35","18"
"2004","Medicine Hat, Alberta, municipal","48062","Total violent Criminal Code violations","575","421","32","5.67","1029.6","826.64","860.51","1193.69","202.7","453","361","414","53","9"
"2005","Medicine Hat, Alberta, municipal","48062","Total violent Criminal Code violations","612","464","49","3.54","1066.09","868.52","890.5","1110.12","355.24","513","391","441","50","16"
"2006","Medicine Hat, Alberta, municipal","48062","Total violent Criminal Code violations","646","488","27","2.8","1095.9","902.82","907.56","956.41","177.94","515","419","462","43","8"
"2007","Medicine Hat, Alberta, municipal","48062","Total violent Criminal Code violations","695","520","53","5.07","1151.48","921.46","966.78","1447.66","311.8","573","439","504","65","14"
"2008","Medicine Hat, Alberta, municipal","48062","Total violent Criminal Code violations","686","517","34","-2.87","1118.43","896.94","942.43","1438.2","269.66","551","435","499","64","12"
"2009","Medicine Hat, Alberta, municipal","48062","Total violent Criminal Code violations","798","600","76","15.09","1287.16","1046.52","1101.08","1713.11","274.1","676","514","589","75","12"
"2010","Medicine Hat, Alberta, municipal","48062","Total violent Criminal Code violations","783","607","50","-1.89","1262.8","1057.13","1043.83","894.09","320.95","657","519","558","39","14"
"2011","Medicine Hat, Alberta, municipal","48062","Total violent Criminal Code violations","694","531","42","-11.36","1119.41","916.22","923.8","1009.17","137.61","573","450","494","44","6"
"2012","Medicine Hat, Alberta, municipal","48062","Total violent Criminal Code violations","751","565","34","6.92","1196.83","978.97","994","1164.65","251.2","599","487","538","51","11"
"2013","Medicine Hat, Alberta, municipal","48062","Total violent Criminal Code violations","657","509","35","-13.59","1034.14","873.02","860.07","710.52","68.76","544","440","471","31","3"
"2014","Medicine Hat, Alberta, municipal","48062","Total violent Criminal Code violations","724","490","67","9.25","1129.78","885.91","870.78","692.84","277.14","557","451","481","30","12"
"2015","Medicine Hat, Alberta, municipal","48062","Total violent Criminal Code violations","760","555","62","4.18","1176.96","981.54","944.5","507.03","230.47","617","503","525","22","10"
"2016","Medicine Hat, Alberta, municipal","48062","Total violent Criminal Code violations","709","534","41","-7.28","1091.27","932.65","922.49","802.57","160.51","575","480","515","35","7"
"1998","Medicine Hat, Alberta, municipal","48062","Homicide","0","0","0","0","0","0","0","0","0","0","0","0","0","0"
"1999","Medicine Hat, Alberta, municipal","48062","Homicide","0","0","0","0","0","0","0","0","0","0","0","0","0","0"
"2000","Medicine Hat, Alberta, municipal","48062","Homicide","0","0","0","0","0","0","0","0","0","0","0","0","0","0"
"2001","Medicine Hat, Alberta, municipal","48062","Homicide","3","3","0","0","5.71","0","0","0","0","3","1","1","0","0"
"2002","Medicine Hat, Alberta, municipal","48062","Homicide","1","1","0","-67.19","1.87","0","0","0","0","1","2","2","0","0"
"2003","Medicine Hat, Alberta, municipal","48062","Homicide","0","0","0","-100","0","0","0","0","0","0","0","0","0","0"
"2004","Medicine Hat, Alberta, municipal","48062","Homicide","0","0","0","0","0","0","0","0","0","0","0","0","0","0"
"2005","Medicine Hat, Alberta, municipal","48062","Homicide","1","1","0","0","1.74","2.22","2.02","0","0","1","1","1","0","0"
"2006","Medicine Hat, Alberta, municipal","48062","Homicide","3","3","0","192.16","5.09","2.15","3.93","22.24","0","3","1","2","1","0"
"2007","Medicine Hat, Alberta, municipal","48062","Homicide","0","0","0","-100","0","0","0","0","0","0","0","0","0","0"
"2008","Medicine Hat, Alberta, municipal","48062","Homicide","0","0","0","0","0","0","0","0","0","0","0","0","0","0"
"2009","Medicine Hat, Alberta, municipal","48062","Homicide","3","3","0","0","4.84","8.14","7.48","0","0","3","4","4","0","0"
"2010","Medicine Hat, Alberta, municipal","48062","Homicide","2","2","0","-33.34","3.23","4.07","3.74","0","0","2","2","2","0","0"
"2011","Medicine Hat, Alberta, municipal","48062","Homicide","2","2","0","0.01","3.23","6.11","5.61","0","0","2","3","3","0","0"
"2012","Medicine Hat, Alberta, municipal","48062","Homicide","3","1","1","48.2","4.78","2.01","1.85","0","0","2","1","1","0","0"
"2013","Medicine Hat, Alberta, municipal","48062","Homicide","1","0","1","-67.08","1.57","0","0","0","0","1","0","0","0","0"
"2014","Medicine Hat, Alberta, municipal","48062","Homicide","0","0","0","-100","0","0","0","0","0","0","0","0","0","0"
"2015","Medicine Hat, Alberta, municipal","48062","Homicide","0","0","0","0","0","0","0","0","0","0","0","0","0","0"
"2016","Medicine Hat, Alberta, municipal","48062","Homicide","4","3","0","0","6.16","7.77","7.16","0","0","3","4","4","0","0"
"1998","Medicine Hat, Alberta, municipal","48062","Murder, first degree","0","0","0","0","0","0","0","0","0","0","0","0","0","0"
"1999","Medicine Hat, Alberta, municipal","48062","Murder, first degree","0","0","0","0","0","0","0","0","0","0","0","0","0","0"
"2000","Medicine Hat, Alberta, municipal","48062","Murder, first degree","0","0","0","0","0","0","0","0","0","0","0","0","0","0"
"2001","Medicine Hat, Alberta, municipal","48062","Murder, first degree","3","3","0","0","5.71","0","0","0","0","3","1","1","0","0"
"2002","Medicine Hat, Alberta, municipal","48062","Murder, first degree","1","1","0","-67.19","1.87","0","0","0","0","1","2","2","0","0"
"2003","Medicine Hat, Alberta, municipal","48062","Murder, first degree","0","0","0","-100","0","0","0","0","0","0","0","0","0","0"
"2004","Medicine Hat, Alberta, municipal","48062","Murder, first degree","0","0","0","0","0","0","0","0","0","0","0","0","0","0"
"2005","Medicine Hat, Alberta, municipal","48062","Murder, first degree","1","1","0","0","1.74","2.22","2.02","0","0","1","1","1","0","0"
"2006","Medicine Hat, Alberta, municipal","48062","Murder, first degree","3","3","0","192.16","5.09","2.15","3.93","22.24","0","3","1","2","1","0"
"2007","Medicine Hat, Alberta, municipal","48062","Murder, first degree","0","0","0","-100","0","0","0","0","0","0","0","0","0","0"
"2008","Medicine Hat, Alberta, municipal","48062","Murder, first degree","0","0","0","0","0","0","0","0","0","0","0","0","0","0"
"2009","Medicine Hat, Alberta, municipal","48062","Murder, first degree","0","0","0","0","0","0","0","0","0","0","0","0","0","0"
"2010","Medicine Hat, Alberta, municipal","48062","Murder, first degree","0","0","0","0","0","0","0","0","0","0","0","0","0","0"
"2011","Medicine Hat, Alberta, municipal","48062","Murder, first degree","2","2","0","0","3.23","6.11","5.61","0","0","2","3","3","0","0"
"2012","Medicine Hat, Alberta, municipal","48062","Murder, first degree","1","0","0","-50.6","1.59","0","0","0","0","0","0","0","0","0"
"2013","Medicine Hat, Alberta, municipal","48062","Murder, first degree","1","0","1","-1.23","1.57","0","0","0","0","1","0","0","0","0"
"2014","Medicine Hat, Alberta, municipal","48062","Murder, first degree","0","0","0","-100","0","0","0","0","0","0","0","0","0","0"
"2015","Medicine Hat, Alberta, municipal","48062","Murder, first degree","0","0","0","0","0","0","0","0","0","0","0","0","0","0"
"2016","Medicine Hat, Alberta, municipal","48062","Murder, first degree","0","0","0","0","0","0","0","0","0","0","0","0","0","0"
"1998","Medicine Hat, Alberta, municipal","48062","Murder, second degree","0","0","0","0","0","0","0","0","0","0","0","0","0","0"
"1999","Medicine Hat, Alberta, municipal","48062","Murder, second degree","0","0","0","0","0","0","0","0","0","0","0","0","0","0"
"2000","Medicine Hat, Alberta, municipal","48062","Murder, second degree","0","0","0","0","0","0","0","0","0","0","0","0","0","0"
"2001","Medicine Hat, Alberta, municipal","48062","Murder, second degree","0","0","0","0","0","0","0","0","0","0","0","0","0","0"
"2002","Medicine Hat, Alberta, municipal","48062","Murder, second degree","0","0","0","0","0","0","0","0","0","0","0","0","0","0"
"2003","Medicine Hat, Alberta, municipal","48062","Murder, second degree","0","0","0","0","0","0","0","0","0","0","0","0","0","0"
"2004","Medicine Hat, Alberta, municipal","48062","Murder, second degree","0","0","0","0","0","0","0","0","0","0","0","0","0","0"
"2005","Medicine Hat, Alberta, municipal","48062","Murder, second degree","0","0","0","0","0","0","0","0","0","0","0","0","0","0"
"2006","Medicine Hat, Alberta, municipal","48062","Murder, second degree","0","0","0","0","0","0","0","0","0","0","0","0","0","0"
"2007","Medicine Hat, Alberta, municipal","48062","Murder, second degree","0","0","0","0","0","0","0","0","0","0","0","0","0","0"
"2008","Medicine Hat, Alberta, municipal","48062","Murder, second degree","0","0","0","0","0","0","0","0","0","0","0","0","0","0"
"2009","Medicine Hat, Alberta, municipal","48062","Murder, second degree","1","1","0","0","1.61","2.04","1.87","0","0","1","1","1","0","0"
"2010","Medicine Hat, Alberta, municipal","48062","Murder, second degree","0","0","0","-100","0","0","0","0","0","0","0","0","0","0"
"2011","Medicine Hat, Alberta, municipal","48062","Murder, second degree","0","0","0","0","0","0","0","0","0","0","0","0","0","0"
"2012","Medicine Hat, Alberta, municipal","48062","Murder, second degree","2","1","1","0","3.19","2.01","1.85","0","0","2","1","1","0","0"
"2013","Medicine Hat, Alberta, municipal","48062","Murder, second degree","0","0","0","-100","0","0","0","0","0","0","0","0","0","0"
"2014","Medicine Hat, Alberta, municipal","48062","Murder, second degree","0","0","0","0","0","0","0","0","0","0","0","0","0","0"
"2015","Medicine Hat, Alberta, municipal","48062","Murder, second degree","0","0","0","0","0","0","0","0","0","0","0","0","0","0"
"2016","Medicine Hat, Alberta, municipal","48062","Murder, second degree","4","3","0","0","6.16","7.77","7.16","0","0","3","4","4","0","0"
"1998","Medicine Hat, Alberta, municipal","48062","Manslaughter","0","0","0","0","0","0","0","0","0","0","0","0","0","0"
"1999","Medicine Hat, Alberta, municipal","48062","Manslaughter","0","0","0","0","0","0","0","0","0","0","0","0","0","0"
"2000","Medicine Hat, Alberta, municipal","48062","Manslaughter","0","0","0","0","0","0","0","0","0","0","0","0","0","0"
"2001","Medicine Hat, Alberta, municipal","48062","Manslaughter","0","0","0","0","0","0","0","0","0","0","0","0","0","0"
"2002","Medicine Hat, Alberta, municipal","48062","Manslaughter","0","0","0","0","0","0","0","0","0","0","0","0","0","0"
"2003","Medicine Hat, Alberta, municipal","48062","Manslaughter","0","0","0","0","0","0","0","0","0","0","0","0","0","0"
"2004","Medicine Hat, Alberta, municipal","48062","Manslaughter","0","0","0","0","0","0","0","0","0","0","0","0","0","0"
"2005","Medicine Hat, Alberta, municipal","48062","Manslaughter","0","0","0","0","0","0","0","0","0","0","0","0","0","0"
"2006","Medicine Hat, Alberta, municipal","48062","Manslaughter","0","0","0","0","0","0","0","0","0","0","0","0","0","0"
"2007","Medicine Hat, Alberta, municipal","48062","Manslaughter","0","0","0","0","0","0","0","0","0","0","0","0","0","0"
"2008","Medicine Hat, Alberta, municipal","48062","Manslaughter","0","0","0","0","0","0","0","0","0","0","0","0","0","0"
"2009","Medicine Hat, Alberta, municipal","48062","Manslaughter","2","2","0","0","3.23","6.11","5.61","0","0","2","3","3","0","0"
"2010","Medicine Hat, Alberta, municipal","48062","Manslaughter","2","2","0","-0.01","3.23","4.07","3.74","0","0","2","2","2","0","0"
"2011","Medicine Hat, Alberta, municipal","48062","Manslaughter","0","0","0","-100","0","0","0","0","0","0","0","0","0","0"
"2012","Medicine Hat, Alberta, municipal","48062","Manslaughter","0","0","0","0","0","0","0","0","0","0","0","0","0","0"
"2013","Medicine Hat, Alberta, municipal","48062","Manslaughter","0","0","0","0","0","0","0","0","0","0","0","0","0","0"
"2014","Medicine Hat, Alberta, municipal","48062","Manslaughter","0","0","0","0","0","0","0","0","0","0","0","0","0","0"
"2015","Medicine Hat, Alberta, municipal","48062","Manslaughter","0","0","0","0","0","0","0","0","0","0","0","0","0","0"
"2016","Medicine Hat, Alberta, municipal","48062","Manslaughter","0","0","0","0","0","0","0","0","0","0","0","0","0","0"
"1998","Medicine Hat, Alberta, municipal","48062","Infanticide","0","0","0","0","0","0","0","0","0","0","0","0","0","0"
"1999","Medicine Hat, Alberta, municipal","48062","Infanticide","0","0","0","0","0","0","0","0","0","0","0","0","0","0"
"2000","Medicine Hat, Alberta, municipal","48062","Infanticide","0","0","0","0","0","0","0","0","0","0","0","0","0","0"
"2001","Medicine Hat, Alberta, municipal","48062","Infanticide","0","0","0","0","0","0","0","0","0","0","0","0","0","0"
"2002","Medicine Hat, Alberta, municipal","48062","Infanticide","0","0","0","0","0","0","0","0","0","0","0","0","0","0"
"2003","Medicine Hat, Alberta, municipal","48062","Infanticide","0","0","0","0","0","0","0","0","0","0","0","0","0","0"
"2004","Medicine Hat, Alberta, municipal","48062","Infanticide","0","0","0","0","0","0","0","0","0","0","0","0","0","0"
"2005","Medicine Hat, Alberta, municipal","48062","Infanticide","0","0","0","0","0","0","0","0","0","0","0","0","0","0"
"2006","Medicine Hat, Alberta, municipal","48062","Infanticide","0","0","0","0","0","0","0","0","0","0","0","0","0","0"
"2007","Medicine Hat, Alberta, municipal","48062","Infanticide","0","0","0","0","0","0","0","0","0","0","0","0","0","0"
"2008","Medicine Hat, Alberta, municipal","48062","Infanticide","0","0","0","0","0","0","0","0","0","0","0","0","0","0"
"2009","Medicine Hat, Alberta, municipal","48062","Infanticide","0","0","0","0","0","0","0","0","0","0","0","0","0","0"
"2010","Medicine Hat, Alberta, municipal","48062","Infanticide","0","0","0","0","0","0","0","0","0","0","0","0","0","0"
"2011","Medicine Hat, Alberta, municipal","48062","Infanticide","0","0","0","0","0","0","0","0","0","0","0","0","0","0"
"2012","Medicine Hat, Alberta, municipal","48062","Infanticide","0","0","0","0","0","0","0","0","0","0","0","0","0","0"
"2013","Medicine Hat, Alberta, municipal","48062","Infanticide","0","0","0","0","0","0","0","0","0","0","0","0","0","0"
"2014","Medicine Hat, Alberta, municipal","48062","Infanticide","0","0","0","0","0","0","0","0","0","0","0","0","0","0"
"2015","Medicine Hat, Alberta, municipal","48062","Infanticide","0","0","0","0","0","0","0","0","0","0","0","0","0","0"
"2016","Medicine Hat, Alberta, municipal","48062","Infanticide","0","0","0","0","0","0","0","0","0","0","0","0","0","0"
"1998","Medicine Hat, Alberta, municipal","48062","Total other violations causing death","0","0","0","0","0","0","0","0","0","0","0","0","0","0"
"1999","Medicine Hat, Alberta, municipal","48062","Total other violations causing death","0","0","0","0","0","0","0","0","0","0","0","0","0","0"
"2000","Medicine Hat, Alberta, municipal","48062","Total other violations causing death","0","0","0","0","0","0","0","0","0","0","0","0","0","0"
"2001","Medicine Hat, Alberta, municipal","48062","Total other violations causing death","0","0","0","0","0","0","0","0","0","0","0","0","0","0"
"2002","Medicine Hat, Alberta, municipal","48062","Total other violations causing death","0","0","0","0","0","0","0","0","0","0","0","0","0","0"
"2003","Medicine Hat, Alberta, municipal","48062","Total other violations causing death","0","0","0","0","0","0","0","0","0","0","0","0","0","0"
"2004","Medicine Hat, Alberta, municipal","48062","Total other violations causing death","0","0","0","0","0","0","0","0","0","0","0","0","0","0"
"2005","Medicine Hat, Alberta, municipal","48062","Total other violations causing death","0","0","0","0","0","0","0","0","0","0","0","0","0","0"
"2006","Medicine Hat, Alberta, municipal","48062","Total other violations causing death","0","0","0","0","0","0","0","0","0","0","0","0","0","0"
"2007","Medicine Hat, Alberta, municipal","48062","Total other violations causing death","0","0","0","0","0","0","0","0","0","0","0","0","0","0"
"2008","Medicine Hat, Alberta, municipal","48062","Total other violations causing death","0","0","0","0","0","0","0","0","0","0","0","0","0","0"
"2009","Medicine Hat, Alberta, municipal","48062","Total other violations causing death","0","0","0","0","0","0","0","0","0","0","0","0","0","0"
"2010","Medicine Hat, Alberta, municipal","48062","Total other violations causing death","0","0","0","0","0","0","0","0","0","0","0","0","0","0"
"2011","Medicine Hat, Alberta, municipal","48062","Total other violations causing death","0","0","0","0","0","0","0","0","0","0","0","0","0","0"
"2012","Medicine Hat, Alberta, municipal","48062","Total other violations causing death","0","0","0","0","0","0","0","0","0","0","0","0","0","0"
"2013","Medicine Hat, Alberta, municipal","48062","Total other violations causing death","0","0","0","0","0","0","0","0","0","0","0","0","0","0"
"2014","Medicine Hat, Alberta, municipal","48062","Total other violations causing death","0","0","0","0","0","0","0","0","0","0","0","0","0","0"
"2015","Medicine Hat, Alberta, municipal","48062","Total other violations causing death","1","0","0","0","1.55","0","0","0","0","0","0","0","0","0"
"2016","Medicine Hat, Alberta, municipal","48062","Total other violations causing death","0","0","0","-100","0","0","0","0","0","0","0","0","0","0"
"1998","Medicine Hat, Alberta, municipal","48062","Criminal negligence causing death","0","0","0","0","0","0","0","0","0","0","0","0","0","0"
"1999","Medicine Hat, Alberta, municipal","48062","Criminal negligence causing death","0","0","0","0","0","0","0","0","0","0","0","0","0","0"
"2000","Medicine Hat, Alberta, municipal","48062","Criminal negligence causing death","0","0","0","0","0","0","0","0","0","0","0","0","0","0"
"2001","Medicine Hat, Alberta, municipal","48062","Criminal negligence causing death","0","0","0","0","0","0","0","0","0","0","0","0","0","0"
"2002","Medicine Hat, Alberta, municipal","48062","Criminal negligence causing death","0","0","0","0","0","0","0","0","0","0","0","0","0","0"
"2003","Medicine Hat, Alberta, municipal","48062","Criminal negligence causing death","0","0","0","0","0","0","0","0","0","0","0","0","0","0"
"2004","Medicine Hat, Alberta, municipal","48062","Criminal negligence causing death","0","0","0","0","0","0","0","0","0","0","0","0","0","0"
"2005","Medicine Hat, Alberta, municipal","48062","Criminal negligence causing death","0","0","0","0","0","0","0","0","0","0","0","0","0","0"
"2006","Medicine Hat, Alberta, municipal","48062","Criminal negligence causing death","0","0","0","0","0","0","0","0","0","0","0","0","0","0"
"2007","Medicine Hat, Alberta, municipal","48062","Criminal negligence causing death","0","0","0","0","0","0","0","0","0","0","0","0","0","0"
"2008","Medicine Hat, Alberta, municipal","48062","Criminal negligence causing death","0","0","0","0","0","0","0","0","0","0","0","0","0","0"
"2009","Medicine Hat, Alberta, municipal","48062","Criminal negligence causing death","0","0","0","0","0","0","0","0","0","0","0","0","0","0"
"2010","Medicine Hat, Alberta, municipal","48062","Criminal negligence causing death","0","0","0","0","0","0","0","0","0","0","0","0","0","0"
"2011","Medicine Hat, Alberta, municipal","48062","Criminal negligence causing death","0","0","0","0","0","0","0","0","0","0","0","0","0","0"
"2012","Medicine Hat, Alberta, municipal","48062","Criminal negligence causing death","0","0","0","0","0","0","0","0","0","0","0","0","0","0"
"2013","Medicine Hat, Alberta, municipal","48062","Criminal negligence causing death","0","0","0","0","0","0","0","0","0","0","0","0","0","0"
"2014","Medicine Hat, Alberta, municipal","48062","Criminal negligence causing death","0","0","0","0","0","0","0","0","0","0","0","0","0","0"
"2015","Medicine Hat, Alberta, municipal","48062","Criminal negligence causing death","1","0","0","0","1.55","0","0","0","0","0","0","0","0","0"
"2016","Medicine Hat, Alberta, municipal","48062","Criminal negligence causing death","0","0","0","-100","0","0","0","0","0","0","0","0","0","0"
"1998","Medicine Hat, Alberta, municipal","48062","Other related violations causing death","0","0","0","0","0","0","0","0","0","0","0","0","0","0"
"1999","Medicine Hat, Alberta, municipal","48062","Other related violations causing death","0","0","0","0","0","0","0","0","0","0","0","0","0","0"
"2000","Medicine Hat, Alberta, municipal","48062","Other related violations causing death","0","0","0","0","0","0","0","0","0","0","0","0","0","0"
"2001","Medicine Hat, Alberta, municipal","48062","Other related violations causing death","0","0","0","0","0","0","0","0","0","0","0","0","0","0"
"2002","Medicine Hat, Alberta, municipal","48062","Other related violations causing death","0","0","0","0","0","0","0","0","0","0","0","0","0","0"
"2003","Medicine Hat, Alberta, municipal","48062","Other related violations causing death","0","0","0","0","0","0","0","0","0","0","0","0","0","0"
"2004","Medicine Hat, Alberta, municipal","48062","Other related violations causing death","0","0","0","0","0","0","0","0","0","0","0","0","0","0"
"2005","Medicine Hat, Alberta, municipal","48062","Other related violations causing death","0","0","0","0","0","0","0","0","0","0","0","0","0","0"
"2006","Medicine Hat, Alberta, municipal","48062","Other related violations causing death","0","0","0","0","0","0","0","0","0","0","0","0","0","0"
"2007","Medicine Hat, Alberta, municipal","48062","Other related violations causing death","0","0","0","0","0","0","0","0","0","0","0","0","0","0"
"2008","Medicine Hat, Alberta, municipal","48062","Other related violations causing death","0","0","0","0","0","0","0","0","0","0","0","0","0","0"
"2009","Medicine Hat, Alberta, municipal","48062","Other related violations causing death","0","0","0","0","0","0","0","0","0","0","0","0","0","0"
"2010","Medicine Hat, Alberta, municipal","48062","Other related violations causing death","0","0","0","0","0","0","0","0","0","0","0","0","0","0"
"2011","Medicine Hat, Alberta, municipal","48062","Other related violations causing death","0","0","0","0","0","0","0","0","0","0","0","0","0","0"
"2012","Medicine Hat, Alberta, municipal","48062","Other related violations causing death","0","0","0","0","0","0","0","0","0","0","0","0","0","0"
"2013","Medicine Hat, Alberta, municipal","48062","Other related violations causing death","0","0","0","0","0","0","0","0","0","0","0","0","0","0"
"2014","Medicine Hat, Alberta, municipal","48062","Other related violations causing death","0","0","0","0","0","0","0","0","0","0","0","0","0","0"
"2015","Medicine Hat, Alberta, municipal","48062","Other related violations causing death","0","0","0","0","0","0","0","0","0","0","0","0","0","0"
"2016","Medicine Hat, Alberta, municipal","48062","Other related violations causing death","0","0","0","0","0","0","0","0","0","0","0","0","0","0"
"1998","Medicine Hat, Alberta, municipal","48062","Attempted murder","1","0","0","0","2.01","0","0","0","0","0","0","0","0","0"
"1999","Medicine Hat, Alberta, municipal","48062","Attempted murder","0","0","0","-100","0","0","0","0","0","0","0","0","0","0"
"2000","Medicine Hat, Alberta, municipal","48062","Attempted murder","1","1","0","0","1.93","0","0","0","0","1","1","1","0","0"
"2001","Medicine Hat, Alberta, municipal","48062","Attempted murder","1","1","0","-1.44","1.9","0","0","0","0","1","1","1","0","0"
"2002","Medicine Hat, Alberta, municipal","48062","Attempted murder","1","1","0","-1.56","1.87","0","0","0","0","1","1","1","0","0"
"2003","Medicine Hat, Alberta, municipal","48062","Attempted murder","0","0","0","-100","0","0","0","0","0","0","0","0","0","0"
"2004","Medicine Hat, Alberta, municipal","48062","Attempted murder","4","4","0","0","7.16","6.87","8.31","22.52","0","4","3","4","1","0"
"2005","Medicine Hat, Alberta, municipal","48062","Attempted murder","2","2","0","-51.36","3.48","2.22","2.02","0","0","2","1","1","0","0"
"2006","Medicine Hat, Alberta, municipal","48062","Attempted murder","1","1","0","-51.31","1.7","2.15","1.96","0","0","1","1","1","0","0"
"2007","Medicine Hat, Alberta, municipal","48062","Attempted murder","2","1","1","95.33","3.31","2.1","1.92","0","0","2","1","1","0","0"
"2008","Medicine Hat, Alberta, municipal","48062","Attempted murder","0","0","0","-100","0","0","0","0","0","0","0","0","0","0"
"2009","Medicine Hat, Alberta, municipal","48062","Attempted murder","2","0","2","0","3.23","0","0","0","0","2","0","0","0","0"
"2010","Medicine Hat, Alberta, municipal","48062","Attempted murder","1","1","0","-50.01","1.61","2.04","1.87","0","0","1","1","1","0","0"
"2011","Medicine Hat, Alberta, municipal","48062","Attempted murder","0","0","0","-100","0","0","0","0","0","0","0","0","0","0"
"2012","Medicine Hat, Alberta, municipal","48062","Attempted murder","0","0","0","0","0","0","0","0","0","0","0","0","0","0"
"2013","Medicine Hat, Alberta, municipal","48062","Attempted murder","2","2","0","0","3.15","3.97","5.48","22.92","0","2","2","3","1","0"
"2014","Medicine Hat, Alberta, municipal","48062","Attempted murder","1","1","0","-50.43","1.56","1.96","1.81","0","0","1","1","1","0","0"
"2015","Medicine Hat, Alberta, municipal","48062","Attempted murder","0","0","0","-100","0","0","0","0","0","0","0","0","0","0"
"2016","Medicine Hat, Alberta, municipal","48062","Attempted murder","0","0","0","0","0","0","0","0","0","0","0","0","0","0"
"1998","Medicine Hat, Alberta, municipal","48062","Sexual assault, level 3, aggravated","0","0","0","0","0","0","0","0","0","0","0","0","0","0"
"1999","Medicine Hat, Alberta, municipal","48062","Sexual assault, level 3, aggravated","1","0","0","0","1.97","0","0","0","0","0","0","0","0","0"
"2000","Medicine Hat, Alberta, municipal","48062","Sexual assault, level 3, aggravated","0","0","0","-100","0","0","0","0","0","0","0","0","0","0"
"2001","Medicine Hat, Alberta, municipal","48062","Sexual assault, level 3, aggravated","0","0","0","0","0","0","0","0","0","0","0","0","0","0"
"2002","Medicine Hat, Alberta, municipal","48062","Sexual assault, level 3, aggravated","0","0","0","0","0","0","0","0","0","0","0","0","0","0"
"2003","Medicine Hat, Alberta, municipal","48062","Sexual assault, level 3, aggravated","2","2","0","0","3.69","0","0","0","0","2","2","2","0","0"
"2004","Medicine Hat, Alberta, municipal","48062","Sexual assault, level 3, aggravated","1","1","0","-51.48","1.79","2.29","2.08","0","0","1","1","1","0","0"
"2005","Medicine Hat, Alberta, municipal","48062","Sexual assault, level 3, aggravated","0","1","0","-100","0","2.22","2.02","0","0","1","1","1","0","0"
"2006","Medicine Hat, Alberta, municipal","48062","Sexual assault, level 3, aggravated","0","0","0","0","0","0","0","0","0","0","0","0","0","0"
"2007","Medicine Hat, Alberta, municipal","48062","Sexual assault, level 3, aggravated","0","0","0","0","0","0","0","0","0","0","0","0","0","0"
"2008","Medicine Hat, Alberta, municipal","48062","Sexual assault, level 3, aggravated","0","0","0","0","0","0","0","0","0","0","0","0","0","0"
"2009","Medicine Hat, Alberta, municipal","48062","Sexual assault, level 3, aggravated","1","0","0","0","1.61","0","0","0","0","0","0","0","0","0"
"2010","Medicine Hat, Alberta, municipal","48062","Sexual assault, level 3, aggravated","0","0","0","-100","0","0","0","0","0","0","0","0","0","0"
"2011","Medicine Hat, Alberta, municipal","48062","Sexual assault, level 3, aggravated","1","3","0","0","1.61","4.07","3.74","0","0","3","2","2","0","0"
"2012","Medicine Hat, Alberta, municipal","48062","Sexual assault, level 3, aggravated","0","0","0","-100","0","0","0","0","0","0","0","0","0","0"
"2013","Medicine Hat, Alberta, municipal","48062","Sexual assault, level 3, aggravated","1","1","0","0","1.57","0","0","0","0","1","0","0","0","0"
"2014","Medicine Hat, Alberta, municipal","48062","Sexual assault, level 3, aggravated","0","0","0","-100","0","0","0","0","0","0","0","0","0","0"
"2015","Medicine Hat, Alberta, municipal","48062","Sexual assault, level 3, aggravated","0","0","0","0","0","0","0","0","0","0","0","0","0","0"
"2016","Medicine Hat, Alberta, municipal","48062","Sexual assault, level 3, aggravated","0","0","0","0","0","0","0","0","0","0","0","0","0","0"
"1998","Medicine Hat, Alberta, municipal","48062","Sexual assault, level 2, weapon or bodily harm","0","0","0","0","0","0","0","0","0","0","0","0","0","0"
"1999","Medicine Hat, Alberta, municipal","48062","Sexual assault, level 2, weapon or bodily harm","0","0","0","0","0","0","0","0","0","0","0","0","0","0"
"2000","Medicine Hat, Alberta, municipal","48062","Sexual assault, level 2, weapon or bodily harm","0","0","0","0","0","0","0","0","0","0","0","0","0","0"
"2001","Medicine Hat, Alberta, municipal","48062","Sexual assault, level 2, weapon or bodily harm","0","0","0","0","0","0","0","0","0","0","0","0","0","0"
"2002","Medicine Hat, Alberta, municipal","48062","Sexual assault, level 2, weapon or bodily harm","0","0","0","0","0","0","0","0","0","0","0","0","0","0"
"2003","Medicine Hat, Alberta, municipal","48062","Sexual assault, level 2, weapon or bodily harm","0","0","0","0","0","0","0","0","0","0","0","0","0","0"
"2004","Medicine Hat, Alberta, municipal","48062","Sexual assault, level 2, weapon or bodily harm","0","0","0","0","0","0","0","0","0","0","0","0","0","0"
"2005","Medicine Hat, Alberta, municipal","48062","Sexual assault, level 2, weapon or bodily harm","0","0","0","0","0","0","0","0","0","0","0","0","0","0"
"2006","Medicine Hat, Alberta, municipal","48062","Sexual assault, level 2, weapon or bodily harm","0","0","0","0","0","0","0","0","0","0","0","0","0","0"
"2007","Medicine Hat, Alberta, municipal","48062","Sexual assault, level 2, weapon or bodily harm","0","0","0","0","0","0","0","0","0","0","0","0","0","0"
"2008","Medicine Hat, Alberta, municipal","48062","Sexual assault, level 2, weapon or bodily harm","0","0","0","0","0","0","0","0","0","0","0","0","0","0"
"2009","Medicine Hat, Alberta, municipal","48062","Sexual assault, level 2, weapon or bodily harm","2","0","0","0","3.23","0","0","0","0","0","0","0","0","0"
"2010","Medicine Hat, Alberta, municipal","48062","Sexual assault, level 2, weapon or bodily harm","0","0","0","-100","0","0","0","0","0","0","0","0","0","0"
"2011","Medicine Hat, Alberta, municipal","48062","Sexual assault, level 2, weapon or bodily harm","3","4","0","0","4.84","4.07","3.74","0","0","4","2","2","0","0"
"2012","Medicine Hat, Alberta, municipal","48062","Sexual assault, level 2, weapon or bodily harm","0","2","0","-100","0","2.01","1.85","0","0","2","1","1","0","0"
"2013","Medicine Hat, Alberta, municipal","48062","Sexual assault, level 2, weapon or bodily harm","0","0","0","0","0","0","0","0","0","0","0","0","0","0"
"2014","Medicine Hat, Alberta, municipal","48062","Sexual assault, level 2, weapon or bodily harm","0","0","0","0","0","0","0","0","0","0","0","0","0","0"
"2015","Medicine Hat, Alberta, municipal","48062","Sexual assault, level 2, weapon or bodily harm","0","0","0","0","0","0","0","0","0","0","0","0","0","0"
"2016","Medicine Hat, Alberta, municipal","48062","Sexual assault, level 2, weapon or bodily harm","0","0","0","0","0","0","0","0","0","0","0","0","0","0"
"1998","Medicine Hat, Alberta, municipal","48062","Sexual assault, level 1","49","26","6","0","98.6","0","0","0","0","32","21","23","2","2"
"1999","Medicine Hat, Alberta, municipal","48062","Sexual assault, level 1","50","27","6","0.11","98.71","0","0","0","0","33","25","27","2","2"
"2000","Medicine Hat, Alberta, municipal","48062","Sexual assault, level 1","40","21","2","-21.79","77.2","0","0","0","0","23","16","19","3","2"
"2001","Medicine Hat, Alberta, municipal","48062","Sexual assault, level 1","38","15","5","-6.37","72.28","0","0","0","0","20","8","11","3","1"
"2002","Medicine Hat, Alberta, municipal","48062","Sexual assault, level 1","30","14","9","-22.29","56.17","0","0","0","0","23","9","13","4","0"
"2003","Medicine Hat, Alberta, municipal","48062","Sexual assault, level 1","31","11","2","1.84","57.21","0","0","0","0","13","11","11","0","0"
"2004","Medicine Hat, Alberta, municipal","48062","Sexual assault, level 1","30","14","0","-6.1","53.72","25.19","27.02","45.05","0","14","11","13","2","0"
"2005","Medicine Hat, Alberta, municipal","48062","Sexual assault, level 1","37","15","6","19.98","64.45","26.66","28.27","44.4","22.2","21","12","14","2","1"
"2006","Medicine Hat, Alberta, municipal","48062","Sexual assault, level 1","26","18","1","-31.57","44.11","32.32","33.39","44.48","0","19","15","17","2","0"
"2007","Medicine Hat, Alberta, municipal","48062","Sexual assault, level 1","47","28","5","76.55","77.87","39.88","44.12","89.09","0","33","19","23","4","0"
"2008","Medicine Hat, Alberta, municipal","48062","Sexual assault, level 1","34","20","3","-28.81","55.43","30.93","35.88","89.89","22.47","23","15","19","4","1"
"2009","Medicine Hat, Alberta, municipal","48062","Sexual assault, level 1","37","24","4","7.66","59.68","32.58","39.26","114.21","22.84","28","16","21","5","1"
"2010","Medicine Hat, Alberta, municipal","48062","Sexual assault, level 1","38","15","5","2.69","61.29","30.55","29.93","22.93","0","20","15","16","1","0"
"2011","Medicine Hat, Alberta, municipal","48062","Sexual assault, level 1","47","26","5","23.7","75.81","34.61","35.53","45.87","0","31","17","19","2","0"
"2012","Medicine Hat, Alberta, municipal","48062","Sexual assault, level 1","51","28","2","7.21","81.28","46.23","48.04","68.51","0","30","23","26","3","0"
"2013","Medicine Hat, Alberta, municipal","48062","Sexual assault, level 1","57","38","5","10.39","89.72","53.57","58.43","114.6","22.92","43","27","32","5","1"
"2014","Medicine Hat, Alberta, municipal","48062","Sexual assault, level 1","49","20","3","-14.78","76.46","37.32","36.21","23.09","23.09","23","19","20","1","1"
"2015","Medicine Hat, Alberta, municipal","48062","Sexual assault, level 1","58","28","2","17.47","89.82","40.98","43.18","69.14","23.05","30","21","24","3","1"
"2016","Medicine Hat, Alberta, municipal","48062","Sexual assault, level 1","34","16","3","-41.74","52.33","19.43","19.7","22.93","45.86","19","10","11","1","2"
"1998","Medicine Hat, Alberta, municipal","48062","Total sexual violations against children","0","0","0","0","0","0","0","0","0","0","0","0","0","0"
"1999","Medicine Hat, Alberta, municipal","48062","Total sexual violations against children","0","0","0","0","0","0","0","0","0","0","0","0","0","0"
"2000","Medicine Hat, Alberta, municipal","48062","Total sexual violations against children","0","0","0","0","0","0","0","0","0","0","0","0","0","0"
"2001","Medicine Hat, Alberta, municipal","48062","Total sexual violations against children","0","0","0","0","0","0","0","0","0","0","0","0","0","0"
"2002","Medicine Hat, Alberta, municipal","48062","Total sexual violations against children","0","0","0","0","0","0","0","0","0","0","0","0","0","0"
"2003","Medicine Hat, Alberta, municipal","48062","Total sexual violations against children","0","0","0","0","0","0","0","0","0","0","0","0","0","0"
"2004","Medicine Hat, Alberta, municipal","48062","Total sexual violations against children","0","0","0","0","0","0","0","0","0","0","0","0","0","0"
"2005","Medicine Hat, Alberta, municipal","48062","Total sexual violations against children","0","0","0","0","0","0","0","0","0","0","0","0","0","0"
"2006","Medicine Hat, Alberta, municipal","48062","Total sexual violations against children","2","0","0","0","3.39","0","0","0","0","0","0","0","0","0"
"2007","Medicine Hat, Alberta, municipal","48062","Total sexual violations against children","4","0","0","95.33","6.63","0","0","0","0","0","0","0","0","0"
"2008","Medicine Hat, Alberta, municipal","48062","Total sexual violations against children","9","1","1","121.41","14.67","0","1.89","22.47","22.47","2","0","1","1","1"
"2009","Medicine Hat, Alberta, municipal","48062","Total sexual violations against children","7","4","0","-23.05","11.29","6.11","7.48","22.84","0","4","3","4","1","0"
"2010","Medicine Hat, Alberta, municipal","48062","Total sexual violations against children","13","7","1","85.69","20.97","2.04","7.48","68.78","22.93","8","1","4","3","1"
"2011","Medicine Hat, Alberta, municipal","48062","Total sexual violations against children","11","10","0","-15.37","17.74","10.18","16.83","91.74","0","10","5","9","4","0"
"2012","Medicine Hat, Alberta, municipal","48062","Total sexual violations against children","8","3","3","-28.14","12.75","4.02","5.54","22.84","45.67","6","2","3","1","2"
"2013","Medicine Hat, Alberta, municipal","48062","Total sexual violations against children","3","1","0","-62.96","4.72","1.98","1.83","0","0","1","1","1","0","0"
"2014","Medicine Hat, Alberta, municipal","48062","Total sexual violations against children","8","1","2","164.37","12.48","1.96","1.81","0","0","3","1","1","0","0"
"2015","Medicine Hat, Alberta, municipal","48062","Total sexual violations against children","14","9","2","73.67","21.68","13.66","14.39","23.05","23.05","11","7","8","1","1"
"2016","Medicine Hat, Alberta, municipal","48062","Total sexual violations against children","32","16","3","127.17","49.25","25.26","26.87","45.86","0","19","13","15","2","0"
"1999","Medicine Hat, Alberta, municipal","48062","Sexual interference","0","0","0","0","0","0","0","0","0","0","0","0","0","0"
"2000","Medicine Hat, Alberta, municipal","48062","Sexual interference","0","0","0","0","0","0","0","0","0","0","0","0","0","0"
"2001","Medicine Hat, Alberta, municipal","48062","Sexual interference","0","0","0","0","0","0","0","0","0","0","0","0","0","0"
"2002","Medicine Hat, Alberta, municipal","48062","Sexual interference","0","0","0","0","0","0","0","0","0","0","0","0","0","0"
"2003","Medicine Hat, Alberta, municipal","48062","Sexual interference","0","0","0","0","0","0","0","0","0","0","0","0","0","0"
"2004","Medicine Hat, Alberta, municipal","48062","Sexual interference","0","0","0","0","0","0","0","0","0","0","0","0","0","0"
"2005","Medicine Hat, Alberta, municipal","48062","Sexual interference","0","0","0","0","0","0","0","0","0","0","0","0","0","0"
"2006","Medicine Hat, Alberta, municipal","48062","Sexual interference","1","0","0","0","1.7","0","0","0","0","0","0","0","0","0"
"2007","Medicine Hat, Alberta, municipal","48062","Sexual interference","2","0","0","95.33","3.31","0","0","0","0","0","0","0","0","0"
"2008","Medicine Hat, Alberta, municipal","48062","Sexual interference","1","0","0","-50.8","1.63","0","0","0","0","0","0","0","0","0"
"2009","Medicine Hat, Alberta, municipal","48062","Sexual interference","5","4","0","394.67","8.06","6.11","7.48","22.84","0","4","3","4","1","0"
"2010","Medicine Hat, Alberta, municipal","48062","Sexual interference","7","6","0","39.98","11.29","2.04","5.61","45.85","0","6","1","3","2","0"
"2011","Medicine Hat, Alberta, municipal","48062","Sexual interference","7","8","0","0.01","11.29","8.14","14.96","91.74","0","8","4","8","4","0"
"2012","Medicine Hat, Alberta, municipal","48062","Sexual interference","3","2","1","-57.66","4.78","2.01","3.7","22.84","0","3","1","2","1","0"
"2013","Medicine Hat, Alberta, municipal","48062","Sexual interference","0","0","0","-100","0","0","0","0","0","0","0","0","0","0"
"2014","Medicine Hat, Alberta, municipal","48062","Sexual interference","4","1","1","0","6.24","1.96","1.81","0","0","2","1","1","0","0"
"2015","Medicine Hat, Alberta, municipal","48062","Sexual interference","8","6","0","98.48","12.39","9.76","10.79","23.05","0","6","5","6","1","0"
"2016","Medicine Hat, Alberta, municipal","48062","Sexual interference","20","13","2","148.47","30.78","19.43","21.49","45.86","0","15","10","12","2","0"
"2003","Medicine Hat, Alberta, municipal","48062","Invitation to sexual touching","0","0","0","0","0","0","0","0","0","0","0","0","0","0"
"2004","Medicine Hat, Alberta, municipal","48062","Invitation to sexual touching","0","0","0","0","0","0","0","0","0","0","0","0","0","0"
"2005","Medicine Hat, Alberta, municipal","48062","Invitation to sexual touching","0","0","0","0","0","0","0","0","0","0","0","0","0","0"
"2006","Medicine Hat, Alberta, municipal","48062","Invitation to sexual touching","0","0","0","0","0","0","0","0","0","0","0","0","0","0"
"2007","Medicine Hat, Alberta, municipal","48062","Invitation to sexual touching","1","0","0","0","1.66","0","0","0","0","0","0","0","0","0"
"2008","Medicine Hat, Alberta, municipal","48062","Invitation to sexual touching","8","1","1","687.23","13.04","0","1.89","22.47","22.47","2","0","1","1","1"
"2009","Medicine Hat, Alberta, municipal","48062","Invitation to sexual touching","0","0","0","-100","0","0","0","0","0","0","0","0","0","0"
"2010","Medicine Hat, Alberta, municipal","48062","Invitation to sexual touching","3","1","1","0","4.84","0","1.87","22.93","22.93","2","0","1","1","1"
"2011","Medicine Hat, Alberta, municipal","48062","Invitation to sexual touching","4","2","0","33.35","6.45","2.04","1.87","0","0","2","1","1","0","0"
"2012","Medicine Hat, Alberta, municipal","48062","Invitation to sexual touching","4","1","2","-1.2","6.37","2.01","1.85","0","45.67","3","1","1","0","2"
"2013","Medicine Hat, Alberta, municipal","48062","Invitation to sexual touching","1","0","0","-75.31","1.57","0","0","0","0","0","0","0","0","0"
"2014","Medicine Hat, Alberta, municipal","48062","Invitation to sexual touching","2","0","1","98.28","3.12","0","0","0","0","1","0","0","0","0"
"2015","Medicine Hat, Alberta, municipal","48062","Invitation to sexual touching","3","2","1","48.86","4.65","1.95","1.8","0","0","3","1","1","0","0"
"2016","Medicine Hat, Alberta, municipal","48062","Invitation to sexual touching","0","0","0","-100","0","0","0","0","0","0","0","0","0","0"
"2003","Medicine Hat, Alberta, municipal","48062","Sexual exploitation","0","0","0","0","0","0","0","0","0","0","0","0","0","0"
"2004","Medicine Hat, Alberta, municipal","48062","Sexual exploitation","0","0","0","0","0","0","0","0","0","0","0","0","0","0"
"2005","Medicine Hat, Alberta, municipal","48062","Sexual exploitation","0","0","0","0","0","0","0","0","0","0","0","0","0","0"
"2006","Medicine Hat, Alberta, municipal","48062","Sexual exploitation","0","0","0","0","0","0","0","0","0","0","0","0","0","0"
"2007","Medicine Hat, Alberta, municipal","48062","Sexual exploitation","0","0","0","0","0","0","0","0","0","0","0","0","0","0"
"2008","Medicine Hat, Alberta, municipal","48062","Sexual exploitation","0","0","0","0","0","0","0","0","0","0","0","0","0","0"
"2009","Medicine Hat, Alberta, municipal","48062","Sexual exploitation","0","0","0","0","0","0","0","0","0","0","0","0","0","0"
"2010","Medicine Hat, Alberta, municipal","48062","Sexual exploitation","0","0","0","0","0","0","0","0","0","0","0","0","0","0"
"2011","Medicine Hat, Alberta, municipal","48062","Sexual exploitation","0","0","0","0","0","0","0","0","0","0","0","0","0","0"
"2012","Medicine Hat, Alberta, municipal","48062","Sexual exploitation","0","0","0","0","0","0","0","0","0","0","0","0","0","0"
"2013","Medicine Hat, Alberta, municipal","48062","Sexual exploitation","0","0","0","0","0","0","0","0","0","0","0","0","0","0"
"2014","Medicine Hat, Alberta, municipal","48062","Sexual exploitation","0","0","0","0","0","0","0","0","0","0","0","0","0","0"
"2015","Medicine Hat, Alberta, municipal","48062","Sexual exploitation","0","0","0","0","0","0","0","0","0","0","0","0","0","0"
"2016","Medicine Hat, Alberta, municipal","48062","Sexual exploitation","2","2","0","0","3.08","3.89","3.58","0","0","2","2","2","0","0"
"2005","Medicine Hat, Alberta, municipal","48062","Making sexually explicit material available to children","0","0","0","0","0","0","0","0","0","0","0","0","0","0"
"2006","Medicine Hat, Alberta, municipal","48062","Making sexually explicit material available to children","0","0","0","0","0","0","0","0","0","0","0","0","0","0"
"2007","Medicine Hat, Alberta, municipal","48062","Making sexually explicit material available to children","0","0","0","0","0","0","0","0","0","0","0","0","0","0"
"2008","Medicine Hat, Alberta, municipal","48062","Making sexually explicit material available to children","0","0","0","0","0","0","0","0","0","0","0","0","0","0"
"2009","Medicine Hat, Alberta, municipal","48062","Making sexually explicit material available to children","0","0","0","0","0","0","0","0","0","0","0","0","0","0"
"2010","Medicine Hat, Alberta, municipal","48062","Making sexually explicit material available to children","0","0","0","0","0","0","0","0","0","0","0","0","0","0"
"2011","Medicine Hat, Alberta, municipal","48062","Making sexually explicit material available to children","0","0","0","0","0","0","0","0","0","0","0","0","0","0"
"2012","Medicine Hat, Alberta, municipal","48062","Making sexually explicit material available to children","0","0","0","0","0","0","0","0","0","0","0","0","0","0"
"2013","Medicine Hat, Alberta, municipal","48062","Making sexually explicit material available to children","0","0","0","0","0","0","0","0","0","0","0","0","0","0"
"2014","Medicine Hat, Alberta, municipal","48062","Making sexually explicit material available to children","2","0","0","0","3.12","0","0","0","0","0","0","0","0","0"
"2015","Medicine Hat, Alberta, municipal","48062","Making sexually explicit material available to children","3","1","1","48.86","4.65","1.95","1.8","0","23.05","2","1","1","0","1"
"2016","Medicine Hat, Alberta, municipal","48062","Making sexually explicit material available to children","4","0","1","32.52","6.16","0","0","0","0","1","0","0","0","0"
"2012","Medicine Hat, Alberta, municipal","48062","Parent or guardian procuring sexual activity: person procured under the age of 16 years","0","0","0","0","0","0","0","0","0","0","0","0","0","0"
"2013","Medicine Hat, Alberta, municipal","48062","Parent or guardian procuring sexual activity: person procured under the age of 16 years","0","0","0","0","0","0","0","0","0","0","0","0","0","0"
"2014","Medicine Hat, Alberta, municipal","48062","Parent or guardian procuring sexual activity: person procured under the age of 16 years","0","0","0","0","0","0","0","0","0","0","0","0","0","0"
"2012","Medicine Hat, Alberta, municipal","48062","Parent or guardian procuring sexual activity","0","0","0","0","0","0","0","0","0","0","0","0","0","0"
"2013","Medicine Hat, Alberta, municipal","48062","Parent or guardian procuring sexual activity","0","0","0","0","0","0","0","0","0","0","0","0","0","0"
"2014","Medicine Hat, Alberta, municipal","48062","Parent or guardian procuring sexual activity","0","0","0","0","0","0","0","0","0","0","0","0","0","0"
"2015","Medicine Hat, Alberta, municipal","48062","Parent or guardian procuring sexual activity","0","0","0","0","0","0","0","0","0","0","0","0","0","0"
"2016","Medicine Hat, Alberta, municipal","48062","Parent or guardian procuring sexual activity","0","0","0","0","0","0","0","0","0","0","0","0","0","0"
"2012","Medicine Hat, Alberta, municipal","48062","Householder permitting illegal sexual activity: person under the age of 16 years","0","0","0","0","0","0","0","0","0","0","0","0","0","0"
"2013","Medicine Hat, Alberta, municipal","48062","Householder permitting illegal sexual activity: person under the age of 16 years","0","0","0","0","0","0","0","0","0","0","0","0","0","0"
"2014","Medicine Hat, Alberta, municipal","48062","Householder permitting illegal sexual activity: person under the age of 16 years","0","0","0","0","0","0","0","0","0","0","0","0","0","0"
"2012","Medicine Hat, Alberta, municipal","48062","Householder permitting prohibited sexual activity","0","0","0","0","0","0","0","0","0","0","0","0","0","0"
"2013","Medicine Hat, Alberta, municipal","48062","Householder permitting prohibited sexual activity","0","0","0","0","0","0","0","0","0","0","0","0","0","0"
"2014","Medicine Hat, Alberta, municipal","48062","Householder permitting prohibited sexual activity","0","0","0","0","0","0","0","0","0","0","0","0","0","0"
"2015","Medicine Hat, Alberta, municipal","48062","Householder permitting prohibited sexual activity","0","0","0","0","0","0","0","0","0","0","0","0","0","0"
"2016","Medicine Hat, Alberta, municipal","48062","Householder permitting prohibited sexual activity","0","0","0","0","0","0","0","0","0","0","0","0","0","0"
"1998","Medicine Hat, Alberta, municipal","48062","Luring a child via a computer","0","0","0","0","0","0","0","0","0","0","0","0","0","0"
"1999","Medicine Hat, Alberta, municipal","48062","Luring a child via a computer","0","0","0","0","0","0","0","0","0","0","0","0","0","0"
"2000","Medicine Hat, Alberta, municipal","48062","Luring a child via a computer","0","0","0","0","0","0","0","0","0","0","0","0","0","0"
"2001","Medicine Hat, Alberta, municipal","48062","Luring a child via a computer","0","0","0","0","0","0","0","0","0","0","0","0","0","0"
"2002","Medicine Hat, Alberta, municipal","48062","Luring a child via a computer","0","0","0","0","0","0","0","0","0","0","0","0","0","0"
"2003","Medicine Hat, Alberta, municipal","48062","Luring a child via a computer","0","0","0","0","0","0","0","0","0","0","0","0","0","0"
"2004","Medicine Hat, Alberta, municipal","48062","Luring a child via a computer","0","0","0","0","0","0","0","0","0","0","0","0","0","0"
"2005","Medicine Hat, Alberta, municipal","48062","Luring a child via a computer","0","0","0","0","0","0","0","0","0","0","0","0","0","0"
"2006","Medicine Hat, Alberta, municipal","48062","Luring a child via a computer","1","0","0","0","1.7","0","0","0","0","0","0","0","0","0"
"2007","Medicine Hat, Alberta, municipal","48062","Luring a child via a computer","1","0","0","-2.34","1.66","0","0","0","0","0","0","0","0","0"
"2008","Medicine Hat, Alberta, municipal","48062","Luring a child via a computer","0","0","0","-100","0","0","0","0","0","0","0","0","0","0"
"2009","Medicine Hat, Alberta, municipal","48062","Luring a child via a computer","2","0","0","0","3.23","0","0","0","0","0","0","0","0","0"
"2010","Medicine Hat, Alberta, municipal","48062","Luring a child via a computer","3","0","0","49.98","4.84","0","0","0","0","0","0","0","0","0"
"2011","Medicine Hat, Alberta, municipal","48062","Luring a child via a computer","0","0","0","-100","0","0","0","0","0","0","0","0","0","0"
"2012","Medicine Hat, Alberta, municipal","48062","Luring a child via a computer","1","0","0","0","1.59","0","0","0","0","0","0","0","0","0"
"2013","Medicine Hat, Alberta, municipal","48062","Luring a child via a computer","2","1","0","97.54","3.15","1.98","1.83","0","0","1","1","1","0","0"
"2014","Medicine Hat, Alberta, municipal","48062","Luring a child via a computer","0","0","0","-100","0","0","0","0","0","0","0","0","0","0"
"2015","Medicine Hat, Alberta, municipal","48062","Luring a child via a computer","0","0","0","0","0","0","0","0","0","0","0","0","0","0"
"2016","Medicine Hat, Alberta, municipal","48062","Luring a child via a computer","6","1","0","0","9.24","1.94","1.79","0","0","1","1","1","0","0"
"1998","Medicine Hat, Alberta, municipal","48062","Assault, level 3, aggravated","4","4","0","0","8.05","0","0","0","0","4","4","8","4","0"
"1999","Medicine Hat, Alberta, municipal","48062","Assault, level 3, aggravated","0","0","0","-100","0","0","0","0","0","0","0","0","0","0"
"2000","Medicine Hat, Alberta, municipal","48062","Assault, level 3, aggravated","4","2","0","0","7.72","0","0","0","0","2","2","2","0","0"
"2001","Medicine Hat, Alberta, municipal","48062","Assault, level 3, aggravated","5","5","0","23.2","9.51","0","0","0","0","5","4","4","0","0"
"2002","Medicine Hat, Alberta, municipal","48062","Assault, level 3, aggravated","3","3","0","-40.94","5.62","0","0","0","0","3","2","3","1","0"
"2003","Medicine Hat, Alberta, municipal","48062","Assault, level 3, aggravated","5","4","0","64.26","9.23","0","0","0","0","4","1","2","1","0"
"2004","Medicine Hat, Alberta, municipal","48062","Assault, level 3, aggravated","8","4","1","55.25","14.32","13.74","12.47","0","0","5","6","6","0","0"
"2005","Medicine Hat, Alberta, municipal","48062","Assault, level 3, aggravated","3","3","0","-63.52","5.23","6.66","6.06","0","0","3","3","3","0","0"
"2006","Medicine Hat, Alberta, municipal","48062","Assault, level 3, aggravated","1","1","0","-67.54","1.7","2.15","1.96","0","0","1","1","1","0","0"
"2007","Medicine Hat, Alberta, municipal","48062","Assault, level 3, aggravated","10","9","0","876.64","16.57","18.89","19.18","22.27","0","9","9","10","1","0"
"2008","Medicine Hat, Alberta, municipal","48062","Assault, level 3, aggravated","7","6","0","-31.12","11.41","24.74","24.55","22.47","0","6","12","13","1","0"
"2009","Medicine Hat, Alberta, municipal","48062","Assault, level 3, aggravated","8","6","0","13.07","12.9","10.18","9.35","0","0","6","5","5","0","0"
"2010","Medicine Hat, Alberta, municipal","48062","Assault, level 3, aggravated","7","5","0","-12.51","11.29","12.22","11.22","0","0","5","6","6","0","0"
"2011","Medicine Hat, Alberta, municipal","48062","Assault, level 3, aggravated","1","1","0","-85.71","1.61","0","0","0","0","1","0","0","0","0"
"2012","Medicine Hat, Alberta, municipal","48062","Assault, level 3, aggravated","6","5","0","492.81","9.56","10.05","9.24","0","0","5","5","5","0","0"
"2013","Medicine Hat, Alberta, municipal","48062","Assault, level 3, aggravated","7","7","0","15.23","11.02","13.89","12.78","0","0","7","7","7","0","0"
"2014","Medicine Hat, Alberta, municipal","48062","Assault, level 3, aggravated","8","7","0","13.3","12.48","7.86","7.24","0","0","7","4","4","0","0"
"2015","Medicine Hat, Alberta, municipal","48062","Assault, level 3, aggravated","10","9","0","24.05","15.49","17.56","16.19","0","0","9","9","9","0","0"
"2016","Medicine Hat, Alberta, municipal","48062","Assault, level 3, aggravated","9","9","0","-10.55","13.85","19.43","17.91","0","0","9","10","10","0","0"
"1998","Medicine Hat, Alberta, municipal","48062","Assault, level 2, weapon or bodily harm","33","26","1","0","66.4","0","0","0","0","27","23","34","11","0"
"1999","Medicine Hat, Alberta, municipal","48062","Assault, level 2, weapon or bodily harm","66","63","3","96.23","130.3","0","0","0","0","66","58","70","12","0"
"2000","Medicine Hat, Alberta, municipal","48062","Assault, level 2, weapon or bodily harm","59","46","0","-12.61","113.87","0","0","0","0","46","45","63","18","4"
"2001","Medicine Hat, Alberta, municipal","48062","Assault, level 2, weapon or bodily harm","35","27","2","-41.53","66.58","0","0","0","0","29","16","25","9","0"
"2002","Medicine Hat, Alberta, municipal","48062","Assault, level 2, weapon or bodily harm","50","40","1","40.62","93.62","0","0","0","0","41","37","52","15","0"
"2003","Medicine Hat, Alberta, municipal","48062","Assault, level 2, weapon or bodily harm","33","23","0","-34.95","60.9","0","0","0","0","23","19","24","5","1"
"2004","Medicine Hat, Alberta, municipal","48062","Assault, level 2, weapon or bodily harm","49","45","1","44.08","87.74","84.72","87.3","112.61","0","46","37","42","5","0"
"2005","Medicine Hat, Alberta, municipal","48062","Assault, level 2, weapon or bodily harm","72","67","1","42.95","125.42","119.95","133.27","266.43","44.4","68","54","66","12","2"
"2006","Medicine Hat, Alberta, municipal","48062","Assault, level 2, weapon or bodily harm","90","70","2","21.73","152.68","129.28","135.54","200.18","22.24","72","60","69","9","1"
"2007","Medicine Hat, Alberta, municipal","48062","Assault, level 2, weapon or bodily harm","82","72","1","-11.02","135.86","123.84","132.36","222.72","0","73","59","69","10","0"
"2008","Medicine Hat, Alberta, municipal","48062","Assault, level 2, weapon or bodily harm","80","68","2","-4","130.43","123.72","137.87","292.13","22.47","70","60","73","13","1"
"2009","Medicine Hat, Alberta, municipal","48062","Assault, level 2, weapon or bodily harm","112","97","3","38.51","180.65","173.06","179.46","251.26","0","100","85","96","11","0"
"2010","Medicine Hat, Alberta, municipal","48062","Assault, level 2, weapon or bodily harm","96","84","4","-14.3","154.83","136.47","145.91","252.18","45.85","88","67","78","11","2"
"2011","Medicine Hat, Alberta, municipal","48062","Assault, level 2, weapon or bodily harm","69","58","0","-28.12","111.3","107.91","106.59","91.74","0","58","53","57","4","0"
"2012","Medicine Hat, Alberta, municipal","48062","Assault, level 2, weapon or bodily harm","80","65","3","14.55","127.49","132.67","125.64","45.67","0","68","66","68","2","0"
"2013","Medicine Hat, Alberta, municipal","48062","Assault, level 2, weapon or bodily harm","94","83","4","16.05","147.96","136.9","138.78","160.44","22.92","87","69","76","7","1"
"2014","Medicine Hat, Alberta, municipal","48062","Assault, level 2, weapon or bodily harm","88","76","2","-7.19","137.32","149.29","141.21","46.19","23.09","78","76","78","2","1"
"2015","Medicine Hat, Alberta, municipal","48062","Assault, level 2, weapon or bodily harm","88","71","2","-0.76","136.28","134.64","129.53","69.14","0","73","69","72","3","0"
"2016","Medicine Hat, Alberta, municipal","48062","Assault, level 2, weapon or bodily harm","92","77","2","3.91","141.6","130.18","128.97","114.65","0","79","67","72","5","0"
"1998","Medicine Hat, Alberta, municipal","48062","Assault, level 1","198","144","15","0","398.41","0","0","0","0","159","116","140","24","5"
"1999","Medicine Hat, Alberta, municipal","48062","Assault, level 1","192","140","13","-4.86","379.04","0","0","0","0","153","102","132","30","10"
"2000","Medicine Hat, Alberta, municipal","48062","Assault, level 1","209","140","16","6.42","403.36","0","0","0","0","156","105","136","31","7"
"2001","Medicine Hat, Alberta, municipal","48062","Assault, level 1","246","181","28","16.01","467.93","0","0","0","0","209","143","166","23","8"
"2002","Medicine Hat, Alberta, municipal","48062","Assault, level 1","249","211","16","-0.36","466.23","0","0","0","0","227","180","214","34","4"
"2003","Medicine Hat, Alberta, municipal","48062","Assault, level 1","232","163","19","-8.17","428.12","0","0","0","0","182","138","147","9","11"
"2004","Medicine Hat, Alberta, municipal","48062","Assault, level 1","248","194","16","3.72","444.07","386.98","405.31","585.59","135.14","210","169","195","26","6"
"2005","Medicine Hat, Alberta, municipal","48062","Assault, level 1","266","218","23","4.35","463.37","415.38","413.95","399.64","177.62","241","187","205","18","8"
"2006","Medicine Hat, Alberta, municipal","48062","Assault, level 1","285","227","9","4.34","483.49","422.32","418.42","378.11","66.73","236","196","213","17","3"
"2007","Medicine Hat, Alberta, municipal","48062","Assault, level 1","319","262","30","9.32","528.52","472.27","494.9","734.97","200.45","292","225","258","33","9"
"2008","Medicine Hat, Alberta, municipal","48062","Assault, level 1","304","250","11","-6.22","495.63","437.13","457.05","674.16","157.3","261","212","242","30","7"
"2009","Medicine Hat, Alberta, municipal","48062","Assault, level 1","391","319","29","27.25","630.68","566.02","588.86","845.13","91.37","348","278","315","37","4"
"2010","Medicine Hat, Alberta, municipal","48062","Assault, level 1","364","314","19","-6.92","587.05","549.95","531.27","320.95","183.4","333","270","284","14","8"
"2011","Medicine Hat, Alberta, municipal","48062","Assault, level 1","326","273","16","-10.43","525.83","484.58","484.34","481.65","91.74","289","238","259","21","4"
"2012","Medicine Hat, Alberta, municipal","48062","Assault, level 1","355","292","14","7.59","565.75","500.54","509.93","616.58","114.18","306","249","276","27","5"
"2013","Medicine Hat, Alberta, municipal","48062","Assault, level 1","277","236","9","-22.93","436.01","416.67","399.91","206.28","0","245","210","219","9","0"
"2014","Medicine Hat, Alberta, municipal","48062","Assault, level 1","319","247","25","14.17","497.79","445.9","436.29","323.33","138.57","272","227","241","14","6"
"2015","Medicine Hat, Alberta, municipal","48062","Assault, level 1","307","248","24","-4.49","475.43","439.06","415.58","138.28","115.23","272","225","231","6","5"
"2016","Medicine Hat, Alberta, municipal","48062","Assault, level 1","292","247","16","-5.47","449.44","443.01","435.27","343.96","68.79","263","228","243","15","3"
"1998","Medicine Hat, Alberta, municipal","48062","Total assaults against a peace officer","15","15","0","0","30.18","0","0","0","0","15","10","10","0","0"
"1999","Medicine Hat, Alberta, municipal","48062","Total assaults against a peace officer","8","7","0","-47.67","15.79","0","0","0","0","7","7","7","0","0"
"2000","Medicine Hat, Alberta, municipal","48062","Total assaults against a peace officer","6","6","0","-26.68","11.58","0","0","0","0","6","6","6","0","0"
"2001","Medicine Hat, Alberta, municipal","48062","Total assaults against a peace officer","7","8","0","14.99","13.32","0","0","0","0","8","5","9","4","0"
"2002","Medicine Hat, Alberta, municipal","48062","Total assaults against a peace officer","23","23","0","223.43","43.07","0","0","0","0","23","19","26","7","2"
"2003","Medicine Hat, Alberta, municipal","48062","Total assaults against a peace officer","23","22","0","-1.44","42.44","0","0","0","0","22","20","23","3","0"
"2004","Medicine Hat, Alberta, municipal","48062","Total assaults against a peace officer","16","17","0","-32.5","28.65","36.64","35.33","22.52","0","17","16","17","1","0"
"2005","Medicine Hat, Alberta, municipal","48062","Total assaults against a peace officer","19","19","0","15.53","33.1","39.98","38.37","22.2","0","19","18","19","1","0"
"2006","Medicine Hat, Alberta, municipal","48062","Total assaults against a peace officer","21","21","0","7.64","35.63","43.09","41.25","22.24","0","21","20","21","1","0"
"2007","Medicine Hat, Alberta, municipal","48062","Total assaults against a peace officer","21","21","0","-2.34","34.79","29.39","26.85","0","0","21","14","14","0","0"
"2008","Medicine Hat, Alberta, municipal","48062","Total assaults against a peace officer","19","19","0","-10.97","30.98","39.18","35.88","0","0","19","19","19","0","0"
"2009","Medicine Hat, Alberta, municipal","48062","Total assaults against a peace officer","23","21","2","19.76","37.1","34.61","44.87","159.89","0","23","17","24","7","0"
"2010","Medicine Hat, Alberta, municipal","48062","Total assaults against a peace officer","24","24","0","4.33","38.71","26.48","28.06","45.85","0","24","13","15","2","0"
"2011","Medicine Hat, Alberta, municipal","48062","Total assaults against a peace officer","27","27","0","12.51","43.55","59.05","57.97","45.87","0","27","29","31","2","0"
"2012","Medicine Hat, Alberta, municipal","48062","Total assaults against a peace officer","20","20","0","-26.81","31.87","30.15","27.71","0","0","20","15","15","0","0"
"2013","Medicine Hat, Alberta, municipal","48062","Total assaults against a peace officer","19","19","0","-6.17","29.91","29.76","27.39","0","0","19","15","15","0","0"
"2014","Medicine Hat, Alberta, municipal","48062","Total assaults against a peace officer","25","24","1","30.45","39.01","49.11","57.93","161.66","0","25","25","32","7","0"
"2015","Medicine Hat, Alberta, municipal","48062","Total assaults against a peace officer","21","21","0","-16.64","32.52","33.17","32.38","23.05","0","21","17","18","1","0"
"2016","Medicine Hat, Alberta, municipal","48062","Total assaults against a peace officer","12","11","1","-43.21","18.47","19.43","19.7","22.93","0","12","10","11","1","0"
"1998","Medicine Hat, Alberta, municipal","48062","Total other assaults","9","5","0","0","18.11","0","0","0","0","5","4","4","0","0"
"1999","Medicine Hat, Alberta, municipal","48062","Total other assaults","1","1","0","-89.1","1.97","0","0","0","0","1","1","1","0","0"
"2000","Medicine Hat, Alberta, municipal","48062","Total other assaults","1","1","0","-2.24","1.93","0","0","0","0","1","0","0","0","0"
"2001","Medicine Hat, Alberta, municipal","48062","Total other assaults","30","22","3","2856.8","57.06","0","0","0","0","25","19","23","4","1"
"2002","Medicine Hat, Alberta, municipal","48062","Total other assaults","24","22","1","-21.25","44.94","0","0","0","0","23","21","23","2","0"
"2003","Medicine Hat, Alberta, municipal","48062","Total other assaults","39","28","1","60.15","71.97","0","0","0","0","29","32","34","2","0"
"2004","Medicine Hat, Alberta, municipal","48062","Total other assaults","34","24","1","-15.41","60.88","50.38","51.96","67.57","22.52","25","22","25","3","1"
"2005","Medicine Hat, Alberta, municipal","48062","Total other assaults","11","9","0","-68.53","19.16","19.99","24.23","66.61","0","9","9","12","3","0"
"2006","Medicine Hat, Alberta, municipal","48062","Total other assaults","7","6","0","-38.03","11.88","12.93","11.79","0","0","6","6","6","0","0"
"2007","Medicine Hat, Alberta, municipal","48062","Total other assaults","4","4","0","-44.19","6.63","6.3","7.67","22.27","0","4","3","4","1","0"
"2008","Medicine Hat, Alberta, municipal","48062","Total other assaults","3","2","0","-26.2","4.89","6.19","5.67","0","0","2","3","3","0","0"
"2009","Medicine Hat, Alberta, municipal","48062","Total other assaults","3","3","0","-1.07","4.84","6.11","5.61","0","0","3","3","3","0","0"
"2010","Medicine Hat, Alberta, municipal","48062","Total other assaults","6","4","0","99.97","9.68","8.15","7.48","0","0","4","4","4","0","0"
"2011","Medicine Hat, Alberta, municipal","48062","Total other assaults","7","6","1","16.68","11.29","6.11","7.48","22.94","0","7","3","4","1","0"
"2012","Medicine Hat, Alberta, municipal","48062","Total other assaults","4","3","0","-43.54","6.37","6.03","7.39","22.84","0","3","3","4","1","0"
"2013","Medicine Hat, Alberta, municipal","48062","Total other assaults","1","1","0","-75.31","1.57","1.98","1.83","0","0","1","1","1","0","0"
"2014","Medicine Hat, Alberta, municipal","48062","Total other assaults","2","2","0","98.28","3.12","3.93","3.62","0","0","2","2","2","0","0"
"2015","Medicine Hat, Alberta, municipal","48062","Total other assaults","0","0","0","-100","0","0","0","0","0","0","0","0","0","0"
"2016","Medicine Hat, Alberta, municipal","48062","Total other assaults","1","1","0","0","1.54","0","1.79","22.93","0","1","0","1","1","0"
"1998","Medicine Hat, Alberta, municipal","48062","Unlawfully causing bodily harm","2","1","0","0","4.02","0","0","0","0","1","1","1","0","0"
"1999","Medicine Hat, Alberta, municipal","48062","Unlawfully causing bodily harm","0","1","0","-100","0","0","0","0","0","1","1","1","0","0"
"2000","Medicine Hat, Alberta, municipal","48062","Unlawfully causing bodily harm","0","0","0","0","0","0","0","0","0","0","0","0","0","0"
"2001","Medicine Hat, Alberta, municipal","48062","Unlawfully causing bodily harm","24","19","1","0","45.65","0","0","0","0","20","17","20","3","1"
"2002","Medicine Hat, Alberta, municipal","48062","Unlawfully causing bodily harm","23","21","1","-5.66","43.07","0","0","0","0","22","19","21","2","0"
"2003","Medicine Hat, Alberta, municipal","48062","Unlawfully causing bodily harm","36","27","0","54.26","66.43","0","0","0","0","27","31","33","2","0"
"2004","Medicine Hat, Alberta, municipal","48062","Unlawfully causing bodily harm","31","24","1","-16.44","55.51","50.38","51.96","67.57","22.52","25","22","25","3","1"
"2005","Medicine Hat, Alberta, municipal","48062","Unlawfully causing bodily harm","4","4","0","-87.45","6.97","13.33","14.13","22.2","0","4","6","7","1","0"
"2006","Medicine Hat, Alberta, municipal","48062","Unlawfully causing bodily harm","2","2","0","-51.31","3.39","4.31","3.93","0","0","2","2","2","0","0"
"2007","Medicine Hat, Alberta, municipal","48062","Unlawfully causing bodily harm","0","0","0","-100","0","0","0","0","0","0","0","0","0","0"
"2008","Medicine Hat, Alberta, municipal","48062","Unlawfully causing bodily harm","0","0","0","0","0","0","0","0","0","0","0","0","0","0"
"2009","Medicine Hat, Alberta, municipal","48062","Unlawfully causing bodily harm","0","0","0","0","0","0","0","0","0","0","0","0","0","0"
"2010","Medicine Hat, Alberta, municipal","48062","Unlawfully causing bodily harm","0","0","0","0","0","0","0","0","0","0","0","0","0","0"
"2011","Medicine Hat, Alberta, municipal","48062","Unlawfully causing bodily harm","1","1","0","0","1.61","2.04","1.87","0","0","1","1","1","0","0"
"2012","Medicine Hat, Alberta, municipal","48062","Unlawfully causing bodily harm","0","0","0","-100","0","0","0","0","0","0","0","0","0","0"
"2013","Medicine Hat, Alberta, municipal","48062","Unlawfully causing bodily harm","0","0","0","0","0","0","0","0","0","0","0","0","0","0"
"2014","Medicine Hat, Alberta, municipal","48062","Unlawfully causing bodily harm","0","0","0","0","0","0","0","0","0","0","0","0","0","0"
"2015","Medicine Hat, Alberta, municipal","48062","Unlawfully causing bodily harm","0","0","0","0","0","0","0","0","0","0","0","0","0","0"
"2016","Medicine Hat, Alberta, municipal","48062","Unlawfully causing bodily harm","0","0","0","0","0","0","0","0","0","0","0","0","0","0"
"1998","Medicine Hat, Alberta, municipal","48062","Criminal negligence causing bodily harm","0","0","0","0","0","0","0","0","0","0","0","0","0","0"
"1999","Medicine Hat, Alberta, municipal","48062","Criminal negligence causing bodily harm","0","0","0","0","0","0","0","0","0","0","0","0","0","0"
"2000","Medicine Hat, Alberta, municipal","48062","Criminal negligence causing bodily harm","0","0","0","0","0","0","0","0","0","0","0","0","0","0"
"2001","Medicine Hat, Alberta, municipal","48062","Criminal negligence causing bodily harm","1","1","0","0","1.9","0","0","0","0","1","1","1","0","0"
"2002","Medicine Hat, Alberta, municipal","48062","Criminal negligence causing bodily harm","0","0","0","-100","0","0","0","0","0","0","0","0","0","0"
"2003","Medicine Hat, Alberta, municipal","48062","Criminal negligence causing bodily harm","1","1","0","0","1.85","0","0","0","0","1","1","1","0","0"
"2004","Medicine Hat, Alberta, municipal","48062","Criminal negligence causing bodily harm","0","0","0","-100","0","0","0","0","0","0","0","0","0","0"
"2005","Medicine Hat, Alberta, municipal","48062","Criminal negligence causing bodily harm","0","0","0","0","0","0","0","0","0","0","0","0","0","0"
"2006","Medicine Hat, Alberta, municipal","48062","Criminal negligence causing bodily harm","0","0","0","0","0","0","0","0","0","0","0","0","0","0"
"2007","Medicine Hat, Alberta, municipal","48062","Criminal negligence causing bodily harm","0","0","0","0","0","0","0","0","0","0","0","0","0","0"
"2008","Medicine Hat, Alberta, municipal","48062","Criminal negligence causing bodily harm","1","0","0","0","1.63","0","0","0","0","0","0","0","0","0"
"2009","Medicine Hat, Alberta, municipal","48062","Criminal negligence causing bodily harm","0","0","0","-100","0","0","0","0","0","0","0","0","0","0"
"2010","Medicine Hat, Alberta, municipal","48062","Criminal negligence causing bodily harm","0","0","0","0","0","0","0","0","0","0","0","0","0","0"
"2011","Medicine Hat, Alberta, municipal","48062","Criminal negligence causing bodily harm","0","0","0","0","0","0","0","0","0","0","0","0","0","0"
"2012","Medicine Hat, Alberta, municipal","48062","Criminal negligence causing bodily harm","0","0","0","0","0","0","0","0","0","0","0","0","0","0"
"2013","Medicine Hat, Alberta, municipal","48062","Criminal negligence causing bodily harm","0","0","0","0","0","0","0","0","0","0","0","0","0","0"
"2014","Medicine Hat, Alberta, municipal","48062","Criminal negligence causing bodily harm","0","0","0","0","0","0","0","0","0","0","0","0","0","0"
"2015","Medicine Hat, Alberta, municipal","48062","Criminal negligence causing bodily harm","0","0","0","0","0","0","0","0","0","0","0","0","0","0"
"2016","Medicine Hat, Alberta, municipal","48062","Criminal negligence causing bodily harm","0","0","0","0","0","0","0","0","0","0","0","0","0","0"
"1998","Medicine Hat, Alberta, municipal","48062","Other assaults","7","4","0","0","14.09","0","0","0","0","4","3","3","0","0"
"1999","Medicine Hat, Alberta, municipal","48062","Other assaults","1","0","0","-85.98","1.97","0","0","0","0","0","0","0","0","0"
"2000","Medicine Hat, Alberta, municipal","48062","Other assaults","1","1","0","-2.24","1.93","0","0","0","0","1","0","0","0","0"
"2001","Medicine Hat, Alberta, municipal","48062","Other assaults","5","2","2","392.8","9.51","0","0","0","0","4","1","2","1","0"
"2002","Medicine Hat, Alberta, municipal","48062","Other assaults","1","1","0","-80.31","1.87","0","0","0","0","1","2","2","0","0"
"2003","Medicine Hat, Alberta, municipal","48062","Other assaults","2","0","1","97.11","3.69","0","0","0","0","1","0","0","0","0"
"2004","Medicine Hat, Alberta, municipal","48062","Other assaults","3","0","0","45.55","5.37","0","0","0","0","0","0","0","0","0"
"2005","Medicine Hat, Alberta, municipal","48062","Other assaults","7","5","0","127","12.19","6.66","10.1","44.4","0","5","3","5","2","0"
"2006","Medicine Hat, Alberta, municipal","48062","Other assaults","5","4","0","-30.44","8.48","8.62","7.86","0","0","4","4","4","0","0"
"2007","Medicine Hat, Alberta, municipal","48062","Other assaults","4","4","0","-21.87","6.63","6.3","7.67","22.27","0","4","3","4","1","0"
"2008","Medicine Hat, Alberta, municipal","48062","Other assaults","2","2","0","-50.8","3.26","6.19","5.67","0","0","2","3","3","0","0"
"2009","Medicine Hat, Alberta, municipal","48062","Other assaults","3","3","0","48.4","4.84","6.11","5.61","0","0","3","3","3","0","0"
"2010","Medicine Hat, Alberta, municipal","48062","Other assaults","6","4","0","99.97","9.68","8.15","7.48","0","0","4","4","4","0","0"
"2011","Medicine Hat, Alberta, municipal","48062","Other assaults","6","5","1","0.01","9.68","4.07","5.61","22.94","0","6","2","3","1","0"
"2012","Medicine Hat, Alberta, municipal","48062","Other assaults","4","3","0","-34.13","6.37","6.03","7.39","22.84","0","3","3","4","1","0"
"2013","Medicine Hat, Alberta, municipal","48062","Other assaults","1","1","0","-75.31","1.57","1.98","1.83","0","0","1","1","1","0","0"
"2014","Medicine Hat, Alberta, municipal","48062","Other assaults","2","2","0","98.28","3.12","3.93","3.62","0","0","2","2","2","0","0"
"2015","Medicine Hat, Alberta, municipal","48062","Other assaults","0","0","0","-100","0","0","0","0","0","0","0","0","0","0"
"2016","Medicine Hat, Alberta, municipal","48062","Other assaults","1","1","0","0","1.54","0","1.79","22.93","0","1","0","1","1","0"
"1998","Medicine Hat, Alberta, municipal","48062","Total firearms, use of, discharge, pointing","1","0","0","0","2.01","0","0","0","0","0","0","0","0","0"
"1999","Medicine Hat, Alberta, municipal","48062","Total firearms, use of, discharge, pointing","2","2","0","96.23","3.95","0","0","0","0","2","2","4","2","0"
"2000","Medicine Hat, Alberta, municipal","48062","Total firearms, use of, discharge, pointing","5","3","0","144.4","9.65","0","0","0","0","3","1","1","0","0"
"2001","Medicine Hat, Alberta, municipal","48062","Total firearms, use of, discharge, pointing","0","0","0","-100","0","0","0","0","0","0","0","0","0","0"
"2002","Medicine Hat, Alberta, municipal","48062","Total firearms, use of, discharge, pointing","4","4","0","0","7.49","0","0","0","0","4","4","4","0","0"
"2003","Medicine Hat, Alberta, municipal","48062","Total firearms, use of, discharge, pointing","2","2","0","-50.72","3.69","0","0","0","0","2","1","2","1","0"
"2004","Medicine Hat, Alberta, municipal","48062","Total firearms, use of, discharge, pointing","0","0","0","-100","0","0","0","0","0","0","0","0","0","0"
"2005","Medicine Hat, Alberta, municipal","48062","Total firearms, use of, discharge, pointing","1","0","1","0","1.74","0","0","0","22.2","1","0","0","0","1"
"2006","Medicine Hat, Alberta, municipal","48062","Total firearms, use of, discharge, pointing","1","1","0","-2.61","1.7","2.15","1.96","0","0","1","1","1","0","0"
"2007","Medicine Hat, Alberta, municipal","48062","Total firearms, use of, discharge, pointing","1","1","0","-2.34","1.66","2.1","1.92","0","0","1","1","1","0","0"
"2008","Medicine Hat, Alberta, municipal","48062","Total firearms, use of, discharge, pointing","4","4","0","293.62","6.52","6.19","5.67","0","0","4","3","3","0","0"
"2009","Medicine Hat, Alberta, municipal","48062","Total firearms, use of, discharge, pointing","1","1","0","-75.27","1.61","0","1.87","22.84","0","1","0","1","1","0"
"2010","Medicine Hat, Alberta, municipal","48062","Total firearms, use of, discharge, pointing","2","2","0","99.97","3.23","2.04","3.74","22.93","0","2","1","2","1","0"
"2011","Medicine Hat, Alberta, municipal","48062","Total firearms, use of, discharge, pointing","1","1","0","-49.99","1.61","2.04","1.87","0","0","1","1","1","0","0"
"2012","Medicine Hat, Alberta, municipal","48062","Total firearms, use of, discharge, pointing","0","0","0","-100","0","0","0","0","0","0","0","0","0","0"
"2013","Medicine Hat, Alberta, municipal","48062","Total firearms, use of, discharge, pointing","0","0","0","0","0","0","0","0","0","0","0","0","0","0"
"2014","Medicine Hat, Alberta, municipal","48062","Total firearms, use of, discharge, pointing","0","0","0","0","0","0","0","0","0","0","0","0","0","0"
"2015","Medicine Hat, Alberta, municipal","48062","Total firearms, use of, discharge, pointing","0","0","0","0","0","0","0","0","0","0","0","0","0","0"
"2016","Medicine Hat, Alberta, municipal","48062","Total firearms, use of, discharge, pointing","0","0","0","0","0","0","0","0","0","0","0","0","0","0"
"1998","Medicine Hat, Alberta, municipal","48062","Discharge firearm with intent","0","0","0","0","0","0","0","0","0","0","0","0","0","0"
"1999","Medicine Hat, Alberta, municipal","48062","Discharge firearm with intent","0","0","0","0","0","0","0","0","0","0","0","0","0","0"
"2000","Medicine Hat, Alberta, municipal","48062","Discharge firearm with intent","0","0","0","0","0","0","0","0","0","0","0","0","0","0"
"2001","Medicine Hat, Alberta, municipal","48062","Discharge firearm with intent","0","0","0","0","0","0","0","0","0","0","0","0","0","0"
"2002","Medicine Hat, Alberta, municipal","48062","Discharge firearm with intent","0","0","0","0","0","0","0","0","0","0","0","0","0","0"
"2003","Medicine Hat, Alberta, municipal","48062","Discharge firearm with intent","0","0","0","0","0","0","0","0","0","0","0","0","0","0"
"2004","Medicine Hat, Alberta, municipal","48062","Discharge firearm with intent","0","0","0","0","0","0","0","0","0","0","0","0","0","0"
"2005","Medicine Hat, Alberta, municipal","48062","Discharge firearm with intent","0","0","0","0","0","0","0","0","0","0","0","0","0","0"
"2006","Medicine Hat, Alberta, municipal","48062","Discharge firearm with intent","1","1","0","0","1.7","2.15","1.96","0","0","1","1","1","0","0"
"2007","Medicine Hat, Alberta, municipal","48062","Discharge firearm with intent","0","0","0","-100","0","0","0","0","0","0","0","0","0","0"
"2008","Medicine Hat, Alberta, municipal","48062","Discharge firearm with intent","4","4","0","0","6.52","6.19","5.67","0","0","4","3","3","0","0"
"2009","Medicine Hat, Alberta, municipal","48062","Discharge firearm with intent","0","0","0","-100","0","0","0","0","0","0","0","0","0","0"
"2010","Medicine Hat, Alberta, municipal","48062","Discharge firearm with intent","0","0","0","0","0","0","0","0","0","0","0","0","0","0"
"2011","Medicine Hat, Alberta, municipal","48062","Discharge firearm with intent","0","0","0","0","0","0","0","0","0","0","0","0","0","0"
"2012","Medicine Hat, Alberta, municipal","48062","Discharge firearm with intent","0","0","0","0","0","0","0","0","0","0","0","0","0","0"
"2013","Medicine Hat, Alberta, municipal","48062","Discharge firearm with intent","0","0","0","0","0","0","0","0","0","0","0","0","0","0"
"2014","Medicine Hat, Alberta, municipal","48062","Discharge firearm with intent","0","0","0","0","0","0","0","0","0","0","0","0","0","0"
"2015","Medicine Hat, Alberta, municipal","48062","Discharge firearm with intent","0","0","0","0","0","0","0","0","0","0","0","0","0","0"
"2016","Medicine Hat, Alberta, municipal","48062","Discharge firearm with intent","0","0","0","0","0","0","0","0","0","0","0","0","0","0"
"1998","Medicine Hat, Alberta, municipal","48062","Using firearm in commission of offence","0","0","0","0","0","0","0","0","0","0","0","0","0","0"
"1999","Medicine Hat, Alberta, municipal","48062","Using firearm in commission of offence","0","0","0","0","0","0","0","0","0","0","0","0","0","0"
"2000","Medicine Hat, Alberta, municipal","48062","Using firearm in commission of offence","1","0","0","0","1.93","0","0","0","0","0","0","0","0","0"
"2001","Medicine Hat, Alberta, municipal","48062","Using firearm in commission of offence","0","0","0","-100","0","0","0","0","0","0","0","0","0","0"
"2002","Medicine Hat, Alberta, municipal","48062","Using firearm in commission of offence","1","1","0","0","1.87","0","0","0","0","1","1","1","0","0"
"2003","Medicine Hat, Alberta, municipal","48062","Using firearm in commission of offence","0","0","0","-100","0","0","0","0","0","0","0","0","0","0"
"2004","Medicine Hat, Alberta, municipal","48062","Using firearm in commission of offence","0","0","0","0","0","0","0","0","0","0","0","0","0","0"
"2005","Medicine Hat, Alberta, municipal","48062","Using firearm in commission of offence","0","0","0","0","0","0","0","0","0","0","0","0","0","0"
"2006","Medicine Hat, Alberta, municipal","48062","Using firearm in commission of offence","0","0","0","0","0","0","0","0","0","0","0","0","0","0"
"2007","Medicine Hat, Alberta, municipal","48062","Using firearm in commission of offence","0","0","0","0","0","0","0","0","0","0","0","0","0","0"
"2008","Medicine Hat, Alberta, municipal","48062","Using firearm in commission of offence","0","0","0","0","0","0","0","0","0","0","0","0","0","0"
"2009","Medicine Hat, Alberta, municipal","48062","Using firearm in commission of offence","0","0","0","0","0","0","0","0","0","0","0","0","0","0"
"2010","Medicine Hat, Alberta, municipal","48062","Using firearm in commission of offence","0","0","0","0","0","0","0","0","0","0","0","0","0","0"
"2011","Medicine Hat, Alberta, municipal","48062","Using firearm in commission of offence","1","1","0","0","1.61","2.04","1.87","0","0","1","1","1","0","0"
"2012","Medicine Hat, Alberta, municipal","48062","Using firearm in commission of offence","0","0","0","-100","0","0","0","0","0","0","0","0","0","0"
"2013","Medicine Hat, Alberta, municipal","48062","Using firearm in commission of offence","0","0","0","0","0","0","0","0","0","0","0","0","0","0"
"2014","Medicine Hat, Alberta, municipal","48062","Using firearm in commission of offence","0","0","0","0","0","0","0","0","0","0","0","0","0","0"
"2015","Medicine Hat, Alberta, municipal","48062","Using firearm in commission of offence","0","0","0","0","0","0","0","0","0","0","0","0","0","0"
"2016","Medicine Hat, Alberta, municipal","48062","Using firearm in commission of offence","0","0","0","0","0","0","0","0","0","0","0","0","0","0"
"1998","Medicine Hat, Alberta, municipal","48062","Pointing a firearm","1","0","0","0","2.01","0","0","0","0","0","0","0","0","0"
"1999","Medicine Hat, Alberta, municipal","48062","Pointing a firearm","2","2","0","96.23","3.95","0","0","0","0","2","2","4","2","0"
"2000","Medicine Hat, Alberta, municipal","48062","Pointing a firearm","4","3","0","95.52","7.72","0","0","0","0","3","1","1","0","0"
"2001","Medicine Hat, Alberta, municipal","48062","Pointing a firearm","0","0","0","-100","0","0","0","0","0","0","0","0","0","0"
"2002","Medicine Hat, Alberta, municipal","48062","Pointing a firearm","3","3","0","0","5.62","0","0","0","0","3","3","3","0","0"
"2003","Medicine Hat, Alberta, municipal","48062","Pointing a firearm","2","2","0","-34.3","3.69","0","0","0","0","2","1","2","1","0"
"2004","Medicine Hat, Alberta, municipal","48062","Pointing a firearm","0","0","0","-100","0","0","0","0","0","0","0","0","0","0"
"2005","Medicine Hat, Alberta, municipal","48062","Pointing a firearm","1","0","1","0","1.74","0","0","0","22.2","1","0","0","0","1"
"2006","Medicine Hat, Alberta, municipal","48062","Pointing a firearm","0","0","0","-100","0","0","0","0","0","0","0","0","0","0"
"2007","Medicine Hat, Alberta, municipal","48062","Pointing a firearm","1","1","0","0","1.66","2.1","1.92","0","0","1","1","1","0","0"
"2008","Medicine Hat, Alberta, municipal","48062","Pointing a firearm","0","0","0","-100","0","0","0","0","0","0","0","0","0","0"
"2009","Medicine Hat, Alberta, municipal","48062","Pointing a firearm","1","1","0","0","1.61","0","1.87","22.84","0","1","0","1","1","0"
"2010","Medicine Hat, Alberta, municipal","48062","Pointing a firearm","2","2","0","99.97","3.23","2.04","3.74","22.93","0","2","1","2","1","0"
"2011","Medicine Hat, Alberta, municipal","48062","Pointing a firearm","0","0","0","-100","0","0","0","0","0","0","0","0","0","0"
"2012","Medicine Hat, Alberta, municipal","48062","Pointing a firearm","0","0","0","0","0","0","0","0","0","0","0","0","0","0"
"2013","Medicine Hat, Alberta, municipal","48062","Pointing a firearm","0","0","0","0","0","0","0","0","0","0","0","0","0","0"
"2014","Medicine Hat, Alberta, municipal","48062","Pointing a firearm","0","0","0","0","0","0","0","0","0","0","0","0","0","0"
"2015","Medicine Hat, Alberta, municipal","48062","Pointing a firearm","0","0","0","0","0","0","0","0","0","0","0","0","0","0"
"2016","Medicine Hat, Alberta, municipal","48062","Pointing a firearm","0","0","0","0","0","0","0","0","0","0","0","0","0","0"
"1998","Medicine Hat, Alberta, municipal","48062","Total robbery","27","13","0","0","54.33","0","0","0","0","13","12","20","8","0"
"1999","Medicine Hat, Alberta, municipal","48062","Total robbery","16","8","0","-41.86","31.59","0","0","0","0","8","9","14","5","0"
"2000","Medicine Hat, Alberta, municipal","48062","Total robbery","29","13","0","77.19","55.97","0","0","0","0","13","11","20","9","0"
"2001","Medicine Hat, Alberta, municipal","48062","Total robbery","21","12","0","-28.63","39.95","0","0","0","0","12","16","21","5","1"
"2002","Medicine Hat, Alberta, municipal","48062","Total robbery","30","11","1","40.62","56.17","0","0","0","0","12","12","19","7","0"
"2003","Medicine Hat, Alberta, municipal","48062","Total robbery","33","11","0","8.41","60.9","0","0","0","0","11","10","10","0","0"
"2004","Medicine Hat, Alberta, municipal","48062","Total robbery","27","15","0","-20.61","48.35","41.22","41.57","45.05","0","15","18","20","2","0"
"2005","Medicine Hat, Alberta, municipal","48062","Total robbery","20","15","0","-27.94","34.84","39.98","40.39","44.4","0","15","18","20","2","0"
"2006","Medicine Hat, Alberta, municipal","48062","Total robbery","20","16","0","-2.61","33.93","49.56","51.07","66.73","0","16","23","26","3","0"
"2007","Medicine Hat, Alberta, municipal","48062","Total robbery","33","18","0","61.15","54.67","37.78","51.79","200.45","0","18","18","27","9","0"
"2008","Medicine Hat, Alberta, municipal","48062","Total robbery","32","20","0","-4.58","52.17","26.81","32.11","89.89","0","20","13","17","4","0"
"2009","Medicine Hat, Alberta, municipal","48062","Total robbery","29","16","1","-10.34","46.78","24.43","26.17","45.68","0","17","12","14","2","0"
"2010","Medicine Hat, Alberta, municipal","48062","Total robbery","28","20","0","-3.46","45.16","36.66","33.67","0","0","20","18","18","0","0"
"2011","Medicine Hat, Alberta, municipal","48062","Total robbery","18","11","0","-35.71","29.03","22.4","22.44","22.94","0","11","11","12","1","0"
"2012","Medicine Hat, Alberta, municipal","48062","Total robbery","13","9","0","-28.64","20.72","18.09","22.17","68.51","0","9","9","12","3","0"
"2013","Medicine Hat, Alberta, municipal","48062","Total robbery","25","13","0","89.94","39.35","25.79","25.56","22.92","0","13","13","14","1","0"
"2014","Medicine Hat, Alberta, municipal","48062","Total robbery","10","7","0","-60.34","15.6","9.82","9.05","0","0","7","5","5","0","0"
"2015","Medicine Hat, Alberta, municipal","48062","Total robbery","17","13","0","68.71","26.33","27.32","28.78","46.09","0","13","14","16","2","0"
"2016","Medicine Hat, Alberta, municipal","48062","Total robbery","28","23","0","63.7","43.1","46.63","48.36","68.79","0","23","24","27","3","0"
"1998","Medicine Hat, Alberta, municipal","48062","Robbery","27","13","0","0","54.33","0","0","0","0","13","12","20","8","0"
"1999","Medicine Hat, Alberta, municipal","48062","Robbery","16","8","0","-41.86","31.59","0","0","0","0","8","9","14","5","0"
"2000","Medicine Hat, Alberta, municipal","48062","Robbery","29","13","0","77.19","55.97","0","0","0","0","13","11","20","9","0"
"2001","Medicine Hat, Alberta, municipal","48062","Robbery","21","12","0","-28.63","39.95","0","0","0","0","12","16","21","5","1"
"2002","Medicine Hat, Alberta, municipal","48062","Robbery","30","11","1","40.62","56.17","0","0","0","0","12","12","19","7","0"
"2003","Medicine Hat, Alberta, municipal","48062","Robbery","33","11","0","8.41","60.9","0","0","0","0","11","10","10","0","0"
"2004","Medicine Hat, Alberta, municipal","48062","Robbery","27","15","0","-20.61","48.35","41.22","41.57","45.05","0","15","18","20","2","0"
"2005","Medicine Hat, Alberta, municipal","48062","Robbery","20","15","0","-27.94","34.84","39.98","40.39","44.4","0","15","18","20","2","0"
"2006","Medicine Hat, Alberta, municipal","48062","Robbery","20","16","0","-2.61","33.93","49.56","51.07","66.73","0","16","23","26","3","0"
"2007","Medicine Hat, Alberta, municipal","48062","Robbery","33","18","0","61.15","54.67","37.78","51.79","200.45","0","18","18","27","9","0"
"2008","Medicine Hat, Alberta, municipal","48062","Robbery","32","20","0","-4.58","52.17","26.81","32.11","89.89","0","20","13","17","4","0"
"2009","Medicine Hat, Alberta, municipal","48062","Robbery","29","16","1","-10.34","46.78","24.43","26.17","45.68","0","17","12","14","2","0"
"2010","Medicine Hat, Alberta, municipal","48062","Robbery","28","20","0","-3.46","45.16","36.66","33.67","0","0","20","18","18","0","0"
"2011","Medicine Hat, Alberta, municipal","48062","Robbery","18","11","0","-35.71","29.03","22.4","22.44","22.94","0","11","11","12","1","0"
"2012","Medicine Hat, Alberta, municipal","48062","Robbery","13","9","0","-28.64","20.72","18.09","22.17","68.51","0","9","9","12","3","0"
"2013","Medicine Hat, Alberta, municipal","48062","Robbery","25","13","0","89.94","39.35","25.79","25.56","22.92","0","13","13","14","1","0"
"2014","Medicine Hat, Alberta, municipal","48062","Robbery","10","7","0","-60.34","15.6","9.82","9.05","0","0","7","5","5","0","0"
"2015","Medicine Hat, Alberta, municipal","48062","Robbery","17","13","0","68.71","26.33","27.32","28.78","46.09","0","13","14","16","2","0"
"2016","Medicine Hat, Alberta, municipal","48062","Robbery","28","23","0","63.7","43.1","46.63","48.36","68.79","0","23","24","27","3","0"
"2005","Medicine Hat, Alberta, municipal","48062","Robbery to steal a firearm","0","0","0","0","0","0","0","0","0","0","0","0","0","0"
"2006","Medicine Hat, Alberta, municipal","48062","Robbery to steal a firearm","0","0","0","0","0","0","0","0","0","0","0","0","0","0"
"2007","Medicine Hat, Alberta, municipal","48062","Robbery to steal a firearm","0","0","0","0","0","0","0","0","0","0","0","0","0","0"
"2008","Medicine Hat, Alberta, municipal","48062","Robbery to steal a firearm","0","0","0","0","0","0","0","0","0","0","0","0","0","0"
"2009","Medicine Hat, Alberta, municipal","48062","Robbery to steal a firearm","0","0","0","0","0","0","0","0","0","0","0","0","0","0"
"2010","Medicine Hat, Alberta, municipal","48062","Robbery to steal a firearm","0","0","0","0","0","0","0","0","0","0","0","0","0","0"
"2011","Medicine Hat, Alberta, municipal","48062","Robbery to steal a firearm","0","0","0","0","0","0","0","0","0","0","0","0","0","0"
"2012","Medicine Hat, Alberta, municipal","48062","Robbery to steal a firearm","0","0","0","0","0","0","0","0","0","0","0","0","0","0"
"2013","Medicine Hat, Alberta, municipal","48062","Robbery to steal a firearm","0","0","0","0","0","0","0","0","0","0","0","0","0","0"
"2014","Medicine Hat, Alberta, municipal","48062","Robbery to steal a firearm","0","0","0","0","0","0","0","0","0","0","0","0","0","0"
"2015","Medicine Hat, Alberta, municipal","48062","Robbery to steal a firearm","0","0","0","0","0","0","0","0","0","0","0","0","0","0"
"2016","Medicine Hat, Alberta, municipal","48062","Robbery to steal a firearm","0","0","0","0","0","0","0","0","0","0","0","0","0","0"
"1998","Medicine Hat, Alberta, municipal","48062","Total forcible confinement or kidnapping","2","2","2","0","4.02","0","0","0","0","4","0","0","0","0"
"1999","Medicine Hat, Alberta, municipal","48062","Total forcible confinement or kidnapping","3","3","0","47.17","5.92","0","0","0","0","3","3","3","0","0"
"2000","Medicine Hat, Alberta, municipal","48062","Total forcible confinement or kidnapping","1","1","0","-67.41","1.93","0","0","0","0","1","2","2","0","0"
"2001","Medicine Hat, Alberta, municipal","48062","Total forcible confinement or kidnapping","4","3","0","294.24","7.61","0","0","0","0","3","3","3","0","0"
"2002","Medicine Hat, Alberta, municipal","48062","Total forcible confinement or kidnapping","4","4","0","-1.56","7.49","0","0","0","0","4","2","2","0","0"
"2003","Medicine Hat, Alberta, municipal","48062","Total forcible confinement or kidnapping","10","9","0","146.39","18.45","0","0","0","0","9","10","11","1","0"
"2004","Medicine Hat, Alberta, municipal","48062","Total forcible confinement or kidnapping","6","6","0","-41.78","10.74","11.45","10.39","0","0","6","5","5","0","0"
"2005","Medicine Hat, Alberta, municipal","48062","Total forcible confinement or kidnapping","12","12","0","94.57","20.9","19.99","18.17","0","0","12","9","9","0","0"
"2006","Medicine Hat, Alberta, municipal","48062","Total forcible confinement or kidnapping","12","11","0","-2.61","20.36","17.24","15.72","0","0","11","8","8","0","0"
"2007","Medicine Hat, Alberta, municipal","48062","Total forcible confinement or kidnapping","12","13","0","-2.34","19.88","25.19","23.02","0","0","13","12","12","0","0"
"2008","Medicine Hat, Alberta, municipal","48062","Total forcible confinement or kidnapping","9","9","0","-26.2","14.67","18.56","17","0","0","9","9","9","0","0"
"2009","Medicine Hat, Alberta, municipal","48062","Total forcible confinement or kidnapping","7","7","0","-23.05","11.29","14.25","13.09","0","0","7","7","7","0","0"
"2010","Medicine Hat, Alberta, municipal","48062","Total forcible confinement or kidnapping","14","12","0","99.97","22.58","22.41","20.58","0","0","12","11","11","0","0"
"2011","Medicine Hat, Alberta, municipal","48062","Total forcible confinement or kidnapping","5","5","0","-64.28","8.06","10.18","9.35","0","0","5","5","5","0","0"
"2012","Medicine Hat, Alberta, municipal","48062","Total forcible confinement or kidnapping","15","15","0","196.4","23.9","34.17","33.26","22.84","0","15","17","18","1","0"
"2013","Medicine Hat, Alberta, municipal","48062","Total forcible confinement or kidnapping","8","7","0","-47.32","12.59","13.89","12.78","0","0","7","7","7","0","0"
"2014","Medicine Hat, Alberta, municipal","48062","Total forcible confinement or kidnapping","7","6","0","-13.25","10.92","9.82","9.05","0","0","6","5","5","0","0"
"2015","Medicine Hat, Alberta, municipal","48062","Total forcible confinement or kidnapping","18","18","0","155.19","27.88","31.22","28.78","0","0","18","16","16","0","0"
"2016","Medicine Hat, Alberta, municipal","48062","Total forcible confinement or kidnapping","17","17","0","-6.13","26.17","42.75","39.41","0","0","17","22","22","0","0"
"1998","Medicine Hat, Alberta, municipal","48062","Forcible confinement or kidnapping","2","2","2","0","4.02","0","0","0","0","4","0","0","0","0"
"1999","Medicine Hat, Alberta, municipal","48062","Forcible confinement or kidnapping","3","3","0","47.17","5.92","0","0","0","0","3","3","3","0","0"
"2000","Medicine Hat, Alberta, municipal","48062","Forcible confinement or kidnapping","1","1","0","-67.41","1.93","0","0","0","0","1","2","2","0","0"
"2001","Medicine Hat, Alberta, municipal","48062","Forcible confinement or kidnapping","4","3","0","294.24","7.61","0","0","0","0","3","3","3","0","0"
"2002","Medicine Hat, Alberta, municipal","48062","Forcible confinement or kidnapping","4","4","0","-1.56","7.49","0","0","0","0","4","2","2","0","0"
"2003","Medicine Hat, Alberta, municipal","48062","Forcible confinement or kidnapping","10","9","0","146.39","18.45","0","0","0","0","9","10","11","1","0"
"2004","Medicine Hat, Alberta, municipal","48062","Forcible confinement or kidnapping","6","6","0","-41.78","10.74","11.45","10.39","0","0","6","5","5","0","0"
"2005","Medicine Hat, Alberta, municipal","48062","Forcible confinement or kidnapping","12","12","0","94.57","20.9","19.99","18.17","0","0","12","9","9","0","0"
"2006","Medicine Hat, Alberta, municipal","48062","Forcible confinement or kidnapping","12","11","0","-2.61","20.36","17.24","15.72","0","0","11","8","8","0","0"
"2007","Medicine Hat, Alberta, municipal","48062","Forcible confinement or kidnapping","12","13","0","-2.34","19.88","25.19","23.02","0","0","13","12","12","0","0"
"2008","Medicine Hat, Alberta, municipal","48062","Forcible confinement or kidnapping","8","8","0","-34.4","13.04","16.5","15.11","0","0","8","8","8","0","0"
"2009","Medicine Hat, Alberta, municipal","48062","Forcible confinement or kidnapping","1","1","0","-87.63","1.61","2.04","1.87","0","0","1","1","1","0","0"
"2010","Medicine Hat, Alberta, municipal","48062","Forcible confinement or kidnapping","0","0","0","-100","0","0","0","0","0","0","0","0","0","0"
"2011","Medicine Hat, Alberta, municipal","48062","Forcible confinement or kidnapping","0","0","0","0","0","0","0","0","0","0","0","0","0","0"
"2012","Medicine Hat, Alberta, municipal","48062","Forcible confinement or kidnapping","0","0","0","0","0","0","0","0","0","0","0","0","0","0"
"2013","Medicine Hat, Alberta, municipal","48062","Forcible confinement or kidnapping","0","0","0","0","0","0","0","0","0","0","0","0","0","0"
"2014","Medicine Hat, Alberta, municipal","48062","Forcible confinement or kidnapping","0","0","0","0","0","0","0","0","0","0","0","0","0","0"
"2015","Medicine Hat, Alberta, municipal","48062","Forcible confinement or kidnapping","0","0","0","0","0","0","0","0","0","0","0","0","0","0"
"2016","Medicine Hat, Alberta, municipal","48062","Forcible confinement or kidnapping","0","0","0","0","0","0","0","0","0","0","0","0","0","0"
"2005","Medicine Hat, Alberta, municipal","48062","Kidnapping","0","0","0","0","0","0","0","0","0","0","0","0","0","0"
"2006","Medicine Hat, Alberta, municipal","48062","Kidnapping","0","0","0","0","0","0","0","0","0","0","0","0","0","0"
"2007","Medicine Hat, Alberta, municipal","48062","Kidnapping","0","0","0","0","0","0","0","0","0","0","0","0","0","0"
"2008","Medicine Hat, Alberta, municipal","48062","Kidnapping","0","0","0","0","0","0","0","0","0","0","0","0","0","0"
"2009","Medicine Hat, Alberta, municipal","48062","Kidnapping","0","0","0","0","0","0","0","0","0","0","0","0","0","0"
"2010","Medicine Hat, Alberta, municipal","48062","Kidnapping","0","0","0","0","0","0","0","0","0","0","0","0","0","0"
"2011","Medicine Hat, Alberta, municipal","48062","Kidnapping","1","1","0","0","1.61","2.04","1.87","0","0","1","1","1","0","0"
"2012","Medicine Hat, Alberta, municipal","48062","Kidnapping","1","1","0","-1.2","1.59","8.04","7.39","0","0","1","4","4","0","0"
"2013","Medicine Hat, Alberta, municipal","48062","Kidnapping","0","0","0","-100","0","0","0","0","0","0","0","0","0","0"
"2014","Medicine Hat, Alberta, municipal","48062","Kidnapping","2","1","0","0","3.12","0","0","0","0","1","0","0","0","0"
"2015","Medicine Hat, Alberta, municipal","48062","Kidnapping","1","1","0","-50.38","1.55","1.95","1.8","0","0","1","1","1","0","0"
"2016","Medicine Hat, Alberta, municipal","48062","Kidnapping","2","2","0","98.78","3.08","13.6","12.54","0","0","2","7","7","0","0"
"2005","Medicine Hat, Alberta, municipal","48062","Forcible confinement","0","0","0","0","0","0","0","0","0","0","0","0","0","0"
"2006","Medicine Hat, Alberta, municipal","48062","Forcible confinement","0","0","0","0","0","0","0","0","0","0","0","0","0","0"
"2007","Medicine Hat, Alberta, municipal","48062","Forcible confinement","0","0","0","0","0","0","0","0","0","0","0","0","0","0"
"2008","Medicine Hat, Alberta, municipal","48062","Forcible confinement","1","1","0","0","1.63","2.06","1.89","0","0","1","1","1","0","0"
"2009","Medicine Hat, Alberta, municipal","48062","Forcible confinement","6","6","0","493.6","9.68","12.22","11.22","0","0","6","6","6","0","0"
"2010","Medicine Hat, Alberta, municipal","48062","Forcible confinement","14","12","0","133.3","22.58","22.41","20.58","0","0","12","11","11","0","0"
"2011","Medicine Hat, Alberta, municipal","48062","Forcible confinement","4","4","0","-71.42","6.45","8.14","7.48","0","0","4","4","4","0","0"
"2012","Medicine Hat, Alberta, municipal","48062","Forcible confinement","14","14","0","245.81","22.31","26.13","25.87","22.84","0","14","13","14","1","0"
"2013","Medicine Hat, Alberta, municipal","48062","Forcible confinement","8","7","0","-43.56","12.59","13.89","12.78","0","0","7","7","7","0","0"
"2014","Medicine Hat, Alberta, municipal","48062","Forcible confinement","5","5","0","-38.04","7.8","9.82","9.05","0","0","5","5","5","0","0"
"2015","Medicine Hat, Alberta, municipal","48062","Forcible confinement","17","17","0","237.42","26.33","29.27","26.99","0","0","17","15","15","0","0"
"2016","Medicine Hat, Alberta, municipal","48062","Forcible confinement","15","15","0","-12.3","23.09","29.15","26.87","0","0","15","15","15","0","0"
"1998","Medicine Hat, Alberta, municipal","48062","Total abduction","0","0","0","0","0","0","0","0","0","0","0","0","0","0"
"1999","Medicine Hat, Alberta, municipal","48062","Total abduction","3","3","0","0","5.92","0","0","0","0","3","2","2","0","0"
"2000","Medicine Hat, Alberta, municipal","48062","Total abduction","4","4","1","30.35","7.72","0","0","0","0","5","2","2","0","0"
"2001","Medicine Hat, Alberta, municipal","48062","Total abduction","4","0","4","-1.44","7.61","0","0","0","0","4","0","0","0","0"
"2002","Medicine Hat, Alberta, municipal","48062","Total abduction","1","0","0","-75.39","1.87","0","0","0","0","0","0","0","0","0"
"2003","Medicine Hat, Alberta, municipal","48062","Total abduction","1","0","0","-1.44","1.85","0","0","0","0","0","0","0","0","0"
"2004","Medicine Hat, Alberta, municipal","48062","Total abduction","0","0","0","-100","0","0","0","0","0","0","0","0","0","0"
"2005","Medicine Hat, Alberta, municipal","48062","Total abduction","10","2","0","0","17.42","4.44","4.04","0","0","2","2","2","0","0"
"2006","Medicine Hat, Alberta, municipal","48062","Total abduction","3","2","0","-70.78","5.09","2.15","1.96","0","0","2","1","1","0","0"
"2007","Medicine Hat, Alberta, municipal","48062","Total abduction","1","0","0","-67.45","1.66","0","0","0","0","0","0","0","0","0"
"2008","Medicine Hat, Alberta, municipal","48062","Total abduction","1","1","0","-1.6","1.63","2.06","1.89","0","0","1","1","1","0","0"
"2009","Medicine Hat, Alberta, municipal","48062","Total abduction","2","1","1","97.87","3.23","2.04","1.87","0","0","2","1","1","0","0"
"2010","Medicine Hat, Alberta, municipal","48062","Total abduction","0","0","0","-100","0","0","0","0","0","0","0","0","0","0"
"2011","Medicine Hat, Alberta, municipal","48062","Total abduction","0","0","0","0","0","0","0","0","0","0","0","0","0","0"
"2012","Medicine Hat, Alberta, municipal","48062","Total abduction","2","0","0","0","3.19","0","0","0","0","0","0","0","0","0"
"2013","Medicine Hat, Alberta, municipal","48062","Total abduction","0","0","0","-100","0","0","0","0","0","0","0","0","0","0"
"2014","Medicine Hat, Alberta, municipal","48062","Total abduction","1","0","0","0","1.56","0","0","0","0","0","0","0","0","0"
"2015","Medicine Hat, Alberta, municipal","48062","Total abduction","1","1","0","-0.76","1.55","1.95","1.8","0","0","1","1","1","0","0"
"2016","Medicine Hat, Alberta, municipal","48062","Total abduction","0","0","0","-100","0","0","0","0","0","0","0","0","0","0"
"1998","Medicine Hat, Alberta, municipal","48062","Abduction under the age 14, not parent or guardian","0","0","0","0","0","0","0","0","0","0","0","0","0","0"
"1999","Medicine Hat, Alberta, municipal","48062","Abduction under the age 14, not parent or guardian","0","0","0","0","0","0","0","0","0","0","0","0","0","0"
"2000","Medicine Hat, Alberta, municipal","48062","Abduction under the age 14, not parent or guardian","0","0","1","0","0","0","0","0","0","1","0","0","0","0"
"2001","Medicine Hat, Alberta, municipal","48062","Abduction under the age 14, not parent or guardian","0","0","0","0","0","0","0","0","0","0","0","0","0","0"
"2002","Medicine Hat, Alberta, municipal","48062","Abduction under the age 14, not parent or guardian","0","0","0","0","0","0","0","0","0","0","0","0","0","0"
"2003","Medicine Hat, Alberta, municipal","48062","Abduction under the age 14, not parent or guardian","0","0","0","0","0","0","0","0","0","0","0","0","0","0"
"2004","Medicine Hat, Alberta, municipal","48062","Abduction under the age 14, not parent or guardian","0","0","0","0","0","0","0","0","0","0","0","0","0","0"
"2005","Medicine Hat, Alberta, municipal","48062","Abduction under the age 14, not parent or guardian","4","0","0","0","6.97","0","0","0","0","0","0","0","0","0"
"2006","Medicine Hat, Alberta, municipal","48062","Abduction under the age 14, not parent or guardian","1","0","0","-75.65","1.7","0","0","0","0","0","0","0","0","0"
"2007","Medicine Hat, Alberta, municipal","48062","Abduction under the age 14, not parent or guardian","0","0","0","-100","0","0","0","0","0","0","0","0","0","0"
"2008","Medicine Hat, Alberta, municipal","48062","Abduction under the age 14, not parent or guardian","1","1","0","0","1.63","2.06","1.89","0","0","1","1","1","0","0"
"2009","Medicine Hat, Alberta, municipal","48062","Abduction under the age 14, not parent or guardian","0","0","0","-100","0","0","0","0","0","0","0","0","0","0"
"2010","Medicine Hat, Alberta, municipal","48062","Abduction under the age 14, not parent or guardian","0","0","0","0","0","0","0","0","0","0","0","0","0","0"
"2011","Medicine Hat, Alberta, municipal","48062","Abduction under the age 14, not parent or guardian","0","0","0","0","0","0","0","0","0","0","0","0","0","0"
"2012","Medicine Hat, Alberta, municipal","48062","Abduction under the age 14, not parent or guardian","0","0","0","0","0","0","0","0","0","0","0","0","0","0"
"2013","Medicine Hat, Alberta, municipal","48062","Abduction under the age 14, not parent or guardian","0","0","0","0","0","0","0","0","0","0","0","0","0","0"
"2014","Medicine Hat, Alberta, municipal","48062","Abduction under the age 14, not parent or guardian","1","0","0","0","1.56","0","0","0","0","0","0","0","0","0"
"2015","Medicine Hat, Alberta, municipal","48062","Abduction under the age 14, not parent or guardian","0","0","0","-100","0","0","0","0","0","0","0","0","0","0"
"2016","Medicine Hat, Alberta, municipal","48062","Abduction under the age 14, not parent or guardian","0","0","0","0","0","0","0","0","0","0","0","0","0","0"
"1998","Medicine Hat, Alberta, municipal","48062","Abduction under the age 16","0","0","0","0","0","0","0","0","0","0","0","0","0","0"
"1999","Medicine Hat, Alberta, municipal","48062","Abduction under the age 16","0","0","0","0","0","0","0","0","0","0","0","0","0","0"
"2000","Medicine Hat, Alberta, municipal","48062","Abduction under the age 16","0","0","0","0","0","0","0","0","0","0","0","0","0","0"
"2001","Medicine Hat, Alberta, municipal","48062","Abduction under the age 16","0","0","0","0","0","0","0","0","0","0","0","0","0","0"
"2002","Medicine Hat, Alberta, municipal","48062","Abduction under the age 16","1","0","0","0","1.87","0","0","0","0","0","0","0","0","0"
"2003","Medicine Hat, Alberta, municipal","48062","Abduction under the age 16","0","0","0","-100","0","0","0","0","0","0","0","0","0","0"
"2004","Medicine Hat, Alberta, municipal","48062","Abduction under the age 16","0","0","0","0","0","0","0","0","0","0","0","0","0","0"
"2005","Medicine Hat, Alberta, municipal","48062","Abduction under the age 16","3","1","0","0","5.23","2.22","2.02","0","0","1","1","1","0","0"
"2006","Medicine Hat, Alberta, municipal","48062","Abduction under the age 16","2","2","0","-35.08","3.39","2.15","1.96","0","0","2","1","1","0","0"
"2007","Medicine Hat, Alberta, municipal","48062","Abduction under the age 16","0","0","0","-100","0","0","0","0","0","0","0","0","0","0"
"2008","Medicine Hat, Alberta, municipal","48062","Abduction under the age 16","0","0","0","0","0","0","0","0","0","0","0","0","0","0"
"2009","Medicine Hat, Alberta, municipal","48062","Abduction under the age 16","0","0","0","0","0","0","0","0","0","0","0","0","0","0"
"2010","Medicine Hat, Alberta, municipal","48062","Abduction under the age 16","0","0","0","0","0","0","0","0","0","0","0","0","0","0"
"2011","Medicine Hat, Alberta, municipal","48062","Abduction under the age 16","0","0","0","0","0","0","0","0","0","0","0","0","0","0"
"2012","Medicine Hat, Alberta, municipal","48062","Abduction under the age 16","0","0","0","0","0","0","0","0","0","0","0","0","0","0"
"2013","Medicine Hat, Alberta, municipal","48062","Abduction under the age 16","0","0","0","0","0","0","0","0","0","0","0","0","0","0"
"2014","Medicine Hat, Alberta, municipal","48062","Abduction under the age 16","0","0","0","0","0","0","0","0","0","0","0","0","0","0"
"2015","Medicine Hat, Alberta, municipal","48062","Abduction under the age 16","0","0","0","0","0","0","0","0","0","0","0","0","0","0"
"2016","Medicine Hat, Alberta, municipal","48062","Abduction under the age 16","0","0","0","0","0","0","0","0","0","0","0","0","0","0"
"1998","Medicine Hat, Alberta, municipal","48062","Removal of children from Canada","0","0","0","0","0","0","0","0","0","0","0","0","0","0"
"1999","Medicine Hat, Alberta, municipal","48062","Removal of children from Canada","0","0","0","0","0","0","0","0","0","0","0","0","0","0"
"2000","Medicine Hat, Alberta, municipal","48062","Removal of children from Canada","0","0","0","0","0","0","0","0","0","0","0","0","0","0"
"2001","Medicine Hat, Alberta, municipal","48062","Removal of children from Canada","0","0","0","0","0","0","0","0","0","0","0","0","0","0"
"2002","Medicine Hat, Alberta, municipal","48062","Removal of children from Canada","0","0","0","0","0","0","0","0","0","0","0","0","0","0"
"2003","Medicine Hat, Alberta, municipal","48062","Removal of children from Canada","0","0","0","0","0","0","0","0","0","0","0","0","0","0"
"2004","Medicine Hat, Alberta, municipal","48062","Removal of children from Canada","0","0","0","0","0","0","0","0","0","0","0","0","0","0"
"2005","Medicine Hat, Alberta, municipal","48062","Removal of children from Canada","0","0","0","0","0","0","0","0","0","0","0","0","0","0"
"2006","Medicine Hat, Alberta, municipal","48062","Removal of children from Canada","0","0","0","0","0","0","0","0","0","0","0","0","0","0"
"2007","Medicine Hat, Alberta, municipal","48062","Removal of children from Canada","0","0","0","0","0","0","0","0","0","0","0","0","0","0"
"2008","Medicine Hat, Alberta, municipal","48062","Removal of children from Canada","0","0","0","0","0","0","0","0","0","0","0","0","0","0"
"2009","Medicine Hat, Alberta, municipal","48062","Removal of children from Canada","0","0","0","0","0","0","0","0","0","0","0","0","0","0"
"2010","Medicine Hat, Alberta, municipal","48062","Removal of children from Canada","0","0","0","0","0","0","0","0","0","0","0","0","0","0"
"2011","Medicine Hat, Alberta, municipal","48062","Removal of children from Canada","0","0","0","0","0","0","0","0","0","0","0","0","0","0"
"2012","Medicine Hat, Alberta, municipal","48062","Removal of children from Canada","0","0","0","0","0","0","0","0","0","0","0","0","0","0"
"2013","Medicine Hat, Alberta, municipal","48062","Removal of children from Canada","0","0","0","0","0","0","0","0","0","0","0","0","0","0"
"2014","Medicine Hat, Alberta, municipal","48062","Removal of children from Canada","0","0","0","0","0","0","0","0","0","0","0","0","0","0"
"2015","Medicine Hat, Alberta, municipal","48062","Removal of children from Canada","0","0","0","0","0","0","0","0","0","0","0","0","0","0"
"2016","Medicine Hat, Alberta, municipal","48062","Removal of children from Canada","0","0","0","0","0","0","0","0","0","0","0","0","0","0"
"1998","Medicine Hat, Alberta, municipal","48062","Abduction under the age 14 contravening a custody order","0","0","0","0","0","0","0","0","0","0","0","0","0","0"
"1999","Medicine Hat, Alberta, municipal","48062","Abduction under the age 14 contravening a custody order","0","0","0","0","0","0","0","0","0","0","0","0","0","0"
"2000","Medicine Hat, Alberta, municipal","48062","Abduction under the age 14 contravening a custody order","3","3","0","0","5.79","0","0","0","0","3","1","1","0","0"
"2001","Medicine Hat, Alberta, municipal","48062","Abduction under the age 14 contravening a custody order","0","0","0","-100","0","0","0","0","0","0","0","0","0","0"
"2002","Medicine Hat, Alberta, municipal","48062","Abduction under the age 14 contravening a custody order","0","0","0","0","0","0","0","0","0","0","0","0","0","0"
"2003","Medicine Hat, Alberta, municipal","48062","Abduction under the age 14 contravening a custody order","1","0","0","0","1.85","0","0","0","0","0","0","0","0","0"
"2004","Medicine Hat, Alberta, municipal","48062","Abduction under the age 14 contravening a custody order","0","0","0","-100","0","0","0","0","0","0","0","0","0","0"
"2005","Medicine Hat, Alberta, municipal","48062","Abduction under the age 14 contravening a custody order","0","0","0","0","0","0","0","0","0","0","0","0","0","0"
"2006","Medicine Hat, Alberta, municipal","48062","Abduction under the age 14 contravening a custody order","0","0","0","0","0","0","0","0","0","0","0","0","0","0"
"2007","Medicine Hat, Alberta, municipal","48062","Abduction under the age 14 contravening a custody order","0","0","0","0","0","0","0","0","0","0","0","0","0","0"
"2008","Medicine Hat, Alberta, municipal","48062","Abduction under the age 14 contravening a custody order","0","0","0","0","0","0","0","0","0","0","0","0","0","0"
"2009","Medicine Hat, Alberta, municipal","48062","Abduction under the age 14 contravening a custody order","2","1","1","0","3.23","2.04","1.87","0","0","2","1","1","0","0"
"2010","Medicine Hat, Alberta, municipal","48062","Abduction under the age 14 contravening a custody order","0","0","0","-100","0","0","0","0","0","0","0","0","0","0"
"2011","Medicine Hat, Alberta, municipal","48062","Abduction under the age 14 contravening a custody order","0","0","0","0","0","0","0","0","0","0","0","0","0","0"
"2012","Medicine Hat, Alberta, municipal","48062","Abduction under the age 14 contravening a custody order","0","0","0","0","0","0","0","0","0","0","0","0","0","0"
"2013","Medicine Hat, Alberta, municipal","48062","Abduction under the age 14 contravening a custody order","0","0","0","0","0","0","0","0","0","0","0","0","0","0"
"2014","Medicine Hat, Alberta, municipal","48062","Abduction under the age 14 contravening a custody order","0","0","0","0","0","0","0","0","0","0","0","0","0","0"
"2015","Medicine Hat, Alberta, municipal","48062","Abduction under the age 14 contravening a custody order","1","1","0","0","1.55","1.95","1.8","0","0","1","1","1","0","0"
"2016","Medicine Hat, Alberta, municipal","48062","Abduction under the age 14 contravening a custody order","0","0","0","-100","0","0","0","0","0","0","0","0","0","0"
"1998","Medicine Hat, Alberta, municipal","48062","Abduction under age 14, by parent or guardian","0","0","0","0","0","0","0","0","0","0","0","0","0","0"
"1999","Medicine Hat, Alberta, municipal","48062","Abduction under age 14, by parent or guardian","3","3","0","0","5.92","0","0","0","0","3","2","2","0","0"
"2000","Medicine Hat, Alberta, municipal","48062","Abduction under age 14, by parent or guardian","1","1","0","-67.41","1.93","0","0","0","0","1","1","1","0","0"
"2001","Medicine Hat, Alberta, municipal","48062","Abduction under age 14, by parent or guardian","4","0","4","294.24","7.61","0","0","0","0","4","0","0","0","0"
"2002","Medicine Hat, Alberta, municipal","48062","Abduction under age 14, by parent or guardian","0","0","0","-100","0","0","0","0","0","0","0","0","0","0"
"2003","Medicine Hat, Alberta, municipal","48062","Abduction under age 14, by parent or guardian","0","0","0","0","0","0","0","0","0","0","0","0","0","0"
"2004","Medicine Hat, Alberta, municipal","48062","Abduction under age 14, by parent or guardian","0","0","0","0","0","0","0","0","0","0","0","0","0","0"
"2005","Medicine Hat, Alberta, municipal","48062","Abduction under age 14, by parent or guardian","3","1","0","0","5.23","2.22","2.02","0","0","1","1","1","0","0"
"2006","Medicine Hat, Alberta, municipal","48062","Abduction under age 14, by parent or guardian","0","0","0","-100","0","0","0","0","0","0","0","0","0","0"
"2007","Medicine Hat, Alberta, municipal","48062","Abduction under age 14, by parent or guardian","1","0","0","0","1.66","0","0","0","0","0","0","0","0","0"
"2008","Medicine Hat, Alberta, municipal","48062","Abduction under age 14, by parent or guardian","0","0","0","-100","0","0","0","0","0","0","0","0","0","0"
"2009","Medicine Hat, Alberta, municipal","48062","Abduction under age 14, by parent or guardian","0","0","0","0","0","0","0","0","0","0","0","0","0","0"
"2010","Medicine Hat, Alberta, municipal","48062","Abduction under age 14, by parent or guardian","0","0","0","0","0","0","0","0","0","0","0","0","0","0"
"2011","Medicine Hat, Alberta, municipal","48062","Abduction under age 14, by parent or guardian","0","0","0","0","0","0","0","0","0","0","0","0","0","0"
"2012","Medicine Hat, Alberta, municipal","48062","Abduction under age 14, by parent or guardian","2","0","0","0","3.19","0","0","0","0","0","0","0","0","0"
"2013","Medicine Hat, Alberta, municipal","48062","Abduction under age 14, by parent or guardian","0","0","0","-100","0","0","0","0","0","0","0","0","0","0"
"2014","Medicine Hat, Alberta, municipal","48062","Abduction under age 14, by parent or guardian","0","0","0","0","0","0","0","0","0","0","0","0","0","0"
"2015","Medicine Hat, Alberta, municipal","48062","Abduction under age 14, by parent or guardian","0","0","0","0","0","0","0","0","0","0","0","0","0","0"
"2016","Medicine Hat, Alberta, municipal","48062","Abduction under age 14, by parent or guardian","0","0","0","0","0","0","0","0","0","0","0","0","0","0"
"1998","Medicine Hat, Alberta, municipal","48062","Extortion","1","1","0","0","2.01","0","0","0","0","1","0","0","0","0"
"1999","Medicine Hat, Alberta, municipal","48062","Extortion","1","1","0","-1.89","1.97","0","0","0","0","1","0","0","0","0"
"2000","Medicine Hat, Alberta, municipal","48062","Extortion","2","1","0","95.52","3.86","0","0","0","0","1","1","2","1","0"
"2001","Medicine Hat, Alberta, municipal","48062","Extortion","0","0","0","-100","0","0","0","0","0","0","0","0","0","0"
"2002","Medicine Hat, Alberta, municipal","48062","Extortion","2","2","0","0","3.74","0","0","0","0","2","2","2","0","0"
"2003","Medicine Hat, Alberta, municipal","48062","Extortion","2","2","0","-1.44","3.69","0","0","0","0","2","1","2","1","0"
"2004","Medicine Hat, Alberta, municipal","48062","Extortion","3","0","1","45.55","5.37","0","0","0","0","1","0","0","0","0"
"2005","Medicine Hat, Alberta, municipal","48062","Extortion","1","1","0","-67.57","1.74","2.22","2.02","0","0","1","1","1","0","0"
"2006","Medicine Hat, Alberta, municipal","48062","Extortion","3","3","0","192.16","5.09","6.46","5.89","0","0","3","3","3","0","0"
"2007","Medicine Hat, Alberta, municipal","48062","Extortion","2","2","0","-34.89","3.31","6.3","5.75","0","0","2","3","3","0","0"
"2008","Medicine Hat, Alberta, municipal","48062","Extortion","0","0","0","-100","0","0","0","0","0","0","0","0","0","0"
"2009","Medicine Hat, Alberta, municipal","48062","Extortion","3","2","0","0","4.84","4.07","5.61","22.84","0","2","2","3","1","0"
"2010","Medicine Hat, Alberta, municipal","48062","Extortion","1","1","0","-66.67","1.61","4.07","3.74","0","0","1","2","2","0","0"
"2011","Medicine Hat, Alberta, municipal","48062","Extortion","0","0","0","-100","0","0","0","0","0","0","0","0","0","0"
"2012","Medicine Hat, Alberta, municipal","48062","Extortion","2","2","0","0","3.19","2.01","3.7","22.84","0","2","1","2","1","0"
"2013","Medicine Hat, Alberta, municipal","48062","Extortion","4","2","0","97.54","6.3","7.94","7.3","0","0","2","4","4","0","0"
"2014","Medicine Hat, Alberta, municipal","48062","Extortion","4","3","0","-0.86","6.24","3.93","5.43","23.09","0","3","2","3","1","0"
"2015","Medicine Hat, Alberta, municipal","48062","Extortion","8","4","1","98.48","12.39","9.76","9","0","0","5","5","5","0","0"
"2016","Medicine Hat, Alberta, municipal","48062","Extortion","2","0","1","-75.15","3.08","0","0","0","0","1","0","0","0","0"
"1998","Medicine Hat, Alberta, municipal","48062","Criminal harassment","10","7","1","0","20.12","0","0","0","0","8","5","5","0","0"
"1999","Medicine Hat, Alberta, municipal","48062","Criminal harassment","12","8","0","17.74","23.69","0","0","0","0","8","7","7","0","0"
"2000","Medicine Hat, Alberta, municipal","48062","Criminal harassment","16","11","0","30.35","30.88","0","0","0","0","11","9","9","0","0"
"2001","Medicine Hat, Alberta, municipal","48062","Criminal harassment","11","5","6","-32.24","20.92","0","0","0","0","11","5","5","0","0"
"2002","Medicine Hat, Alberta, municipal","48062","Criminal harassment","14","8","2","25.28","26.21","0","0","0","0","10","8","8","0","0"
"2003","Medicine Hat, Alberta, municipal","48062","Criminal harassment","12","7","2","-15.52","22.14","0","0","0","0","9","7","7","0","1"
"2004","Medicine Hat, Alberta, municipal","48062","Criminal harassment","19","7","1","53.64","34.02","16.03","14.55","0","0","8","7","7","0","0"
"2005","Medicine Hat, Alberta, municipal","48062","Criminal harassment","26","10","4","33.13","45.29","19.99","18.17","0","0","14","9","9","0","0"
"2006","Medicine Hat, Alberta, municipal","48062","Criminal harassment","33","25","5","23.61","55.98","47.4","43.22","0","0","30","22","22","0","0"
"2007","Medicine Hat, Alberta, municipal","48062","Criminal harassment","15","8","2","-55.61","24.85","14.69","13.43","0","0","10","7","7","0","0"
"2008","Medicine Hat, Alberta, municipal","48062","Criminal harassment","37","27","2","142.73","60.32","51.55","47.22","0","0","29","25","25","0","0"
"2009","Medicine Hat, Alberta, municipal","48062","Criminal harassment","52","35","9","39.04","83.88","63.12","57.95","0","22.84","44","31","31","0","1"
"2010","Medicine Hat, Alberta, municipal","48062","Criminal harassment","79","56","8","51.9","127.41","112.03","102.89","0","0","64","55","55","0","0"
"2011","Medicine Hat, Alberta, municipal","48062","Criminal harassment","58","29","9","-26.57","93.55","44.79","43.01","22.94","45.87","38","22","23","1","2"
"2012","Medicine Hat, Alberta, municipal","48062","Criminal harassment","56","37","2","-4.61","89.24","64.33","60.97","22.84","0","39","32","33","1","0"
"2013","Medicine Hat, Alberta, municipal","48062","Criminal harassment","49","28","10","-13.58","77.13","53.57","49.3","0","0","38","27","27","0","0"
"2014","Medicine Hat, Alberta, municipal","48062","Criminal harassment","64","29","16","29.49","99.87","51.07","52.5","69.28","0","45","26","29","3","0"
"2015","Medicine Hat, Alberta, municipal","48062","Criminal harassment","62","34","12","-3.86","96.02","58.54","55.77","23.05","0","46","30","31","1","0"
"2016","Medicine Hat, Alberta, municipal","48062","Criminal harassment","42","28","5","-32.67","64.65","46.63","46.57","45.86","0","33","24","26","2","0"
"1998","Medicine Hat, Alberta, municipal","48062","Uttering threats","23","17","2","0","46.28","0","0","0","0","19","9","12","3","1"
"1999","Medicine Hat, Alberta, municipal","48062","Uttering threats","51","33","3","117.55","100.68","0","0","0","0","36","23","30","7","0"
"2000","Medicine Hat, Alberta, municipal","48062","Uttering threats","73","50","3","39.93","140.89","0","0","0","0","53","30","41","11","2"
"2001","Medicine Hat, Alberta, municipal","48062","Uttering threats","81","55","12","9.36","154.07","0","0","0","0","67","39","46","7","3"
"2002","Medicine Hat, Alberta, municipal","48062","Uttering threats","88","69","16","6.94","164.77","0","0","0","0","85","48","56","8","0"
"2003","Medicine Hat, Alberta, municipal","48062","Uttering threats","82","65","8","-8.16","151.32","0","0","0","0","73","44","56","12","3"
"2004","Medicine Hat, Alberta, municipal","48062","Uttering threats","105","78","5","24.25","188.01","135.1","147.58","270.27","22.52","83","59","71","12","1"
"2005","Medicine Hat, Alberta, municipal","48062","Uttering threats","108","81","8","0.06","188.13","135.5","145.39","244.23","44.4","89","61","72","11","2"
"2006","Medicine Hat, Alberta, municipal","48062","Uttering threats","102","72","5","-8.02","173.04","116.35","119.83","155.69","66.73","77","54","61","7","3"
"2007","Medicine Hat, Alberta, municipal","48062","Uttering threats","101","68","10","-3.29","167.34","119.64","118.93","111.36","111.36","78","57","62","5","5"
"2008","Medicine Hat, Alberta, municipal","48062","Uttering threats","127","84","12","23.74","207.06","119.59","128.43","224.72","44.94","96","58","68","10","2"
"2009","Medicine Hat, Alberta, municipal","48062","Uttering threats","95","58","18","-25.99","153.23","95.69","106.56","228.41","137.05","76","47","57","10","6"
"2010","Medicine Hat, Alberta, municipal","48062","Uttering threats","85","53","8","-10.54","137.09","97.77","102.89","160.48","68.78","61","48","55","7","3"
"2011","Medicine Hat, Alberta, municipal","48062","Uttering threats","99","72","6","16.49","159.69","114.02","119.68","183.49","0","78","56","64","8","0"
"2012","Medicine Hat, Alberta, municipal","48062","Uttering threats","123","78","6","22.75","196.02","114.58","125.64","251.2","68.51","84","57","68","11","3"
"2013","Medicine Hat, Alberta, municipal","48062","Uttering threats","93","67","4","-25.32","146.39","105.16","111.39","183.36","0","71","53","61","8","0"
"2014","Medicine Hat, Alberta, municipal","48062","Uttering threats","103","65","12","9.8","160.73","110","105","46.19","0","77","56","58","2","0"
"2015","Medicine Hat, Alberta, municipal","48062","Uttering threats","120","85","18","15.62","185.84","144.4","138.53","69.14","46.09","103","74","77","3","2"
"2016","Medicine Hat, Alberta, municipal","48062","Uttering threats","124","83","6","2.7","190.86","124.35","123.6","114.65","45.86","89","64","69","5","2"
"1998","Medicine Hat, Alberta, municipal","48062","Indecent/Harassing communications","20","3","2","0","40.24","0","0","0","0","5","2","2","0","1"
"1999","Medicine Hat, Alberta, municipal","48062","Indecent/Harassing communications","23","3","1","12.83","45.41","0","0","0","0","4","1","1","0","0"
"2000","Medicine Hat, Alberta, municipal","48062","Indecent/Harassing communications","27","4","1","14.76","52.11","0","0","0","0","5","1","1","0","0"
"2001","Medicine Hat, Alberta, municipal","48062","Indecent/Harassing communications","7","5","1","-74.45","13.32","0","0","0","0","6","5","5","0","0"
"2002","Medicine Hat, Alberta, municipal","48062","Indecent/Harassing communications","7","2","0","-1.56","13.11","0","0","0","0","2","1","2","1","0"
"2003","Medicine Hat, Alberta, municipal","48062","Indecent/Harassing communications","7","2","1","-1.44","12.92","0","0","0","0","3","2","2","0","2"
"2004","Medicine Hat, Alberta, municipal","48062","Indecent/Harassing communications","7","1","4","-2.97","12.53","2.29","2.08","0","22.52","5","1","1","0","1"
"2005","Medicine Hat, Alberta, municipal","48062","Indecent/Harassing communications","12","4","3","66.77","20.9","6.66","6.06","0","0","7","3","3","0","0"
"2006","Medicine Hat, Alberta, municipal","48062","Indecent/Harassing communications","15","4","2","21.73","25.45","4.31","7.86","44.48","0","6","2","4","2","0"
"2007","Medicine Hat, Alberta, municipal","48062","Indecent/Harassing communications","23","4","4","49.75","38.11","6.3","7.67","22.27","0","8","3","4","1","0"
"2008","Medicine Hat, Alberta, municipal","48062","Indecent/Harassing communications","16","4","2","-31.55","26.09","6.19","7.55","22.47","0","6","3","4","1","0"
"2009","Medicine Hat, Alberta, municipal","48062","Indecent/Harassing communications","17","2","7","5.12","27.42","4.07","3.74","0","0","9","2","2","0","0"
"2010","Medicine Hat, Alberta, municipal","48062","Indecent/Harassing communications","16","1","5","-5.89","25.8","2.04","1.87","0","0","6","1","1","0","0"
"2011","Medicine Hat, Alberta, municipal","48062","Indecent/Harassing communications","10","0","4","-37.49","16.13","0","0","0","0","4","0","0","0","0"
"2012","Medicine Hat, Alberta, municipal","48062","Indecent/Harassing communications","6","0","3","-40.72","9.56","0","0","0","22.84","3","0","0","0","1"
"2013","Medicine Hat, Alberta, municipal","48062","Indecent/Harassing communications","11","2","1","81.08","17.31","3.97","3.65","0","0","3","2","2","0","0"
"2014","Medicine Hat, Alberta, municipal","48062","Indecent/Harassing communications","29","0","6","161.37","45.25","0","0","0","92.38","6","0","0","0","4"
"2015","Medicine Hat, Alberta, municipal","48062","Indecent/Harassing communications","21","2","1","-28.14","32.52","3.9","3.6","0","23.05","3","2","2","0","1"
"2016","Medicine Hat, Alberta, municipal","48062","Indecent/Harassing communications","17","0","4","-19.54","26.17","0","0","0","0","4","0","0","0","0"
"2012","Medicine Hat, Alberta, municipal","48062","Total commodification of sexual activity violations","0","0","0","0","0","0","0","0","0","0","0","0","0","0"
"2013","Medicine Hat, Alberta, municipal","48062","Total commodification of sexual activity violations","0","0","0","0","0","0","0","0","0","0","0","0","0","0"
"2014","Medicine Hat, Alberta, municipal","48062","Total commodification of sexual activity violations","0","0","0","0","0","0","0","0","0","0","0","0","0","0"
"2015","Medicine Hat, Alberta, municipal","48062","Total commodification of sexual activity violations","4","4","0","0","6.19","13.66","12.59","0","0","4","7","7","0","0"
"2016","Medicine Hat, Alberta, municipal","48062","Total commodification of sexual activity violations","3","3","0","-25.46","4.62","7.77","7.16","0","0","3","4","4","0","0"
"2012","Medicine Hat, Alberta, municipal","48062","Obtaining sexual services for consideration","0","0","0","0","0","0","0","0","0","0","0","0","0","0"
"2013","Medicine Hat, Alberta, municipal","48062","Obtaining sexual services for consideration","0","0","0","0","0","0","0","0","0","0","0","0","0","0"
"2014","Medicine Hat, Alberta, municipal","48062","Obtaining sexual services for consideration","0","0","0","0","0","0","0","0","0","0","0","0","0","0"
"2015","Medicine Hat, Alberta, municipal","48062","Obtaining sexual services for consideration","0","0","0","0","0","0","0","0","0","0","0","0","0","0"
"2016","Medicine Hat, Alberta, municipal","48062","Obtaining sexual services for consideration","1","1","0","0","1.54","1.94","1.79","0","0","1","1","1","0","0"
"2012","Medicine Hat, Alberta, municipal","48062","Obtaining sexual services for consideration from person under 18 years","0","0","0","0","0","0","0","0","0","0","0","0","0","0"
"2013","Medicine Hat, Alberta, municipal","48062","Obtaining sexual services for consideration from person under 18 years","0","0","0","0","0","0","0","0","0","0","0","0","0","0"
"2014","Medicine Hat, Alberta, municipal","48062","Obtaining sexual services for consideration from person under 18 years","0","0","0","0","0","0","0","0","0","0","0","0","0","0"
"2015","Medicine Hat, Alberta, municipal","48062","Obtaining sexual services for consideration from person under 18 years","0","0","0","0","0","0","0","0","0","0","0","0","0","0"
"2016","Medicine Hat, Alberta, municipal","48062","Obtaining sexual services for consideration from person under 18 years","0","0","0","0","0","0","0","0","0","0","0","0","0","0"
"2012","Medicine Hat, Alberta, municipal","48062","Receive material benefit from sexual services","0","0","0","0","0","0","0","0","0","0","0","0","0","0"
"2013","Medicine Hat, Alberta, municipal","48062","Receive material benefit from sexual services","0","0","0","0","0","0","0","0","0","0","0","0","0","0"
"2014","Medicine Hat, Alberta, municipal","48062","Receive material benefit from sexual services","0","0","0","0","0","0","0","0","0","0","0","0","0","0"
"2015","Medicine Hat, Alberta, municipal","48062","Receive material benefit from sexual services","0","0","0","0","0","0","0","0","0","0","0","0","0","0"
"2016","Medicine Hat, Alberta, municipal","48062","Receive material benefit from sexual services","0","0","0","0","0","0","0","0","0","0","0","0","0","0"
"2012","Medicine Hat, Alberta, municipal","48062","Receive material benefit from sexual services provided by a person under 18 years","0","0","0","0","0","0","0","0","0","0","0","0","0","0"
"2013","Medicine Hat, Alberta, municipal","48062","Receive material benefit from sexual services provided by a person under 18 years","0","0","0","0","0","0","0","0","0","0","0","0","0","0"
"2014","Medicine Hat, Alberta, municipal","48062","Receive material benefit from sexual services provided by a person under 18 years","0","0","0","0","0","0","0","0","0","0","0","0","0","0"
"2015","Medicine Hat, Alberta, municipal","48062","Receive material benefit from sexual services provided by a person under 18 years","0","0","0","0","0","0","0","0","0","0","0","0","0","0"
"2016","Medicine Hat, Alberta, municipal","48062","Receive material benefit from sexual services provided by a person under 18 years","0","0","0","0","0","0","0","0","0","0","0","0","0","0"
"2012","Medicine Hat, Alberta, municipal","48062","Procuring","1","1","0","0","1.59","4.02","3.7","0","0","1","2","2","0","0"
"2013","Medicine Hat, Alberta, municipal","48062","Procuring","0","0","0","-100","0","0","0","0","0","0","0","0","0","0"
"2014","Medicine Hat, Alberta, municipal","48062","Procuring","0","0","0","0","0","0","0","0","0","0","0","0","0","0"
"2015","Medicine Hat, Alberta, municipal","48062","Procuring","4","4","0","0","6.19","13.66","12.59","0","0","4","7","7","0","0"
"2016","Medicine Hat, Alberta, municipal","48062","Procuring","1","1","0","-75.15","1.54","3.89","3.58","0","0","1","2","2","0","0"
"2012","Medicine Hat, Alberta, municipal","48062","Procuring - person under 18 years","0","0","0","0","0","0","0","0","0","0","0","0","0","0"
"2013","Medicine Hat, Alberta, municipal","48062","Procuring - person under 18 years","0","0","0","0","0","0","0","0","0","0","0","0","0","0"
"2014","Medicine Hat, Alberta, municipal","48062","Procuring - person under 18 years","0","0","0","0","0","0","0","0","0","0","0","0","0","0"
"2015","Medicine Hat, Alberta, municipal","48062","Procuring - person under 18 years","0","0","0","0","0","0","0","0","0","0","0","0","0","0"
"2016","Medicine Hat, Alberta, municipal","48062","Procuring - person under 18 years","1","1","0","0","1.54","1.94","1.79","0","0","1","1","1","0","0"
"2012","Medicine Hat, Alberta, municipal","48062","Advertising sexual services","0","0","0","0","0","0","0","0","0","0","0","0","0","0"
"2013","Medicine Hat, Alberta, municipal","48062","Advertising sexual services","0","0","0","0","0","0","0","0","0","0","0","0","0","0"
"2014","Medicine Hat, Alberta, municipal","48062","Advertising sexual services","0","0","0","0","0","0","0","0","0","0","0","0","0","0"
"2015","Medicine Hat, Alberta, municipal","48062","Advertising sexual services","0","0","0","0","0","0","0","0","0","0","0","0","0","0"
"2016","Medicine Hat, Alberta, municipal","48062","Advertising sexual services","0","0","0","0","0","0","0","0","0","0","0","0","0","0"
"1998","Medicine Hat, Alberta, municipal","48062","Total other violent violations","14","4","3","0","28.17","0","0","0","0","7","1","2","1","2"
"1999","Medicine Hat, Alberta, municipal","48062","Total other violent violations","9","4","0","-36.93","17.77","0","0","0","0","4","4","4","0","0"
"2000","Medicine Hat, Alberta, municipal","48062","Total other violent violations","9","3","0","-2.24","17.37","0","0","0","0","3","0","1","1","0"
"2001","Medicine Hat, Alberta, municipal","48062","Total other violent violations","22","11","1","140.92","41.85","0","0","0","0","12","3","7","4","0"
"2002","Medicine Hat, Alberta, municipal","48062","Total other violent violations","19","7","7","-14.99","35.58","0","0","0","0","14","3","6","3","1"
"2003","Medicine Hat, Alberta, municipal","48062","Total other violent violations","14","6","1","-27.38","25.84","0","0","0","0","7","6","6","0","0"
"2004","Medicine Hat, Alberta, municipal","48062","Total other violent violations","18","11","2","24.76","32.23","13.74","14.55","22.52","0","13","6","7","1","0"
"2005","Medicine Hat, Alberta, municipal","48062","Total other violent violations","11","4","3","-40.55","19.16","4.44","6.06","22.2","44.4","7","2","3","1","2"
"2006","Medicine Hat, Alberta, municipal","48062","Total other violent violations","21","7","3","85.92","35.63","10.77","11.79","22.24","22.24","10","5","6","1","1"
"2007","Medicine Hat, Alberta, municipal","48062","Total other violent violations","18","9","0","-16.29","29.82","16.79","17.26","22.27","0","9","8","9","1","0"
"2008","Medicine Hat, Alberta, municipal","48062","Total other violent violations","4","2","1","-78.13","6.52","4.12","3.78","0","0","3","2","2","0","0"
"2009","Medicine Hat, Alberta, municipal","48062","Total other violent violations","3","1","0","-25.8","4.84","2.04","1.87","0","0","1","1","1","0","0"
"2010","Medicine Hat, Alberta, municipal","48062","Total other violent violations","7","6","0","133.3","11.29","8.15","7.48","0","0","6","4","4","0","0"
"2011","Medicine Hat, Alberta, municipal","48062","Total other violent violations","9","3","1","28.59","14.52","6.11","5.61","0","0","4","3","3","0","0"
"2012","Medicine Hat, Alberta, municipal","48062","Total other violent violations","7","5","0","-23.15","11.16","12.06","11.09","0","0","5","6","6","0","0"
"2013","Medicine Hat, Alberta, municipal","48062","Total other violent violations","5","2","1","-29.45","7.87","3.97","3.65","0","22.92","3","2","2","0","1"
"2014","Medicine Hat, Alberta, municipal","48062","Total other violent violations","6","2","0","18.97","9.36","3.93","3.62","0","0","2","2","2","0","0"
"2015","Medicine Hat, Alberta, municipal","48062","Total other violent violations","10","8","0","65.4","15.49","11.71","14.39","46.09","0","8","6","8","2","0"
"2016","Medicine Hat, Alberta, municipal","48062","Total other violent violations","0","0","0","-100","0","0","0","0","0","0","0","0","0","0"
"1998","Medicine Hat, Alberta, municipal","48062","Conspire to commit murder","0","0","0","0","0","0","0","0","0","0","0","0","0","0"
"1999","Medicine Hat, Alberta, municipal","48062","Conspire to commit murder","0","0","0","0","0","0","0","0","0","0","0","0","0","0"
"2000","Medicine Hat, Alberta, municipal","48062","Conspire to commit murder","0","0","0","0","0","0","0","0","0","0","0","0","0","0"
"2001","Medicine Hat, Alberta, municipal","48062","Conspire to commit murder","0","0","0","0","0","0","0","0","0","0","0","0","0","0"
"2002","Medicine Hat, Alberta, municipal","48062","Conspire to commit murder","0","0","0","0","0","0","0","0","0","0","0","0","0","0"
"2003","Medicine Hat, Alberta, municipal","48062","Conspire to commit murder","0","0","0","0","0","0","0","0","0","0","0","0","0","0"
"2004","Medicine Hat, Alberta, municipal","48062","Conspire to commit murder","0","0","0","0","0","0","0","0","0","0","0","0","0","0"
"2005","Medicine Hat, Alberta, municipal","48062","Conspire to commit murder","0","0","0","0","0","0","0","0","0","0","0","0","0","0"
"2006","Medicine Hat, Alberta, municipal","48062","Conspire to commit murder","0","0","0","0","0","0","0","0","0","0","0","0","0","0"
"2007","Medicine Hat, Alberta, municipal","48062","Conspire to commit murder","0","0","0","0","0","0","0","0","0","0","0","0","0","0"
"2008","Medicine Hat, Alberta, municipal","48062","Conspire to commit murder","0","0","0","0","0","0","0","0","0","0","0","0","0","0"
"2009","Medicine Hat, Alberta, municipal","48062","Conspire to commit murder","0","0","0","0","0","0","0","0","0","0","0","0","0","0"
"2010","Medicine Hat, Alberta, municipal","48062","Conspire to commit murder","0","0","0","0","0","0","0","0","0","0","0","0","0","0"
"2011","Medicine Hat, Alberta, municipal","48062","Conspire to commit murder","0","0","0","0","0","0","0","0","0","0","0","0","0","0"
"2012","Medicine Hat, Alberta, municipal","48062","Conspire to commit murder","0","0","0","0","0","0","0","0","0","0","0","0","0","0"
"2013","Medicine Hat, Alberta, municipal","48062","Conspire to commit murder","0","0","0","0","0","0","0","0","0","0","0","0","0","0"
"2014","Medicine Hat, Alberta, municipal","48062","Conspire to commit murder","1","0","0","0","1.56","0","0","0","0","0","0","0","0","0"
"2015","Medicine Hat, Alberta, municipal","48062","Conspire to commit murder","0","0","0","-100","0","0","0","0","0","0","0","0","0","0"
"2016","Medicine Hat, Alberta, municipal","48062","Conspire to commit murder","0","0","0","0","0","0","0","0","0","0","0","0","0","0"
"1998","Medicine Hat, Alberta, municipal","48062","Other sexual violations","13","4","3","0","26.16","0","0","0","0","7","1","2","1","2"
"1999","Medicine Hat, Alberta, municipal","48062","Other sexual violations","8","4","0","-39.62","15.79","0","0","0","0","4","4","4","0","0"
"2000","Medicine Hat, Alberta, municipal","48062","Other sexual violations","8","2","0","-2.24","15.44","0","0","0","0","2","0","1","1","0"
"2001","Medicine Hat, Alberta, municipal","48062","Other sexual violations","17","10","0","109.44","32.34","0","0","0","0","10","3","6","3","0"
"2002","Medicine Hat, Alberta, municipal","48062","Other sexual violations","17","7","7","-1.56","31.83","0","0","0","0","14","3","6","3","1"
"2003","Medicine Hat, Alberta, municipal","48062","Other sexual violations","10","6","0","-42.03","18.45","0","0","0","0","6","6","6","0","0"
"2004","Medicine Hat, Alberta, municipal","48062","Other sexual violations","15","9","2","45.55","26.86","6.87","8.31","22.52","0","11","3","4","1","0"
"2005","Medicine Hat, Alberta, municipal","48062","Other sexual violations","7","3","3","-54.6","12.19","2.22","4.04","22.2","44.4","6","1","2","1","2"
"2006","Medicine Hat, Alberta, municipal","48062","Other sexual violations","18","4","3","150.42","30.54","6.46","5.89","0","22.24","7","3","3","0","1"
"2007","Medicine Hat, Alberta, municipal","48062","Other sexual violations","10","5","0","-45.74","16.57","6.3","7.67","22.27","0","5","3","4","1","0"
"2008","Medicine Hat, Alberta, municipal","48062","Other sexual violations","0","0","0","-100","0","0","0","0","0","0","0","0","0","0"
"2009","Medicine Hat, Alberta, municipal","48062","Other sexual violations","0","0","0","0","0","0","0","0","0","0","0","0","0","0"
"2010","Medicine Hat, Alberta, municipal","48062","Other sexual violations","0","0","0","0","0","0","0","0","0","0","0","0","0","0"
"2011","Medicine Hat, Alberta, municipal","48062","Other sexual violations","0","0","0","0","0","0","0","0","0","0","0","0","0","0"
"2012","Medicine Hat, Alberta, municipal","48062","Other sexual violations","0","0","0","0","0","0","0","0","0","0","0","0","0","0"
"2013","Medicine Hat, Alberta, municipal","48062","Other sexual violations","0","0","0","0","0","0","0","0","0","0","0","0","0","0"
"2014","Medicine Hat, Alberta, municipal","48062","Other sexual violations","0","0","0","0","0","0","0","0","0","0","0","0","0","0"
"2015","Medicine Hat, Alberta, municipal","48062","Other sexual violations","0","0","0","0","0","0","0","0","0","0","0","0","0","0"
"2016","Medicine Hat, Alberta, municipal","48062","Other sexual violations","0","0","0","0","0","0","0","0","0","0","0","0","0","0"
"2005","Medicine Hat, Alberta, municipal","48062","Sexual Exploitation of a person with a disability","0","0","0","0","0","0","0","0","0","0","0","0","0","0"
"2006","Medicine Hat, Alberta, municipal","48062","Sexual Exploitation of a person with a disability","0","0","0","0","0","0","0","0","0","0","0","0","0","0"
"2007","Medicine Hat, Alberta, municipal","48062","Sexual Exploitation of a person with a disability","0","0","0","0","0","0","0","0","0","0","0","0","0","0"
"2008","Medicine Hat, Alberta, municipal","48062","Sexual Exploitation of a person with a disability","0","0","0","0","0","0","0","0","0","0","0","0","0","0"
"2009","Medicine Hat, Alberta, municipal","48062","Sexual Exploitation of a person with a disability","0","0","0","0","0","0","0","0","0","0","0","0","0","0"
"2010","Medicine Hat, Alberta, municipal","48062","Sexual Exploitation of a person with a disability","1","0","0","0","1.61","0","0","0","0","0","0","0","0","0"
"2011","Medicine Hat, Alberta, municipal","48062","Sexual Exploitation of a person with a disability","0","0","0","-100","0","0","0","0","0","0","0","0","0","0"
"2012","Medicine Hat, Alberta, municipal","48062","Sexual Exploitation of a person with a disability","1","0","0","0","1.59","0","0","0","0","0","0","0","0","0"
"2013","Medicine Hat, Alberta, municipal","48062","Sexual Exploitation of a person with a disability","0","0","0","-100","0","0","0","0","0","0","0","0","0","0"
"2014","Medicine Hat, Alberta, municipal","48062","Sexual Exploitation of a person with a disability","0","0","0","0","0","0","0","0","0","0","0","0","0","0"
"2015","Medicine Hat, Alberta, municipal","48062","Sexual Exploitation of a person with a disability","0","0","0","0","0","0","0","0","0","0","0","0","0","0"
"2016","Medicine Hat, Alberta, municipal","48062","Sexual Exploitation of a person with a disability","0","0","0","0","0","0","0","0","0","0","0","0","0","0"
"2005","Medicine Hat, Alberta, municipal","48062","Incest","0","0","0","0","0","0","0","0","0","0","0","0","0","0"
"2006","Medicine Hat, Alberta, municipal","48062","Incest","0","0","0","0","0","0","0","0","0","0","0","0","0","0"
"2007","Medicine Hat, Alberta, municipal","48062","Incest","1","1","0","0","1.66","2.1","1.92","0","0","1","1","1","0","0"
"2008","Medicine Hat, Alberta, municipal","48062","Incest","1","0","1","-1.6","1.63","0","0","0","0","1","0","0","0","0"
"2009","Medicine Hat, Alberta, municipal","48062","Incest","0","0","0","-100","0","0","0","0","0","0","0","0","0","0"
"2010","Medicine Hat, Alberta, municipal","48062","Incest","0","0","0","0","0","0","0","0","0","0","0","0","0","0"
"2011","Medicine Hat, Alberta, municipal","48062","Incest","1","1","0","0","1.61","2.04","1.87","0","0","1","1","1","0","0"
"2012","Medicine Hat, Alberta, municipal","48062","Incest","0","0","0","-100","0","0","0","0","0","0","0","0","0","0"
"2013","Medicine Hat, Alberta, municipal","48062","Incest","1","1","0","0","1.57","1.98","1.83","0","0","1","1","1","0","0"
"2014","Medicine Hat, Alberta, municipal","48062","Incest","0","0","0","-100","0","0","0","0","0","0","0","0","0","0"
"2015","Medicine Hat, Alberta, municipal","48062","Incest","0","0","0","0","0","0","0","0","0","0","0","0","0","0"
"2016","Medicine Hat, Alberta, municipal","48062","Incest","0","0","0","0","0","0","0","0","0","0","0","0","0","0"
"2005","Medicine Hat, Alberta, municipal","48062","Corrupting morals of a child","0","0","0","0","0","0","0","0","0","0","0","0","0","0"
"2006","Medicine Hat, Alberta, municipal","48062","Corrupting morals of a child","0","0","0","0","0","0","0","0","0","0","0","0","0","0"
"2007","Medicine Hat, Alberta, municipal","48062","Corrupting morals of a child","0","0","0","0","0","0","0","0","0","0","0","0","0","0"
"2008","Medicine Hat, Alberta, municipal","48062","Corrupting morals of a child","0","0","0","0","0","0","0","0","0","0","0","0","0","0"
"2009","Medicine Hat, Alberta, municipal","48062","Corrupting morals of a child","0","0","0","0","0","0","0","0","0","0","0","0","0","0"
"2010","Medicine Hat, Alberta, municipal","48062","Corrupting morals of a child","0","0","0","0","0","0","0","0","0","0","0","0","0","0"
"2011","Medicine Hat, Alberta, municipal","48062","Corrupting morals of a child","0","0","0","0","0","0","0","0","0","0","0","0","0","0"
"2012","Medicine Hat, Alberta, municipal","48062","Corrupting morals of a child","0","0","0","0","0","0","0","0","0","0","0","0","0","0"
"2013","Medicine Hat, Alberta, municipal","48062","Corrupting morals of a child","0","0","0","0","0","0","0","0","0","0","0","0","0","0"
"2014","Medicine Hat, Alberta, municipal","48062","Corrupting morals of a child","0","0","0","0","0","0","0","0","0","0","0","0","0","0"
"2015","Medicine Hat, Alberta, municipal","48062","Corrupting morals of a child","0","0","0","0","0","0","0","0","0","0","0","0","0","0"
"2016","Medicine Hat, Alberta, municipal","48062","Corrupting morals of a child","0","0","0","0","0","0","0","0","0","0","0","0","0","0"
"2005","Medicine Hat, Alberta, municipal","48062","Anal intercourse","0","0","0","0","0","0","0","0","0","0","0","0","0","0"
"2006","Medicine Hat, Alberta, municipal","48062","Anal intercourse","0","0","0","0","0","0","0","0","0","0","0","0","0","0"
"2007","Medicine Hat, Alberta, municipal","48062","Anal intercourse","0","0","0","0","0","0","0","0","0","0","0","0","0","0"
"2008","Medicine Hat, Alberta, municipal","48062","Anal intercourse","0","0","0","0","0","0","0","0","0","0","0","0","0","0"
"2009","Medicine Hat, Alberta, municipal","48062","Anal intercourse","1","0","0","0","1.61","0","0","0","0","0","0","0","0","0"
"2010","Medicine Hat, Alberta, municipal","48062","Anal intercourse","0","0","0","-100","0","0","0","0","0","0","0","0","0","0"
"2011","Medicine Hat, Alberta, municipal","48062","Anal intercourse","0","0","0","0","0","0","0","0","0","0","0","0","0","0"
"2012","Medicine Hat, Alberta, municipal","48062","Anal intercourse","0","0","0","0","0","0","0","0","0","0","0","0","0","0"
"2013","Medicine Hat, Alberta, municipal","48062","Anal intercourse","1","0","0","0","1.57","0","0","0","0","0","0","0","0","0"
"2014","Medicine Hat, Alberta, municipal","48062","Anal intercourse","0","0","0","-100","0","0","0","0","0","0","0","0","0","0"
"2015","Medicine Hat, Alberta, municipal","48062","Anal intercourse","1","0","0","0","1.55","0","0","0","0","0","0","0","0","0"
"2016","Medicine Hat, Alberta, municipal","48062","Anal intercourse","0","0","0","-100","0","0","0","0","0","0","0","0","0","0"
"2005","Medicine Hat, Alberta, municipal","48062","Bestiality, commit or compel person","0","0","0","0","0","0","0","0","0","0","0","0","0","0"
"2006","Medicine Hat, Alberta, municipal","48062","Bestiality, commit or compel person","0","0","0","0","0","0","0","0","0","0","0","0","0","0"
"2007","Medicine Hat, Alberta, municipal","48062","Bestiality, commit or compel person","0","0","0","0","0","0","0","0","0","0","0","0","0","0"
"2008","Medicine Hat, Alberta, municipal","48062","Bestiality, commit or compel person","0","0","0","0","0","0","0","0","0","0","0","0","0","0"
"2009","Medicine Hat, Alberta, municipal","48062","Bestiality, commit or compel person","0","0","0","0","0","0","0","0","0","0","0","0","0","0"
"2010","Medicine Hat, Alberta, municipal","48062","Bestiality, commit or compel person","0","0","0","0","0","0","0","0","0","0","0","0","0","0"
"2011","Medicine Hat, Alberta, municipal","48062","Bestiality, commit or compel person","0","0","0","0","0","0","0","0","0","0","0","0","0","0"
"2012","Medicine Hat, Alberta, municipal","48062","Bestiality, commit or compel person","0","0","0","0","0","0","0","0","0","0","0","0","0","0"
"2013","Medicine Hat, Alberta, municipal","48062","Bestiality, commit or compel person","0","0","0","0","0","0","0","0","0","0","0","0","0","0"
"2014","Medicine Hat, Alberta, municipal","48062","Bestiality, commit or compel person","0","0","0","0","0","0","0","0","0","0","0","0","0","0"
"2015","Medicine Hat, Alberta, municipal","48062","Bestiality, commit or compel person","0","0","0","0","0","0","0","0","0","0","0","0","0","0"
"2016","Medicine Hat, Alberta, municipal","48062","Bestiality, commit or compel person","0","0","0","0","0","0","0","0","0","0","0","0","0","0"
"1998","Medicine Hat, Alberta, municipal","48062","Voyeurism","0","0","0","0","0","0","0","0","0","0","0","0","0","0"
"1999","Medicine Hat, Alberta, municipal","48062","Voyeurism","0","0","0","0","0","0","0","0","0","0","0","0","0","0"
"2000","Medicine Hat, Alberta, municipal","48062","Voyeurism","0","0","0","0","0","0","0","0","0","0","0","0","0","0"
"2001","Medicine Hat, Alberta, municipal","48062","Voyeurism","0","0","0","0","0","0","0","0","0","0","0","0","0","0"
"2002","Medicine Hat, Alberta, municipal","48062","Voyeurism","0","0","0","0","0","0","0","0","0","0","0","0","0","0"
"2003","Medicine Hat, Alberta, municipal","48062","Voyeurism","0","0","0","0","0","0","0","0","0","0","0","0","0","0"
"2004","Medicine Hat, Alberta, municipal","48062","Voyeurism","0","0","0","0","0","0","0","0","0","0","0","0","0","0"
"2005","Medicine Hat, Alberta, municipal","48062","Voyeurism","0","0","0","0","0","0","0","0","0","0","0","0","0","0"
"2006","Medicine Hat, Alberta, municipal","48062","Voyeurism","1","1","0","0","1.7","2.15","1.96","0","0","1","1","1","0","0"
"2007","Medicine Hat, Alberta, municipal","48062","Voyeurism","0","0","0","-100","0","0","0","0","0","0","0","0","0","0"
"2008","Medicine Hat, Alberta, municipal","48062","Voyeurism","1","1","0","0","1.63","2.06","1.89","0","0","1","1","1","0","0"
"2009","Medicine Hat, Alberta, municipal","48062","Voyeurism","0","0","0","-100","0","0","0","0","0","0","0","0","0","0"
"2010","Medicine Hat, Alberta, municipal","48062","Voyeurism","6","6","0","0","9.68","4.07","3.74","0","0","6","2","2","0","0"
"2011","Medicine Hat, Alberta, municipal","48062","Voyeurism","3","0","0","-49.99","4.84","0","0","0","0","0","0","0","0","0"
"2012","Medicine Hat, Alberta, municipal","48062","Voyeurism","3","2","0","-1.2","4.78","4.02","3.7","0","0","2","2","2","0","0"
"2013","Medicine Hat, Alberta, municipal","48062","Voyeurism","1","0","0","-67.08","1.57","0","0","0","0","0","0","0","0","0"
"2014","Medicine Hat, Alberta, municipal","48062","Voyeurism","3","1","0","197.42","4.68","1.96","1.81","0","0","1","1","1","0","0"
"2015","Medicine Hat, Alberta, municipal","48062","Voyeurism","2","2","0","-33.84","3.1","0","3.6","46.09","0","2","0","2","2","0"
"2016","Medicine Hat, Alberta, municipal","48062","Voyeurism","0","0","0","-100","0","0","0","0","0","0","0","0","0","0"
"2012","Medicine Hat, Alberta, municipal","48062","Nonconsensual distribution of intimate images","0","0","0","0","0","0","0","0","0","0","0","0","0","0"
"2013","Medicine Hat, Alberta, municipal","48062","Nonconsensual distribution of intimate images","0","0","0","0","0","0","0","0","0","0","0","0","0","0"
"2014","Medicine Hat, Alberta, municipal","48062","Nonconsensual distribution of intimate images","0","0","0","0","0","0","0","0","0","0","0","0","0","0"
"2015","Medicine Hat, Alberta, municipal","48062","Nonconsensual distribution of intimate images","0","0","0","0","0","0","0","0","0","0","0","0","0","0"
"2016","Medicine Hat, Alberta, municipal","48062","Nonconsensual distribution of intimate images","0","0","0","0","0","0","0","0","0","0","0","0","0","0"
"2005","Medicine Hat, Alberta, municipal","48062","Trap likely to or causing bodily harm","0","0","0","0","0","0","0","0","0","0","0","0","0","0"
"2006","Medicine Hat, Alberta, municipal","48062","Trap likely to or causing bodily harm","0","0","0","0","0","0","0","0","0","0","0","0","0","0"
"2007","Medicine Hat, Alberta, municipal","48062","Trap likely to or causing bodily harm","0","0","0","0","0","0","0","0","0","0","0","0","0","0"
"2008","Medicine Hat, Alberta, municipal","48062","Trap likely to or causing bodily harm","0","0","0","0","0","0","0","0","0","0","0","0","0","0"
"2009","Medicine Hat, Alberta, municipal","48062","Trap likely to or causing bodily harm","0","0","0","0","0","0","0","0","0","0","0","0","0","0"
"2010","Medicine Hat, Alberta, municipal","48062","Trap likely to or causing bodily harm","0","0","0","0","0","4.07","3.74","0","0","0","2","2","0","0"
"2011","Medicine Hat, Alberta, municipal","48062","Trap likely to or causing bodily harm","0","0","0","0","0","0","0","0","0","0","0","0","0","0"
"2012","Medicine Hat, Alberta, municipal","48062","Trap likely to or causing bodily harm","0","0","0","0","0","0","0","0","0","0","0","0","0","0"
"2013","Medicine Hat, Alberta, municipal","48062","Trap likely to or causing bodily harm","0","0","0","0","0","0","0","0","0","0","0","0","0","0"
"2014","Medicine Hat, Alberta, municipal","48062","Trap likely to or causing bodily harm","0","0","0","0","0","0","0","0","0","0","0","0","0","0"
"2015","Medicine Hat, Alberta, municipal","48062","Trap likely to or causing bodily harm","0","0","0","0","0","0","0","0","0","0","0","0","0","0"
"2016","Medicine Hat, Alberta, municipal","48062","Trap likely to or causing bodily harm","0","0","0","0","0","0","0","0","0","0","0","0","0","0"
"1998","Medicine Hat, Alberta, municipal","48062","Hostage-taking","0","0","0","0","0","0","0","0","0","0","0","0","0","0"
"1999","Medicine Hat, Alberta, municipal","48062","Hostage-taking","0","0","0","0","0","0","0","0","0","0","0","0","0","0"
"2000","Medicine Hat, Alberta, municipal","48062","Hostage-taking","0","0","0","0","0","0","0","0","0","0","0","0","0","0"
"2001","Medicine Hat, Alberta, municipal","48062","Hostage-taking","0","0","0","0","0","0","0","0","0","0","0","0","0","0"
"2002","Medicine Hat, Alberta, municipal","48062","Hostage-taking","0","0","0","0","0","0","0","0","0","0","0","0","0","0"
"2003","Medicine Hat, Alberta, municipal","48062","Hostage-taking","0","0","0","0","0","0","0","0","0","0","0","0","0","0"
"2004","Medicine Hat, Alberta, municipal","48062","Hostage-taking","0","0","0","0","0","0","0","0","0","0","0","0","0","0"
"2005","Medicine Hat, Alberta, municipal","48062","Hostage-taking","0","0","0","0","0","0","0","0","0","0","0","0","0","0"
"2006","Medicine Hat, Alberta, municipal","48062","Hostage-taking","0","0","0","0","0","0","0","0","0","0","0","0","0","0"
"2007","Medicine Hat, Alberta, municipal","48062","Hostage-taking","0","0","0","0","0","0","0","0","0","0","0","0","0","0"
"2008","Medicine Hat, Alberta, municipal","48062","Hostage-taking","0","0","0","0","0","0","0","0","0","0","0","0","0","0"
"2009","Medicine Hat, Alberta, municipal","48062","Hostage-taking","0","0","0","0","0","0","0","0","0","0","0","0","0","0"
"2010","Medicine Hat, Alberta, municipal","48062","Hostage-taking","0","0","0","0","0","0","0","0","0","0","0","0","0","0"
"2011","Medicine Hat, Alberta, municipal","48062","Hostage-taking","0","0","0","0","0","0","0","0","0","0","0","0","0","0"
"2012","Medicine Hat, Alberta, municipal","48062","Hostage-taking","0","0","0","0","0","0","0","0","0","0","0","0","0","0"
"2013","Medicine Hat, Alberta, municipal","48062","Hostage-taking","0","0","0","0","0","0","0","0","0","0","0","0","0","0"
"2014","Medicine Hat, Alberta, municipal","48062","Hostage-taking","0","0","0","0","0","0","0","0","0","0","0","0","0","0"
"2015","Medicine Hat, Alberta, municipal","48062","Hostage-taking","0","0","0","0","0","0","0","0","0","0","0","0","0","0"
"2016","Medicine Hat, Alberta, municipal","48062","Hostage-taking","0","0","0","0","0","0","0","0","0","0","0","0","0","0"
"2005","Medicine Hat, Alberta, municipal","48062","Trafficking in persons","0","0","0","0","0","0","0","0","0","0","0","0","0","0"
"2006","Medicine Hat, Alberta, municipal","48062","Trafficking in persons","0","0","0","0","0","0","0","0","0","0","0","0","0","0"
"2007","Medicine Hat, Alberta, municipal","48062","Trafficking in persons","0","0","0","0","0","0","0","0","0","0","0","0","0","0"
"2008","Medicine Hat, Alberta, municipal","48062","Trafficking in persons","0","0","0","0","0","0","0","0","0","0","0","0","0","0"
"2009","Medicine Hat, Alberta, municipal","48062","Trafficking in persons","0","0","0","0","0","0","0","0","0","0","0","0","0","0"
"2010","Medicine Hat, Alberta, municipal","48062","Trafficking in persons","0","0","0","0","0","0","0","0","0","0","0","0","0","0"
"2011","Medicine Hat, Alberta, municipal","48062","Trafficking in persons","0","0","0","0","0","0","0","0","0","0","0","0","0","0"
"2012","Medicine Hat, Alberta, municipal","48062","Trafficking in persons","0","0","0","0","0","0","0","0","0","0","0","0","0","0"
"2013","Medicine Hat, Alberta, municipal","48062","Trafficking in persons","0","0","0","0","0","0","0","0","0","0","0","0","0","0"
"2014","Medicine Hat, Alberta, municipal","48062","Trafficking in persons","0","0","0","0","0","0","0","0","0","0","0","0","0","0"
"2015","Medicine Hat, Alberta, municipal","48062","Trafficking in persons","0","0","0","0","0","0","0","0","0","0","0","0","0","0"
"2016","Medicine Hat, Alberta, municipal","48062","Trafficking in persons","0","0","0","0","0","0","0","0","0","0","0","0","0","0"
"1998","Medicine Hat, Alberta, municipal","48062","Intimidation of a justice system participant or a journalist","0","0","0","0","0","0","0","0","0","0","0","0","0","0"
"1999","Medicine Hat, Alberta, municipal","48062","Intimidation of a justice system participant or a journalist","0","0","0","0","0","0","0","0","0","0","0","0","0","0"
"2000","Medicine Hat, Alberta, municipal","48062","Intimidation of a justice system participant or a journalist","0","0","0","0","0","0","0","0","0","0","0","0","0","0"
"2001","Medicine Hat, Alberta, municipal","48062","Intimidation of a justice system participant or a journalist","0","0","0","0","0","0","0","0","0","0","0","0","0","0"
"2002","Medicine Hat, Alberta, municipal","48062","Intimidation of a justice system participant or a journalist","0","0","0","0","0","0","0","0","0","0","0","0","0","0"
"2003","Medicine Hat, Alberta, municipal","48062","Intimidation of a justice system participant or a journalist","0","0","0","0","0","0","0","0","0","0","0","0","0","0"
"2004","Medicine Hat, Alberta, municipal","48062","Intimidation of a justice system participant or a journalist","0","0","0","0","0","0","0","0","0","0","0","0","0","0"
"2005","Medicine Hat, Alberta, municipal","48062","Intimidation of a justice system participant or a journalist","0","0","0","0","0","0","0","0","0","0","0","0","0","0"
"2006","Medicine Hat, Alberta, municipal","48062","Intimidation of a justice system participant or a journalist","1","1","0","0","1.7","0","0","0","0","1","0","0","0","0"
"2007","Medicine Hat, Alberta, municipal","48062","Intimidation of a justice system participant or a journalist","0","0","0","-100","0","0","0","0","0","0","0","0","0","0"
"2008","Medicine Hat, Alberta, municipal","48062","Intimidation of a justice system participant or a journalist","1","1","0","0","1.63","2.06","1.89","0","0","1","1","1","0","0"
"2009","Medicine Hat, Alberta, municipal","48062","Intimidation of a justice system participant or a journalist","1","1","0","-1.07","1.61","2.04","1.87","0","0","1","1","1","0","0"
"2010","Medicine Hat, Alberta, municipal","48062","Intimidation of a justice system participant or a journalist","0","0","0","-100","0","0","0","0","0","0","0","0","0","0"
"2011","Medicine Hat, Alberta, municipal","48062","Intimidation of a justice system participant or a journalist","2","2","0","0","3.23","4.07","3.74","0","0","2","2","2","0","0"
"2012","Medicine Hat, Alberta, municipal","48062","Intimidation of a justice system participant or a journalist","2","2","0","-1.2","3.19","4.02","3.7","0","0","2","2","2","0","0"
"2013","Medicine Hat, Alberta, municipal","48062","Intimidation of a justice system participant or a journalist","0","0","0","-100","0","0","0","0","0","0","0","0","0","0"
"2014","Medicine Hat, Alberta, municipal","48062","Intimidation of a justice system participant or a journalist","1","1","0","0","1.56","1.96","1.81","0","0","1","1","1","0","0"
"2015","Medicine Hat, Alberta, municipal","48062","Intimidation of a justice system participant or a journalist","4","2","0","296.96","6.19","3.9","3.6","0","0","2","2","2","0","0"
"2016","Medicine Hat, Alberta, municipal","48062","Intimidation of a justice system participant or a journalist","0","0","0","-100","0","0","0","0","0","0","0","0","0","0"
"2005","Medicine Hat, Alberta, municipal","48062","Intimidation of a non-justice participant","0","0","0","0","0","0","0","0","0","0","0","0","0","0"
"2006","Medicine Hat, Alberta, municipal","48062","Intimidation of a non-justice participant","0","0","0","0","0","0","0","0","0","0","0","0","0","0"
"2007","Medicine Hat, Alberta, municipal","48062","Intimidation of a non-justice participant","0","0","0","0","0","0","0","0","0","0","0","0","0","0"
"2008","Medicine Hat, Alberta, municipal","48062","Intimidation of a non-justice participant","0","0","0","0","0","0","0","0","0","0","0","0","0","0"
"2009","Medicine Hat, Alberta, municipal","48062","Intimidation of a non-justice participant","0","0","0","0","0","0","0","0","0","0","0","0","0","0"
"2010","Medicine Hat, Alberta, municipal","48062","Intimidation of a non-justice participant","0","0","0","0","0","0","0","0","0","0","0","0","0","0"
"2011","Medicine Hat, Alberta, municipal","48062","Intimidation of a non-justice participant","0","0","0","0","0","0","0","0","0","0","0","0","0","0"
"2012","Medicine Hat, Alberta, municipal","48062","Intimidation of a non-justice participant","0","0","0","0","0","0","0","0","0","0","0","0","0","0"
"2013","Medicine Hat, Alberta, municipal","48062","Intimidation of a non-justice participant","0","0","0","0","0","0","0","0","0","0","0","0","0","0"
"2014","Medicine Hat, Alberta, municipal","48062","Intimidation of a non-justice participant","1","0","0","0","1.56","0","0","0","0","0","0","0","0","0"
"2015","Medicine Hat, Alberta, municipal","48062","Intimidation of a non-justice participant","2","3","0","98.48","3.1","5.85","5.4","0","0","3","3","3","0","0"
"2016","Medicine Hat, Alberta, municipal","48062","Intimidation of a non-justice participant","0","0","0","-100","0","0","0","0","0","0","0","0","0","0"
"1998","Medicine Hat, Alberta, municipal","48062","Explosives causing death or bodily harm","0","0","0","0","0","0","0","0","0","0","0","0","0","0"
"1999","Medicine Hat, Alberta, municipal","48062","Explosives causing death or bodily harm","0","0","0","0","0","0","0","0","0","0","0","0","0","0"
"2000","Medicine Hat, Alberta, municipal","48062","Explosives causing death or bodily harm","0","0","0","0","0","0","0","0","0","0","0","0","0","0"
"2001","Medicine Hat, Alberta, municipal","48062","Explosives causing death or bodily harm","0","0","0","0","0","0","0","0","0","0","0","0","0","0"
"2002","Medicine Hat, Alberta, municipal","48062","Explosives causing death or bodily harm","0","0","0","0","0","0","0","0","0","0","0","0","0","0"
"2003","Medicine Hat, Alberta, municipal","48062","Explosives causing death or bodily harm","0","0","0","0","0","0","0","0","0","0","0","0","0","0"
"2004","Medicine Hat, Alberta, municipal","48062","Explosives causing death or bodily harm","0","0","0","0","0","0","0","0","0","0","0","0","0","0"
"2005","Medicine Hat, Alberta, municipal","48062","Explosives causing death or bodily harm","0","0","0","0","0","0","0","0","0","0","0","0","0","0"
"2006","Medicine Hat, Alberta, municipal","48062","Explosives causing death or bodily harm","0","0","0","0","0","0","0","0","0","0","0","0","0","0"
"2007","Medicine Hat, Alberta, municipal","48062","Explosives causing death or bodily harm","0","0","0","0","0","0","0","0","0","0","0","0","0","0"
"2008","Medicine Hat, Alberta, municipal","48062","Explosives causing death or bodily harm","0","0","0","0","0","0","0","0","0","0","0","0","0","0"
"2009","Medicine Hat, Alberta, municipal","48062","Explosives causing death or bodily harm","0","0","0","0","0","0","0","0","0","0","0","0","0","0"
"2010","Medicine Hat, Alberta, municipal","48062","Explosives causing death or bodily harm","0","0","0","0","0","0","0","0","0","0","0","0","0","0"
"2011","Medicine Hat, Alberta, municipal","48062","Explosives causing death or bodily harm","0","0","0","0","0","0","0","0","0","0","0","0","0","0"
"2012","Medicine Hat, Alberta, municipal","48062","Explosives causing death or bodily harm","0","0","0","0","0","0","0","0","0","0","0","0","0","0"
"2013","Medicine Hat, Alberta, municipal","48062","Explosives causing death or bodily harm","0","0","0","0","0","0","0","0","0","0","0","0","0","0"
"2014","Medicine Hat, Alberta, municipal","48062","Explosives causing death or bodily harm","0","0","0","0","0","0","0","0","0","0","0","0","0","0"
"2015","Medicine Hat, Alberta, municipal","48062","Explosives causing death or bodily harm","0","0","0","0","0","0","0","0","0","0","0","0","0","0"
"2016","Medicine Hat, Alberta, municipal","48062","Explosives causing death or bodily harm","0","0","0","0","0","0","0","0","0","0","0","0","0","0"
"1998","Medicine Hat, Alberta, municipal","48062","Arson, disregard for human life","0","0","0","0","0","0","0","0","0","0","0","0","0","0"
"1999","Medicine Hat, Alberta, municipal","48062","Arson, disregard for human life","0","0","0","0","0","0","0","0","0","0","0","0","0","0"
"2000","Medicine Hat, Alberta, municipal","48062","Arson, disregard for human life","0","0","0","0","0","0","0","0","0","0","0","0","0","0"
"2001","Medicine Hat, Alberta, municipal","48062","Arson, disregard for human life","4","1","1","0","7.61","0","0","0","0","2","0","1","1","0"
"2002","Medicine Hat, Alberta, municipal","48062","Arson, disregard for human life","2","0","0","-50.78","3.74","0","0","0","0","0","0","0","0","0"
"2003","Medicine Hat, Alberta, municipal","48062","Arson, disregard for human life","0","0","0","-100","0","0","0","0","0","0","0","0","0","0"
"2004","Medicine Hat, Alberta, municipal","48062","Arson, disregard for human life","1","1","0","0","1.79","2.29","2.08","0","0","1","1","1","0","0"
"2005","Medicine Hat, Alberta, municipal","48062","Arson, disregard for human life","0","0","0","-100","0","0","0","0","0","0","0","0","0","0"
"2006","Medicine Hat, Alberta, municipal","48062","Arson, disregard for human life","0","0","0","0","0","0","0","0","0","0","0","0","0","0"
"2007","Medicine Hat, Alberta, municipal","48062","Arson, disregard for human life","1","1","0","0","1.66","4.2","3.84","0","0","1","2","2","0","0"
"2008","Medicine Hat, Alberta, municipal","48062","Arson, disregard for human life","0","0","0","-100","0","0","0","0","0","0","0","0","0","0"
"2009","Medicine Hat, Alberta, municipal","48062","Arson, disregard for human life","1","0","0","0","1.61","0","0","0","0","0","0","0","0","0"
"2010","Medicine Hat, Alberta, municipal","48062","Arson, disregard for human life","0","0","0","-100","0","0","0","0","0","0","0","0","0","0"
"2011","Medicine Hat, Alberta, municipal","48062","Arson, disregard for human life","0","0","0","0","0","0","0","0","0","0","0","0","0","0"
"2012","Medicine Hat, Alberta, municipal","48062","Arson, disregard for human life","0","0","0","0","0","0","0","0","0","0","0","0","0","0"
"2013","Medicine Hat, Alberta, municipal","48062","Arson, disregard for human life","0","0","0","0","0","0","0","0","0","0","0","0","0","0"
"2014","Medicine Hat, Alberta, municipal","48062","Arson, disregard for human life","0","0","0","0","0","0","0","0","0","0","0","0","0","0"
"2015","Medicine Hat, Alberta, municipal","48062","Arson, disregard for human life","0","0","0","0","0","0","0","0","0","0","0","0","0","0"
"2016","Medicine Hat, Alberta, municipal","48062","Arson, disregard for human life","0","0","0","0","0","0","0","0","0","0","0","0","0","0"
"2012","Medicine Hat, Alberta, municipal","48062","Failure to comply with mandatory safeguards in relation to medical assistance in dying","0","0","0","0","0","0","0","0","0","0","0","0","0","0"
"2013","Medicine Hat, Alberta, municipal","48062","Failure to comply with mandatory safeguards in relation to medical assistance in dying","0","0","0","0","0","0","0","0","0","0","0","0","0","0"
"2014","Medicine Hat, Alberta, municipal","48062","Failure to comply with mandatory safeguards in relation to medical assistance in dying","0","0","0","0","0","0","0","0","0","0","0","0","0","0"
"2015","Medicine Hat, Alberta, municipal","48062","Failure to comply with mandatory safeguards in relation to medical assistance in dying","0","0","0","0","0","0","0","0","0","0","0","0","0","0"
"2016","Medicine Hat, Alberta, municipal","48062","Failure to comply with mandatory safeguards in relation to medical assistance in dying","0","0","0","0","0","0","0","0","0","0","0","0","0","0"
"2012","Medicine Hat, Alberta, municipal","48062","Forging or destroying documents related to assistance requests with criminal intent","0","0","0","0","0","0","0","0","0","0","0","0","0","0"
"2013","Medicine Hat, Alberta, municipal","48062","Forging or destroying documents related to assistance requests with criminal intent","0","0","0","0","0","0","0","0","0","0","0","0","0","0"
"2014","Medicine Hat, Alberta, municipal","48062","Forging or destroying documents related to assistance requests with criminal intent","0","0","0","0","0","0","0","0","0","0","0","0","0","0"
"2015","Medicine Hat, Alberta, municipal","48062","Forging or destroying documents related to assistance requests with criminal intent","0","0","0","0","0","0","0","0","0","0","0","0","0","0"
"2016","Medicine Hat, Alberta, municipal","48062","Forging or destroying documents related to assistance requests with criminal intent","0","0","0","0","0","0","0","0","0","0","0","0","0","0"
"1998","Medicine Hat, Alberta, municipal","48062","Other violent violations","1","0","0","0","2.01","0","0","0","0","0","0","0","0","0"
"1999","Medicine Hat, Alberta, municipal","48062","Other violent violations","1","0","0","-1.89","1.97","0","0","0","0","0","0","0","0","0"
"2000","Medicine Hat, Alberta, municipal","48062","Other violent violations","1","1","0","-2.24","1.93","0","0","0","0","1","0","0","0","0"
"2001","Medicine Hat, Alberta, municipal","48062","Other violent violations","1","0","0","-1.44","1.9","0","0","0","0","0","0","0","0","0"
"2002","Medicine Hat, Alberta, municipal","48062","Other violent violations","0","0","0","-100","0","0","0","0","0","0","0","0","0","0"
"2003","Medicine Hat, Alberta, municipal","48062","Other violent violations","4","0","1","0","7.38","0","0","0","0","1","0","0","0","0"
"2004","Medicine Hat, Alberta, municipal","48062","Other violent violations","2","1","0","-51.48","3.58","4.58","4.16","0","0","1","2","2","0","0"
"2005","Medicine Hat, Alberta, municipal","48062","Other violent violations","4","1","0","94.57","6.97","2.22","2.02","0","0","1","1","1","0","0"
"2006","Medicine Hat, Alberta, municipal","48062","Other violent violations","1","1","0","-75.65","1.7","2.15","3.93","22.24","0","1","1","2","1","0"
"2007","Medicine Hat, Alberta, municipal","48062","Other violent violations","6","2","0","485.98","9.94","4.2","3.84","0","0","2","2","2","0","0"
"2008","Medicine Hat, Alberta, municipal","48062","Other violent violations","1","0","0","-83.6","1.63","0","0","0","0","0","0","0","0","0"
"2009","Medicine Hat, Alberta, municipal","48062","Other violent violations","0","0","0","-100","0","0","0","0","0","0","0","0","0","0"
"2010","Medicine Hat, Alberta, municipal","48062","Other violent violations","0","0","0","0","0","0","0","0","0","0","0","0","0","0"
"2011","Medicine Hat, Alberta, municipal","48062","Other violent violations","3","0","1","0","4.84","0","0","0","0","1","0","0","0","0"
"2012","Medicine Hat, Alberta, municipal","48062","Other violent violations","1","1","0","-67.07","1.59","4.02","3.7","0","0","1","2","2","0","0"
"2013","Medicine Hat, Alberta, municipal","48062","Other violent violations","2","1","1","97.54","3.15","1.98","1.83","0","22.92","2","1","1","0","1"
"2014","Medicine Hat, Alberta, municipal","48062","Other violent violations","0","0","0","-100","0","0","0","0","0","0","0","0","0","0"
"2015","Medicine Hat, Alberta, municipal","48062","Other violent violations","1","1","0","0","1.55","1.95","1.8","0","0","1","1","1","0","0"
"2016","Medicine Hat, Alberta, municipal","48062","Other violent violations","0","0","0","-100","0","0","0","0","0","0","0","0","0","0"
"1998","Medicine Hat, Alberta, municipal","48062","Total property crime violations","3177","770","174","0","6392.61","0","0","0","0","944","553","966","413","130"
"1999","Medicine Hat, Alberta, municipal","48062","Total property crime violations","3538","721","126","9.26","6984.64","0","0","0","0","847","492","931","439","132"
"2000","Medicine Hat, Alberta, municipal","48062","Total property crime violations","3046","793","108","-15.84","5878.61","0","0","0","0","901","583","989","406","131"
"2001","Medicine Hat, Alberta, municipal","48062","Total property crime violations","2654","525","124","-14.12","5048.31","0","0","0","0","649","374","576","202","87"
"2002","Medicine Hat, Alberta, municipal","48062","Total property crime violations","2879","574","116","6.78","5390.68","0","0","0","0","690","423","616","193","55"
"2003","Medicine Hat, Alberta, municipal","48062","Total property crime violations","2812","575","89","-3.74","5189.15","0","0","0","0","664","416","622","206","80"
"2004","Medicine Hat, Alberta, municipal","48062","Total property crime violations","3406","840","99","17.53","6098.81","1147.21","1357.28","3423.42","1869.37","939","501","653","152","83"
"2005","Medicine Hat, Alberta, municipal","48062","Total property crime violations","2591","636","90","-25.99","4513.47","957.37","1268.1","4373.89","1976.02","726","431","628","197","89"
"2006","Medicine Hat, Alberta, municipal","48062","Total property crime violations","2836","568","62","6.59","4811.1","909.29","1225.79","4492.88","1045.37","630","422","624","202","47"
"2007","Medicine Hat, Alberta, municipal","48062","Total property crime violations","2818","561","82","-2.96","4668.89","934.05","1143.25","3363.03","1514.48","643","445","596","151","68"
"2008","Medicine Hat, Alberta, municipal","48062","Total property crime violations","2447","628","101","-14.55","3989.5","940.24","1178.51","3775.28","1617.98","729","456","624","168","72"
"2009","Medicine Hat, Alberta, municipal","48062","Total property crime violations","2505","622","78","1.28","4040.52","979.33","1175.85","3380.54","1393.33","700","481","629","148","61"
"2010","Medicine Hat, Alberta, municipal","48062","Total property crime violations","2219","554","51","-11.43","3578.74","924.74","1056.92","2544.7","687.76","605","454","565","111","30"
"2011","Medicine Hat, Alberta, municipal","48062","Total property crime violations","2372","597","37","6.91","3825.99","844.96","1028.52","3096.33","504.59","634","415","550","135","22"
"2012","Medicine Hat, Alberta, municipal","48062","Total property crime violations","1830","441","58","-23.77","2916.38","689.5","840.65","2557.66","799.27","499","343","455","112","35"
"2013","Medicine Hat, Alberta, municipal","48062","Total property crime violations","1745","485","83","-5.82","2746.69","714.29","843.64","2337.84","1008.48","568","360","462","102","44"
"2014","Medicine Hat, Alberta, municipal","48062","Total property crime violations","2231","448","211","26.75","3481.42","707.16","794.74","1824.48","1685.91","659","360","439","79","73"
"2015","Medicine Hat, Alberta, municipal","48062","Total property crime violations","2592","549","219","15.3","4014.06","936.66","996.67","1705.46","2051.16","768","480","554","74","89"
"2016","Medicine Hat, Alberta, municipal","48062","Total property crime violations","3308","663","182","26.84","5091.58","1191.08","1257.46","2040.82","1146.53","845","613","702","89","50"
"1998","Medicine Hat, Alberta, municipal","48062","Total breaking and entering","455","129","3","0","915.53","0","0","0","0","132","62","178","116","4"
"1999","Medicine Hat, Alberta, municipal","48062","Total breaking and entering","581","112","1","25.28","1147","0","0","0","0","113","77","205","128","7"
"2000","Medicine Hat, Alberta, municipal","48062","Total breaking and entering","500","171","0","-15.87","964.97","0","0","0","0","171","141","263","122","13"
"2001","Medicine Hat, Alberta, municipal","48062","Total breaking and entering","399","73","20","-21.35","758.96","0","0","0","0","93","54","110","56","5"
"2002","Medicine Hat, Alberta, municipal","48062","Total breaking and entering","482","86","6","18.91","902.5","0","0","0","0","92","64","106","42","3"
"2003","Medicine Hat, Alberta, municipal","48062","Total breaking and entering","521","137","1","6.53","961.43","0","0","0","0","138","79","149","70","0"
"2004","Medicine Hat, Alberta, municipal","48062","Total breaking and entering","433","82","7","-19.36","775.33","176.32","216.17","608.11","135.14","89","77","104","27","6"
"2005","Medicine Hat, Alberta, municipal","48062","Total breaking and entering","359","121","10","-19.34","625.37","159.93","262.5","1287.74","44.4","131","72","130","58","2"
"2006","Medicine Hat, Alberta, municipal","48062","Total breaking and entering","412","112","2","11.76","698.93","155.14","265.19","1401.25","0","114","72","135","63","0"
"2007","Medicine Hat, Alberta, municipal","48062","Total breaking and entering","357","85","4","-15.37","591.48","151.13","209.08","824.05","89.09","89","72","109","37","4"
"2008","Medicine Hat, Alberta, municipal","48062","Total breaking and entering","242","53","4","-33.29","394.55","76.29","107.65","449.44","0","57","37","57","20","0"
"2009","Medicine Hat, Alberta, municipal","48062","Total breaking and entering","355","81","3","45.13","572.61","146.59","179.46","548.2","45.68","84","72","96","24","2"
"2010","Medicine Hat, Alberta, municipal","48062","Total breaking and entering","307","65","1","-13.53","495.12","99.81","125.33","412.65","22.93","66","49","67","18","1"
"2011","Medicine Hat, Alberta, municipal","48062","Total breaking and entering","331","70","0","7.83","533.9","118.09","155.21","573.39","0","70","58","83","25","0"
"2012","Medicine Hat, Alberta, municipal","48062","Total breaking and entering","216","51","3","-35.53","344.23","66.34","92.38","388.22","22.84","54","33","50","17","1"
"2013","Medicine Hat, Alberta, municipal","48062","Total breaking and entering","188","41","4","-14.03","295.92","71.43","93.13","343.8","22.92","45","36","51","15","1"
"2014","Medicine Hat, Alberta, municipal","48062","Total breaking and entering","172","31","6","-9.3","268.4","56.97","79.66","346.42","92.38","37","29","44","15","4"
"2015","Medicine Hat, Alberta, municipal","48062","Total breaking and entering","241","71","5","39.05","373.22","105.37","122.34","322.65","92.19","76","54","68","14","4"
"2016","Medicine Hat, Alberta, municipal","48062","Total breaking and entering","404","75","12","66.61","621.83","112.7","136.13","412.75","114.65","87","58","76","18","5"
"1998","Medicine Hat, Alberta, municipal","48062","Breaking and entering","455","129","3","0","915.53","0","0","0","0","132","62","178","116","4"
"1999","Medicine Hat, Alberta, municipal","48062","Breaking and entering","581","112","1","25.28","1147","0","0","0","0","113","77","205","128","7"
"2000","Medicine Hat, Alberta, municipal","48062","Breaking and entering","500","171","0","-15.87","964.97","0","0","0","0","171","141","263","122","13"
"2001","Medicine Hat, Alberta, municipal","48062","Breaking and entering","399","73","20","-21.35","758.96","0","0","0","0","93","54","110","56","5"
"2002","Medicine Hat, Alberta, municipal","48062","Breaking and entering","482","86","6","18.91","902.5","0","0","0","0","92","64","106","42","3"
"2003","Medicine Hat, Alberta, municipal","48062","Breaking and entering","521","137","1","6.53","961.43","0","0","0","0","138","79","149","70","0"
"2004","Medicine Hat, Alberta, municipal","48062","Breaking and entering","433","82","7","-19.36","775.33","176.32","216.17","608.11","135.14","89","77","104","27","6"
"2005","Medicine Hat, Alberta, municipal","48062","Breaking and entering","359","121","10","-19.34","625.37","159.93","262.5","1287.74","44.4","131","72","130","58","2"
"2006","Medicine Hat, Alberta, municipal","48062","Breaking and entering","412","112","2","11.76","698.93","155.14","265.19","1401.25","0","114","72","135","63","0"
"2007","Medicine Hat, Alberta, municipal","48062","Breaking and entering","357","85","4","-15.37","591.48","151.13","209.08","824.05","89.09","89","72","109","37","4"
"2008","Medicine Hat, Alberta, municipal","48062","Breaking and entering","242","53","4","-33.29","394.55","76.29","107.65","449.44","0","57","37","57","20","0"
"2009","Medicine Hat, Alberta, municipal","48062","Breaking and entering","351","79","3","43.49","566.16","140.49","171.99","525.35","45.68","82","69","92","23","2"
"2010","Medicine Hat, Alberta, municipal","48062","Breaking and entering","302","64","1","-13.97","487.06","93.7","119.72","412.65","22.93","65","46","64","18","1"
"2011","Medicine Hat, Alberta, municipal","48062","Breaking and entering","331","70","0","9.62","533.9","118.09","155.21","573.39","0","70","58","83","25","0"
"2012","Medicine Hat, Alberta, municipal","48062","Breaking and entering","215","51","3","-35.82","342.63","66.34","92.38","388.22","22.84","54","33","50","17","1"
"2013","Medicine Hat, Alberta, municipal","48062","Breaking and entering","186","41","4","-14.55","292.77","71.43","93.13","343.8","22.92","45","36","51","15","1"
"2014","Medicine Hat, Alberta, municipal","48062","Breaking and entering","172","31","6","-8.32","268.4","56.97","79.66","346.42","92.38","37","29","44","15","4"
"2015","Medicine Hat, Alberta, municipal","48062","Breaking and entering","239","69","5","37.9","370.12","99.52","113.34","276.56","92.19","74","51","63","12","4"
"2016","Medicine Hat, Alberta, municipal","48062","Breaking and entering","402","74","12","67.17","618.75","110.75","134.34","412.75","114.65","86","57","75","18","5"
"2005","Medicine Hat, Alberta, municipal","48062","Breaking and entering to steal a firearm","0","0","0","0","0","0","0","0","0","0","0","0","0","0"
"2006","Medicine Hat, Alberta, municipal","48062","Breaking and entering to steal a firearm","0","0","0","0","0","0","0","0","0","0","0","0","0","0"
"2007","Medicine Hat, Alberta, municipal","48062","Breaking and entering to steal a firearm","0","0","0","0","0","0","0","0","0","0","0","0","0","0"
"2008","Medicine Hat, Alberta, municipal","48062","Breaking and entering to steal a firearm","0","0","0","0","0","0","0","0","0","0","0","0","0","0"
"2009","Medicine Hat, Alberta, municipal","48062","Breaking and entering to steal a firearm","4","2","0","0","6.45","6.11","7.48","22.84","0","2","3","4","1","0"
"2010","Medicine Hat, Alberta, municipal","48062","Breaking and entering to steal a firearm","1","1","0","-75","1.61","6.11","5.61","0","0","1","3","3","0","0"
"2011","Medicine Hat, Alberta, municipal","48062","Breaking and entering to steal a firearm","0","0","0","-100","0","0","0","0","0","0","0","0","0","0"
"2012","Medicine Hat, Alberta, municipal","48062","Breaking and entering to steal a firearm","0","0","0","0","0","0","0","0","0","0","0","0","0","0"
"2013","Medicine Hat, Alberta, municipal","48062","Breaking and entering to steal a firearm","0","0","0","0","0","0","0","0","0","0","0","0","0","0"
"2014","Medicine Hat, Alberta, municipal","48062","Breaking and entering to steal a firearm","0","0","0","0","0","0","0","0","0","0","0","0","0","0"
"2015","Medicine Hat, Alberta, municipal","48062","Breaking and entering to steal a firearm","0","0","0","0","0","0","0","0","0","0","0","0","0","0"
"2016","Medicine Hat, Alberta, municipal","48062","Breaking and entering to steal a firearm","1","1","0","0","1.54","1.94","1.79","0","0","1","1","1","0","0"
"2005","Medicine Hat, Alberta, municipal","48062","Break and enter to steal a firearm from a motor vehicle","0","0","0","0","0","0","0","0","0","0","0","0","0","0"
"2006","Medicine Hat, Alberta, municipal","48062","Break and enter to steal a firearm from a motor vehicle","0","0","0","0","0","0","0","0","0","0","0","0","0","0"
"2007","Medicine Hat, Alberta, municipal","48062","Break and enter to steal a firearm from a motor vehicle","0","0","0","0","0","0","0","0","0","0","0","0","0","0"
"2008","Medicine Hat, Alberta, municipal","48062","Break and enter to steal a firearm from a motor vehicle","0","0","0","0","0","0","0","0","0","0","0","0","0","0"
"2009","Medicine Hat, Alberta, municipal","48062","Break and enter to steal a firearm from a motor vehicle","0","0","0","0","0","0","0","0","0","0","0","0","0","0"
"2010","Medicine Hat, Alberta, municipal","48062","Break and enter to steal a firearm from a motor vehicle","4","0","0","0","6.45","0","0","0","0","0","0","0","0","0"
"2011","Medicine Hat, Alberta, municipal","48062","Break and enter to steal a firearm from a motor vehicle","0","0","0","-100","0","0","0","0","0","0","0","0","0","0"
"2012","Medicine Hat, Alberta, municipal","48062","Break and enter to steal a firearm from a motor vehicle","1","0","0","0","1.59","0","0","0","0","0","0","0","0","0"
"2013","Medicine Hat, Alberta, municipal","48062","Break and enter to steal a firearm from a motor vehicle","2","0","0","97.54","3.15","0","0","0","0","0","0","0","0","0"
"2014","Medicine Hat, Alberta, municipal","48062","Break and enter to steal a firearm from a motor vehicle","0","0","0","-100","0","0","0","0","0","0","0","0","0","0"
"2015","Medicine Hat, Alberta, municipal","48062","Break and enter to steal a firearm from a motor vehicle","2","2","0","0","3.1","5.85","9","46.09","0","2","3","5","2","0"
"2016","Medicine Hat, Alberta, municipal","48062","Break and enter to steal a firearm from a motor vehicle","1","0","0","-50.31","1.54","0","0","0","0","0","0","0","0","0"
"1998","Medicine Hat, Alberta, municipal","48062","Total possession of stolen property","71","68","1","0","142.86","0","0","0","0","69","57","93","36","7"
"1999","Medicine Hat, Alberta, municipal","48062","Total possession of stolen property","86","78","5","18.84","169.78","0","0","0","0","83","49","99","50","18"
"2000","Medicine Hat, Alberta, municipal","48062","Total possession of stolen property","79","74","3","-10.2","152.47","0","0","0","0","77","60","106","46","5"
"2001","Medicine Hat, Alberta, municipal","48062","Total possession of stolen property","50","45","2","-37.62","95.11","0","0","0","0","47","43","54","11","4"
"2002","Medicine Hat, Alberta, municipal","48062","Total possession of stolen property","42","28","3","-17.31","78.64","0","0","0","0","31","27","37","10","3"
"2003","Medicine Hat, Alberta, municipal","48062","Total possession of stolen property","68","63","0","59.57","125.48","0","0","0","0","63","52","81","29","2"
"2004","Medicine Hat, Alberta, municipal","48062","Total possession of stolen property","75","69","2","7.02","134.3","171.74","193.3","405.41","67.57","71","75","93","18","3"
"2005","Medicine Hat, Alberta, municipal","48062","Total possession of stolen property","71","67","2","-7.9","123.68","153.27","185.77","510.66","111.01","69","69","92","23","5"
"2006","Medicine Hat, Alberta, municipal","48062","Total possession of stolen property","80","73","2","9.73","135.72","142.21","186.62","645.02","44.48","75","66","95","29","2"
"2007","Medicine Hat, Alberta, municipal","48062","Total possession of stolen property","69","65","3","-15.76","114.32","121.74","147.7","423.16","44.54","68","58","77","19","2"
"2008","Medicine Hat, Alberta, municipal","48062","Total possession of stolen property","81","77","1","15.52","132.06","152.58","173.76","404.49","22.47","78","74","92","18","1"
"2009","Medicine Hat, Alberta, municipal","48062","Total possession of stolen property","75","70","1","-8.39","120.97","107.91","142.07","525.35","0","71","53","76","23","0"
"2010","Medicine Hat, Alberta, municipal","48062","Total possession of stolen property","92","80","3","22.65","148.38","109.99","151.52","618.98","45.85","83","54","81","27","2"
"2011","Medicine Hat, Alberta, municipal","48062","Total possession of stolen property","58","56","1","-36.95","93.55","83.48","110.33","412.84","0","57","41","59","18","0"
"2012","Medicine Hat, Alberta, municipal","48062","Total possession of stolen property","50","41","3","-14.83","79.68","58.3","70.21","205.53","22.84","44","29","38","9","1"
"2013","Medicine Hat, Alberta, municipal","48062","Total possession of stolen property","58","58","0","14.57","91.29","65.48","93.13","412.56","0","58","33","51","18","0"
"2014","Medicine Hat, Alberta, municipal","48062","Total possession of stolen property","49","42","2","-16.24","76.46","49.11","72.41","346.42","46.19","44","25","40","15","2"
"2015","Medicine Hat, Alberta, municipal","48062","Total possession of stolen property","73","68","3","47.85","113.05","115.13","118.74","161.33","0","71","59","66","7","0"
"2016","Medicine Hat, Alberta, municipal","48062","Total possession of stolen property","62","50","7","-15.59","95.43","79.66","85.98","160.51","45.86","57","41","48","7","2"
"2005","Medicine Hat, Alberta, municipal","48062","Total trafficking in stolen property","0","0","0","0","0","0","0","0","0","0","0","0","0","0"
"2006","Medicine Hat, Alberta, municipal","48062","Total trafficking in stolen property","0","0","0","0","0","0","0","0","0","0","0","0","0","0"
"2007","Medicine Hat, Alberta, municipal","48062","Total trafficking in stolen property","0","0","0","0","0","0","0","0","0","0","0","0","0","0"
"2008","Medicine Hat, Alberta, municipal","48062","Total trafficking in stolen property","0","0","0","0","0","0","0","0","0","0","0","0","0","0"
"2009","Medicine Hat, Alberta, municipal","48062","Total trafficking in stolen property","0","0","0","0","0","0","0","0","0","0","0","0","0","0"
"2010","Medicine Hat, Alberta, municipal","48062","Total trafficking in stolen property","0","0","0","0","0","0","0","0","0","0","0","0","0","0"
"2011","Medicine Hat, Alberta, municipal","48062","Total trafficking in stolen property","8","8","0","0","12.9","34.61","35.53","45.87","0","8","17","19","2","0"
"2012","Medicine Hat, Alberta, municipal","48062","Total trafficking in stolen property","1","1","0","-87.65","1.59","0","1.85","22.84","0","1","0","1","1","0"
"2013","Medicine Hat, Alberta, municipal","48062","Total trafficking in stolen property","1","1","0","-1.23","1.57","1.98","1.83","0","0","1","1","1","0","0"
"2014","Medicine Hat, Alberta, municipal","48062","Total trafficking in stolen property","1","1","0","-0.86","1.56","0","1.81","23.09","0","1","0","1","1","0"
"2015","Medicine Hat, Alberta, municipal","48062","Total trafficking in stolen property","5","5","0","396.21","7.74","11.71","10.79","0","0","5","6","6","0","0"
"2016","Medicine Hat, Alberta, municipal","48062","Total trafficking in stolen property","5","5","0","-0.61","7.7","11.66","12.54","22.93","0","5","6","7","1","0"
"1998","Medicine Hat, Alberta, municipal","48062","Total theft of motor vehicle","109","34","7","0","219.32","0","0","0","0","41","21","53","32","10"
"1999","Medicine Hat, Alberta, municipal","48062","Total theft of motor vehicle","175","42","4","57.52","345.48","0","0","0","0","46","24","67","43","3"
"2000","Medicine Hat, Alberta, municipal","48062","Total theft of motor vehicle","112","32","5","-37.43","216.15","0","0","0","0","37","24","54","30","10"
"2001","Medicine Hat, Alberta, municipal","48062","Total theft of motor vehicle","119","30","2","4.72","226.36","0","0","0","0","32","25","38","13","1"
"2002","Medicine Hat, Alberta, municipal","48062","Total theft of motor vehicle","180","48","4","48.9","337.03","0","0","0","0","52","29","54","25","2"
"2003","Medicine Hat, Alberta, municipal","48062","Total theft of motor vehicle","176","40","3","-3.64","324.78","0","0","0","0","43","28","51","23","3"
"2004","Medicine Hat, Alberta, municipal","48062","Total theft of motor vehicle","200","44","4","10.26","358.12","80.14","97.69","270.27","22.52","48","35","47","12","1"
"2005","Medicine Hat, Alberta, municipal","48062","Total theft of motor vehicle","132","25","1","-35.79","229.94","24.43","56.54","377.44","44.4","26","11","28","17","2"
"2006","Medicine Hat, Alberta, municipal","48062","Total theft of motor vehicle","215","46","8","58.62","364.73","49.56","111.97","756.23","66.73","54","23","57","34","3"
"2007","Medicine Hat, Alberta, municipal","48062","Total theft of motor vehicle","192","44","6","-12.78","318.11","58.77","76.73","267.26","66.82","50","28","40","12","3"
"2008","Medicine Hat, Alberta, municipal","48062","Total theft of motor vehicle","115","23","0","-41.06","187.49","37.11","58.55","292.13","0","23","18","31","13","0"
"2009","Medicine Hat, Alberta, municipal","48062","Total theft of motor vehicle","123","28","1","5.82","198.4","42.76","52.34","159.89","22.84","29","21","28","7","1"
"2010","Medicine Hat, Alberta, municipal","48062","Total theft of motor vehicle","105","25","1","-14.65","169.34","30.55","37.41","114.63","0","26","15","20","5","0"
"2011","Medicine Hat, Alberta, municipal","48062","Total theft of motor vehicle","67","23","0","-36.18","108.07","30.54","43.01","183.49","0","23","15","23","8","0"
"2012","Medicine Hat, Alberta, municipal","48062","Total theft of motor vehicle","65","22","4","-4.15","103.59","28.14","33.26","91.35","22.84","26","14","18","4","1"
"2013","Medicine Hat, Alberta, municipal","48062","Total theft of motor vehicle","37","6","0","-43.78","58.24","3.97","9.13","68.76","0","6","2","5","3","0"
"2014","Medicine Hat, Alberta, municipal","48062","Total theft of motor vehicle","60","15","0","60.77","93.63","17.68","23.53","92.38","0","15","9","13","4","0"
"2015","Medicine Hat, Alberta, municipal","48062","Total theft of motor vehicle","104","29","4","72.02","161.06","52.69","52.17","46.09","0","33","27","29","2","0"
"2016","Medicine Hat, Alberta, municipal","48062","Total theft of motor vehicle","112","17","0","7.03","172.39","21.37","21.49","22.93","0","17","11","12","1","0"
"1998","Medicine Hat, Alberta, municipal","48062","Total theft over $5,000 (non-motor vehicle)","12","5","0","0","24.15","0","0","0","0","5","6","7","1","0"
"1999","Medicine Hat, Alberta, municipal","48062","Total theft over $5,000 (non-motor vehicle)","13","5","2","6.29","25.66","0","0","0","0","7","5","5","0","0"
"2000","Medicine Hat, Alberta, municipal","48062","Total theft over $5,000 (non-motor vehicle)","18","3","1","35.36","34.74","0","0","0","0","4","3","5","2","0"
"2001","Medicine Hat, Alberta, municipal","48062","Total theft over $5,000 (non-motor vehicle)","44","8","1","140.92","83.69","0","0","0","0","9","9","10","1","1"
"2002","Medicine Hat, Alberta, municipal","48062","Total theft over $5,000 (non-motor vehicle)","22","3","0","-50.78","41.19","0","0","0","0","3","4","6","2","0"
"2003","Medicine Hat, Alberta, municipal","48062","Total theft over $5,000 (non-motor vehicle)","30","7","1","34.39","55.36","0","0","0","0","8","6","6","0","0"
"2004","Medicine Hat, Alberta, municipal","48062","Total theft over $5,000 (non-motor vehicle)","24","6","2","-22.37","42.97","11.45","10.39","0","0","8","5","5","0","0"
"2005","Medicine Hat, Alberta, municipal","48062","Total theft over $5,000 (non-motor vehicle)","31","3","0","25.66","54","4.44","8.08","44.4","0","3","2","4","2","0"
"2006","Medicine Hat, Alberta, municipal","48062","Total theft over $5,000 (non-motor vehicle)","34","10","0","6.81","57.68","23.7","21.61","0","0","10","11","11","0","0"
"2007","Medicine Hat, Alberta, municipal","48062","Total theft over $5,000 (non-motor vehicle)","29","5","0","-16.7","48.05","12.59","11.51","0","0","5","6","6","0","0"
"2008","Medicine Hat, Alberta, municipal","48062","Total theft over $5,000 (non-motor vehicle)","20","6","1","-32.14","32.61","14.43","13.22","0","0","7","7","7","0","0"
"2009","Medicine Hat, Alberta, municipal","48062","Total theft over $5,000 (non-motor vehicle)","10","1","1","-50.53","16.13","2.04","1.87","0","0","2","1","1","0","0"
"2010","Medicine Hat, Alberta, municipal","48062","Total theft over $5,000 (non-motor vehicle)","8","1","0","-20.01","12.9","2.04","1.87","0","0","1","1","1","0","0"
"2011","Medicine Hat, Alberta, municipal","48062","Total theft over $5,000 (non-motor vehicle)","15","3","0","87.52","24.19","6.11","5.61","0","0","3","3","3","0","0"
"2012","Medicine Hat, Alberta, municipal","48062","Total theft over $5,000 (non-motor vehicle)","12","2","0","-20.96","19.12","4.02","3.7","0","0","2","2","2","0","0"
"2013","Medicine Hat, Alberta, municipal","48062","Total theft over $5,000 (non-motor vehicle)","17","4","0","39.92","26.76","7.94","7.3","0","0","4","4","4","0","0"
"2014","Medicine Hat, Alberta, municipal","48062","Total theft over $5,000 (non-motor vehicle)","15","8","0","-12.52","23.41","17.68","16.29","0","0","8","9","9","0","0"
"2015","Medicine Hat, Alberta, municipal","48062","Total theft over $5,000 (non-motor vehicle)","27","5","0","78.63","41.81","9.76","9","0","0","5","5","5","0","0"
"2016","Medicine Hat, Alberta, municipal","48062","Total theft over $5,000 (non-motor vehicle)","22","2","0","-19.02","33.86","3.89","3.58","0","0","2","2","2","0","0"
"1998","Medicine Hat, Alberta, municipal","48062","Theft over $5,000","12","5","0","0","24.15","0","0","0","0","5","6","7","1","0"
"1999","Medicine Hat, Alberta, municipal","48062","Theft over $5,000","11","5","2","-10.06","21.72","0","0","0","0","7","5","5","0","0"
"2000","Medicine Hat, Alberta, municipal","48062","Theft over $5,000","12","2","1","6.65","23.16","0","0","0","0","3","2","3","1","0"
"2001","Medicine Hat, Alberta, municipal","48062","Theft over $5,000","21","7","0","72.48","39.95","0","0","0","0","7","8","9","1","0"
"2002","Medicine Hat, Alberta, municipal","48062","Theft over $5,000","20","3","0","-6.25","37.45","0","0","0","0","3","4","6","2","0"
"2003","Medicine Hat, Alberta, municipal","48062","Theft over $5,000","20","6","1","-1.44","36.91","0","0","0","0","7","6","6","0","0"
"2004","Medicine Hat, Alberta, municipal","48062","Theft over $5,000","17","6","2","-17.52","30.44","11.45","10.39","0","0","8","5","5","0","0"
"2005","Medicine Hat, Alberta, municipal","48062","Theft over $5,000","19","3","0","8.73","33.1","4.44","8.08","44.4","0","3","2","4","2","0"
"2006","Medicine Hat, Alberta, municipal","48062","Theft over $5,000","26","8","0","33.26","44.11","17.24","15.72","0","0","8","8","8","0","0"
"2007","Medicine Hat, Alberta, municipal","48062","Theft over $5,000","21","5","0","-21.12","34.79","12.59","11.51","0","0","5","6","6","0","0"
"2008","Medicine Hat, Alberta, municipal","48062","Theft over $5,000","17","6","1","-20.34","27.72","14.43","13.22","0","0","7","7","7","0","0"
"2009","Medicine Hat, Alberta, municipal","48062","Theft over $5,000","4","1","1","-76.72","6.45","2.04","1.87","0","0","2","1","1","0","0"
"2010","Medicine Hat, Alberta, municipal","48062","Theft over $5,000","6","1","0","49.98","9.68","2.04","1.87","0","0","1","1","1","0","0"
"2011","Medicine Hat, Alberta, municipal","48062","Theft over $5,000","7","1","0","16.68","11.29","2.04","1.87","0","0","1","1","1","0","0"
"2012","Medicine Hat, Alberta, municipal","48062","Theft over $5,000","9","2","0","27.03","14.34","4.02","3.7","0","0","2","2","2","0","0"
"2013","Medicine Hat, Alberta, municipal","48062","Theft over $5,000","14","4","0","53.64","22.04","7.94","7.3","0","0","4","4","4","0","0"
"2014","Medicine Hat, Alberta, municipal","48062","Theft over $5,000","10","6","0","-29.19","15.6","11.79","10.86","0","0","6","6","6","0","0"
"2015","Medicine Hat, Alberta, municipal","48062","Theft over $5,000","22","3","0","118.33","34.07","5.85","5.4","0","0","3","3","3","0","0"
"2016","Medicine Hat, Alberta, municipal","48062","Theft over $5,000","18","2","0","-18.68","27.71","3.89","3.58","0","0","2","2","2","0","0"
"2006","Medicine Hat, Alberta, municipal","48062","Theft $5,000 or under","575","78","16","-17.16","975.45","135.75","163.05","444.84","244.66","94","63","83","20","11"
"2007","Medicine Hat, Alberta, municipal","48062","Theft $5,000 or under","508","80","24","-13.72","841.66","111.25","138.11","423.16","579.06","104","53","72","19","26"
"2008","Medicine Hat, Alberta, municipal","48062","Theft $5,000 or under","414","83","14","-19.8","674.97","131.96","149.2","337.08","202.25","97","64","79","15","9"
"2009","Medicine Hat, Alberta, municipal","48062","Theft $5,000 or under","410","67","11","-2.02","661.32","89.59","123.38","502.51","205.57","78","44","66","22","9"
"2010","Medicine Hat, Alberta, municipal","48062","Theft $5,000 or under","361","40","10","-11.96","582.21","71.29","84.18","229.25","91.7","50","35","45","10","4"
"2011","Medicine Hat, Alberta, municipal","48062","Theft $5,000 or under","359","50","6","-0.54","579.06","85.51","97.24","229.36","91.74","56","42","52","10","4"
"2012","Medicine Hat, Alberta, municipal","48062","Theft $5,000 or under","320","44","5","-11.93","509.97","58.3","84.99","388.22","45.67","49","29","46","17","2"
"2013","Medicine Hat, Alberta, municipal","48062","Theft $5,000 or under","290","33","16","-10.49","456.47","49.6","67.56","275.04","160.44","49","25","37","12","7"
"2014","Medicine Hat, Alberta, municipal","48062","Theft $5,000 or under","509","52","90","74.01","794.28","88.39","101.38","254.04","392.61","142","45","56","11","17"
"2015","Medicine Hat, Alberta, municipal","48062","Theft $5,000 or under","537","42","72","4.7","831.62","72.2","84.56","230.47","322.65","114","37","47","10","14"
"2016","Medicine Hat, Alberta, municipal","48062","Theft $5,000 or under","651","64","43","20.49","1002","130.18","127.18","91.72","160.51","107","67","71","4","7"
"1998","Medicine Hat, Alberta, municipal","48062","Theft $5,000 or under","664","85","15","0","1336.07","0","0","0","0","100","59","107","48","15"
"1999","Medicine Hat, Alberta, municipal","48062","Theft $5,000 or under","672","75","15","-0.71","1326.65","0","0","0","0","90","49","82","33","18"
"2000","Medicine Hat, Alberta, municipal","48062","Theft $5,000 or under","656","76","14","-4.57","1266.04","0","0","0","0","90","42","87","45","13"
"2001","Medicine Hat, Alberta, municipal","48062","Theft $5,000 or under","856","115","39","28.61","1628.24","0","0","0","0","154","84","135","51","33"
"2002","Medicine Hat, Alberta, municipal","48062","Theft $5,000 or under","790","109","25","-9.15","1479.21","0","0","0","0","134","89","119","30","17"
"1998","Medicine Hat, Alberta, municipal","48062","Theft over $5,000 from a motor vehicle","0","0","0","0","0","0","0","0","0","0","0","0","0","0"
"2003","Medicine Hat, Alberta, municipal","48062","Theft $5,000 or under","794","85","26","-0.95","1465.21","0","0","0","0","111","62","92","30","25"
"2004","Medicine Hat, Alberta, municipal","48062","Theft $5,000 or under","787","161","48","-3.82","1409.21","295.39","340.88","788.29","1126.13","209","129","164","35","50"
"1999","Medicine Hat, Alberta, municipal","48062","Theft over $5,000 from a motor vehicle","2","0","0","0","3.95","0","0","0","0","0","0","0","0","0"
"2005","Medicine Hat, Alberta, municipal","48062","Theft $5,000 or under","676","139","52","-16.44","1177.58","215.46","272.6","843.69","976.91","191","97","135","38","44"
"2000","Medicine Hat, Alberta, municipal","48062","Theft over $5,000 from a motor vehicle","4","0","0","95.52","7.72","0","0","0","0","0","0","0","0","0"
"2001","Medicine Hat, Alberta, municipal","48062","Theft over $5,000 from a motor vehicle","23","1","1","466.72","43.75","0","0","0","0","2","1","1","0","1"
"1998","Medicine Hat, Alberta, municipal","48062","Theft $5,000 or under from a motor vehicle","504","28","5","0","1014.13","0","0","0","0","33","18","46","28","4"
"2002","Medicine Hat, Alberta, municipal","48062","Theft over $5,000 from a motor vehicle","2","0","0","-91.44","3.74","0","0","0","0","0","0","0","0","0"
"1999","Medicine Hat, Alberta, municipal","48062","Theft $5,000 or under from a motor vehicle","644","29","2","25.37","1271.37","0","0","0","0","31","12","43","31","2"
"2003","Medicine Hat, Alberta, municipal","48062","Theft over $5,000 from a motor vehicle","10","1","0","392.78","18.45","0","0","0","0","1","0","0","0","0"
"2000","Medicine Hat, Alberta, municipal","48062","Theft $5,000 or under from a motor vehicle","412","56","0","-37.46","795.14","0","0","0","0","56","50","61","11","6"
"2004","Medicine Hat, Alberta, municipal","48062","Theft over $5,000 from a motor vehicle","7","0","0","-32.08","12.53","0","0","0","0","0","0","0","0","0"
"2001","Medicine Hat, Alberta, municipal","48062","Theft $5,000 or under from a motor vehicle","239","20","1","-42.83","454.61","0","0","0","0","21","6","16","10","0"
"2005","Medicine Hat, Alberta, municipal","48062","Theft over $5,000 from a motor vehicle","12","0","0","66.77","20.9","0","0","0","0","0","0","0","0","0"
"2002","Medicine Hat, Alberta, municipal","48062","Theft $5,000 or under from a motor vehicle","324","17","2","33.45","606.66","0","0","0","0","19","12","15","3","1"
"2006","Medicine Hat, Alberta, municipal","48062","Theft over $5,000 from a motor vehicle","7","1","0","-43.19","11.88","2.15","1.96","0","0","1","1","1","0","0"
"2003","Medicine Hat, Alberta, municipal","48062","Theft $5,000 or under from a motor vehicle","204","40","1","-37.95","376.45","0","0","0","0","41","19","29","10","2"
"2007","Medicine Hat, Alberta, municipal","48062","Theft over $5,000 from a motor vehicle","8","0","0","11.62","13.25","0","0","0","0","0","0","0","0","0"
"2004","Medicine Hat, Alberta, municipal","48062","Theft $5,000 or under from a motor vehicle","460","14","0","118.8","823.68","22.9","33.26","135.14","0","14","10","16","6","0"
"2008","Medicine Hat, Alberta, municipal","48062","Theft over $5,000 from a motor vehicle","3","0","0","-63.1","4.89","0","0","0","0","0","0","0","0","0"
"2005","Medicine Hat, Alberta, municipal","48062","Theft $5,000 or under from a motor vehicle","316","10","2","-33.17","550.47","8.89","22.21","155.42","22.2","12","4","11","7","1"
"2009","Medicine Hat, Alberta, municipal","48062","Theft over $5,000 from a motor vehicle","6","0","0","97.87","9.68","0","0","0","0","0","0","0","0","0"
"2006","Medicine Hat, Alberta, municipal","48062","Theft $5,000 or under from a motor vehicle","391","14","1","20.5","663.31","17.24","25.54","111.21","44.48","15","8","13","5","2"
"2010","Medicine Hat, Alberta, municipal","48062","Theft over $5,000 from a motor vehicle","2","0","0","-66.67","3.23","0","0","0","0","0","0","0","0","0"
"2007","Medicine Hat, Alberta, municipal","48062","Theft $5,000 or under from a motor vehicle","418","15","1","4.41","692.55","16.79","26.85","133.63","111.36","16","8","14","6","5"
"2011","Medicine Hat, Alberta, municipal","48062","Theft over $5,000 from a motor vehicle","6","0","0","200.04","9.68","0","0","0","0","0","0","0","0","0"
"2008","Medicine Hat, Alberta, municipal","48062","Theft $5,000 or under from a motor vehicle","327","32","0","-23.02","533.13","24.74","43.44","247.19","0","32","12","23","11","0"
"2012","Medicine Hat, Alberta, municipal","48062","Theft over $5,000 from a motor vehicle","2","0","0","-67.07","3.19","0","0","0","0","0","0","0","0","0"
"2009","Medicine Hat, Alberta, municipal","48062","Theft $5,000 or under from a motor vehicle","429","22","0","29.79","691.97","30.54","39.26","137.05","0","22","15","21","6","0"
"2013","Medicine Hat, Alberta, municipal","48062","Theft over $5,000 from a motor vehicle","0","0","0","-100","0","0","0","0","0","0","0","0","0","0"
"2010","Medicine Hat, Alberta, municipal","48062","Theft $5,000 or under from a motor vehicle","301","12","0","-29.85","485.44","18.33","18.71","22.93","0","12","9","10","1","0"
"2014","Medicine Hat, Alberta, municipal","48062","Theft over $5,000 from a motor vehicle","3","0","0","0","4.68","0","0","0","0","0","0","0","0","0"
"2011","Medicine Hat, Alberta, municipal","48062","Theft $5,000 or under from a motor vehicle","407","43","0","35.23","656.48","24.43","56.1","412.84","68.81","43","12","30","18","3"
"2015","Medicine Hat, Alberta, municipal","48062","Theft over $5,000 from a motor vehicle","4","1","0","32.32","6.19","0","0","0","0","1","0","0","0","0"
"2012","Medicine Hat, Alberta, municipal","48062","Theft $5,000 or under from a motor vehicle","317","19","0","-23.05","505.19","24.12","35.1","159.85","0","19","12","19","7","0"
"2016","Medicine Hat, Alberta, municipal","48062","Theft over $5,000 from a motor vehicle","4","0","0","-0.61","6.16","0","0","0","0","0","0","0","0","0"
"2013","Medicine Hat, Alberta, municipal","48062","Theft $5,000 or under from a motor vehicle","274","13","0","-14.63","431.29","23.81","32.87","137.52","0","13","12","18","6","0"
"2014","Medicine Hat, Alberta, municipal","48062","Theft $5,000 or under from a motor vehicle","256","9","5","-7.37","399.48","3.93","12.67","115.47","23.09","14","2","7","5","1"
"2015","Medicine Hat, Alberta, municipal","48062","Theft $5,000 or under from a motor vehicle","406","30","3","57.39","628.75","21.47","30.58","138.28","46.09","33","11","17","6","2"
"2016","Medicine Hat, Alberta, municipal","48062","Theft $5,000 or under from a motor vehicle","637","15","2","55.94","980.45","21.37","25.08","68.79","0","17","11","14","3","0"
"1998","Medicine Hat, Alberta, municipal","48062","Shoplifting over $5,000","0","0","0","0","0","0","0","0","0","0","0","0","0","0"
"1998","Medicine Hat, Alberta, municipal","48062","Shoplifting $5,000 or under","180","88","45","0","362.19","0","0","0","0","133","43","104","61","71"
"1999","Medicine Hat, Alberta, municipal","48062","Shoplifting over $5,000","0","0","0","0","0","0","0","0","0","0","0","0","0","0"
"1999","Medicine Hat, Alberta, municipal","48062","Shoplifting $5,000 or under","209","104","50","13.92","412.6","0","0","0","0","154","55","131","76","60"
"2000","Medicine Hat, Alberta, municipal","48062","Shoplifting over $5,000","2","1","0","0","3.86","0","0","0","0","1","1","2","1","0"
"2000","Medicine Hat, Alberta, municipal","48062","Shoplifting $5,000 or under","202","115","45","-5.51","389.85","0","0","0","0","160","61","131","70","55"
"2001","Medicine Hat, Alberta, municipal","48062","Shoplifting over $5,000","0","0","0","-100","0","0","0","0","0","0","0","0","0","0"
"2001","Medicine Hat, Alberta, municipal","48062","Shoplifting $5,000 or under","79","35","28","-61.45","150.27","0","0","0","0","63","18","39","21","30"
"2002","Medicine Hat, Alberta, municipal","48062","Shoplifting over $5,000","0","0","0","0","0","0","0","0","0","0","0","0","0","0"
"2002","Medicine Hat, Alberta, municipal","48062","Shoplifting $5,000 or under","87","37","25","8.4","162.9","0","0","0","0","62","24","39","15","25"
"2003","Medicine Hat, Alberta, municipal","48062","Shoplifting over $5,000","0","0","0","0","0","0","0","0","0","0","0","0","0","0"
"2003","Medicine Hat, Alberta, municipal","48062","Shoplifting $5,000 or under","93","55","18","5.35","171.62","0","0","0","0","73","43","56","13","18"
"2004","Medicine Hat, Alberta, municipal","48062","Shoplifting over $5,000","0","0","0","0","0","0","0","0","0","0","0","0","0","0"
"2004","Medicine Hat, Alberta, municipal","48062","Shoplifting $5,000 or under","3","2","1","-96.87","5.37","4.58","4.16","0","22.52","3","2","2","0","1"
"2005","Medicine Hat, Alberta, municipal","48062","Shoplifting over $5,000","0","0","0","0","0","0","0","0","0","0","0","0","0","0"
"2005","Medicine Hat, Alberta, municipal","48062","Shoplifting $5,000 or under","10","0","7","224.28","17.42","0","0","0","244.23","7","0","0","0","11"
"2006","Medicine Hat, Alberta, municipal","48062","Shoplifting over $5,000","1","1","0","0","1.7","4.31","3.93","0","0","1","2","2","0","0"
"2006","Medicine Hat, Alberta, municipal","48062","Shoplifting $5,000 or under","82","42","20","698.56","139.11","56.02","84.47","378.11","333.63","62","26","43","17","15"
"2007","Medicine Hat, Alberta, municipal","48062","Shoplifting over $5,000","0","0","0","-100","0","0","0","0","0","0","0","0","0","0"
"2007","Medicine Hat, Alberta, municipal","48062","Shoplifting $5,000 or under","119","67","19","41.73","197.16","123.84","147.7","400.89","334.08","86","59","77","18","15"
"2008","Medicine Hat, Alberta, municipal","48062","Shoplifting over $5,000","0","0","0","0","0","0","0","0","0","0","0","0","0","0"
"2008","Medicine Hat, Alberta, municipal","48062","Shoplifting $5,000 or under","193","116","47","59.6","314.66","179.39","230.41","786.52","808.99","163","87","122","35","36"
"2009","Medicine Hat, Alberta, municipal","48062","Shoplifting over $5,000","0","0","0","0","0","0","0","0","0","0","0","0","0","0"
"2009","Medicine Hat, Alberta, municipal","48062","Shoplifting $5,000 or under","250","168","38","28.15","403.25","260.61","336.49","1187.76","936.5","206","128","180","52","41"
"2010","Medicine Hat, Alberta, municipal","48062","Shoplifting over $5,000","0","0","0","0","0","0","0","0","0","0","0","0","0","0"
"2010","Medicine Hat, Alberta, municipal","48062","Shoplifting $5,000 or under","174","125","23","-30.41","280.62","232.2","250.67","458.51","458.51","148","114","134","20","20"
"2011","Medicine Hat, Alberta, municipal","48062","Shoplifting over $5,000","2","2","0","0","3.23","4.07","3.74","0","0","2","2","2","0","0"
"2011","Medicine Hat, Alberta, municipal","48062","Shoplifting $5,000 or under","146","98","19","-16.08","235.5","164.92","192.61","504.59","229.36","117","81","103","22","10"
"2012","Medicine Hat, Alberta, municipal","48062","Shoplifting over $5,000","1","0","0","-50.6","1.59","0","0","0","0","0","0","0","0","0"
"2012","Medicine Hat, Alberta, municipal","48062","Shoplifting $5,000 or under","170","115","29","15.04","270.92","188.96","225.4","639.42","502.4","144","94","122","28","22"
"2013","Medicine Hat, Alberta, municipal","48062","Shoplifting over $5,000","3","0","0","196.31","4.72","0","0","0","0","0","0","0","0","0"
"2013","Medicine Hat, Alberta, municipal","48062","Shoplifting $5,000 or under","196","127","43","13.87","308.51","210.32","241.04","595.92","550.08","170","106","132","26","24"
"2014","Medicine Hat, Alberta, municipal","48062","Shoplifting over $5,000","2","2","0","-33.91","3.12","5.89","5.43","0","0","2","3","3","0","0"
"2014","Medicine Hat, Alberta, municipal","48062","Shoplifting $5,000 or under","221","119","65","11.78","344.87","239.65","244.4","300.23","762.12","184","122","135","13","33"
"2015","Medicine Hat, Alberta, municipal","48062","Shoplifting over $5,000","1","1","0","-50.38","1.55","3.9","3.6","0","0","1","2","2","0","0"
"2015","Medicine Hat, Alberta, municipal","48062","Shoplifting $5,000 or under","274","147","74","23.04","424.33","284.9","291.45","368.75","875.78","221","146","162","16","38"
"2016","Medicine Hat, Alberta, municipal","48062","Shoplifting over $5,000","0","0","0","-100","0","0","0","0","0","0","0","0","0","0"
"2016","Medicine Hat, Alberta, municipal","48062","Shoplifting $5,000 or under","331","191","72","20.06","509.47","371.12","410.2","871.36","596.19","263","191","229","38","26"
"1998","Medicine Hat, Alberta, municipal","48062","Total theft under $5,000 (non-motor vehicle)","1348","201","65","0","2712.38","0","0","0","0","266","120","257","137","90"
"1999","Medicine Hat, Alberta, municipal","48062","Total theft under $5,000 (non-motor vehicle)","1525","208","67","11","3010.62","0","0","0","0","275","116","256","140","80"
"2000","Medicine Hat, Alberta, municipal","48062","Total theft under $5,000 (non-motor vehicle)","1270","247","59","-18.59","2451.03","0","0","0","0","306","153","279","126","74"
"2001","Medicine Hat, Alberta, municipal","48062","Total theft under $5,000 (non-motor vehicle)","1174","170","68","-8.89","2233.13","0","0","0","0","238","108","190","82","63"
"2002","Medicine Hat, Alberta, municipal","48062","Total theft under $5,000 (non-motor vehicle)","1201","163","52","0.7","2248.77","0","0","0","0","215","125","173","48","43"
"2003","Medicine Hat, Alberta, municipal","48062","Total theft under $5,000 (non-motor vehicle)","1091","180","45","-10.47","2013.29","0","0","0","0","225","124","177","53","45"
"2004","Medicine Hat, Alberta, municipal","48062","Total theft under $5,000 (non-motor vehicle)","1250","177","49","11.17","2238.26","322.87","378.29","923.42","1148.65","226","141","182","41","51"
"2005","Medicine Hat, Alberta, municipal","48062","Total theft under $5,000 (non-motor vehicle)","1002","149","61","-22.02","1745.46","224.35","294.81","999.11","1243.34","210","101","146","45","56"
"2006","Medicine Hat, Alberta, municipal","48062","Total theft under $5,000 (non-motor vehicle)","1048","134","37","1.86","1777.87","209.01","273.05","934.16","622.78","171","97","139","42","28"
"1998","Medicine Hat, Alberta, municipal","48062","Fraud","441","264","84","0","887.36","0","0","0","0","348","238","293","55","3"
"2007","Medicine Hat, Alberta, municipal","48062","Total theft under $5,000 (non-motor vehicle)","1045","162","44","-2.62","1731.37","251.88","312.67","957.68","1024.5","206","120","163","43","46"
"1999","Medicine Hat, Alberta, municipal","48062","Fraud","282","210","33","-37.26","556.72","0","0","0","0","243","184","220","36","7"
"2008","Medicine Hat, Alberta, municipal","48062","Total theft under $5,000 (non-motor vehicle)","934","231","61","-12.05","1522.76","336.1","423.06","1370.79","1011.24","292","163","224","61","45"
"2000","Medicine Hat, Alberta, municipal","48062","Fraud","231","151","29","-19.92","445.82","0","0","0","0","180","135","162","27","3"
"2009","Medicine Hat, Alberta, municipal","48062","Total theft under $5,000 (non-motor vehicle)","1089","257","49","15.35","1756.54","380.74","499.13","1827.32","1142.07","306","187","267","80","50"
"2001","Medicine Hat, Alberta, municipal","48062","Fraud","181","113","12","-22.77","344.29","0","0","0","0","125","83","100","17","0"
"2010","Medicine Hat, Alberta, municipal","48062","Total theft under $5,000 (non-motor vehicle)","836","177","33","-23.24","1348.28","321.83","353.56","710.68","550.21","210","158","189","31","24"
"2002","Medicine Hat, Alberta, municipal","48062","Fraud","213","121","33","15.84","398.82","0","0","0","0","154","105","131","26","0"
"2011","Medicine Hat, Alberta, municipal","48062","Total theft under $5,000 (non-motor vehicle)","912","191","25","9.1","1471.04","274.87","345.96","1146.79","389.91","216","135","185","50","17"
"2003","Medicine Hat, Alberta, municipal","48062","Fraud","170","78","13","-21.34","313.71","0","0","0","0","91","75","81","6","2"
"2012","Medicine Hat, Alberta, municipal","48062","Total theft under $5,000 (non-motor vehicle)","807","178","34","-12.57","1286.08","271.38","345.5","1187.49","548.07","212","135","187","52","24"
"2004","Medicine Hat, Alberta, municipal","48062","Fraud","220","122","9","25.57","393.93","224.41","220.32","180.18","67.57","131","98","106","8","3"
"2013","Medicine Hat, Alberta, municipal","48062","Total theft under $5,000 (non-motor vehicle)","760","173","59","-6.98","1196.27","283.73","341.47","1008.48","710.52","232","143","187","44","31"
"2005","Medicine Hat, Alberta, municipal","48062","Fraud","199","130","6","-12","346.65","253.23","246.35","177.62","0","136","114","122","8","0"
"2014","Medicine Hat, Alberta, municipal","48062","Total theft under $5,000 (non-motor vehicle)","986","180","160","28.62","1538.63","331.97","358.45","669.75","1177.83","340","169","198","29","51"
"2006","Medicine Hat, Alberta, municipal","48062","Fraud","181","99","1","-11.42","307.06","200.39","190.55","88.97","0","100","93","97","4","0"
"2015","Medicine Hat, Alberta, municipal","48062","Total theft under $5,000 (non-motor vehicle)","1217","219","149","22.49","1884.69","378.57","406.58","737.5","1244.53","368","194","226","32","54"
"2007","Medicine Hat, Alberta, municipal","48062","Fraud","193","111","7","4.14","319.76","197.3","197.58","200.45","44.54","118","94","103","9","2"
"2016","Medicine Hat, Alberta, municipal","48062","Total theft under $5,000 (non-motor vehicle)","1619","270","117","32.22","2491.92","522.68","562.45","1031.87","756.71","387","269","314","45","33"
"2008","Medicine Hat, Alberta, municipal","48062","Fraud","174","85","8","-11.28","283.68","162.89","164.31","179.78","67.42","93","79","87","8","3"
"2009","Medicine Hat, Alberta, municipal","48062","Fraud","182","85","6","3.48","293.56","146.59","142.07","91.37","45.68","91","72","76","4","2"
"2010","Medicine Hat, Alberta, municipal","48062","Fraud","225","108","4","23.61","362.87","209.8","196.42","45.85","22.93","112","103","105","2","1"
"2011","Medicine Hat, Alberta, municipal","48062","Fraud","151","68","3","-32.88","243.56","150.67","151.47","160.55","0","71","74","81","7","0"
"2012","Medicine Hat, Alberta, municipal","48062","Fraud","132","59","4","-13.63","210.36","122.62","131.18","228.36","22.84","63","61","71","10","1"
"2013","Medicine Hat, Alberta, municipal","48062","Fraud","153","85","6","14.48","240.83","158.73","153.39","91.68","68.76","91","80","84","4","3"
"2014","Medicine Hat, Alberta, municipal","48062","Fraud","208","68","19","34.78","324.58","135.54","128.53","46.19","115.47","87","69","71","2","5"
"2015","Medicine Hat, Alberta, municipal","48062","Fraud","242","77","37","15.46","374.77","154.16","145.72","46.09","207.42","114","79","81","2","9"
"2016","Medicine Hat, Alberta, municipal","48062","Fraud","373","175","23","53.19","574.11","351.69","327.8","45.86","68.79","198","181","183","2","3"
"2005","Medicine Hat, Alberta, municipal","48062","Identity theft","0","0","0","0","0","0","0","0","0","0","0","0","0","0"
"2006","Medicine Hat, Alberta, municipal","48062","Identity theft","0","0","0","0","0","0","0","0","0","0","0","0","0","0"
"2007","Medicine Hat, Alberta, municipal","48062","Identity theft","0","0","0","0","0","0","0","0","0","0","0","0","0","0"
"2008","Medicine Hat, Alberta, municipal","48062","Identity theft","0","0","0","0","0","0","0","0","0","0","0","0","0","0"
"2009","Medicine Hat, Alberta, municipal","48062","Identity theft","0","0","0","0","0","0","0","0","0","0","0","0","0","0"
"2010","Medicine Hat, Alberta, municipal","48062","Identity theft","0","0","0","0","0","0","0","0","0","0","0","0","0","0"
"2011","Medicine Hat, Alberta, municipal","48062","Identity theft","0","0","0","0","0","0","0","0","0","0","0","0","0","0"
"2012","Medicine Hat, Alberta, municipal","48062","Identity theft","0","0","0","0","0","0","0","0","0","0","0","0","0","0"
"2013","Medicine Hat, Alberta, municipal","48062","Identity theft","0","0","0","0","0","0","0","0","0","0","0","0","0","0"
"2014","Medicine Hat, Alberta, municipal","48062","Identity theft","0","0","0","0","0","0","0","0","0","0","0","0","0","0"
"2015","Medicine Hat, Alberta, municipal","48062","Identity theft","0","0","0","0","0","0","0","0","0","0","0","0","0","0"
"2016","Medicine Hat, Alberta, municipal","48062","Identity theft","4","2","0","0","6.16","5.83","5.37","0","0","2","3","3","0","0"
"2005","Medicine Hat, Alberta, municipal","48062","Identity fraud","0","0","0","0","0","0","0","0","0","0","0","0","0","0"
"2006","Medicine Hat, Alberta, municipal","48062","Identity fraud","0","0","0","0","0","0","0","0","0","0","0","0","0","0"
"2007","Medicine Hat, Alberta, municipal","48062","Identity fraud","0","0","0","0","0","0","0","0","0","0","0","0","0","0"
"2008","Medicine Hat, Alberta, municipal","48062","Identity fraud","0","0","0","0","0","0","0","0","0","0","0","0","0","0"
"2009","Medicine Hat, Alberta, municipal","48062","Identity fraud","0","0","0","0","0","0","0","0","0","0","0","0","0","0"
"2010","Medicine Hat, Alberta, municipal","48062","Identity fraud","0","0","0","0","0","0","0","0","0","0","0","0","0","0"
"2011","Medicine Hat, Alberta, municipal","48062","Identity fraud","2","2","0","0","3.23","6.11","5.61","0","0","2","3","3","0","0"
"2012","Medicine Hat, Alberta, municipal","48062","Identity fraud","4","3","0","97.6","6.37","6.03","7.39","22.84","0","3","3","4","1","0"
"2013","Medicine Hat, Alberta, municipal","48062","Identity fraud","11","3","0","171.62","17.31","5.95","5.48","0","0","3","3","3","0","0"
"2014","Medicine Hat, Alberta, municipal","48062","Identity fraud","17","6","1","53.21","26.53","11.79","10.86","0","0","7","6","6","0","0"
"2015","Medicine Hat, Alberta, municipal","48062","Identity fraud","3","4","0","-82.49","4.65","7.81","7.2","0","0","4","4","4","0","0"
"2016","Medicine Hat, Alberta, municipal","48062","Identity fraud","14","3","0","363.82","21.55","5.83","5.37","0","0","3","3","3","0","0"
"1998","Medicine Hat, Alberta, municipal","48062","Total mischief","736","67","13","0","1480.94","0","0","0","0","80","44","80","36","14"
"1999","Medicine Hat, Alberta, municipal","48062","Total mischief","870","63","14","15.98","1717.53","0","0","0","0","77","37","76","39","17"
"2000","Medicine Hat, Alberta, municipal","48062","Total mischief","831","114","11","-6.62","1603.78","0","0","0","0","125","66","119","53","26"
"2001","Medicine Hat, Alberta, municipal","48062","Total mischief","680","84","19","-19.35","1293.46","0","0","0","0","103","51","71","20","13"
"2002","Medicine Hat, Alberta, municipal","48062","Total mischief","733","124","18","6.11","1372.48","0","0","0","0","142","68","108","40","4"
"2003","Medicine Hat, Alberta, municipal","48062","Total mischief","752","69","26","1.11","1387.71","0","0","0","0","95","52","76","24","28"
"2004","Medicine Hat, Alberta, municipal","48062","Total mischief","1195","336","25","54.19","2139.77","158","228.64","923.42","427.93","361","69","110","41","19"
"2005","Medicine Hat, Alberta, municipal","48062","Total mischief","796","141","10","-35.2","1386.61","137.72","214.04","976.91","532.86","151","62","106","44","24"
"2006","Medicine Hat, Alberta, municipal","48062","Total mischief","859","94","12","5.09","1457.24","129.28","176.8","667.26","311.39","106","60","90","30","14"
"2007","Medicine Hat, Alberta, municipal","48062","Total mischief","920","86","17","4.6","1524.26","136.43","184.15","690.42","200.45","103","65","96","31","9"
"2008","Medicine Hat, Alberta, municipal","48062","Total mischief","869","149","26","-7.05","1416.79","154.65","220.97","943.82","516.85","175","75","117","42","23"
"2009","Medicine Hat, Alberta, municipal","48062","Total mischief","657","95","16","-25.2","1059.73","144.56","149.55","205.57","137.05","111","71","80","9","6"
"2010","Medicine Hat, Alberta, municipal","48062","Total mischief","635","96","9","-3.36","1024.11","150.73","183.32","550.21","45.85","105","74","98","24","2"
"2011","Medicine Hat, Alberta, municipal","48062","Total mischief","812","171","8","27.89","1309.74","134.38","170.17","573.39","114.68","179","66","91","25","5"
"2012","Medicine Hat, Alberta, municipal","48062","Total mischief","532","81","10","-35.27","847.82","126.64","149.65","411.05","159.85","91","63","81","18","7"
"2013","Medicine Hat, Alberta, municipal","48062","Total mischief","508","110","13","-5.69","799.61","113.1","136.95","412.56","206.28","123","57","75","18","9"
"2014","Medicine Hat, Alberta, municipal","48062","Total mischief","718","96","23","40.12","1120.42","86.43","103.19","300.23","254.04","119","44","57","13","11"
"2015","Medicine Hat, Alberta, municipal","48062","Total mischief","666","67","21","-7.95","1031.39","97.57","115.14","322.65","507.03","88","50","64","14","22"
"2016","Medicine Hat, Alberta, municipal","48062","Total mischief","685","63","23","2.22","1054.33","73.84","94.94","343.96","160.51","86","38","53","15","7"
"1998","Medicine Hat, Alberta, municipal","48062","Mischief","736","67","13","0","1480.94","0","0","0","0","80","44","80","36","14"
"1999","Medicine Hat, Alberta, municipal","48062","Mischief","870","63","14","15.98","1717.53","0","0","0","0","77","37","76","39","17"
"2000","Medicine Hat, Alberta, municipal","48062","Mischief","831","114","11","-6.62","1603.78","0","0","0","0","125","66","119","53","26"
"2001","Medicine Hat, Alberta, municipal","48062","Mischief","680","84","19","-19.35","1293.46","0","0","0","0","103","51","71","20","13"
"2002","Medicine Hat, Alberta, municipal","48062","Mischief","733","124","18","6.11","1372.48","0","0","0","0","142","68","108","40","4"
"2003","Medicine Hat, Alberta, municipal","48062","Mischief","752","69","26","1.11","1387.71","0","0","0","0","95","52","76","24","28"
"2004","Medicine Hat, Alberta, municipal","48062","Mischief","1195","336","25","54.19","2139.77","158","228.64","923.42","427.93","361","69","110","41","19"
"2005","Medicine Hat, Alberta, municipal","48062","Mischief","796","141","10","-35.2","1386.61","137.72","214.04","976.91","532.86","151","62","106","44","24"
"2006","Medicine Hat, Alberta, municipal","48062","Mischief","859","94","12","5.09","1457.24","129.28","176.8","667.26","311.39","106","60","90","30","14"
"2007","Medicine Hat, Alberta, municipal","48062","Mischief","920","86","17","4.6","1524.26","136.43","184.15","690.42","200.45","103","65","96","31","9"
"2008","Medicine Hat, Alberta, municipal","48062","Mischief","868","149","26","-7.16","1415.16","154.65","220.97","943.82","516.85","175","75","117","42","23"
"2009","Medicine Hat, Alberta, municipal","48062","Mischief","657","95","16","-25.12","1059.73","144.56","149.55","205.57","137.05","111","71","80","9","6"
"2010","Medicine Hat, Alberta, municipal","48062","Mischief","635","96","9","-3.36","1024.11","150.73","183.32","550.21","45.85","105","74","98","24","2"
"2011","Medicine Hat, Alberta, municipal","48062","Mischief","812","171","8","27.89","1309.74","134.38","170.17","573.39","114.68","179","66","91","25","5"
"2012","Medicine Hat, Alberta, municipal","48062","Mischief","532","81","10","-35.27","847.82","126.64","149.65","411.05","159.85","91","63","81","18","7"
"2013","Medicine Hat, Alberta, municipal","48062","Mischief","508","110","13","-5.69","799.61","113.1","136.95","412.56","206.28","123","57","75","18","9"
"2014","Medicine Hat, Alberta, municipal","48062","Mischief","718","96","23","40.12","1120.42","86.43","103.19","300.23","254.04","119","44","57","13","11"
"2015","Medicine Hat, Alberta, municipal","48062","Mischief","666","67","21","-7.95","1031.39","97.57","115.14","322.65","507.03","88","50","64","14","22"
"2016","Medicine Hat, Alberta, municipal","48062","Mischief","685","63","23","2.22","1054.33","73.84","94.94","343.96","160.51","86","38","53","15","7"
"2012","Medicine Hat, Alberta, municipal","48062","Mischief in relation to cultural property","0","0","0","0","0","0","0","0","0","0","0","0","0","0"
"2013","Medicine Hat, Alberta, municipal","48062","Mischief in relation to cultural property","0","0","0","0","0","0","0","0","0","0","0","0","0","0"
"2014","Medicine Hat, Alberta, municipal","48062","Mischief in relation to cultural property","0","0","0","0","0","0","0","0","0","0","0","0","0","0"
"2015","Medicine Hat, Alberta, municipal","48062","Mischief in relation to cultural property","0","0","0","0","0","0","0","0","0","0","0","0","0","0"
"2016","Medicine Hat, Alberta, municipal","48062","Mischief in relation to cultural property","0","0","0","0","0","0","0","0","0","0","0","0","0","0"
"2005","Medicine Hat, Alberta, municipal","48062","Mischief to religious property motivated by hate","0","0","0","0","0","0","0","0","0","0","0","0","0","0"
"2006","Medicine Hat, Alberta, municipal","48062","Mischief to religious property motivated by hate","0","0","0","0","0","0","0","0","0","0","0","0","0","0"
"2007","Medicine Hat, Alberta, municipal","48062","Mischief to religious property motivated by hate","0","0","0","0","0","0","0","0","0","0","0","0","0","0"
"2008","Medicine Hat, Alberta, municipal","48062","Mischief to religious property motivated by hate","1","0","0","0","1.63","0","0","0","0","0","0","0","0","0"
"2009","Medicine Hat, Alberta, municipal","48062","Mischief to religious property motivated by hate","0","0","0","-100","0","0","0","0","0","0","0","0","0","0"
"2010","Medicine Hat, Alberta, municipal","48062","Mischief to religious property motivated by hate","0","0","0","0","0","0","0","0","0","0","0","0","0","0"
"2011","Medicine Hat, Alberta, municipal","48062","Mischief to religious property motivated by hate","0","0","0","0","0","0","0","0","0","0","0","0","0","0"
"2012","Medicine Hat, Alberta, municipal","48062","Mischief to religious property motivated by hate","0","0","0","0","0","0","0","0","0","0","0","0","0","0"
"2013","Medicine Hat, Alberta, municipal","48062","Mischief to religious property motivated by hate","0","0","0","0","0","0","0","0","0","0","0","0","0","0"
"2014","Medicine Hat, Alberta, municipal","48062","Mischief to religious property motivated by hate","0","0","0","0","0","0","0","0","0","0","0","0","0","0"
"2015","Medicine Hat, Alberta, municipal","48062","Mischief to religious property motivated by hate","0","0","0","0","0","0","0","0","0","0","0","0","0","0"
"2016","Medicine Hat, Alberta, municipal","48062","Mischief to religious property motivated by hate","0","0","0","0","0","0","0","0","0","0","0","0","0","0"
"2012","Medicine Hat, Alberta, municipal","48062","Mischief relating to war memorials","0","0","0","0","0","0","0","0","0","0","0","0","0","0"
"2013","Medicine Hat, Alberta, municipal","48062","Mischief relating to war memorials","0","0","0","0","0","0","0","0","0","0","0","0","0","0"
"2014","Medicine Hat, Alberta, municipal","48062","Mischief relating to war memorials","0","0","0","0","0","0","0","0","0","0","0","0","0","0"
"2015","Medicine Hat, Alberta, municipal","48062","Mischief relating to war memorials","0","0","0","0","0","0","0","0","0","0","0","0","0","0"
"2016","Medicine Hat, Alberta, municipal","48062","Mischief relating to war memorials","0","0","0","0","0","0","0","0","0","0","0","0","0","0"
"1998","Medicine Hat, Alberta, municipal","48062","Arson","5","2","1","0","10.06","0","0","0","0","3","5","5","0","2"
"1999","Medicine Hat, Alberta, municipal","48062","Arson","6","3","0","17.74","11.85","0","0","0","0","3","0","3","3","0"
"2000","Medicine Hat, Alberta, municipal","48062","Arson","5","1","0","-18.53","9.65","0","0","0","0","1","1","1","0","0"
"2001","Medicine Hat, Alberta, municipal","48062","Arson","7","2","0","37.98","13.32","0","0","0","0","2","1","3","2","0"
"2002","Medicine Hat, Alberta, municipal","48062","Arson","6","1","0","-15.63","11.23","0","0","0","0","1","1","1","0","0"
"2003","Medicine Hat, Alberta, municipal","48062","Arson","4","1","0","-34.3","7.38","0","0","0","0","1","0","1","1","0"
"2004","Medicine Hat, Alberta, municipal","48062","Arson","9","4","1","118.32","16.12","2.29","12.47","112.61","0","5","1","6","5","0"
"2005","Medicine Hat, Alberta, municipal","48062","Arson","1","0","0","-89.19","1.74","0","0","0","0","0","0","0","0","0"
"2006","Medicine Hat, Alberta, municipal","48062","Arson","7","0","0","581.7","11.88","0","0","0","0","0","0","0","0","0"
"2007","Medicine Hat, Alberta, municipal","48062","Arson","13","3","1","81.38","21.54","4.2","3.84","0","44.54","4","2","2","0","2"
"2008","Medicine Hat, Alberta, municipal","48062","Arson","12","4","0","-9.17","19.56","6.19","17","134.83","0","4","3","9","6","0"
"2009","Medicine Hat, Alberta, municipal","48062","Arson","14","5","1","15.42","22.58","8.14","9.35","22.84","0","6","4","5","1","0"
"2010","Medicine Hat, Alberta, municipal","48062","Arson","11","2","0","-21.44","17.74","0","7.48","91.7","0","2","0","4","4","0"
"2011","Medicine Hat, Alberta, municipal","48062","Arson","16","5","0","45.47","25.81","6.11","5.61","0","0","5","3","3","0","0"
"2012","Medicine Hat, Alberta, municipal","48062","Arson","11","3","0","-32.07","17.53","6.03","5.54","0","0","3","3","3","0","0"
"2013","Medicine Hat, Alberta, municipal","48062","Arson","12","4","1","7.75","18.89","1.98","1.83","0","0","5","1","1","0","0"
"2014","Medicine Hat, Alberta, municipal","48062","Arson","5","1","0","-58.69","7.8","0","0","0","0","1","0","0","0","0"
"2015","Medicine Hat, Alberta, municipal","48062","Arson","14","4","0","177.88","21.68","3.9","9","69.14","0","4","2","5","3","0"
"2016","Medicine Hat, Alberta, municipal","48062","Arson","8","1","0","-43.21","12.31","1.94","1.79","0","0","1","1","1","0","0"
"2005","Medicine Hat, Alberta, municipal","48062","Altering, removing or destroying Vehicle Identification Number (VIN)","0","0","0","0","0","0","0","0","0","0","0","0","0","0"
"2006","Medicine Hat, Alberta, municipal","48062","Altering, removing or destroying Vehicle Identification Number (VIN)","0","0","0","0","0","0","0","0","0","0","0","0","0","0"
"2007","Medicine Hat, Alberta, municipal","48062","Altering, removing or destroying Vehicle Identification Number (VIN)","0","0","0","0","0","0","0","0","0","0","0","0","0","0"
"2008","Medicine Hat, Alberta, municipal","48062","Altering, removing or destroying Vehicle Identification Number (VIN)","0","0","0","0","0","0","0","0","0","0","0","0","0","0"
"2009","Medicine Hat, Alberta, municipal","48062","Altering, removing or destroying Vehicle Identification Number (VIN)","0","0","0","0","0","0","0","0","0","0","0","0","0","0"
"2010","Medicine Hat, Alberta, municipal","48062","Altering, removing or destroying Vehicle Identification Number (VIN)","0","0","0","0","0","0","0","0","0","0","0","0","0","0"
"2011","Medicine Hat, Alberta, municipal","48062","Altering, removing or destroying Vehicle Identification Number (VIN)","0","0","0","0","0","0","0","0","0","0","0","0","0","0"
"2012","Medicine Hat, Alberta, municipal","48062","Altering, removing or destroying Vehicle Identification Number (VIN)","0","0","0","0","0","0","0","0","0","0","0","0","0","0"
"2013","Medicine Hat, Alberta, municipal","48062","Altering, removing or destroying Vehicle Identification Number (VIN)","0","0","0","0","0","0","0","0","0","0","0","0","0","0"
"2014","Medicine Hat, Alberta, municipal","48062","Altering, removing or destroying Vehicle Identification Number (VIN)","0","0","0","0","0","0","0","0","0","0","0","0","0","0"
"2015","Medicine Hat, Alberta, municipal","48062","Altering, removing or destroying Vehicle Identification Number (VIN)","0","0","0","0","0","0","0","0","0","0","0","0","0","0"
"2016","Medicine Hat, Alberta, municipal","48062","Altering, removing or destroying Vehicle Identification Number (VIN)","0","0","0","0","0","0","0","0","0","0","0","0","0","0"
"1998","Medicine Hat, Alberta, municipal","48062","Total other Criminal Code violations","381","334","10","0","766.63","0","0","0","0","344","273","361","88","8"
"1999","Medicine Hat, Alberta, municipal","48062","Total other Criminal Code violations","604","553","11","55.54","1192.4","0","0","0","0","564","426","584","158","4"
"2000","Medicine Hat, Alberta, municipal","48062","Total other Criminal Code violations","536","481","7","-13.25","1034.45","0","0","0","0","488","397","509","112","6"
"2001","Medicine Hat, Alberta, municipal","48062","Total other Criminal Code violations","581","514","42","6.83","1105.15","0","0","0","0","556","421","520","99","2"
"2002","Medicine Hat, Alberta, municipal","48062","Total other Criminal Code violations","615","580","12","4.2","1151.53","0","0","0","0","592","486","591","105","5"
"2003","Medicine Hat, Alberta, municipal","48062","Total other Criminal Code violations","742","674","10","18.91","1369.26","0","0","0","0","684","553","675","122","2"
"2004","Medicine Hat, Alberta, municipal","48062","Total other Criminal Code violations","792","744","9","3.57","1418.16","1570.84","1567.21","1531.53","67.57","753","686","754","68","3"
"2005","Medicine Hat, Alberta, municipal","48062","Total other Criminal Code violations","905","854","8","11.16","1576.49","1732.6","1748.68","1909.41","44.4","862","780","866","86","2"
"2006","Medicine Hat, Alberta, municipal","48062","Total other Criminal Code violations","795","745","18","-14.45","1348.67","1478.13","1504.73","1779.36","66.73","763","686","766","80","3"
"2007","Medicine Hat, Alberta, municipal","48062","Total other Criminal Code violations","1004","966","18","23.34","1663.44","1989.84","1962.33","1670.38","133.63","984","948","1023","75","6"
"2008","Medicine Hat, Alberta, municipal","48062","Total other Criminal Code violations","1133","1089","12","11.05","1847.2","2171.22","2245.6","3056.18","89.89","1101","1053","1189","136","4"
"2009","Medicine Hat, Alberta, municipal","48062","Total other Criminal Code violations","1183","1124","22","3.3","1908.16","2168.38","2247.02","3129.28","91.37","1146","1065","1202","137","4"
"2010","Medicine Hat, Alberta, municipal","48062","Total other Criminal Code violations","1192","1141","16","0.75","1922.43","2248.7","2284.08","2682.26","45.85","1157","1104","1221","117","2"
"2011","Medicine Hat, Alberta, municipal","48062","Total other Criminal Code violations","1264","1187","20","6.05","2038.81","2172.45","2275.83","3440.37","91.74","1207","1067","1217","150","4"
"2012","Medicine Hat, Alberta, municipal","48062","Total other Criminal Code violations","1274","1207","18","-0.42","2030.31","2231.34","2298.38","3060.06","45.67","1225","1110","1244","134","2"
"2013","Medicine Hat, Alberta, municipal","48062","Total other Criminal Code violations","1251","1210","17","-3.01","1969.12","2281.75","2262.48","2039.88","45.84","1227","1150","1239","89","2"
"2014","Medicine Hat, Alberta, municipal","48062","Total other Criminal Code violations","1113","1001","52","-11.8","1736.81","1856.29","1815.78","1339.49","254.04","1053","945","1003","58","11"
"2015","Medicine Hat, Alberta, municipal","48062","Total other Criminal Code violations","1180","1083","46","5.22","1827.39","2031.38","1960.96","1129.29","115.23","1129","1041","1090","49","5"
"2016","Medicine Hat, Alberta, municipal","48062","Total other Criminal Code violations","1450","1351","57","22.13","2231.8","2457.93","2373.4","1375.83","137.58","1408","1265","1325","60","6"
"1998","Medicine Hat, Alberta, municipal","48062","Counterfeiting","0","0","0","0","0","0","0","0","0","0","0","0","0","0"
"1999","Medicine Hat, Alberta, municipal","48062","Counterfeiting","1","0","1","0","1.97","0","0","0","0","1","0","0","0","0"
"2000","Medicine Hat, Alberta, municipal","48062","Counterfeiting","1","1","0","-2.24","1.93","0","0","0","0","1","1","1","0","0"
"2001","Medicine Hat, Alberta, municipal","48062","Counterfeiting","26","23","3","2462.56","49.46","0","0","0","0","26","11","11","0","0"
"2002","Medicine Hat, Alberta, municipal","48062","Counterfeiting","0","0","0","-100","0","0","0","0","0","0","0","0","0","0"
"2003","Medicine Hat, Alberta, municipal","48062","Counterfeiting","1","0","1","0","1.85","0","0","0","0","1","0","0","0","0"
"2004","Medicine Hat, Alberta, municipal","48062","Counterfeiting","16","16","0","1452.53","28.65","29.77","27.02","0","0","16","13","13","0","0"
"2005","Medicine Hat, Alberta, municipal","48062","Counterfeiting","3","3","0","-81.76","5.23","6.66","6.06","0","0","3","3","3","0","0"
"2006","Medicine Hat, Alberta, municipal","48062","Counterfeiting","1","1","0","-67.54","1.7","2.15","1.96","0","0","1","1","1","0","0"
"2007","Medicine Hat, Alberta, municipal","48062","Counterfeiting","1","1","0","-2.34","1.66","4.2","3.84","0","0","1","2","2","0","0"
"2008","Medicine Hat, Alberta, municipal","48062","Counterfeiting","2","2","0","96.81","3.26","2.06","3.78","22.47","0","2","1","2","1","0"
"2009","Medicine Hat, Alberta, municipal","48062","Counterfeiting","3","3","0","48.4","4.84","0","11.22","137.05","0","3","0","6","6","0"
"2010","Medicine Hat, Alberta, municipal","48062","Counterfeiting","0","0","0","-100","0","0","0","0","0","0","0","0","0","0"
"2011","Medicine Hat, Alberta, municipal","48062","Counterfeiting","0","0","0","0","0","0","0","0","0","0","0","0","0","0"
"2012","Medicine Hat, Alberta, municipal","48062","Counterfeiting","2","2","0","0","3.19","4.02","3.7","0","0","2","2","2","0","0"
"2013","Medicine Hat, Alberta, municipal","48062","Counterfeiting","0","0","0","-100","0","0","0","0","0","0","0","0","0","0"
"2014","Medicine Hat, Alberta, municipal","48062","Counterfeiting","0","0","0","0","0","0","0","0","0","0","0","0","0","0"
"2015","Medicine Hat, Alberta, municipal","48062","Counterfeiting","8","8","0","0","12.39","19.51","17.99","0","0","8","10","10","0","0"
"2016","Medicine Hat, Alberta, municipal","48062","Counterfeiting","8","8","0","-0.61","12.31","13.6","12.54","0","0","8","7","7","0","0"
"1998","Medicine Hat, Alberta, municipal","48062","Total weapons violations","21","18","0","0","42.26","0","0","0","0","18","15","18","3","2"
"1999","Medicine Hat, Alberta, municipal","48062","Total weapons violations","27","22","3","26.14","53.3","0","0","0","0","25","14","24","10","2"
"2000","Medicine Hat, Alberta, municipal","48062","Total weapons violations","28","21","1","1.38","54.04","0","0","0","0","22","15","23","8","1"
"2001","Medicine Hat, Alberta, municipal","48062","Total weapons violations","20","16","3","-29.6","38.04","0","0","0","0","19","15","17","2","0"
"2002","Medicine Hat, Alberta, municipal","48062","Total weapons violations","20","15","2","-1.56","37.45","0","0","0","0","17","15","18","3","0"
"2003","Medicine Hat, Alberta, municipal","48062","Total weapons violations","17","13","1","-16.23","31.37","0","0","0","0","14","15","17","2","0"
"2004","Medicine Hat, Alberta, municipal","48062","Total weapons violations","16","17","0","-8.67","28.65","45.8","41.57","0","0","17","20","20","0","0"
"2005","Medicine Hat, Alberta, municipal","48062","Total weapons violations","28","23","0","70.25","48.78","55.53","50.48","0","0","23","25","25","0","0"
"2006","Medicine Hat, Alberta, municipal","48062","Total weapons violations","31","26","1","7.82","52.59","58.18","64.83","133.45","0","27","27","33","6","0"
"2007","Medicine Hat, Alberta, municipal","48062","Total weapons violations","40","40","1","26.02","66.27","88.16","86.32","66.82","22.27","41","42","45","3","1"
"2008","Medicine Hat, Alberta, municipal","48062","Total weapons violations","42","39","2","3.32","68.48","103.1","111.43","202.25","0","41","50","59","9","0"
"2009","Medicine Hat, Alberta, municipal","48062","Total weapons violations","36","33","3","-15.2","58.07","59.05","71.04","205.57","0","36","29","38","9","0"
"2010","Medicine Hat, Alberta, municipal","48062","Total weapons violations","19","17","1","-47.23","30.64","36.66","43.03","114.63","0","18","18","23","5","0"
"2011","Medicine Hat, Alberta, municipal","48062","Total weapons violations","28","28","0","47.39","45.16","63.12","61.71","45.87","0","28","31","33","2","0"
"2012","Medicine Hat, Alberta, municipal","48062","Total weapons violations","29","28","0","2.33","46.22","68.35","68.36","68.51","0","28","34","37","3","0"
"2013","Medicine Hat, Alberta, municipal","48062","Total weapons violations","29","27","0","-1.23","45.65","53.57","56.61","91.68","0","27","27","31","4","0"
"2014","Medicine Hat, Alberta, municipal","48062","Total weapons violations","19","18","1","-35.05","29.65","37.32","36.21","23.09","0","19","19","20","1","0"
"2015","Medicine Hat, Alberta, municipal","48062","Total weapons violations","40","36","3","108.93","61.95","78.05","75.56","46.09","0","39","40","42","2","0"
"2016","Medicine Hat, Alberta, municipal","48062","Total weapons violations","47","45","1","16.78","72.34","99.09","91.35","0","0","46","51","51","0","0"
"1998","Medicine Hat, Alberta, municipal","48062","Offensive weapons, explosives","0","0","0","0","0","0","0","0","0","0","0","0","0","0"
"1999","Medicine Hat, Alberta, municipal","48062","Offensive weapons, explosives","0","0","0","0","0","0","0","0","0","0","0","0","0","0"
"2000","Medicine Hat, Alberta, municipal","48062","Offensive weapons, explosives","1","1","0","0","1.93","0","0","0","0","1","1","1","0","0"
"2001","Medicine Hat, Alberta, municipal","48062","Offensive weapons, explosives","1","0","1","-1.44","1.9","0","0","0","0","1","1","1","0","0"
"2002","Medicine Hat, Alberta, municipal","48062","Offensive weapons, explosives","0","0","0","-100","0","0","0","0","0","0","0","0","0","0"
"2003","Medicine Hat, Alberta, municipal","48062","Offensive weapons, explosives","0","0","0","0","0","0","0","0","0","0","0","0","0","0"
"2004","Medicine Hat, Alberta, municipal","48062","Offensive weapons, explosives","0","0","0","0","0","0","0","0","0","0","0","0","0","0"
"2005","Medicine Hat, Alberta, municipal","48062","Offensive weapons, explosives","1","0","0","0","1.74","0","0","0","0","0","0","0","0","0"
"2006","Medicine Hat, Alberta, municipal","48062","Offensive weapons, explosives","0","0","0","-100","0","0","0","0","0","0","0","0","0","0"
"2007","Medicine Hat, Alberta, municipal","48062","Offensive weapons, explosives","0","0","0","0","0","0","0","0","0","0","0","0","0","0"
"2008","Medicine Hat, Alberta, municipal","48062","Offensive weapons, explosives","0","0","0","0","0","0","0","0","0","0","0","0","0","0"
"2009","Medicine Hat, Alberta, municipal","48062","Offensive weapons, explosives","0","0","0","0","0","0","0","0","0","0","0","0","0","0"
"2010","Medicine Hat, Alberta, municipal","48062","Offensive weapons, explosives","0","0","0","0","0","0","0","0","0","0","0","0","0","0"
"2011","Medicine Hat, Alberta, municipal","48062","Offensive weapons, explosives","0","0","0","0","0","0","0","0","0","0","0","0","0","0"
"2012","Medicine Hat, Alberta, municipal","48062","Offensive weapons, explosives","0","0","0","0","0","0","0","0","0","0","0","0","0","0"
"2013","Medicine Hat, Alberta, municipal","48062","Offensive weapons, explosives","1","0","0","0","1.57","0","0","0","0","0","0","0","0","0"
"2014","Medicine Hat, Alberta, municipal","48062","Offensive weapons, explosives","0","0","0","-100","0","0","0","0","0","0","0","0","0","0"
"2015","Medicine Hat, Alberta, municipal","48062","Offensive weapons, explosives","1","0","0","0","1.55","0","0","0","0","0","0","0","0","0"
"2016","Medicine Hat, Alberta, municipal","48062","Offensive weapons, explosives","0","0","0","-100","0","0","0","0","0","0","0","0","0","0"
"1998","Medicine Hat, Alberta, municipal","48062","Offensive weapons, prohibited","3","3","0","0","6.04","0","0","0","0","3","3","3","0","0"
"1999","Medicine Hat, Alberta, municipal","48062","Offensive weapons, prohibited","0","0","0","-100","0","0","0","0","0","0","0","0","0","0"
"2000","Medicine Hat, Alberta, municipal","48062","Offensive weapons, prohibited","0","0","0","0","0","0","0","0","0","0","0","0","0","0"
"2001","Medicine Hat, Alberta, municipal","48062","Offensive weapons, prohibited","0","0","0","0","0","0","0","0","0","0","0","0","0","0"
"2002","Medicine Hat, Alberta, municipal","48062","Offensive weapons, prohibited","0","0","0","0","0","0","0","0","0","0","0","0","0","0"
"2003","Medicine Hat, Alberta, municipal","48062","Offensive weapons, prohibited","0","0","0","0","0","0","0","0","0","0","0","0","0","0"
"2004","Medicine Hat, Alberta, municipal","48062","Offensive weapons, prohibited","0","0","0","0","0","0","0","0","0","0","0","0","0","0"
"2005","Medicine Hat, Alberta, municipal","48062","Offensive weapons, prohibited","0","0","0","0","0","0","0","0","0","0","0","0","0","0"
"2006","Medicine Hat, Alberta, municipal","48062","Offensive weapons, prohibited","0","0","0","0","0","0","0","0","0","0","0","0","0","0"
"2007","Medicine Hat, Alberta, municipal","48062","Offensive weapons, prohibited","0","0","0","0","0","0","0","0","0","0","0","0","0","0"
"2008","Medicine Hat, Alberta, municipal","48062","Offensive weapons, prohibited","0","0","0","0","0","0","0","0","0","0","0","0","0","0"
"2009","Medicine Hat, Alberta, municipal","48062","Offensive weapons, prohibited","0","0","0","0","0","0","0","0","0","0","0","0","0","0"
"2010","Medicine Hat, Alberta, municipal","48062","Offensive weapons, prohibited","0","0","0","0","0","0","0","0","0","0","0","0","0","0"
"2011","Medicine Hat, Alberta, municipal","48062","Offensive weapons, prohibited","0","0","0","0","0","0","0","0","0","0","0","0","0","0"
"2012","Medicine Hat, Alberta, municipal","48062","Offensive weapons, prohibited","0","0","0","0","0","0","0","0","0","0","0","0","0","0"
"2013","Medicine Hat, Alberta, municipal","48062","Offensive weapons, prohibited","0","0","0","0","0","0","0","0","0","0","0","0","0","0"
"2014","Medicine Hat, Alberta, municipal","48062","Offensive weapons, prohibited","0","0","0","0","0","0","0","0","0","0","0","0","0","0"
"2015","Medicine Hat, Alberta, municipal","48062","Offensive weapons, prohibited","0","0","0","0","0","0","0","0","0","0","0","0","0","0"
"2016","Medicine Hat, Alberta, municipal","48062","Offensive weapons, prohibited","0","0","0","0","0","0","0","0","0","0","0","0","0","0"
"1998","Medicine Hat, Alberta, municipal","48062","Offensive weapons, restricted","2","2","0","0","4.02","0","0","0","0","2","2","2","0","0"
"1999","Medicine Hat, Alberta, municipal","48062","Offensive weapons, restricted","0","0","0","-100","0","0","0","0","0","0","0","0","0","0"
"2000","Medicine Hat, Alberta, municipal","48062","Offensive weapons, restricted","0","0","0","0","0","0","0","0","0","0","0","0","0","0"
"2001","Medicine Hat, Alberta, municipal","48062","Offensive weapons, restricted","0","0","0","0","0","0","0","0","0","0","0","0","0","0"
"2002","Medicine Hat, Alberta, municipal","48062","Offensive weapons, restricted","0","0","0","0","0","0","0","0","0","0","0","0","0","0"
"2003","Medicine Hat, Alberta, municipal","48062","Offensive weapons, restricted","0","0","0","0","0","0","0","0","0","0","0","0","0","0"
"2004","Medicine Hat, Alberta, municipal","48062","Offensive weapons, restricted","0","0","0","0","0","0","0","0","0","0","0","0","0","0"
"2005","Medicine Hat, Alberta, municipal","48062","Offensive weapons, restricted","0","0","0","0","0","0","0","0","0","0","0","0","0","0"
"2006","Medicine Hat, Alberta, municipal","48062","Offensive weapons, restricted","0","0","0","0","0","0","0","0","0","0","0","0","0","0"
"2007","Medicine Hat, Alberta, municipal","48062","Offensive weapons, restricted","0","0","0","0","0","0","0","0","0","0","0","0","0","0"
"2008","Medicine Hat, Alberta, municipal","48062","Offensive weapons, restricted","0","0","0","0","0","0","0","0","0","0","0","0","0","0"
"2009","Medicine Hat, Alberta, municipal","48062","Offensive weapons, restricted","0","0","0","0","0","0","0","0","0","0","0","0","0","0"
"2010","Medicine Hat, Alberta, municipal","48062","Offensive weapons, restricted","0","0","0","0","0","0","0","0","0","0","0","0","0","0"
"2011","Medicine Hat, Alberta, municipal","48062","Offensive weapons, restricted","0","0","0","0","0","0","0","0","0","0","0","0","0","0"
"2012","Medicine Hat, Alberta, municipal","48062","Offensive weapons, restricted","0","0","0","0","0","0","0","0","0","0","0","0","0","0"
"2013","Medicine Hat, Alberta, municipal","48062","Offensive weapons, restricted","0","0","0","0","0","0","0","0","0","0","0","0","0","0"
"2014","Medicine Hat, Alberta, municipal","48062","Offensive weapons, restricted","0","0","0","0","0","0","0","0","0","0","0","0","0","0"
"2015","Medicine Hat, Alberta, municipal","48062","Offensive weapons, restricted","0","0","0","0","0","0","0","0","0","0","0","0","0","0"
"2016","Medicine Hat, Alberta, municipal","48062","Offensive weapons, restricted","0","0","0","0","0","0","0","0","0","0","0","0","0","0"
"1998","Medicine Hat, Alberta, municipal","48062","Firearm transfers or serial numbers","0","0","0","0","0","0","0","0","0","0","0","0","0","0"
"1999","Medicine Hat, Alberta, municipal","48062","Firearm transfers or serial numbers","0","0","0","0","0","0","0","0","0","0","0","0","0","0"
"2000","Medicine Hat, Alberta, municipal","48062","Firearm transfers or serial numbers","0","0","0","0","0","0","0","0","0","0","0","0","0","0"
"2001","Medicine Hat, Alberta, municipal","48062","Firearm transfers or serial numbers","0","0","0","0","0","0","0","0","0","0","0","0","0","0"
"2002","Medicine Hat, Alberta, municipal","48062","Firearm transfers or serial numbers","0","0","0","0","0","0","0","0","0","0","0","0","0","0"
"2003","Medicine Hat, Alberta, municipal","48062","Firearm transfers or serial numbers","0","0","0","0","0","0","0","0","0","0","0","0","0","0"
"2004","Medicine Hat, Alberta, municipal","48062","Firearm transfers or serial numbers","0","0","0","0","0","0","0","0","0","0","0","0","0","0"
"2005","Medicine Hat, Alberta, municipal","48062","Firearm transfers or serial numbers","0","0","0","0","0","0","0","0","0","0","0","0","0","0"
"2006","Medicine Hat, Alberta, municipal","48062","Firearm transfers or serial numbers","0","0","0","0","0","0","0","0","0","0","0","0","0","0"
"2007","Medicine Hat, Alberta, municipal","48062","Firearm transfers or serial numbers","0","0","0","0","0","0","0","0","0","0","0","0","0","0"
"2008","Medicine Hat, Alberta, municipal","48062","Firearm transfers or serial numbers","0","0","0","0","0","0","0","0","0","0","0","0","0","0"
"2009","Medicine Hat, Alberta, municipal","48062","Firearm transfers or serial numbers","0","0","0","0","0","0","0","0","0","0","0","0","0","0"
"2010","Medicine Hat, Alberta, municipal","48062","Firearm transfers or serial numbers","0","0","0","0","0","0","0","0","0","0","0","0","0","0"
"2011","Medicine Hat, Alberta, municipal","48062","Firearm transfers or serial numbers","0","0","0","0","0","0","0","0","0","0","0","0","0","0"
"2012","Medicine Hat, Alberta, municipal","48062","Firearm transfers or serial numbers","0","0","0","0","0","0","0","0","0","0","0","0","0","0"
"2013","Medicine Hat, Alberta, municipal","48062","Firearm transfers or serial numbers","0","0","0","0","0","0","0","0","0","0","0","0","0","0"
"2014","Medicine Hat, Alberta, municipal","48062","Firearm transfers or serial numbers","0","0","0","0","0","0","0","0","0","0","0","0","0","0"
"2015","Medicine Hat, Alberta, municipal","48062","Firearm transfers or serial numbers","0","0","0","0","0","0","0","0","0","0","0","0","0","0"
"2016","Medicine Hat, Alberta, municipal","48062","Firearm transfers or serial numbers","0","0","0","0","0","0","0","0","0","0","0","0","0","0"
"1998","Medicine Hat, Alberta, municipal","48062","Other offensive weapons","10","9","0","0","20.12","0","0","0","0","9","6","9","3","2"
"1999","Medicine Hat, Alberta, municipal","48062","Other offensive weapons","1","1","0","-90.19","1.97","0","0","0","0","1","1","1","0","0"
"2000","Medicine Hat, Alberta, municipal","48062","Other offensive weapons","1","1","0","-2.24","1.93","0","0","0","0","1","1","1","0","0"
"2001","Medicine Hat, Alberta, municipal","48062","Other offensive weapons","1","1","0","-1.44","1.9","0","0","0","0","1","0","0","0","0"
"2002","Medicine Hat, Alberta, municipal","48062","Other offensive weapons","0","0","0","-100","0","0","0","0","0","0","0","0","0","0"
"2003","Medicine Hat, Alberta, municipal","48062","Other offensive weapons","0","0","0","0","0","0","0","0","0","0","0","0","0","0"
"2004","Medicine Hat, Alberta, municipal","48062","Other offensive weapons","0","0","0","0","0","0","0","0","0","0","0","0","0","0"
"2005","Medicine Hat, Alberta, municipal","48062","Other offensive weapons","0","0","0","0","0","0","0","0","0","0","0","0","0","0"
"2006","Medicine Hat, Alberta, municipal","48062","Other offensive weapons","0","0","0","0","0","0","0","0","0","0","0","0","0","0"
"2007","Medicine Hat, Alberta, municipal","48062","Other offensive weapons","0","0","0","0","0","0","0","0","0","0","0","0","0","0"
"2008","Medicine Hat, Alberta, municipal","48062","Other offensive weapons","0","0","0","0","0","0","0","0","0","0","0","0","0","0"
"2009","Medicine Hat, Alberta, municipal","48062","Other offensive weapons","0","0","0","0","0","0","0","0","0","0","0","0","0","0"
"2010","Medicine Hat, Alberta, municipal","48062","Other offensive weapons","0","0","0","0","0","0","0","0","0","0","0","0","0","0"
"2011","Medicine Hat, Alberta, municipal","48062","Other offensive weapons","0","0","0","0","0","0","0","0","0","0","0","0","0","0"
"2012","Medicine Hat, Alberta, municipal","48062","Other offensive weapons","0","0","0","0","0","0","0","0","0","0","0","0","0","0"
"2013","Medicine Hat, Alberta, municipal","48062","Other offensive weapons","0","0","0","0","0","0","0","0","0","0","0","0","0","0"
"2014","Medicine Hat, Alberta, municipal","48062","Other offensive weapons","0","0","0","0","0","0","0","0","0","0","0","0","0","0"
"2015","Medicine Hat, Alberta, municipal","48062","Other offensive weapons","0","0","0","0","0","0","0","0","0","0","0","0","0","0"
"2016","Medicine Hat, Alberta, municipal","48062","Other offensive weapons","0","0","0","0","0","0","0","0","0","0","0","0","0","0"
"1998","Medicine Hat, Alberta, municipal","48062","Weapons trafficking","1","0","0","0","2.01","0","0","0","0","0","0","0","0","0"
"1999","Medicine Hat, Alberta, municipal","48062","Weapons trafficking","0","0","0","-100","0","0","0","0","0","0","0","0","0","0"
"2000","Medicine Hat, Alberta, municipal","48062","Weapons trafficking","1","1","0","0","1.93","0","0","0","0","1","2","2","0","0"
"2001","Medicine Hat, Alberta, municipal","48062","Weapons trafficking","0","0","0","-100","0","0","0","0","0","0","0","0","0","0"
"2002","Medicine Hat, Alberta, municipal","48062","Weapons trafficking","0","0","0","0","0","0","0","0","0","0","0","0","0","0"
"2003","Medicine Hat, Alberta, municipal","48062","Weapons trafficking","0","0","0","0","0","0","0","0","0","0","0","0","0","0"
"2004","Medicine Hat, Alberta, municipal","48062","Weapons trafficking","0","0","0","0","0","0","0","0","0","0","0","0","0","0"
"2005","Medicine Hat, Alberta, municipal","48062","Weapons trafficking","0","0","0","0","0","0","0","0","0","0","0","0","0","0"
"2006","Medicine Hat, Alberta, municipal","48062","Weapons trafficking","0","0","0","0","0","0","0","0","0","0","0","0","0","0"
"2007","Medicine Hat, Alberta, municipal","48062","Weapons trafficking","0","0","0","0","0","0","0","0","0","0","0","0","0","0"
"2008","Medicine Hat, Alberta, municipal","48062","Weapons trafficking","0","0","0","0","0","0","0","0","0","0","0","0","0","0"
"2009","Medicine Hat, Alberta, municipal","48062","Weapons trafficking","1","1","0","0","1.61","0","0","0","0","1","0","0","0","0"
"2010","Medicine Hat, Alberta, municipal","48062","Weapons trafficking","0","0","0","-100","0","0","0","0","0","0","0","0","0","0"
"2011","Medicine Hat, Alberta, municipal","48062","Weapons trafficking","0","0","0","0","0","0","0","0","0","0","0","0","0","0"
"2012","Medicine Hat, Alberta, municipal","48062","Weapons trafficking","0","0","0","0","0","0","0","0","0","0","0","0","0","0"
"2013","Medicine Hat, Alberta, municipal","48062","Weapons trafficking","0","0","0","0","0","0","0","0","0","0","0","0","0","0"
"2014","Medicine Hat, Alberta, municipal","48062","Weapons trafficking","0","0","0","0","0","0","0","0","0","0","0","0","0","0"
"2015","Medicine Hat, Alberta, municipal","48062","Weapons trafficking","1","1","0","0","1.55","1.95","1.8","0","0","1","1","1","0","0"
"2016","Medicine Hat, Alberta, municipal","48062","Weapons trafficking","0","0","0","-100","0","0","0","0","0","0","0","0","0","0"
"1998","Medicine Hat, Alberta, municipal","48062","Weapons possession contrary to order","0","0","0","0","0","0","0","0","0","0","0","0","0","0"
"1999","Medicine Hat, Alberta, municipal","48062","Weapons possession contrary to order","1","1","0","0","1.97","0","0","0","0","1","1","1","0","0"
"2000","Medicine Hat, Alberta, municipal","48062","Weapons possession contrary to order","1","1","0","-2.24","1.93","0","0","0","0","1","0","0","0","0"
"2001","Medicine Hat, Alberta, municipal","48062","Weapons possession contrary to order","4","3","1","294.24","7.61","0","0","0","0","4","2","3","1","0"
"2002","Medicine Hat, Alberta, municipal","48062","Weapons possession contrary to order","4","3","0","-1.56","7.49","0","0","0","0","3","4","4","0","0"
"2003","Medicine Hat, Alberta, municipal","48062","Weapons possession contrary to order","0","0","0","-100","0","0","0","0","0","0","0","0","0","0"
"2004","Medicine Hat, Alberta, municipal","48062","Weapons possession contrary to order","1","1","0","0","1.79","2.29","2.08","0","0","1","1","1","0","0"
"2005","Medicine Hat, Alberta, municipal","48062","Weapons possession contrary to order","3","3","0","191.85","5.23","6.66","6.06","0","0","3","3","3","0","0"
"2006","Medicine Hat, Alberta, municipal","48062","Weapons possession contrary to order","2","1","0","-35.08","3.39","2.15","1.96","0","0","1","1","1","0","0"
"2007","Medicine Hat, Alberta, municipal","48062","Weapons possession contrary to order","2","3","0","-2.34","3.31","4.2","3.84","0","0","3","2","2","0","0"
"2008","Medicine Hat, Alberta, municipal","48062","Weapons possession contrary to order","1","0","0","-50.8","1.63","0","0","0","0","0","0","0","0","0"
"2009","Medicine Hat, Alberta, municipal","48062","Weapons possession contrary to order","2","2","0","97.87","3.23","2.04","1.87","0","0","2","1","1","0","0"
"2010","Medicine Hat, Alberta, municipal","48062","Weapons possession contrary to order","1","1","0","-50.01","1.61","4.07","3.74","0","0","1","2","2","0","0"
"2011","Medicine Hat, Alberta, municipal","48062","Weapons possession contrary to order","0","0","0","-100","0","0","0","0","0","0","0","0","0","0"
"2012","Medicine Hat, Alberta, municipal","48062","Weapons possession contrary to order","1","1","0","0","1.59","2.01","1.85","0","0","1","1","1","0","0"
"2013","Medicine Hat, Alberta, municipal","48062","Weapons possession contrary to order","2","2","0","97.54","3.15","3.97","3.65","0","0","2","2","2","0","0"
"2014","Medicine Hat, Alberta, municipal","48062","Weapons possession contrary to order","2","2","0","-0.86","3.12","3.93","3.62","0","0","2","2","2","0","0"
"2015","Medicine Hat, Alberta, municipal","48062","Weapons possession contrary to order","1","1","0","-50.38","1.55","3.9","3.6","0","0","1","2","2","0","0"
"2016","Medicine Hat, Alberta, municipal","48062","Weapons possession contrary to order","1","1","0","-0.61","1.54","3.89","3.58","0","0","1","2","2","0","0"
"1998","Medicine Hat, Alberta, municipal","48062","Possession of weapons","5","4","0","0","10.06","0","0","0","0","4","4","4","0","0"
"1999","Medicine Hat, Alberta, municipal","48062","Possession of weapons","23","19","2","351.32","45.41","0","0","0","0","21","11","21","10","2"
"2000","Medicine Hat, Alberta, municipal","48062","Possession of weapons","21","14","1","-10.74","40.53","0","0","0","0","15","8","16","8","1"
"2001","Medicine Hat, Alberta, municipal","48062","Possession of weapons","12","11","1","-43.68","22.83","0","0","0","0","12","11","12","1","0"
"2002","Medicine Hat, Alberta, municipal","48062","Possession of weapons","14","11","2","14.84","26.21","0","0","0","0","13","10","13","3","0"
"2003","Medicine Hat, Alberta, municipal","48062","Possession of weapons","15","13","0","5.59","27.68","0","0","0","0","13","15","17","2","0"
"2004","Medicine Hat, Alberta, municipal","48062","Possession of weapons","11","12","0","-28.84","19.7","34.35","31.18","0","0","12","15","15","0","0"
"2005","Medicine Hat, Alberta, municipal","48062","Possession of weapons","22","18","0","94.57","38.32","44.43","40.39","0","0","18","20","20","0","0"
"2006","Medicine Hat, Alberta, municipal","48062","Possession of weapons","26","25","1","15.09","44.11","56.02","62.86","133.45","0","26","26","32","6","0"
"2007","Medicine Hat, Alberta, municipal","48062","Possession of weapons","34","33","1","27.71","56.33","73.46","72.89","66.82","22.27","34","35","38","3","1"
"2008","Medicine Hat, Alberta, municipal","48062","Possession of weapons","38","35","2","9.98","61.95","94.85","103.88","202.25","0","37","46","55","9","0"
"2009","Medicine Hat, Alberta, municipal","48062","Possession of weapons","29","28","1","-24.5","46.78","52.94","65.43","205.57","0","29","26","35","9","0"
"2010","Medicine Hat, Alberta, municipal","48062","Possession of weapons","15","13","1","-48.28","24.19","26.48","33.67","114.63","0","14","13","18","5","0"
"2011","Medicine Hat, Alberta, municipal","48062","Possession of weapons","23","24","0","53.35","37.1","54.97","54.23","45.87","0","24","27","29","2","0"
"2012","Medicine Hat, Alberta, municipal","48062","Possession of weapons","26","25","0","11.69","41.43","62.32","62.82","68.51","0","25","31","34","3","0"
"2013","Medicine Hat, Alberta, municipal","48062","Possession of weapons","24","23","0","-8.83","37.78","45.63","49.3","91.68","0","23","23","27","4","0"
"2014","Medicine Hat, Alberta, municipal","48062","Possession of weapons","13","13","0","-46.3","20.29","27.5","27.16","23.09","0","13","14","15","1","0"
"2015","Medicine Hat, Alberta, municipal","48062","Possession of weapons","33","31","2","151.92","51.1","66.35","64.77","46.09","0","33","34","36","2","0"
"2016","Medicine Hat, Alberta, municipal","48062","Possession of weapons","43","41","1","29.51","66.18","89.38","82.4","0","0","42","46","46","0","0"
"1998","Medicine Hat, Alberta, municipal","48062","Unauthorized importing or exporting of weapons","0","0","0","0","0","0","0","0","0","0","0","0","0","0"
"1999","Medicine Hat, Alberta, municipal","48062","Unauthorized importing or exporting of weapons","0","0","0","0","0","0","0","0","0","0","0","0","0","0"
"2000","Medicine Hat, Alberta, municipal","48062","Unauthorized importing or exporting of weapons","0","0","0","0","0","0","0","0","0","0","0","0","0","0"
"2001","Medicine Hat, Alberta, municipal","48062","Unauthorized importing or exporting of weapons","0","0","0","0","0","0","0","0","0","0","0","0","0","0"
"2002","Medicine Hat, Alberta, municipal","48062","Unauthorized importing or exporting of weapons","0","0","0","0","0","0","0","0","0","0","0","0","0","0"
"2003","Medicine Hat, Alberta, municipal","48062","Unauthorized importing or exporting of weapons","0","0","0","0","0","0","0","0","0","0","0","0","0","0"
"2004","Medicine Hat, Alberta, municipal","48062","Unauthorized importing or exporting of weapons","0","0","0","0","0","0","0","0","0","0","0","0","0","0"
"2005","Medicine Hat, Alberta, municipal","48062","Unauthorized importing or exporting of weapons","0","0","0","0","0","0","0","0","0","0","0","0","0","0"
"2006","Medicine Hat, Alberta, municipal","48062","Unauthorized importing or exporting of weapons","0","0","0","0","0","0","0","0","0","0","0","0","0","0"
"2007","Medicine Hat, Alberta, municipal","48062","Unauthorized importing or exporting of weapons","0","0","0","0","0","0","0","0","0","0","0","0","0","0"
"2008","Medicine Hat, Alberta, municipal","48062","Unauthorized importing or exporting of weapons","0","0","0","0","0","0","0","0","0","0","0","0","0","0"
"2009","Medicine Hat, Alberta, municipal","48062","Unauthorized importing or exporting of weapons","0","0","0","0","0","0","0","0","0","0","0","0","0","0"
"2010","Medicine Hat, Alberta, municipal","48062","Unauthorized importing or exporting of weapons","0","0","0","0","0","0","0","0","0","0","0","0","0","0"
"2011","Medicine Hat, Alberta, municipal","48062","Unauthorized importing or exporting of weapons","0","0","0","0","0","0","0","0","0","0","0","0","0","0"
"2012","Medicine Hat, Alberta, municipal","48062","Unauthorized importing or exporting of weapons","0","0","0","0","0","0","0","0","0","0","0","0","0","0"
"2013","Medicine Hat, Alberta, municipal","48062","Unauthorized importing or exporting of weapons","0","0","0","0","0","0","0","0","0","0","0","0","0","0"
"2014","Medicine Hat, Alberta, municipal","48062","Unauthorized importing or exporting of weapons","0","0","0","0","0","0","0","0","0","0","0","0","0","0"
"2015","Medicine Hat, Alberta, municipal","48062","Unauthorized importing or exporting of weapons","0","0","0","0","0","0","0","0","0","0","0","0","0","0"
"2016","Medicine Hat, Alberta, municipal","48062","Unauthorized importing or exporting of weapons","0","0","0","0","0","0","0","0","0","0","0","0","0","0"
"1998","Medicine Hat, Alberta, municipal","48062","Firearms documentation or administration","0","0","0","0","0","0","0","0","0","0","0","0","0","0"
"1999","Medicine Hat, Alberta, municipal","48062","Firearms documentation or administration","0","0","0","0","0","0","0","0","0","0","0","0","0","0"
"2000","Medicine Hat, Alberta, municipal","48062","Firearms documentation or administration","0","0","0","0","0","0","0","0","0","0","0","0","0","0"
"2001","Medicine Hat, Alberta, municipal","48062","Firearms documentation or administration","1","0","0","0","1.9","0","0","0","0","0","0","0","0","0"
"2002","Medicine Hat, Alberta, municipal","48062","Firearms documentation or administration","0","0","0","-100","0","0","0","0","0","0","0","0","0","0"
"2003","Medicine Hat, Alberta, municipal","48062","Firearms documentation or administration","0","0","0","0","0","0","0","0","0","0","0","0","0","0"
"2004","Medicine Hat, Alberta, municipal","48062","Firearms documentation or administration","1","1","0","0","1.79","2.29","2.08","0","0","1","1","1","0","0"
"2005","Medicine Hat, Alberta, municipal","48062","Firearms documentation or administration","0","0","0","-100","0","0","0","0","0","0","0","0","0","0"
"2006","Medicine Hat, Alberta, municipal","48062","Firearms documentation or administration","1","0","0","0","1.7","0","0","0","0","0","0","0","0","0"
"2007","Medicine Hat, Alberta, municipal","48062","Firearms documentation or administration","1","0","0","-2.34","1.66","0","0","0","0","0","0","0","0","0"
"2008","Medicine Hat, Alberta, municipal","48062","Firearms documentation or administration","0","0","0","-100","0","0","0","0","0","0","0","0","0","0"
"2009","Medicine Hat, Alberta, municipal","48062","Firearms documentation or administration","0","0","0","0","0","0","0","0","0","0","0","0","0","0"
"2010","Medicine Hat, Alberta, municipal","48062","Firearms documentation or administration","0","0","0","0","0","0","0","0","0","0","0","0","0","0"
"2011","Medicine Hat, Alberta, municipal","48062","Firearms documentation or administration","0","0","0","0","0","0","0","0","0","0","0","0","0","0"
"2012","Medicine Hat, Alberta, municipal","48062","Firearms documentation or administration","0","0","0","0","0","0","0","0","0","0","0","0","0","0"
"2013","Medicine Hat, Alberta, municipal","48062","Firearms documentation or administration","0","0","0","0","0","0","0","0","0","0","0","0","0","0"
"2014","Medicine Hat, Alberta, municipal","48062","Firearms documentation or administration","0","0","0","0","0","0","0","0","0","0","0","0","0","0"
"2015","Medicine Hat, Alberta, municipal","48062","Firearms documentation or administration","0","0","0","0","0","0","0","0","0","0","0","0","0","0"
"2016","Medicine Hat, Alberta, municipal","48062","Firearms documentation or administration","0","0","0","0","0","0","0","0","0","0","0","0","0","0"
"1998","Medicine Hat, Alberta, municipal","48062","Unsafe storage of firearms","0","0","0","0","0","0","0","0","0","0","0","0","0","0"
"1999","Medicine Hat, Alberta, municipal","48062","Unsafe storage of firearms","2","1","1","0","3.95","0","0","0","0","2","1","1","0","0"
"2000","Medicine Hat, Alberta, municipal","48062","Unsafe storage of firearms","3","3","0","46.64","5.79","0","0","0","0","3","3","3","0","0"
"2001","Medicine Hat, Alberta, municipal","48062","Unsafe storage of firearms","1","1","0","-67.15","1.9","0","0","0","0","1","1","1","0","0"
"2002","Medicine Hat, Alberta, municipal","48062","Unsafe storage of firearms","2","1","0","96.87","3.74","0","0","0","0","1","1","1","0","0"
"2003","Medicine Hat, Alberta, municipal","48062","Unsafe storage of firearms","2","0","1","-1.44","3.69","0","0","0","0","1","0","0","0","0"
"2004","Medicine Hat, Alberta, municipal","48062","Unsafe storage of firearms","3","3","0","45.55","5.37","6.87","6.24","0","0","3","3","3","0","0"
"2005","Medicine Hat, Alberta, municipal","48062","Unsafe storage of firearms","2","2","0","-35.14","3.48","4.44","4.04","0","0","2","2","2","0","0"
"2006","Medicine Hat, Alberta, municipal","48062","Unsafe storage of firearms","2","0","0","-2.61","3.39","0","0","0","0","0","0","0","0","0"
"2007","Medicine Hat, Alberta, municipal","48062","Unsafe storage of firearms","3","4","0","46.5","4.97","10.49","9.59","0","0","4","5","5","0","0"
"2008","Medicine Hat, Alberta, municipal","48062","Unsafe storage of firearms","3","4","0","-1.6","4.89","8.25","7.55","0","0","4","4","4","0","0"
"2009","Medicine Hat, Alberta, municipal","48062","Unsafe storage of firearms","4","2","2","31.91","6.45","4.07","3.74","0","0","4","2","2","0","0"
"2010","Medicine Hat, Alberta, municipal","48062","Unsafe storage of firearms","3","3","0","-25.01","4.84","6.11","5.61","0","0","3","3","3","0","0"
"2011","Medicine Hat, Alberta, municipal","48062","Unsafe storage of firearms","5","4","0","66.69","8.06","8.14","7.48","0","0","4","4","4","0","0"
"2012","Medicine Hat, Alberta, municipal","48062","Unsafe storage of firearms","2","2","0","-60.48","3.19","4.02","3.7","0","0","2","2","2","0","0"
"2013","Medicine Hat, Alberta, municipal","48062","Unsafe storage of firearms","2","2","0","-1.23","3.15","3.97","3.65","0","0","2","2","2","0","0"
"2014","Medicine Hat, Alberta, municipal","48062","Unsafe storage of firearms","4","3","1","98.28","6.24","5.89","5.43","0","0","4","3","3","0","0"
"2015","Medicine Hat, Alberta, municipal","48062","Unsafe storage of firearms","4","3","1","-0.76","6.19","5.85","5.4","0","0","4","3","3","0","0"
"2016","Medicine Hat, Alberta, municipal","48062","Unsafe storage of firearms","3","3","0","-25.46","4.62","5.83","5.37","0","0","3","3","3","0","0"
"1998","Medicine Hat, Alberta, municipal","48062","Child pornography","0","0","0","0","0","0","0","0","0","0","0","0","0","0"
"1999","Medicine Hat, Alberta, municipal","48062","Child pornography","0","0","0","0","0","0","0","0","0","0","0","0","0","0"
"2000","Medicine Hat, Alberta, municipal","48062","Child pornography","0","0","0","0","0","0","0","0","0","0","0","0","0","0"
"2001","Medicine Hat, Alberta, municipal","48062","Child pornography","0","0","0","0","0","0","0","0","0","0","0","0","0","0"
"2002","Medicine Hat, Alberta, municipal","48062","Child pornography","0","0","0","0","0","0","0","0","0","0","0","0","0","0"
"2003","Medicine Hat, Alberta, municipal","48062","Child pornography","1","0","0","0","1.85","0","0","0","0","0","0","0","0","0"
"2004","Medicine Hat, Alberta, municipal","48062","Child pornography","1","1","0","-2.97","1.79","4.58","4.16","0","0","1","2","2","0","0"
"2005","Medicine Hat, Alberta, municipal","48062","Child pornography","1","0","0","-2.72","1.74","0","0","0","0","0","0","0","0","0"
"2006","Medicine Hat, Alberta, municipal","48062","Child pornography","3","3","0","192.16","5.09","6.46","5.89","0","0","3","3","3","0","0"
"2007","Medicine Hat, Alberta, municipal","48062","Child pornography","3","2","0","-2.34","4.97","4.2","3.84","0","0","2","2","2","0","0"
"2008","Medicine Hat, Alberta, municipal","48062","Child pornography","5","3","0","64.01","8.15","6.19","5.67","0","0","3","3","3","0","0"
"2009","Medicine Hat, Alberta, municipal","48062","Child pornography","6","3","0","18.72","9.68","4.07","5.61","22.84","0","3","2","3","1","0"
"2010","Medicine Hat, Alberta, municipal","48062","Child pornography","8","2","0","33.32","12.9","4.07","3.74","0","0","2","2","2","0","0"
"2011","Medicine Hat, Alberta, municipal","48062","Child pornography","5","1","0","-37.49","8.06","2.04","1.87","0","0","1","1","1","0","0"
"2012","Medicine Hat, Alberta, municipal","48062","Child pornography","1","1","0","-80.24","1.59","2.01","1.85","0","0","1","1","1","0","0"
"2013","Medicine Hat, Alberta, municipal","48062","Child pornography","0","0","0","-100","0","0","0","0","0","0","0","0","0","0"
"2014","Medicine Hat, Alberta, municipal","48062","Child pornography","5","2","1","0","7.8","3.93","3.62","0","0","3","2","2","0","0"
"2015","Medicine Hat, Alberta, municipal","48062","Child pornography","8","3","1","58.79","12.39","5.85","5.4","0","0","4","3","3","0","0"
"2016","Medicine Hat, Alberta, municipal","48062","Child pornography","2","3","3","-75.15","3.08","5.83","5.37","0","0","6","3","3","0","0"
"2012","Medicine Hat, Alberta, municipal","48062","Making, or distribution of child pornography","0","0","0","0","0","0","0","0","0","0","0","0","0","0"
"2013","Medicine Hat, Alberta, municipal","48062","Making, or distribution of child pornography","0","0","0","0","0","0","0","0","0","0","0","0","0","0"
"2014","Medicine Hat, Alberta, municipal","48062","Making, or distribution of child pornography","0","0","0","0","0","0","0","0","0","0","0","0","0","0"
"2015","Medicine Hat, Alberta, municipal","48062","Making, or distribution of child pornography","0","0","0","0","0","0","0","0","0","0","0","0","0","0"
"2016","Medicine Hat, Alberta, municipal","48062","Making, or distribution of child pornography","1","0","0","0","1.54","0","0","0","0","0","0","0","0","0"
"1998","Medicine Hat, Alberta, municipal","48062","Total prostitution","0","0","0","0","0","0","0","0","0","0","0","0","0","0"
"1999","Medicine Hat, Alberta, municipal","48062","Total prostitution","0","0","0","0","0","0","0","0","0","0","0","0","0","0"
"2000","Medicine Hat, Alberta, municipal","48062","Total prostitution","0","0","0","0","0","0","0","0","0","0","0","0","0","0"
"2001","Medicine Hat, Alberta, municipal","48062","Total prostitution","0","0","0","0","0","0","0","0","0","0","0","0","0","0"
"2002","Medicine Hat, Alberta, municipal","48062","Total prostitution","1","1","0","0","1.87","0","0","0","0","1","1","1","0","0"
"2003","Medicine Hat, Alberta, municipal","48062","Total prostitution","0","0","0","-100","0","0","0","0","0","0","0","0","0","0"
"2004","Medicine Hat, Alberta, municipal","48062","Total prostitution","0","0","0","0","0","0","0","0","0","0","0","0","0","0"
"2005","Medicine Hat, Alberta, municipal","48062","Total prostitution","2","2","0","0","3.48","8.89","8.08","0","0","2","4","4","0","0"
"2006","Medicine Hat, Alberta, municipal","48062","Total prostitution","0","0","0","-100","0","0","0","0","0","0","0","0","0","0"
"2007","Medicine Hat, Alberta, municipal","48062","Total prostitution","0","0","0","0","0","0","0","0","0","0","0","0","0","0"
"2008","Medicine Hat, Alberta, municipal","48062","Total prostitution","0","0","0","0","0","0","0","0","0","0","0","0","0","0"
"2009","Medicine Hat, Alberta, municipal","48062","Total prostitution","0","0","0","0","0","0","0","0","0","0","0","0","0","0"
"2010","Medicine Hat, Alberta, municipal","48062","Total prostitution","0","0","0","0","0","0","0","0","0","0","0","0","0","0"
"2011","Medicine Hat, Alberta, municipal","48062","Total prostitution","1","1","0","0","1.61","2.04","1.87","0","0","1","1","1","0","0"
"2012","Medicine Hat, Alberta, municipal","48062","Total prostitution","2","1","0","97.6","3.19","4.02","3.7","0","0","1","2","2","0","0"
"2013","Medicine Hat, Alberta, municipal","48062","Total prostitution","1","1","0","-50.62","1.57","3.97","3.65","0","0","1","2","2","0","0"
"2014","Medicine Hat, Alberta, municipal","48062","Total prostitution","0","0","0","-100","0","0","0","0","0","0","0","0","0","0"
"2015","Medicine Hat, Alberta, municipal","48062","Total prostitution","0","0","0","0","0","0","0","0","0","0","0","0","0","0"
"2016","Medicine Hat, Alberta, municipal","48062","Total prostitution","0","0","0","0","0","0","0","0","0","0","0","0","0","0"
"1998","Medicine Hat, Alberta, municipal","48062","Bawdy house","0","0","0","0","0","0","0","0","0","0","0","0","0","0"
"1999","Medicine Hat, Alberta, municipal","48062","Bawdy house","0","0","0","0","0","0","0","0","0","0","0","0","0","0"
"2000","Medicine Hat, Alberta, municipal","48062","Bawdy house","0","0","0","0","0","0","0","0","0","0","0","0","0","0"
"2001","Medicine Hat, Alberta, municipal","48062","Bawdy house","0","0","0","0","0","0","0","0","0","0","0","0","0","0"
"2002","Medicine Hat, Alberta, municipal","48062","Bawdy house","0","0","0","0","0","0","0","0","0","0","0","0","0","0"
"2003","Medicine Hat, Alberta, municipal","48062","Bawdy house","0","0","0","0","0","0","0","0","0","0","0","0","0","0"
"2004","Medicine Hat, Alberta, municipal","48062","Bawdy house","0","0","0","0","0","0","0","0","0","0","0","0","0","0"
"2005","Medicine Hat, Alberta, municipal","48062","Bawdy house","0","0","0","0","0","0","0","0","0","0","0","0","0","0"
"2006","Medicine Hat, Alberta, municipal","48062","Bawdy house","0","0","0","0","0","0","0","0","0","0","0","0","0","0"
"2007","Medicine Hat, Alberta, municipal","48062","Bawdy house","0","0","0","0","0","0","0","0","0","0","0","0","0","0"
"2008","Medicine Hat, Alberta, municipal","48062","Bawdy house","0","0","0","0","0","0","0","0","0","0","0","0","0","0"
"2009","Medicine Hat, Alberta, municipal","48062","Bawdy house","0","0","0","0","0","0","0","0","0","0","0","0","0","0"
"2010","Medicine Hat, Alberta, municipal","48062","Bawdy house","0","0","0","0","0","0","0","0","0","0","0","0","0","0"
"2011","Medicine Hat, Alberta, municipal","48062","Bawdy house","0","0","0","0","0","0","0","0","0","0","0","0","0","0"
"2012","Medicine Hat, Alberta, municipal","48062","Bawdy house","0","0","0","0","0","0","0","0","0","0","0","0","0","0"
"2013","Medicine Hat, Alberta, municipal","48062","Bawdy house","1","1","0","0","1.57","3.97","3.65","0","0","1","2","2","0","0"
"2014","Medicine Hat, Alberta, municipal","48062","Bawdy house","0","0","0","-100","0","0","0","0","0","0","0","0","0","0"
"2015","Medicine Hat, Alberta, municipal","48062","Bawdy house","0","0","0","0","0","0","0","0","0","0","0","0","0","0"
"2016","Medicine Hat, Alberta, municipal","48062","Bawdy house","0","0","0","0","0","0","0","0","0","0","0","0","0","0"
"1998","Medicine Hat, Alberta, municipal","48062","Living off the avails of prostitution of a person under age 18","0","0","0","0","0","0","0","0","0","0","0","0","0","0"
"1999","Medicine Hat, Alberta, municipal","48062","Living off the avails of prostitution of a person under age 18","0","0","0","0","0","0","0","0","0","0","0","0","0","0"
"2000","Medicine Hat, Alberta, municipal","48062","Living off the avails of prostitution of a person under age 18","0","0","0","0","0","0","0","0","0","0","0","0","0","0"
"2001","Medicine Hat, Alberta, municipal","48062","Living off the avails of prostitution of a person under age 18","0","0","0","0","0","0","0","0","0","0","0","0","0","0"
"2002","Medicine Hat, Alberta, municipal","48062","Living off the avails of prostitution of a person under age 18","0","0","0","0","0","0","0","0","0","0","0","0","0","0"
"2003","Medicine Hat, Alberta, municipal","48062","Living off the avails of prostitution of a person under age 18","0","0","0","0","0","0","0","0","0","0","0","0","0","0"
"2004","Medicine Hat, Alberta, municipal","48062","Living off the avails of prostitution of a person under age 18","0","0","0","0","0","0","0","0","0","0","0","0","0","0"
"2005","Medicine Hat, Alberta, municipal","48062","Living off the avails of prostitution of a person under age 18","0","0","0","0","0","0","0","0","0","0","0","0","0","0"
"2006","Medicine Hat, Alberta, municipal","48062","Living off the avails of prostitution of a person under age 18","0","0","0","0","0","0","0","0","0","0","0","0","0","0"
"2007","Medicine Hat, Alberta, municipal","48062","Living off the avails of prostitution of a person under age 18","0","0","0","0","0","0","0","0","0","0","0","0","0","0"
"2008","Medicine Hat, Alberta, municipal","48062","Living off the avails of prostitution of a person under age 18","0","0","0","0","0","0","0","0","0","0","0","0","0","0"
"2009","Medicine Hat, Alberta, municipal","48062","Living off the avails of prostitution of a person under age 18","0","0","0","0","0","0","0","0","0","0","0","0","0","0"
"2010","Medicine Hat, Alberta, municipal","48062","Living off the avails of prostitution of a person under age 18","0","0","0","0","0","0","0","0","0","0","0","0","0","0"
"2011","Medicine Hat, Alberta, municipal","48062","Living off the avails of prostitution of a person under age 18","0","0","0","0","0","0","0","0","0","0","0","0","0","0"
"2012","Medicine Hat, Alberta, municipal","48062","Living off the avails of prostitution of a person under age 18","0","0","0","0","0","0","0","0","0","0","0","0","0","0"
"2013","Medicine Hat, Alberta, municipal","48062","Living off the avails of prostitution of a person under age 18","0","0","0","0","0","0","0","0","0","0","0","0","0","0"
"2014","Medicine Hat, Alberta, municipal","48062","Living off the avails of prostitution of a person under age 18","0","0","0","0","0","0","0","0","0","0","0","0","0","0"
"2015","Medicine Hat, Alberta, municipal","48062","Living off the avails of prostitution of a person under age 18","0","0","0","0","0","0","0","0","0","0","0","0","0","0"
"2016","Medicine Hat, Alberta, municipal","48062","Living off the avails of prostitution of a person under age 18","0","0","0","0","0","0","0","0","0","0","0","0","0","0"
"1998","Medicine Hat, Alberta, municipal","48062","Procuring","0","0","0","0","0","0","0","0","0","0","0","0","0","0"
"1999","Medicine Hat, Alberta, municipal","48062","Procuring","0","0","0","0","0","0","0","0","0","0","0","0","0","0"
"2000","Medicine Hat, Alberta, municipal","48062","Procuring","0","0","0","0","0","0","0","0","0","0","0","0","0","0"
"2001","Medicine Hat, Alberta, municipal","48062","Procuring","0","0","0","0","0","0","0","0","0","0","0","0","0","0"
"2002","Medicine Hat, Alberta, municipal","48062","Procuring","0","0","0","0","0","0","0","0","0","0","0","0","0","0"
"2003","Medicine Hat, Alberta, municipal","48062","Procuring","0","0","0","0","0","0","0","0","0","0","0","0","0","0"
"2004","Medicine Hat, Alberta, municipal","48062","Procuring","0","0","0","0","0","0","0","0","0","0","0","0","0","0"
"2005","Medicine Hat, Alberta, municipal","48062","Procuring","0","0","0","0","0","0","0","0","0","0","0","0","0","0"
"2006","Medicine Hat, Alberta, municipal","48062","Procuring","0","0","0","0","0","0","0","0","0","0","0","0","0","0"
"2007","Medicine Hat, Alberta, municipal","48062","Procuring","0","0","0","0","0","0","0","0","0","0","0","0","0","0"
"2008","Medicine Hat, Alberta, municipal","48062","Procuring","0","0","0","0","0","0","0","0","0","0","0","0","0","0"
"2009","Medicine Hat, Alberta, municipal","48062","Procuring","0","0","0","0","0","0","0","0","0","0","0","0","0","0"
"2010","Medicine Hat, Alberta, municipal","48062","Procuring","0","0","0","0","0","0","0","0","0","0","0","0","0","0"
"2011","Medicine Hat, Alberta, municipal","48062","Procuring","0","0","0","0","0","0","0","0","0","0","0","0","0","0"
"1998","Medicine Hat, Alberta, municipal","48062","Obtains or communicates with a person under age 18 for purpose of sex","0","0","0","0","0","0","0","0","0","0","0","0","0","0"
"1999","Medicine Hat, Alberta, municipal","48062","Obtains or communicates with a person under age 18 for purpose of sex","0","0","0","0","0","0","0","0","0","0","0","0","0","0"
"2000","Medicine Hat, Alberta, municipal","48062","Obtains or communicates with a person under age 18 for purpose of sex","0","0","0","0","0","0","0","0","0","0","0","0","0","0"
"2001","Medicine Hat, Alberta, municipal","48062","Obtains or communicates with a person under age 18 for purpose of sex","0","0","0","0","0","0","0","0","0","0","0","0","0","0"
"2002","Medicine Hat, Alberta, municipal","48062","Obtains or communicates with a person under age 18 for purpose of sex","0","0","0","0","0","0","0","0","0","0","0","0","0","0"
"2003","Medicine Hat, Alberta, municipal","48062","Obtains or communicates with a person under age 18 for purpose of sex","0","0","0","0","0","0","0","0","0","0","0","0","0","0"
"2004","Medicine Hat, Alberta, municipal","48062","Obtains or communicates with a person under age 18 for purpose of sex","0","0","0","0","0","0","0","0","0","0","0","0","0","0"
"2005","Medicine Hat, Alberta, municipal","48062","Obtains or communicates with a person under age 18 for purpose of sex","0","0","0","0","0","0","0","0","0","0","0","0","0","0"
"2006","Medicine Hat, Alberta, municipal","48062","Obtains or communicates with a person under age 18 for purpose of sex","0","0","0","0","0","0","0","0","0","0","0","0","0","0"
"2007","Medicine Hat, Alberta, municipal","48062","Obtains or communicates with a person under age 18 for purpose of sex","0","0","0","0","0","0","0","0","0","0","0","0","0","0"
"2008","Medicine Hat, Alberta, municipal","48062","Obtains or communicates with a person under age 18 for purpose of sex","0","0","0","0","0","0","0","0","0","0","0","0","0","0"
"2009","Medicine Hat, Alberta, municipal","48062","Obtains or communicates with a person under age 18 for purpose of sex","0","0","0","0","0","0","0","0","0","0","0","0","0","0"
"2010","Medicine Hat, Alberta, municipal","48062","Obtains or communicates with a person under age 18 for purpose of sex","0","0","0","0","0","0","0","0","0","0","0","0","0","0"
"2011","Medicine Hat, Alberta, municipal","48062","Obtains or communicates with a person under age 18 for purpose of sex","0","0","0","0","0","0","0","0","0","0","0","0","0","0"
"2012","Medicine Hat, Alberta, municipal","48062","Obtains or communicates with a person under age 18 for purpose of sex","0","0","0","0","0","0","0","0","0","0","0","0","0","0"
"2013","Medicine Hat, Alberta, municipal","48062","Obtains or communicates with a person under age 18 for purpose of sex","0","0","0","0","0","0","0","0","0","0","0","0","0","0"
"2014","Medicine Hat, Alberta, municipal","48062","Obtains or communicates with a person under age 18 for purpose of sex","0","0","0","0","0","0","0","0","0","0","0","0","0","0"
"2015","Medicine Hat, Alberta, municipal","48062","Obtains or communicates with a person under age 18 for purpose of sex","0","0","0","0","0","0","0","0","0","0","0","0","0","0"
"2016","Medicine Hat, Alberta, municipal","48062","Obtains or communicates with a person under age 18 for purpose of sex","0","0","0","0","0","0","0","0","0","0","0","0","0","0"
"1998","Medicine Hat, Alberta, municipal","48062","Other prostitution","0","0","0","0","0","0","0","0","0","0","0","0","0","0"
"1999","Medicine Hat, Alberta, municipal","48062","Other prostitution","0","0","0","0","0","0","0","0","0","0","0","0","0","0"
"2000","Medicine Hat, Alberta, municipal","48062","Other prostitution","0","0","0","0","0","0","0","0","0","0","0","0","0","0"
"2001","Medicine Hat, Alberta, municipal","48062","Other prostitution","0","0","0","0","0","0","0","0","0","0","0","0","0","0"
"2002","Medicine Hat, Alberta, municipal","48062","Other prostitution","1","1","0","0","1.87","0","0","0","0","1","1","1","0","0"
"2003","Medicine Hat, Alberta, municipal","48062","Other prostitution","0","0","0","-100","0","0","0","0","0","0","0","0","0","0"
"2004","Medicine Hat, Alberta, municipal","48062","Other prostitution","0","0","0","0","0","0","0","0","0","0","0","0","0","0"
"2005","Medicine Hat, Alberta, municipal","48062","Other prostitution","2","2","0","0","3.48","8.89","8.08","0","0","2","4","4","0","0"
"2006","Medicine Hat, Alberta, municipal","48062","Other prostitution","0","0","0","-100","0","0","0","0","0","0","0","0","0","0"
"2007","Medicine Hat, Alberta, municipal","48062","Other prostitution","0","0","0","0","0","0","0","0","0","0","0","0","0","0"
"2008","Medicine Hat, Alberta, municipal","48062","Other prostitution","0","0","0","0","0","0","0","0","0","0","0","0","0","0"
"2009","Medicine Hat, Alberta, municipal","48062","Other prostitution","0","0","0","0","0","0","0","0","0","0","0","0","0","0"
"2010","Medicine Hat, Alberta, municipal","48062","Other prostitution","0","0","0","0","0","0","0","0","0","0","0","0","0","0"
"2011","Medicine Hat, Alberta, municipal","48062","Other prostitution","1","1","0","0","1.61","2.04","1.87","0","0","1","1","1","0","0"
"2012","Medicine Hat, Alberta, municipal","48062","Other prostitution","1","0","0","-1.2","1.59","0","0","0","0","0","0","0","0","0"
"2013","Medicine Hat, Alberta, municipal","48062","Other prostitution","0","0","0","-100","0","0","0","0","0","0","0","0","0","0"
"2014","Medicine Hat, Alberta, municipal","48062","Other prostitution","0","0","0","0","0","0","0","0","0","0","0","0","0","0"
"2015","Medicine Hat, Alberta, municipal","48062","Other prostitution","0","0","0","0","0","0","0","0","0","0","0","0","0","0"
"2016","Medicine Hat, Alberta, municipal","48062","Other prostitution","0","0","0","0","0","0","0","0","0","0","0","0","0","0"
"2012","Medicine Hat, Alberta, municipal","48062","Communicating to provide sexual services for consideration","0","0","0","0","0","0","0","0","0","0","0","0","0","0"
"2013","Medicine Hat, Alberta, municipal","48062","Communicating to provide sexual services for consideration","0","0","0","0","0","0","0","0","0","0","0","0","0","0"
"2014","Medicine Hat, Alberta, municipal","48062","Communicating to provide sexual services for consideration","0","0","0","0","0","0","0","0","0","0","0","0","0","0"
"2015","Medicine Hat, Alberta, municipal","48062","Communicating to provide sexual services for consideration","0","0","0","0","0","0","0","0","0","0","0","0","0","0"
"2016","Medicine Hat, Alberta, municipal","48062","Communicating to provide sexual services for consideration","0","0","0","0","0","0","0","0","0","0","0","0","0","0"
"2012","Medicine Hat, Alberta, municipal","48062","Stopping or impeding traffic for the purpose of offering, providing or obtaining sexual services for consideration","0","0","0","0","0","0","0","0","0","0","0","0","0","0"
"2013","Medicine Hat, Alberta, municipal","48062","Stopping or impeding traffic for the purpose of offering, providing or obtaining sexual services for consideration","0","0","0","0","0","0","0","0","0","0","0","0","0","0"
"2014","Medicine Hat, Alberta, municipal","48062","Stopping or impeding traffic for the purpose of offering, providing or obtaining sexual services for consideration","0","0","0","0","0","0","0","0","0","0","0","0","0","0"
"2015","Medicine Hat, Alberta, municipal","48062","Stopping or impeding traffic for the purpose of offering, providing or obtaining sexual services for consideration","0","0","0","0","0","0","0","0","0","0","0","0","0","0"
"2016","Medicine Hat, Alberta, municipal","48062","Stopping or impeding traffic for the purpose of offering, providing or obtaining sexual services for consideration","0","0","0","0","0","0","0","0","0","0","0","0","0","0"
"1998","Medicine Hat, Alberta, municipal","48062","Disturb the peace","7","5","3","0","14.09","0","0","0","0","8","8","12","4","3"
"1999","Medicine Hat, Alberta, municipal","48062","Disturb the peace","18","13","1","152.29","35.54","0","0","0","0","14","14","18","4","1"
"2000","Medicine Hat, Alberta, municipal","48062","Disturb the peace","22","12","1","19.48","42.46","0","0","0","0","13","17","21","4","0"
"2001","Medicine Hat, Alberta, municipal","48062","Disturb the peace","38","15","23","70.24","72.28","0","0","0","0","38","17","19","2","1"
"2002","Medicine Hat, Alberta, municipal","48062","Disturb the peace","11","6","1","-71.51","20.6","0","0","0","0","7","6","6","0","0"
"2003","Medicine Hat, Alberta, municipal","48062","Disturb the peace","25","21","1","123.99","46.13","0","0","0","0","22","27","28","1","1"
"2004","Medicine Hat, Alberta, municipal","48062","Disturb the peace","26","23","1","0.91","46.56","54.96","49.88","0","0","24","24","24","0","0"
"2005","Medicine Hat, Alberta, municipal","48062","Disturb the peace","12","9","2","-55.1","20.9","17.77","18.17","22.2","0","11","8","9","1","0"
"2006","Medicine Hat, Alberta, municipal","48062","Disturb the peace","11","6","2","-10.73","18.66","12.93","11.79","0","0","8","6","6","0","0"
"2007","Medicine Hat, Alberta, municipal","48062","Disturb the peace","31","26","3","175.23","51.36","52.47","53.71","66.82","22.27","29","25","28","3","1"
"2008","Medicine Hat, Alberta, municipal","48062","Disturb the peace","13","12","0","-58.73","21.19","30.93","34","67.42","0","12","15","18","3","0"
"2009","Medicine Hat, Alberta, municipal","48062","Disturb the peace","35","32","0","166.36","56.45","77.37","78.51","91.37","0","32","38","42","4","0"
"2010","Medicine Hat, Alberta, municipal","48062","Disturb the peace","29","22","5","-17.15","46.77","46.85","52.38","114.63","0","27","23","28","5","0"
"2011","Medicine Hat, Alberta, municipal","48062","Disturb the peace","10","7","0","-65.51","16.13","16.29","14.96","0","0","7","8","8","0","0"
"2012","Medicine Hat, Alberta, municipal","48062","Disturb the peace","18","9","0","77.84","28.69","18.09","16.63","0","0","9","9","9","0","0"
"2013","Medicine Hat, Alberta, municipal","48062","Disturb the peace","14","8","2","-23.18","22.04","19.84","18.26","0","0","10","10","10","0","0"
"2014","Medicine Hat, Alberta, municipal","48062","Disturb the peace","19","1","1","34.55","29.65","0","1.81","23.09","0","2","0","1","1","0"
"2015","Medicine Hat, Alberta, municipal","48062","Disturb the peace","20","7","3","4.46","30.97","13.66","12.59","0","0","10","7","7","0","0"
"2016","Medicine Hat, Alberta, municipal","48062","Disturb the peace","10","7","0","-50.31","15.39","9.72","8.96","0","0","7","5","5","0","0"
"1998","Medicine Hat, Alberta, municipal","48062","Total administration of justice violations","297","285","4","0","597.61","0","0","0","0","289","228","305","77","2"
"1999","Medicine Hat, Alberta, municipal","48062","Total administration of justice violations","515","495","5","70.13","1016.7","0","0","0","0","500","373","516","143","1"
"2000","Medicine Hat, Alberta, municipal","48062","Total administration of justice violations","431","418","5","-18.19","831.81","0","0","0","0","423","338","433","95","5"
"2001","Medicine Hat, Alberta, municipal","48062","Total administration of justice violations","465","442","12","6.34","884.5","0","0","0","0","454","360","452","92","1"
"2002","Medicine Hat, Alberta, municipal","48062","Total administration of justice violations","547","533","8","15.8","1024.21","0","0","0","0","541","441","541","100","3"
"2003","Medicine Hat, Alberta, municipal","48062","Total administration of justice violations","650","614","6","17.11","1199.48","0","0","0","0","620","484","599","115","1"
"2004","Medicine Hat, Alberta, municipal","48062","Total administration of justice violations","680","656","5","1.51","1217.61","1367.04","1378.06","1486.49","45.05","661","597","663","66","2"
"2005","Medicine Hat, Alberta, municipal","48062","Total administration of justice violations","816","792","6","16.74","1421.45","1570.45","1595.22","1842.81","44.4","798","707","790","83","2"
"2006","Medicine Hat, Alberta, municipal","48062","Total administration of justice violations","697","665","14","-16.82","1182.42","1282.05","1314.19","1645.91","66.73","679","595","669","74","3"
"2007","Medicine Hat, Alberta, municipal","48062","Total administration of justice violations","860","838","12","20.5","1424.86","1706.48","1686.1","1469.93","89.09","850","813","879","66","4"
"2008","Medicine Hat, Alberta, municipal","48062","Total administration of justice violations","1008","982","8","15.34","1643.41","1915.54","1962.3","2471.91","89.89","990","929","1039","110","4"
"2009","Medicine Hat, Alberta, municipal","48062","Total administration of justice violations","1034","1000","17","1.49","1667.82","1932.2","1970.35","2398.36","91.37","1017","949","1054","105","4"
"2010","Medicine Hat, Alberta, municipal","48062","Total administration of justice violations","1057","1034","8","2.21","1704.7","2022.61","2050.25","2361.3","22.93","1042","993","1096","103","1"
"2011","Medicine Hat, Alberta, municipal","48062","Total administration of justice violations","1142","1091","15","8.06","1842.02","1970.88","2070.13","3188.07","68.81","1106","968","1107","139","3"
"2012","Medicine Hat, Alberta, municipal","48062","Total administration of justice violations","1129","1102","11","-2.32","1799.23","2000.16","2061.89","2763.19","22.84","1113","995","1116","121","1"
"2013","Medicine Hat, Alberta, municipal","48062","Total administration of justice violations","1147","1123","15","0.34","1805.42","2095.24","2072.57","1810.68","45.84","1138","1056","1135","79","2"
"2014","Medicine Hat, Alberta, municipal","48062","Total administration of justice violations","1016","940","44","-12.18","1585.44","1738.43","1694.49","1177.83","207.85","984","885","936","51","9"
"2015","Medicine Hat, Alberta, municipal","48062","Total administration of justice violations","1049","988","35","2.46","1624.52","1828.44","1763.07","991.01","46.09","1023","937","980","43","2"
"2016","Medicine Hat, Alberta, municipal","48062","Total administration of justice violations","1323","1247","46","25.35","2036.32","2250.03","2176.37","1307.04","137.58","1293","1158","1215","57","6"
"1998","Medicine Hat, Alberta, municipal","48062","Fail to comply with order","190","181","3","0","382.31","0","0","0","0","184","141","189","48","1"
"1999","Medicine Hat, Alberta, municipal","48062","Fail to comply with order","345","328","5","78.15","681.09","0","0","0","0","333","243","341","98","1"
"2000","Medicine Hat, Alberta, municipal","48062","Fail to comply with order","294","280","5","-16.69","567.4","0","0","0","0","285","224","290","66","5"
"2001","Medicine Hat, Alberta, municipal","48062","Fail to comply with order","157","145","7","-47.37","298.64","0","0","0","0","152","135","158","23","1"
"2002","Medicine Hat, Alberta, municipal","48062","Fail to comply with order","280","270","5","75.56","524.28","0","0","0","0","275","235","282","47","1"
"2003","Medicine Hat, Alberta, municipal","48062","Fail to comply with order","330","305","3","16.15","608.97","0","0","0","0","308","243","306","63","0"
"2004","Medicine Hat, Alberta, municipal","48062","Fail to comply with order","257","242","3","-24.43","460.19","540.4","554.97","698.2","22.52","245","236","267","31","1"
"2005","Medicine Hat, Alberta, municipal","48062","Fail to comply with order","335","317","6","26.81","583.56","661.94","680.49","865.9","22.2","323","298","337","39","1"
"2006","Medicine Hat, Alberta, municipal","48062","Fail to comply with order","324","297","10","-5.81","549.65","579.62","607","889.68","44.48","307","269","309","40","2"
"2007","Medicine Hat, Alberta, municipal","48062","Fail to comply with order","394","380","9","18.76","652.78","818.61","834.42","1002.23","44.54","389","390","435","45","2"
"2008","Medicine Hat, Alberta, municipal","48062","Fail to comply with order","423","406","7","5.65","689.64","849.52","895.22","1393.26","67.42","413","412","474","62","3"
"2009","Medicine Hat, Alberta, municipal","48062","Fail to comply with order","530","509","15","23.96","854.88","1072.99","1084.25","1210.6","68.52","524","527","580","53","3"
"2010","Medicine Hat, Alberta, municipal","48062","Fail to comply with order","569","554","6","7.34","917.67","1158.98","1171.03","1306.74","22.93","560","569","626","57","1"
"2011","Medicine Hat, Alberta, municipal","48062","Fail to comply with order","588","550","10","3.35","948.43","1034.31","1097.71","1811.93","0","560","508","587","79","0"
"2012","Medicine Hat, Alberta, municipal","48062","Fail to comply with order","614","592","10","3.17","978.5","1077.47","1143.65","1895.41","22.84","602","536","619","83","1"
"2013","Medicine Hat, Alberta, municipal","48062","Fail to comply with order","637","616","12","2.47","1002.66","1178.57","1170.5","1077.24","22.92","628","594","641","47","1"
"2014","Medicine Hat, Alberta, municipal","48062","Fail to comply with order","476","412","34","-25.92","742.79","783.77","771.21","623.56","138.57","446","399","426","27","6"
"2015","Medicine Hat, Alberta, municipal","48062","Fail to comply with order","513","463","30","6.96","794.45","899.58","858.15","368.75","23.05","493","461","477","16","1"
"2016","Medicine Hat, Alberta, municipal","48062","Fail to comply with order","603","536","39","16.83","928.12","998.72","972.65","664.99","91.72","575","514","543","29","4"
"1998","Medicine Hat, Alberta, municipal","48062","Escape or helps to escape from lawful custody","1","1","0","0","2.01","0","0","0","0","1","1","1","0","0"
"1999","Medicine Hat, Alberta, municipal","48062","Escape or helps to escape from lawful custody","2","1","0","96.23","3.95","0","0","0","0","1","0","1","1","0"
"2000","Medicine Hat, Alberta, municipal","48062","Escape or helps to escape from lawful custody","0","1","0","-100","0","0","0","0","0","1","1","1","0","0"
"2001","Medicine Hat, Alberta, municipal","48062","Escape or helps to escape from lawful custody","1","1","0","0","1.9","0","0","0","0","1","0","1","1","0"
"2002","Medicine Hat, Alberta, municipal","48062","Escape or helps to escape from lawful custody","1","1","0","-1.56","1.87","0","0","0","0","1","1","1","0","0"
"2003","Medicine Hat, Alberta, municipal","48062","Escape or helps to escape from lawful custody","2","2","0","97.11","3.69","0","0","0","0","2","3","3","0","0"
"2004","Medicine Hat, Alberta, municipal","48062","Escape or helps to escape from lawful custody","0","0","0","-100","0","0","0","0","0","0","0","0","0","0"
"2005","Medicine Hat, Alberta, municipal","48062","Escape or helps to escape from lawful custody","2","2","0","0","3.48","4.44","4.04","0","0","2","2","2","0","0"
"2006","Medicine Hat, Alberta, municipal","48062","Escape or helps to escape from lawful custody","1","1","0","-51.31","1.7","0","0","0","0","1","0","0","0","0"
"2007","Medicine Hat, Alberta, municipal","48062","Escape or helps to escape from lawful custody","2","2","0","95.33","3.31","4.2","3.84","0","0","2","2","2","0","0"
"2008","Medicine Hat, Alberta, municipal","48062","Escape or helps to escape from lawful custody","1","1","0","-50.8","1.63","2.06","1.89","0","0","1","1","1","0","0"
"2009","Medicine Hat, Alberta, municipal","48062","Escape or helps to escape from lawful custody","3","3","0","196.8","4.84","4.07","5.61","22.84","0","3","2","3","1","0"
"2010","Medicine Hat, Alberta, municipal","48062","Escape or helps to escape from lawful custody","0","0","0","-100","0","0","0","0","0","0","0","0","0","0"
"2011","Medicine Hat, Alberta, municipal","48062","Escape or helps to escape from lawful custody","3","3","0","0","4.84","8.14","7.48","0","0","3","4","4","0","0"
"2012","Medicine Hat, Alberta, municipal","48062","Escape or helps to escape from lawful custody","0","0","0","-100","0","0","0","0","0","0","0","0","0","0"
"2013","Medicine Hat, Alberta, municipal","48062","Escape or helps to escape from lawful custody","0","0","0","0","0","0","0","0","0","0","0","0","0","0"
"2014","Medicine Hat, Alberta, municipal","48062","Escape or helps to escape from lawful custody","0","0","0","0","0","0","0","0","0","0","0","0","0","0"
"2015","Medicine Hat, Alberta, municipal","48062","Escape or helps to escape from lawful custody","2","2","0","0","3.1","1.95","1.8","0","0","2","1","1","0","0"
"2016","Medicine Hat, Alberta, municipal","48062","Escape or helps to escape from lawful custody","1","1","0","-50.31","1.54","1.94","1.79","0","0","1","1","1","0","0"
"1998","Medicine Hat, Alberta, municipal","48062","Prisoner unlawfully at large","0","0","0","0","0","0","0","0","0","0","0","0","0","0"
"1999","Medicine Hat, Alberta, municipal","48062","Prisoner unlawfully at large","1","1","0","0","1.97","0","0","0","0","1","0","1","1","0"
"2000","Medicine Hat, Alberta, municipal","48062","Prisoner unlawfully at large","0","0","0","-100","0","0","0","0","0","0","0","0","0","0"
"2001","Medicine Hat, Alberta, municipal","48062","Prisoner unlawfully at large","1","1","0","0","1.9","0","0","0","0","1","1","1","0","0"
"2002","Medicine Hat, Alberta, municipal","48062","Prisoner unlawfully at large","7","7","0","589.06","13.11","0","0","0","0","7","6","6","0","0"
"2003","Medicine Hat, Alberta, municipal","48062","Prisoner unlawfully at large","3","1","0","-57.76","5.54","0","0","0","0","1","1","1","0","0"
"2004","Medicine Hat, Alberta, municipal","48062","Prisoner unlawfully at large","0","0","0","-100","0","0","0","0","0","0","0","0","0","0"
"2005","Medicine Hat, Alberta, municipal","48062","Prisoner unlawfully at large","0","0","0","0","0","0","0","0","0","0","0","0","0","0"
"2006","Medicine Hat, Alberta, municipal","48062","Prisoner unlawfully at large","0","0","0","0","0","0","0","0","0","0","0","0","0","0"
"2007","Medicine Hat, Alberta, municipal","48062","Prisoner unlawfully at large","0","0","0","0","0","0","0","0","0","0","0","0","0","0"
"2008","Medicine Hat, Alberta, municipal","48062","Prisoner unlawfully at large","0","0","0","0","0","0","0","0","0","0","0","0","0","0"
"2009","Medicine Hat, Alberta, municipal","48062","Prisoner unlawfully at large","0","0","0","0","0","0","0","0","0","0","0","0","0","0"
"2010","Medicine Hat, Alberta, municipal","48062","Prisoner unlawfully at large","0","0","0","0","0","0","0","0","0","0","0","0","0","0"
"2011","Medicine Hat, Alberta, municipal","48062","Prisoner unlawfully at large","0","0","0","0","0","0","0","0","0","0","0","0","0","0"
"2012","Medicine Hat, Alberta, municipal","48062","Prisoner unlawfully at large","0","0","0","0","0","0","0","0","0","0","0","0","0","0"
"2013","Medicine Hat, Alberta, municipal","48062","Prisoner unlawfully at large","0","0","0","0","0","0","0","0","0","0","0","0","0","0"
"2014","Medicine Hat, Alberta, municipal","48062","Prisoner unlawfully at large","0","0","0","0","0","0","0","0","0","0","0","0","0","0"
"2015","Medicine Hat, Alberta, municipal","48062","Prisoner unlawfully at large","0","0","0","0","0","0","0","0","0","0","0","0","0","0"
"2016","Medicine Hat, Alberta, municipal","48062","Prisoner unlawfully at large","0","0","0","0","0","0","0","0","0","0","0","0","0","0"
"1998","Medicine Hat, Alberta, municipal","48062","Fail to appear","73","73","0","0","146.89","0","0","0","0","73","58","76","18","0"
"1999","Medicine Hat, Alberta, municipal","48062","Fail to appear","129","129","0","73.38","254.67","0","0","0","0","129","102","140","38","0"
"2000","Medicine Hat, Alberta, municipal","48062","Fail to appear","90","90","0","-31.8","173.69","0","0","0","0","90","75","94","19","0"
"2001","Medicine Hat, Alberta, municipal","48062","Fail to appear","195","193","1","113.55","370.92","0","0","0","0","194","168","191","23","0"
"2002","Medicine Hat, Alberta, municipal","48062","Fail to appear","190","187","2","-4.09","355.76","0","0","0","0","189","157","181","24","1"
"2003","Medicine Hat, Alberta, municipal","48062","Fail to appear","254","252","0","31.75","468.72","0","0","0","0","252","198","235","37","0"
"2004","Medicine Hat, Alberta, municipal","48062","Fail to appear","319","317","0","21.86","571.2","618.26","606.93","495.5","0","317","270","292","22","0"
"2005","Medicine Hat, Alberta, municipal","48062","Fail to appear","371","371","0","13.14","646.27","710.81","702.7","621.67","0","371","320","348","28","0"
"2006","Medicine Hat, Alberta, municipal","48062","Fail to appear","299","297","1","-21.51","507.24","560.22","563.78","600.53","0","298","260","287","27","0"
"2007","Medicine Hat, Alberta, municipal","48062","Fail to appear","393","392","1","28.37","651.13","749.34","707.82","267.26","0","393","357","369","12","0"
"2008","Medicine Hat, Alberta, municipal","48062","Fail to appear","479","478","0","19.94","780.94","839.21","851.78","988.76","0","478","407","451","44","0"
"2009","Medicine Hat, Alberta, municipal","48062","Fail to appear","408","407","1","-15.73","658.1","698.36","721.59","982.18","22.84","408","343","386","43","1"
"2010","Medicine Hat, Alberta, municipal","48062","Fail to appear","379","379","1","-7.12","611.24","672.17","669.7","641.91","0","380","330","358","28","0"
"2011","Medicine Hat, Alberta, municipal","48062","Fail to appear","448","448","0","18.22","722.62","777.77","785.41","871.56","0","448","382","420","38","0"
"2012","Medicine Hat, Alberta, municipal","48062","Fail to appear","428","428","0","-5.61","682.08","794.03","764.9","433.89","0","428","395","414","19","0"
"2013","Medicine Hat, Alberta, municipal","48062","Fail to appear","425","425","0","-1.92","668.96","765.87","752.33","595.92","0","425","386","412","26","0"
"2014","Medicine Hat, Alberta, municipal","48062","Fail to appear","432","431","1","0.77","674.13","766.09","747.67","531.18","0","432","390","413","23","0"
"2015","Medicine Hat, Alberta, municipal","48062","Fail to appear","452","448","1","3.84","699.98","780.55","768.19","622.26","0","449","400","427","27","0"
"2016","Medicine Hat, Alberta, municipal","48062","Fail to appear","637","635","2","40.07","980.45","1105.58","1069.38","642.05","0","637","569","597","28","0"
"1998","Medicine Hat, Alberta, municipal","48062","Breach of probation","28","27","1","0","56.34","0","0","0","0","28","25","35","10","1"
"1999","Medicine Hat, Alberta, municipal","48062","Breach of probation","32","32","0","12.13","63.17","0","0","0","0","32","25","30","5","0"
"2000","Medicine Hat, Alberta, municipal","48062","Breach of probation","40","40","0","22.2","77.2","0","0","0","0","40","33","42","9","0"
"2001","Medicine Hat, Alberta, municipal","48062","Breach of probation","100","95","4","146.4","190.22","0","0","0","0","99","51","91","40","0"
"2002","Medicine Hat, Alberta, municipal","48062","Breach of probation","63","62","1","-37.98","117.96","0","0","0","0","63","36","63","27","0"
"2003","Medicine Hat, Alberta, municipal","48062","Breach of probation","51","46","2","-20.22","94.11","0","0","0","0","48","32","45","13","1"
"2004","Medicine Hat, Alberta, municipal","48062","Breach of probation","94","87","2","78.85","168.32","180.9","189.15","270.27","22.52","89","79","91","12","1"
"2005","Medicine Hat, Alberta, municipal","48062","Breach of probation","100","97","0","3.49","174.2","179.92","195.87","355.24","22.2","97","81","97","16","1"
"2006","Medicine Hat, Alberta, municipal","48062","Breach of probation","58","57","1","-43.52","98.39","112.04","115.9","155.69","0","58","52","59","7","0"
"2007","Medicine Hat, Alberta, municipal","48062","Breach of probation","52","48","1","-12.44","86.15","100.75","99.75","89.09","0","49","48","52","4","0"
"2008","Medicine Hat, Alberta, municipal","48062","Breach of probation","90","88","0","70.31","146.73","204.13","192.64","67.42","0","88","99","102","3","0"
"2009","Medicine Hat, Alberta, municipal","48062","Breach of probation","70","63","1","-23.05","112.91","120.13","125.25","182.73","0","64","59","67","8","0"
"2010","Medicine Hat, Alberta, municipal","48062","Breach of probation","96","90","1","37.13","154.83","167.02","185.2","389.73","0","91","82","99","17","0"
"2011","Medicine Hat, Alberta, municipal","48062","Breach of probation","92","82","4","-4.15","148.39","132.34","162.69","504.59","45.87","86","65","87","22","2"
"2012","Medicine Hat, Alberta, municipal","48062","Breach of probation","77","73","1","-17.31","122.71","112.57","138.57","433.89","0","74","56","75","19","0"
"2013","Medicine Hat, Alberta, municipal","48062","Breach of probation","68","66","3","-12.78","107.03","123.02","120.52","91.68","22.92","69","62","66","4","1"
"2014","Medicine Hat, Alberta, municipal","48062","Breach of probation","93","86","6","35.59","145.12","166.97","155.69","23.09","46.19","92","85","86","1","2"
"2015","Medicine Hat, Alberta, municipal","48062","Breach of probation","64","61","1","-31.71","99.11","119.03","109.74","0","0","62","61","61","0","0"
"2016","Medicine Hat, Alberta, municipal","48062","Breach of probation","68","66","2","5.6","104.66","126.3","116.43","0","0","68","65","65","0","0"
"1998","Medicine Hat, Alberta, municipal","48062","Other violations against the administration of law and justice (Part IV Criminal Code)","5","3","0","0","10.06","0","0","0","0","3","3","4","1","0"
"1999","Medicine Hat, Alberta, municipal","48062","Other violations against the administration of law and justice (Part IV Criminal Code)","6","4","0","17.74","11.85","0","0","0","0","4","3","3","0","0"
"2000","Medicine Hat, Alberta, municipal","48062","Other violations against the administration of law and justice (Part IV Criminal Code)","7","7","0","14.05","13.51","0","0","0","0","7","5","6","1","0"
"2001","Medicine Hat, Alberta, municipal","48062","Other violations against the administration of law and justice (Part IV Criminal Code)","11","7","0","54.88","20.92","0","0","0","0","7","5","10","5","0"
"2002","Medicine Hat, Alberta, municipal","48062","Other violations against the administration of law and justice (Part IV Criminal Code)","6","6","0","-46.31","11.23","0","0","0","0","6","6","8","2","1"
"2003","Medicine Hat, Alberta, municipal","48062","Other violations against the administration of law and justice (Part IV Criminal Code)","10","8","1","64.26","18.45","0","0","0","0","9","7","9","2","0"
"2004","Medicine Hat, Alberta, municipal","48062","Other violations against the administration of law and justice (Part IV Criminal Code)","10","10","0","-2.97","17.91","27.48","27.02","22.52","0","10","12","13","1","0"
"2005","Medicine Hat, Alberta, municipal","48062","Other violations against the administration of law and justice (Part IV Criminal Code)","8","5","0","-22.17","13.94","13.33","12.12","0","0","5","6","6","0","0"
"2006","Medicine Hat, Alberta, municipal","48062","Other violations against the administration of law and justice (Part IV Criminal Code)","15","13","2","82.6","25.45","30.17","27.5","0","22.24","15","14","14","0","1"
"2007","Medicine Hat, Alberta, municipal","48062","Other violations against the administration of law and justice (Part IV Criminal Code)","19","16","1","23.71","31.48","33.58","40.28","111.36","44.54","17","16","21","5","2"
"2008","Medicine Hat, Alberta, municipal","48062","Other violations against the administration of law and justice (Part IV Criminal Code)","15","9","1","-22.31","24.46","20.62","20.78","22.47","22.47","10","10","11","1","1"
"2009","Medicine Hat, Alberta, municipal","48062","Other violations against the administration of law and justice (Part IV Criminal Code)","23","18","0","51.7","37.1","36.65","33.65","0","0","18","18","18","0","0"
"2010","Medicine Hat, Alberta, municipal","48062","Other violations against the administration of law and justice (Part IV Criminal Code)","13","11","0","-43.49","20.97","24.44","24.32","22.93","0","11","12","13","1","0"
"2011","Medicine Hat, Alberta, municipal","48062","Other violations against the administration of law and justice (Part IV Criminal Code)","11","8","1","-15.37","17.74","18.32","16.83","0","22.94","9","9","9","0","1"
"2012","Medicine Hat, Alberta, municipal","48062","Other violations against the administration of law and justice (Part IV Criminal Code)","10","9","0","-10.18","15.94","16.08","14.78","0","0","9","8","8","0","0"
"2013","Medicine Hat, Alberta, municipal","48062","Other violations against the administration of law and justice (Part IV Criminal Code)","17","16","0","67.91","26.76","27.78","29.22","45.84","0","16","14","16","2","0"
"2014","Medicine Hat, Alberta, municipal","48062","Other violations against the administration of law and justice (Part IV Criminal Code)","15","11","3","-12.52","23.41","21.61","19.91","0","23.09","14","11","11","0","1"
"2015","Medicine Hat, Alberta, municipal","48062","Other violations against the administration of law and justice (Part IV Criminal Code)","18","14","3","19.09","27.88","27.32","25.19","0","23.05","17","14","14","0","1"
"2016","Medicine Hat, Alberta, municipal","48062","Other violations against the administration of law and justice (Part IV Criminal Code)","14","9","3","-22.7","21.55","17.49","16.12","0","45.86","12","9","9","0","2"
"1998","Medicine Hat, Alberta, municipal","48062","Total other violations","56","26","3","0","112.68","0","0","0","0","29","22","26","4","1"
"1999","Medicine Hat, Alberta, municipal","48062","Total other violations","43","23","1","-24.66","84.89","0","0","0","0","24","25","26","1","0"
"2000","Medicine Hat, Alberta, municipal","48062","Total other violations","54","29","0","22.77","104.22","0","0","0","0","29","26","31","5","0"
"2001","Medicine Hat, Alberta, municipal","48062","Total other violations","32","18","1","-41.59","60.87","0","0","0","0","19","18","21","3","0"
"2002","Medicine Hat, Alberta, municipal","48062","Total other violations","36","25","1","10.74","67.41","0","0","0","0","26","23","25","2","2"
"2003","Medicine Hat, Alberta, municipal","48062","Total other violations","48","26","1","31.41","88.58","0","0","0","0","27","27","31","4","0"
"2004","Medicine Hat, Alberta, municipal","48062","Total other violations","53","31","3","7.14","94.9","68.7","66.51","45.05","22.52","34","30","32","2","1"
"2005","Medicine Hat, Alberta, municipal","48062","Total other violations","43","25","0","-21.07","74.91","73.3","70.67","44.4","0","25","33","35","2","0"
"2006","Medicine Hat, Alberta, municipal","48062","Total other violations","52","44","1","17.77","88.21","116.35","106.08","0","0","45","54","54","0","0"
"2007","Medicine Hat, Alberta, municipal","48062","Total other violations","69","59","2","29.59","114.32","134.34","128.52","66.82","0","61","64","67","3","0"
"2008","Medicine Hat, Alberta, municipal","48062","Total other violations","63","51","2","-10.15","102.71","113.41","128.43","292.13","0","53","55","68","13","0"
"2009","Medicine Hat, Alberta, municipal","48062","Total other violations","69","53","2","8.36","111.3","95.69","110.29","274.1","0","55","47","59","12","0"
"2010","Medicine Hat, Alberta, municipal","48062","Total other violations","79","66","2","14.48","127.41","138.51","134.69","91.7","22.93","68","68","72","4","1"
"2011","Medicine Hat, Alberta, municipal","48062","Total other violations","78","59","5","-1.25","125.81","118.09","125.29","206.42","22.94","64","58","67","9","1"
"2012","Medicine Hat, Alberta, municipal","48062","Total other violations","93","64","7","17.8","148.21","134.68","142.26","228.36","22.84","71","67","77","10","1"
"2013","Medicine Hat, Alberta, municipal","48062","Total other violations","60","51","0","-36.28","94.44","109.13","111.39","137.52","0","51","55","61","6","0"
"2014","Medicine Hat, Alberta, municipal","48062","Total other violations","54","40","5","-10.78","84.27","76.61","79.66","115.47","46.19","45","39","44","5","2"
"2015","Medicine Hat, Alberta, municipal","48062","Total other violations","55","41","4","1.08","85.17","85.86","86.35","92.19","69.14","45","44","48","4","3"
"2016","Medicine Hat, Alberta, municipal","48062","Total other violations","59","41","7","6.62","90.81","79.66","78.81","68.79","0","48","41","44","3","0"
"1998","Medicine Hat, Alberta, municipal","48062","Betting house","0","0","0","0","0","0","0","0","0","0","0","0","0","0"
"1999","Medicine Hat, Alberta, municipal","48062","Betting house","0","0","0","0","0","0","0","0","0","0","0","0","0","0"
"2000","Medicine Hat, Alberta, municipal","48062","Betting house","0","0","0","0","0","0","0","0","0","0","0","0","0","0"
"2001","Medicine Hat, Alberta, municipal","48062","Betting house","0","0","0","0","0","0","0","0","0","0","0","0","0","0"
"2002","Medicine Hat, Alberta, municipal","48062","Betting house","0","0","0","0","0","0","0","0","0","0","0","0","0","0"
"2003","Medicine Hat, Alberta, municipal","48062","Betting house","0","0","0","0","0","0","0","0","0","0","0","0","0","0"
"2004","Medicine Hat, Alberta, municipal","48062","Betting house","0","0","0","0","0","0","0","0","0","0","0","0","0","0"
"2005","Medicine Hat, Alberta, municipal","48062","Betting house","0","0","0","0","0","0","0","0","0","0","0","0","0","0"
"2006","Medicine Hat, Alberta, municipal","48062","Betting house","0","0","0","0","0","0","0","0","0","0","0","0","0","0"
"2007","Medicine Hat, Alberta, municipal","48062","Betting house","0","0","0","0","0","0","0","0","0","0","0","0","0","0"
"2008","Medicine Hat, Alberta, municipal","48062","Betting house","0","0","0","0","0","0","0","0","0","0","0","0","0","0"
"2009","Medicine Hat, Alberta, municipal","48062","Betting house","0","0","0","0","0","0","0","0","0","0","0","0","0","0"
"2010","Medicine Hat, Alberta, municipal","48062","Betting house","0","0","0","0","0","0","0","0","0","0","0","0","0","0"
"2011","Medicine Hat, Alberta, municipal","48062","Betting house","0","0","0","0","0","0","0","0","0","0","0","0","0","0"
"2012","Medicine Hat, Alberta, municipal","48062","Betting house","0","0","0","0","0","0","0","0","0","0","0","0","0","0"
"2013","Medicine Hat, Alberta, municipal","48062","Betting house","0","0","0","0","0","0","0","0","0","0","0","0","0","0"
"2014","Medicine Hat, Alberta, municipal","48062","Betting house","0","0","0","0","0","0","0","0","0","0","0","0","0","0"
"2015","Medicine Hat, Alberta, municipal","48062","Betting house","0","0","0","0","0","0","0","0","0","0","0","0","0","0"
"2016","Medicine Hat, Alberta, municipal","48062","Betting house","0","0","0","0","0","0","0","0","0","0","0","0","0","0"
"1998","Medicine Hat, Alberta, municipal","48062","Gaming house","0","0","0","0","0","0","0","0","0","0","0","0","0","0"
"1999","Medicine Hat, Alberta, municipal","48062","Gaming house","0","0","0","0","0","0","0","0","0","0","0","0","0","0"
"2000","Medicine Hat, Alberta, municipal","48062","Gaming house","0","0","0","0","0","0","0","0","0","0","0","0","0","0"
"2001","Medicine Hat, Alberta, municipal","48062","Gaming house","0","0","0","0","0","0","0","0","0","0","0","0","0","0"
"2002","Medicine Hat, Alberta, municipal","48062","Gaming house","0","0","0","0","0","0","0","0","0","0","0","0","0","0"
"2003","Medicine Hat, Alberta, municipal","48062","Gaming house","0","0","0","0","0","0","0","0","0","0","0","0","0","0"
"2004","Medicine Hat, Alberta, municipal","48062","Gaming house","0","0","0","0","0","0","0","0","0","0","0","0","0","0"
"2005","Medicine Hat, Alberta, municipal","48062","Gaming house","0","0","0","0","0","0","0","0","0","0","0","0","0","0"
"2006","Medicine Hat, Alberta, municipal","48062","Gaming house","0","0","0","0","0","0","0","0","0","0","0","0","0","0"
"2007","Medicine Hat, Alberta, municipal","48062","Gaming house","0","0","0","0","0","0","0","0","0","0","0","0","0","0"
"2008","Medicine Hat, Alberta, municipal","48062","Gaming house","0","0","0","0","0","0","0","0","0","0","0","0","0","0"
"2009","Medicine Hat, Alberta, municipal","48062","Gaming house","0","0","0","0","0","0","0","0","0","0","0","0","0","0"
"2010","Medicine Hat, Alberta, municipal","48062","Gaming house","0","0","0","0","0","0","0","0","0","0","0","0","0","0"
"2011","Medicine Hat, Alberta, municipal","48062","Gaming house","0","0","0","0","0","0","0","0","0","0","0","0","0","0"
"2012","Medicine Hat, Alberta, municipal","48062","Gaming house","0","0","0","0","0","0","0","0","0","0","0","0","0","0"
"2013","Medicine Hat, Alberta, municipal","48062","Gaming house","0","0","0","0","0","0","0","0","0","0","0","0","0","0"
"2014","Medicine Hat, Alberta, municipal","48062","Gaming house","0","0","0","0","0","0","0","0","0","0","0","0","0","0"
"2015","Medicine Hat, Alberta, municipal","48062","Gaming house","0","0","0","0","0","0","0","0","0","0","0","0","0","0"
"2016","Medicine Hat, Alberta, municipal","48062","Gaming house","0","0","0","0","0","0","0","0","0","0","0","0","0","0"
"1998","Medicine Hat, Alberta, municipal","48062","Other violations related to gaming and betting","0","0","0","0","0","0","0","0","0","0","0","0","0","0"
"1999","Medicine Hat, Alberta, municipal","48062","Other violations related to gaming and betting","0","0","0","0","0","0","0","0","0","0","0","0","0","0"
"2000","Medicine Hat, Alberta, municipal","48062","Other violations related to gaming and betting","0","0","0","0","0","0","0","0","0","0","0","0","0","0"
"2001","Medicine Hat, Alberta, municipal","48062","Other violations related to gaming and betting","0","0","0","0","0","0","0","0","0","0","0","0","0","0"
"2002","Medicine Hat, Alberta, municipal","48062","Other violations related to gaming and betting","0","0","0","0","0","0","0","0","0","0","0","0","0","0"
"2003","Medicine Hat, Alberta, municipal","48062","Other violations related to gaming and betting","6","1","1","0","11.07","0","0","0","0","2","1","1","0","0"
"2004","Medicine Hat, Alberta, municipal","48062","Other violations related to gaming and betting","0","0","0","-100","0","0","0","0","0","0","0","0","0","0"
"2005","Medicine Hat, Alberta, municipal","48062","Other violations related to gaming and betting","2","1","0","0","3.48","13.33","12.12","0","0","1","6","6","0","0"
"2006","Medicine Hat, Alberta, municipal","48062","Other violations related to gaming and betting","0","1","0","-100","0","2.15","1.96","0","0","1","1","1","0","0"
"2007","Medicine Hat, Alberta, municipal","48062","Other violations related to gaming and betting","0","0","0","0","0","0","0","0","0","0","0","0","0","0"
"2008","Medicine Hat, Alberta, municipal","48062","Other violations related to gaming and betting","1","1","0","0","1.63","2.06","1.89","0","0","1","1","1","0","0"
"2009","Medicine Hat, Alberta, municipal","48062","Other violations related to gaming and betting","0","0","0","-100","0","0","0","0","0","0","0","0","0","0"
"2010","Medicine Hat, Alberta, municipal","48062","Other violations related to gaming and betting","0","0","0","0","0","0","0","0","0","0","0","0","0","0"
"2011","Medicine Hat, Alberta, municipal","48062","Other violations related to gaming and betting","0","0","0","0","0","0","0","0","0","0","0","0","0","0"
"2012","Medicine Hat, Alberta, municipal","48062","Other violations related to gaming and betting","0","0","0","0","0","0","0","0","0","0","0","0","0","0"
"2013","Medicine Hat, Alberta, municipal","48062","Other violations related to gaming and betting","0","0","0","0","0","0","0","0","0","0","0","0","0","0"
"2014","Medicine Hat, Alberta, municipal","48062","Other violations related to gaming and betting","0","0","0","0","0","0","0","0","0","0","0","0","0","0"
"2015","Medicine Hat, Alberta, municipal","48062","Other violations related to gaming and betting","0","0","0","0","0","0","0","0","0","0","0","0","0","0"
"2016","Medicine Hat, Alberta, municipal","48062","Other violations related to gaming and betting","0","0","0","0","0","0","0","0","0","0","0","0","0","0"
"2012","Medicine Hat, Alberta, municipal","48062","Common Bawdy House","0","0","0","0","0","0","0","0","0","0","0","0","0","0"
"2013","Medicine Hat, Alberta, municipal","48062","Common Bawdy House","0","0","0","0","0","0","0","0","0","0","0","0","0","0"
"2014","Medicine Hat, Alberta, municipal","48062","Common Bawdy House","0","0","0","0","0","0","0","0","0","0","0","0","0","0"
"2015","Medicine Hat, Alberta, municipal","48062","Common Bawdy House","0","0","0","0","0","0","0","0","0","0","0","0","0","0"
"2016","Medicine Hat, Alberta, municipal","48062","Common Bawdy House","0","0","0","0","0","0","0","0","0","0","0","0","0","0"
"1998","Medicine Hat, Alberta, municipal","48062","Indecent acts","15","4","0","0","30.18","0","0","0","0","4","4","4","0","0"
"1999","Medicine Hat, Alberta, municipal","48062","Indecent acts","12","8","0","-21.51","23.69","0","0","0","0","8","8","8","0","0"
"2000","Medicine Hat, Alberta, municipal","48062","Indecent acts","18","4","0","46.64","34.74","0","0","0","0","4","3","4","1","0"
"2001","Medicine Hat, Alberta, municipal","48062","Indecent acts","11","3","1","-39.77","20.92","0","0","0","0","4","2","3","1","0"
"2002","Medicine Hat, Alberta, municipal","48062","Indecent acts","5","4","0","-55.26","9.36","0","0","0","0","4","4","4","0","0"
"2003","Medicine Hat, Alberta, municipal","48062","Indecent acts","3","1","0","-40.87","5.54","0","0","0","0","1","1","1","0","0"
"2004","Medicine Hat, Alberta, municipal","48062","Indecent acts","5","2","1","61.72","8.95","2.29","4.16","22.52","22.52","3","1","2","1","1"
"2005","Medicine Hat, Alberta, municipal","48062","Indecent acts","5","4","0","-2.72","8.71","8.89","8.08","0","0","4","4","4","0","0"
"2006","Medicine Hat, Alberta, municipal","48062","Indecent acts","0","0","0","-100","0","0","0","0","0","0","0","0","0","0"
"2007","Medicine Hat, Alberta, municipal","48062","Indecent acts","5","3","0","0","8.28","4.2","3.84","0","0","3","2","2","0","0"
"2008","Medicine Hat, Alberta, municipal","48062","Indecent acts","10","1","0","96.81","16.3","2.06","1.89","0","0","1","1","1","0","0"
"2009","Medicine Hat, Alberta, municipal","48062","Indecent acts","15","6","1","48.4","24.19","8.14","7.48","0","0","7","4","4","0","0"
"2010","Medicine Hat, Alberta, municipal","48062","Indecent acts","10","8","1","-33.34","16.13","10.18","11.22","22.93","0","9","5","6","1","0"
"2011","Medicine Hat, Alberta, municipal","48062","Indecent acts","4","1","1","-59.99","6.45","2.04","1.87","0","0","2","1","1","0","0"
"2012","Medicine Hat, Alberta, municipal","48062","Indecent acts","18","2","4","344.61","28.69","4.02","3.7","0","22.84","6","2","2","0","1"
"2013","Medicine Hat, Alberta, municipal","48062","Indecent acts","5","0","0","-72.56","7.87","0","0","0","0","0","0","0","0","0"
"2014","Medicine Hat, Alberta, municipal","48062","Indecent acts","7","3","2","38.79","10.92","3.93","5.43","23.09","0","5","2","3","1","0"
"2015","Medicine Hat, Alberta, municipal","48062","Indecent acts","8","2","3","13.42","12.39","3.9","3.6","0","23.05","5","2","2","0","1"
"2016","Medicine Hat, Alberta, municipal","48062","Indecent acts","4","0","3","-50.31","6.16","0","0","0","0","3","0","0","0","0"
"1998","Medicine Hat, Alberta, municipal","48062","Corrupting morals","1","0","0","0","2.01","0","0","0","0","0","0","0","0","0"
"1999","Medicine Hat, Alberta, municipal","48062","Corrupting morals","1","0","0","-1.89","1.97","0","0","0","0","0","0","0","0","0"
"2000","Medicine Hat, Alberta, municipal","48062","Corrupting morals","1","0","0","-2.24","1.93","0","0","0","0","0","0","0","0","0"
"2001","Medicine Hat, Alberta, municipal","48062","Corrupting morals","0","0","0","-100","0","0","0","0","0","0","0","0","0","0"
"2002","Medicine Hat, Alberta, municipal","48062","Corrupting morals","1","0","0","0","1.87","0","0","0","0","0","0","0","0","0"
"2003","Medicine Hat, Alberta, municipal","48062","Corrupting morals","0","0","0","-100","0","0","0","0","0","0","0","0","0","0"
"2004","Medicine Hat, Alberta, municipal","48062","Corrupting morals","0","0","0","0","0","0","0","0","0","0","0","0","0","0"
"2005","Medicine Hat, Alberta, municipal","48062","Corrupting morals","0","0","0","0","0","0","0","0","0","0","0","0","0","0"
"2006","Medicine Hat, Alberta, municipal","48062","Corrupting morals","0","0","0","0","0","0","0","0","0","0","0","0","0","0"
"2007","Medicine Hat, Alberta, municipal","48062","Corrupting morals","0","0","0","0","0","0","0","0","0","0","0","0","0","0"
"2008","Medicine Hat, Alberta, municipal","48062","Corrupting morals","0","0","0","0","0","0","0","0","0","0","0","0","0","0"
"2009","Medicine Hat, Alberta, municipal","48062","Corrupting morals","0","0","0","0","0","0","0","0","0","0","0","0","0","0"
"2010","Medicine Hat, Alberta, municipal","48062","Corrupting morals","0","0","0","0","0","0","0","0","0","0","0","0","0","0"
"2011","Medicine Hat, Alberta, municipal","48062","Corrupting morals","0","0","0","0","0","0","0","0","0","0","0","0","0","0"
"2012","Medicine Hat, Alberta, municipal","48062","Corrupting morals","1","0","0","0","1.59","0","0","0","0","0","0","0","0","0"
"2013","Medicine Hat, Alberta, municipal","48062","Corrupting morals","0","0","0","-100","0","0","0","0","0","0","0","0","0","0"
"2014","Medicine Hat, Alberta, municipal","48062","Corrupting morals","0","0","0","0","0","0","0","0","0","0","0","0","0","0"
"2015","Medicine Hat, Alberta, municipal","48062","Corrupting morals","0","0","0","0","0","0","0","0","0","0","0","0","0","0"
"2016","Medicine Hat, Alberta, municipal","48062","Corrupting morals","0","0","0","0","0","0","0","0","0","0","0","0","0","0"
"1998","Medicine Hat, Alberta, municipal","48062","Obstruct public or peace officer","7","6","0","0","14.09","0","0","0","0","6","8","8","0","0"
"1999","Medicine Hat, Alberta, municipal","48062","Obstruct public or peace officer","4","4","0","-43.94","7.9","0","0","0","0","4","4","4","0","0"
"2000","Medicine Hat, Alberta, municipal","48062","Obstruct public or peace officer","19","18","0","364.36","36.67","0","0","0","0","18","16","18","2","0"
"2001","Medicine Hat, Alberta, municipal","48062","Obstruct public or peace officer","8","8","0","-58.5","15.22","0","0","0","0","8","8","9","1","0"
"2002","Medicine Hat, Alberta, municipal","48062","Obstruct public or peace officer","15","14","0","84.57","28.09","0","0","0","0","14","13","14","1","0"
"2003","Medicine Hat, Alberta, municipal","48062","Obstruct public or peace officer","13","12","0","-14.59","23.99","0","0","0","0","12","14","15","1","0"
"2004","Medicine Hat, Alberta, municipal","48062","Obstruct public or peace officer","16","17","0","19.43","28.65","41.22","39.49","22.52","0","17","18","19","1","0"
"2005","Medicine Hat, Alberta, municipal","48062","Obstruct public or peace officer","10","9","0","-39.2","17.42","22.21","20.19","0","0","9","10","10","0","0"
"2006","Medicine Hat, Alberta, municipal","48062","Obstruct public or peace officer","29","30","0","182.42","49.2","81.88","74.65","0","0","30","38","38","0","0"
"2007","Medicine Hat, Alberta, municipal","48062","Obstruct public or peace officer","52","51","1","75.12","86.15","115.44","111.26","66.82","0","52","55","58","3","0"
"2008","Medicine Hat, Alberta, municipal","48062","Obstruct public or peace officer","36","35","1","-31.87","58.69","82.48","88.77","157.3","0","36","40","47","7","0"
"2009","Medicine Hat, Alberta, municipal","48062","Obstruct public or peace officer","35","35","0","-3.81","56.45","69.23","76.65","159.89","0","35","34","41","7","0"
"2010","Medicine Hat, Alberta, municipal","48062","Obstruct public or peace officer","39","38","0","11.41","62.9","85.55","82.31","45.85","22.93","38","42","44","2","1"
"2011","Medicine Hat, Alberta, municipal","48062","Obstruct public or peace officer","49","45","3","25.66","79.04","87.55","97.24","206.42","22.94","48","43","52","9","1"
"2012","Medicine Hat, Alberta, municipal","48062","Obstruct public or peace officer","47","43","3","-5.23","74.9","90.46","94.23","137.02","0","46","45","51","6","0"
"2013","Medicine Hat, Alberta, municipal","48062","Obstruct public or peace officer","36","35","0","-24.35","56.67","73.41","76.69","114.6","0","35","37","42","5","0"
"2014","Medicine Hat, Alberta, municipal","48062","Obstruct public or peace officer","30","30","0","-17.38","46.81","58.93","61.55","92.38","0","30","30","34","4","0"
"2015","Medicine Hat, Alberta, municipal","48062","Obstruct public or peace officer","28","27","0","-7.37","43.36","54.64","57.57","92.19","0","27","28","32","4","0"
"2016","Medicine Hat, Alberta, municipal","48062","Obstruct public or peace officer","26","26","1","-7.71","40.02","48.58","48.36","45.86","0","27","25","27","2","0"
"1998","Medicine Hat, Alberta, municipal","48062","Trespass at night","2","0","0","0","4.02","0","0","0","0","0","0","0","0","0"
"1999","Medicine Hat, Alberta, municipal","48062","Trespass at night","5","3","1","145.28","9.87","0","0","0","0","4","5","5","0","0"
"2000","Medicine Hat, Alberta, municipal","48062","Trespass at night","0","0","0","-100","0","0","0","0","0","0","0","0","0","0"
"2001","Medicine Hat, Alberta, municipal","48062","Trespass at night","3","2","0","0","5.71","0","0","0","0","2","3","3","0","0"
"2002","Medicine Hat, Alberta, municipal","48062","Trespass at night","3","2","0","-1.56","5.62","0","0","0","0","2","2","2","0","0"
"2003","Medicine Hat, Alberta, municipal","48062","Trespass at night","3","2","0","-1.44","5.54","0","0","0","0","2","2","2","0","0"
"2004","Medicine Hat, Alberta, municipal","48062","Trespass at night","3","3","0","-2.97","5.37","6.87","6.24","0","0","3","3","3","0","0"
"2005","Medicine Hat, Alberta, municipal","48062","Trespass at night","3","1","0","-2.72","5.23","2.22","2.02","0","0","1","1","1","0","0"
"2006","Medicine Hat, Alberta, municipal","48062","Trespass at night","2","1","0","-35.08","3.39","2.15","1.96","0","0","1","1","1","0","0"
"2007","Medicine Hat, Alberta, municipal","48062","Trespass at night","2","0","1","-2.34","3.31","0","0","0","0","1","0","0","0","0"
"2008","Medicine Hat, Alberta, municipal","48062","Trespass at night","2","2","0","-1.6","3.26","2.06","5.67","44.94","0","2","1","3","2","0"
"2009","Medicine Hat, Alberta, municipal","48062","Trespass at night","3","3","0","48.4","4.84","0","1.87","22.84","0","3","0","1","1","0"
"2010","Medicine Hat, Alberta, municipal","48062","Trespass at night","5","1","0","66.65","8.06","2.04","1.87","0","0","1","1","1","0","0"
"2011","Medicine Hat, Alberta, municipal","48062","Trespass at night","1","0","0","-80","1.61","0","0","0","0","0","0","0","0","0"
"2012","Medicine Hat, Alberta, municipal","48062","Trespass at night","0","0","0","-100","0","0","0","0","0","0","0","0","0","0"
"2013","Medicine Hat, Alberta, municipal","48062","Trespass at night","2","2","0","0","3.15","0","0","0","0","2","0","0","0","0"
"2014","Medicine Hat, Alberta, municipal","48062","Trespass at night","5","0","2","147.85","7.8","0","0","0","46.19","2","0","0","0","2"
"2015","Medicine Hat, Alberta, municipal","48062","Trespass at night","2","0","0","-60.3","3.1","0","0","0","0","0","0","0","0","0"
"2016","Medicine Hat, Alberta, municipal","48062","Trespass at night","5","2","1","148.47","7.7","3.89","3.58","0","0","3","2","2","0","0"
"2005","Medicine Hat, Alberta, municipal","48062","Utter threats to property or animal","0","0","0","0","0","0","0","0","0","0","0","0","0","0"
"2006","Medicine Hat, Alberta, municipal","48062","Utter threats to property or animal","0","0","0","0","0","0","0","0","0","0","0","0","0","0"
"2007","Medicine Hat, Alberta, municipal","48062","Utter threats to property or animal","0","0","0","0","0","0","0","0","0","0","0","0","0","0"
"2008","Medicine Hat, Alberta, municipal","48062","Utter threats to property or animal","0","0","0","0","0","0","0","0","0","0","0","0","0","0"
"2009","Medicine Hat, Alberta, municipal","48062","Utter threats to property or animal","3","0","1","0","4.84","0","0","0","0","1","0","0","0","0"
"2010","Medicine Hat, Alberta, municipal","48062","Utter threats to property or animal","2","0","1","-33.34","3.23","0","0","0","0","1","0","0","0","0"
"2011","Medicine Hat, Alberta, municipal","48062","Utter threats to property or animal","3","0","0","50.02","4.84","0","0","0","0","0","0","0","0","0"
"2012","Medicine Hat, Alberta, municipal","48062","Utter threats to property or animal","5","2","0","64.67","7.97","2.01","3.7","22.84","0","2","1","2","1","0"
"2013","Medicine Hat, Alberta, municipal","48062","Utter threats to property or animal","2","1","0","-60.49","3.15","0","1.83","22.92","0","1","0","1","1","0"
"2014","Medicine Hat, Alberta, municipal","48062","Utter threats to property or animal","3","0","1","48.71","4.68","0","0","0","0","1","0","0","0","0"
"2015","Medicine Hat, Alberta, municipal","48062","Utter threats to property or animal","2","0","0","-33.84","3.1","0","0","0","0","0","0","0","0","0"
"2016","Medicine Hat, Alberta, municipal","48062","Utter threats to property or animal","5","2","1","148.47","7.7","3.89","3.58","0","0","3","2","2","0","0"
"2005","Medicine Hat, Alberta, municipal","48062","Advocating genocide","0","0","0","0","0","0","0","0","0","0","0","0","0","0"
"2006","Medicine Hat, Alberta, municipal","48062","Advocating genocide","0","0","0","0","0","0","0","0","0","0","0","0","0","0"
"2007","Medicine Hat, Alberta, municipal","48062","Advocating genocide","0","0","0","0","0","0","0","0","0","0","0","0","0","0"
"2008","Medicine Hat, Alberta, municipal","48062","Advocating genocide","0","0","0","0","0","0","0","0","0","0","0","0","0","0"
"2009","Medicine Hat, Alberta, municipal","48062","Advocating genocide","0","0","0","0","0","0","0","0","0","0","0","0","0","0"
"2010","Medicine Hat, Alberta, municipal","48062","Advocating genocide","0","0","0","0","0","0","0","0","0","0","0","0","0","0"
"2011","Medicine Hat, Alberta, municipal","48062","Advocating genocide","0","0","0","0","0","0","0","0","0","0","0","0","0","0"
"2012","Medicine Hat, Alberta, municipal","48062","Advocating genocide","0","0","0","0","0","0","0","0","0","0","0","0","0","0"
"2013","Medicine Hat, Alberta, municipal","48062","Advocating genocide","0","0","0","0","0","0","0","0","0","0","0","0","0","0"
"2014","Medicine Hat, Alberta, municipal","48062","Advocating genocide","0","0","0","0","0","0","0","0","0","0","0","0","0","0"
"2015","Medicine Hat, Alberta, municipal","48062","Advocating genocide","0","0","0","0","0","0","0","0","0","0","0","0","0","0"
"2016","Medicine Hat, Alberta, municipal","48062","Advocating genocide","0","0","0","0","0","0","0","0","0","0","0","0","0","0"
"2005","Medicine Hat, Alberta, municipal","48062","Public incitement of hatred","0","0","0","0","0","0","0","0","0","0","0","0","0","0"
"2006","Medicine Hat, Alberta, municipal","48062","Public incitement of hatred","0","0","0","0","0","0","0","0","0","0","0","0","0","0"
"2007","Medicine Hat, Alberta, municipal","48062","Public incitement of hatred","0","0","0","0","0","0","0","0","0","0","0","0","0","0"
"2008","Medicine Hat, Alberta, municipal","48062","Public incitement of hatred","0","0","0","0","0","0","0","0","0","0","0","0","0","0"
"2009","Medicine Hat, Alberta, municipal","48062","Public incitement of hatred","0","0","0","0","0","0","0","0","0","0","0","0","0","0"
"2010","Medicine Hat, Alberta, municipal","48062","Public incitement of hatred","0","0","0","0","0","0","0","0","0","0","0","0","0","0"
"2011","Medicine Hat, Alberta, municipal","48062","Public incitement of hatred","0","0","0","0","0","0","0","0","0","0","0","0","0","0"
"2012","Medicine Hat, Alberta, municipal","48062","Public incitement of hatred","0","0","0","0","0","0","0","0","0","0","0","0","0","0"
"2013","Medicine Hat, Alberta, municipal","48062","Public incitement of hatred","0","0","0","0","0","0","0","0","0","0","0","0","0","0"
"2014","Medicine Hat, Alberta, municipal","48062","Public incitement of hatred","0","0","0","0","0","0","0","0","0","0","0","0","0","0"
"2015","Medicine Hat, Alberta, municipal","48062","Public incitement of hatred","0","0","0","0","0","0","0","0","0","0","0","0","0","0"
"2016","Medicine Hat, Alberta, municipal","48062","Public incitement of hatred","0","0","0","0","0","0","0","0","0","0","0","0","0","0"
"2005","Medicine Hat, Alberta, municipal","48062","Unauthorized recording of a movie","0","0","0","0","0","0","0","0","0","0","0","0","0","0"
"2006","Medicine Hat, Alberta, municipal","48062","Unauthorized recording of a movie","0","0","0","0","0","0","0","0","0","0","0","0","0","0"
"2007","Medicine Hat, Alberta, municipal","48062","Unauthorized recording of a movie","0","0","0","0","0","0","0","0","0","0","0","0","0","0"
"2008","Medicine Hat, Alberta, municipal","48062","Unauthorized recording of a movie","0","0","0","0","0","0","0","0","0","0","0","0","0","0"
"2009","Medicine Hat, Alberta, municipal","48062","Unauthorized recording of a movie","0","0","0","0","0","0","0","0","0","0","0","0","0","0"
"2010","Medicine Hat, Alberta, municipal","48062","Unauthorized recording of a movie","0","0","0","0","0","0","0","0","0","0","0","0","0","0"
"2011","Medicine Hat, Alberta, municipal","48062","Unauthorized recording of a movie","0","0","0","0","0","0","0","0","0","0","0","0","0","0"
"2012","Medicine Hat, Alberta, municipal","48062","Unauthorized recording of a movie","0","0","0","0","0","0","0","0","0","0","0","0","0","0"
"2013","Medicine Hat, Alberta, municipal","48062","Unauthorized recording of a movie","0","0","0","0","0","0","0","0","0","0","0","0","0","0"
"2014","Medicine Hat, Alberta, municipal","48062","Unauthorized recording of a movie","0","0","0","0","0","0","0","0","0","0","0","0","0","0"
"2015","Medicine Hat, Alberta, municipal","48062","Unauthorized recording of a movie","0","0","0","0","0","0","0","0","0","0","0","0","0","0"
"2016","Medicine Hat, Alberta, municipal","48062","Unauthorized recording of a movie","0","0","0","0","0","0","0","0","0","0","0","0","0","0"
"1998","Medicine Hat, Alberta, municipal","48062","Offences against public order (Part II Criminal Code)","1","0","0","0","2.01","0","0","0","0","0","0","0","0","0"
"1999","Medicine Hat, Alberta, municipal","48062","Offences against public order (Part II Criminal Code)","1","0","0","-1.89","1.97","0","0","0","0","0","1","1","0","0"
"2000","Medicine Hat, Alberta, municipal","48062","Offences against public order (Part II Criminal Code)","2","1","0","95.52","3.86","0","0","0","0","1","1","1","0","0"
"2001","Medicine Hat, Alberta, municipal","48062","Offences against public order (Part II Criminal Code)","5","5","0","146.4","9.51","0","0","0","0","5","4","5","1","0"
"2002","Medicine Hat, Alberta, municipal","48062","Offences against public order (Part II Criminal Code)","3","3","0","-40.94","5.62","0","0","0","0","3","2","3","1","0"
"2003","Medicine Hat, Alberta, municipal","48062","Offences against public order (Part II Criminal Code)","7","5","0","129.96","12.92","0","0","0","0","5","4","6","2","0"
"2004","Medicine Hat, Alberta, municipal","48062","Offences against public order (Part II Criminal Code)","3","2","0","-58.41","5.37","4.58","4.16","0","0","2","2","2","0","0"
"2005","Medicine Hat, Alberta, municipal","48062","Offences against public order (Part II Criminal Code)","1","1","0","-67.57","1.74","2.22","2.02","0","0","1","1","1","0","0"
"2006","Medicine Hat, Alberta, municipal","48062","Offences against public order (Part II Criminal Code)","4","3","0","289.54","6.79","6.46","5.89","0","0","3","3","3","0","0"
"2007","Medicine Hat, Alberta, municipal","48062","Offences against public order (Part II Criminal Code)","1","1","0","-75.58","1.66","2.1","1.92","0","0","1","1","1","0","0"
"2008","Medicine Hat, Alberta, municipal","48062","Offences against public order (Part II Criminal Code)","3","3","0","195.21","4.89","6.19","5.67","0","0","3","3","3","0","0"
"2009","Medicine Hat, Alberta, municipal","48062","Offences against public order (Part II Criminal Code)","4","4","0","31.91","6.45","8.14","7.48","0","0","4","4","4","0","0"
"2010","Medicine Hat, Alberta, municipal","48062","Offences against public order (Part II Criminal Code)","5","5","0","24.98","8.06","12.22","11.22","0","0","5","6","6","0","0"
"2011","Medicine Hat, Alberta, municipal","48062","Offences against public order (Part II Criminal Code)","3","3","0","-39.99","4.84","6.11","5.61","0","0","3","3","3","0","0"
"2012","Medicine Hat, Alberta, municipal","48062","Offences against public order (Part II Criminal Code)","7","7","0","130.54","11.16","14.07","12.93","0","0","7","7","7","0","0"
"2013","Medicine Hat, Alberta, municipal","48062","Offences against public order (Part II Criminal Code)","5","5","0","-29.45","7.87","7.94","7.3","0","0","5","4","4","0","0"
"2014","Medicine Hat, Alberta, municipal","48062","Offences against public order (Part II Criminal Code)","4","4","0","-20.69","6.24","7.86","7.24","0","0","4","4","4","0","0"
"2015","Medicine Hat, Alberta, municipal","48062","Offences against public order (Part II Criminal Code)","2","2","0","-50.38","3.1","3.9","3.6","0","0","2","2","2","0","0"
"2016","Medicine Hat, Alberta, municipal","48062","Offences against public order (Part II Criminal Code)","2","2","0","-0.61","3.08","3.89","3.58","0","0","2","2","2","0","0"
"2002","Medicine Hat, Alberta, municipal","48062","Property or service for terrorist activity","0","0","0","0","0","0","0","0","0","0","0","0","0","0"
"2003","Medicine Hat, Alberta, municipal","48062","Property or service for terrorist activity","0","0","0","0","0","0","0","0","0","0","0","0","0","0"
"2004","Medicine Hat, Alberta, municipal","48062","Property or service for terrorist activity","0","0","0","0","0","0","0","0","0","0","0","0","0","0"
"2005","Medicine Hat, Alberta, municipal","48062","Property or service for terrorist activity","0","0","0","0","0","0","0","0","0","0","0","0","0","0"
"2006","Medicine Hat, Alberta, municipal","48062","Property or service for terrorist activity","0","0","0","0","0","0","0","0","0","0","0","0","0","0"
"2007","Medicine Hat, Alberta, municipal","48062","Property or service for terrorist activity","0","0","0","0","0","0","0","0","0","0","0","0","0","0"
"2008","Medicine Hat, Alberta, municipal","48062","Property or service for terrorist activity","0","0","0","0","0","0","0","0","0","0","0","0","0","0"
"2009","Medicine Hat, Alberta, municipal","48062","Property or service for terrorist activity","0","0","0","0","0","0","0","0","0","0","0","0","0","0"
"2010","Medicine Hat, Alberta, municipal","48062","Property or service for terrorist activity","0","0","0","0","0","0","0","0","0","0","0","0","0","0"
"2011","Medicine Hat, Alberta, municipal","48062","Property or service for terrorist activity","0","0","0","0","0","0","0","0","0","0","0","0","0","0"
"2012","Medicine Hat, Alberta, municipal","48062","Property or service for terrorist activity","0","0","0","0","0","0","0","0","0","0","0","0","0","0"
"2013","Medicine Hat, Alberta, municipal","48062","Property or service for terrorist activity","0","0","0","0","0","0","0","0","0","0","0","0","0","0"
"2014","Medicine Hat, Alberta, municipal","48062","Property or service for terrorist activity","0","0","0","0","0","0","0","0","0","0","0","0","0","0"
"2015","Medicine Hat, Alberta, municipal","48062","Property or service for terrorist activity","0","0","0","0","0","0","0","0","0","0","0","0","0","0"
"2016","Medicine Hat, Alberta, municipal","48062","Property or service for terrorist activity","0","0","0","0","0","0","0","0","0","0","0","0","0","0"
"2002","Medicine Hat, Alberta, municipal","48062","Freezing of property, disclosure or audit","0","0","0","0","0","0","0","0","0","0","0","0","0","0"
"2003","Medicine Hat, Alberta, municipal","48062","Freezing of property, disclosure or audit","0","0","0","0","0","0","0","0","0","0","0","0","0","0"
"2004","Medicine Hat, Alberta, municipal","48062","Freezing of property, disclosure or audit","0","0","0","0","0","0","0","0","0","0","0","0","0","0"
"2005","Medicine Hat, Alberta, municipal","48062","Freezing of property, disclosure or audit","0","0","0","0","0","0","0","0","0","0","0","0","0","0"
"2006","Medicine Hat, Alberta, municipal","48062","Freezing of property, disclosure or audit","0","0","0","0","0","0","0","0","0","0","0","0","0","0"
"2007","Medicine Hat, Alberta, municipal","48062","Freezing of property, disclosure or audit","0","0","0","0","0","0","0","0","0","0","0","0","0","0"
"2008","Medicine Hat, Alberta, municipal","48062","Freezing of property, disclosure or audit","0","0","0","0","0","0","0","0","0","0","0","0","0","0"
"2009","Medicine Hat, Alberta, municipal","48062","Freezing of property, disclosure or audit","0","0","0","0","0","0","0","0","0","0","0","0","0","0"
"2010","Medicine Hat, Alberta, municipal","48062","Freezing of property, disclosure or audit","0","0","0","0","0","0","0","0","0","0","0","0","0","0"
"2011","Medicine Hat, Alberta, municipal","48062","Freezing of property, disclosure or audit","0","0","0","0","0","0","0","0","0","0","0","0","0","0"
"2012","Medicine Hat, Alberta, municipal","48062","Freezing of property, disclosure or audit","0","0","0","0","0","0","0","0","0","0","0","0","0","0"
"2013","Medicine Hat, Alberta, municipal","48062","Freezing of property, disclosure or audit","0","0","0","0","0","0","0","0","0","0","0","0","0","0"
"2014","Medicine Hat, Alberta, municipal","48062","Freezing of property, disclosure or audit","0","0","0","0","0","0","0","0","0","0","0","0","0","0"
"2015","Medicine Hat, Alberta, municipal","48062","Freezing of property, disclosure or audit","0","0","0","0","0","0","0","0","0","0","0","0","0","0"
"2016","Medicine Hat, Alberta, municipal","48062","Freezing of property, disclosure or audit","0","0","0","0","0","0","0","0","0","0","0","0","0","0"
"2002","Medicine Hat, Alberta, municipal","48062","Participate in activity of terrorist group","0","0","0","0","0","0","0","0","0","0","0","0","0","0"
"2003","Medicine Hat, Alberta, municipal","48062","Participate in activity of terrorist group","0","0","0","0","0","0","0","0","0","0","0","0","0","0"
"2004","Medicine Hat, Alberta, municipal","48062","Participate in activity of terrorist group","0","0","0","0","0","0","0","0","0","0","0","0","0","0"
"2005","Medicine Hat, Alberta, municipal","48062","Participate in activity of terrorist group","0","0","0","0","0","0","0","0","0","0","0","0","0","0"
"2006","Medicine Hat, Alberta, municipal","48062","Participate in activity of terrorist group","0","0","0","0","0","0","0","0","0","0","0","0","0","0"
"2007","Medicine Hat, Alberta, municipal","48062","Participate in activity of terrorist group","0","0","0","0","0","0","0","0","0","0","0","0","0","0"
"2008","Medicine Hat, Alberta, municipal","48062","Participate in activity of terrorist group","0","0","0","0","0","0","0","0","0","0","0","0","0","0"
"2009","Medicine Hat, Alberta, municipal","48062","Participate in activity of terrorist group","0","0","0","0","0","0","0","0","0","0","0","0","0","0"
"2010","Medicine Hat, Alberta, municipal","48062","Participate in activity of terrorist group","0","0","0","0","0","0","0","0","0","0","0","0","0","0"
"2011","Medicine Hat, Alberta, municipal","48062","Participate in activity of terrorist group","0","0","0","0","0","0","0","0","0","0","0","0","0","0"
"2012","Medicine Hat, Alberta, municipal","48062","Participate in activity of terrorist group","0","0","0","0","0","0","0","0","0","0","0","0","0","0"
"2013","Medicine Hat, Alberta, municipal","48062","Participate in activity of terrorist group","0","0","0","0","0","0","0","0","0","0","0","0","0","0"
"2014","Medicine Hat, Alberta, municipal","48062","Participate in activity of terrorist group","0","0","0","0","0","0","0","0","0","0","0","0","0","0"
"2015","Medicine Hat, Alberta, municipal","48062","Participate in activity of terrorist group","0","0","0","0","0","0","0","0","0","0","0","0","0","0"
"2016","Medicine Hat, Alberta, municipal","48062","Participate in activity of terrorist group","0","0","0","0","0","0","0","0","0","0","0","0","0","0"
"2002","Medicine Hat, Alberta, municipal","48062","Facilitate terrorist activity","0","0","0","0","0","0","0","0","0","0","0","0","0","0"
"2003","Medicine Hat, Alberta, municipal","48062","Facilitate terrorist activity","0","0","0","0","0","0","0","0","0","0","0","0","0","0"
"2004","Medicine Hat, Alberta, municipal","48062","Facilitate terrorist activity","0","0","0","0","0","0","0","0","0","0","0","0","0","0"
"2005","Medicine Hat, Alberta, municipal","48062","Facilitate terrorist activity","0","0","0","0","0","0","0","0","0","0","0","0","0","0"
"2006","Medicine Hat, Alberta, municipal","48062","Facilitate terrorist activity","0","0","0","0","0","0","0","0","0","0","0","0","0","0"
"2007","Medicine Hat, Alberta, municipal","48062","Facilitate terrorist activity","0","0","0","0","0","0","0","0","0","0","0","0","0","0"
"2008","Medicine Hat, Alberta, municipal","48062","Facilitate terrorist activity","0","0","0","0","0","0","0","0","0","0","0","0","0","0"
"2009","Medicine Hat, Alberta, municipal","48062","Facilitate terrorist activity","0","0","0","0","0","0","0","0","0","0","0","0","0","0"
"2010","Medicine Hat, Alberta, municipal","48062","Facilitate terrorist activity","0","0","0","0","0","0","0","0","0","0","0","0","0","0"
"2011","Medicine Hat, Alberta, municipal","48062","Facilitate terrorist activity","0","0","0","0","0","0","0","0","0","0","0","0","0","0"
"2012","Medicine Hat, Alberta, municipal","48062","Facilitate terrorist activity","0","0","0","0","0","0","0","0","0","0","0","0","0","0"
"2013","Medicine Hat, Alberta, municipal","48062","Facilitate terrorist activity","0","0","0","0","0","0","0","0","0","0","0","0","0","0"
"2014","Medicine Hat, Alberta, municipal","48062","Facilitate terrorist activity","0","0","0","0","0","0","0","0","0","0","0","0","0","0"
"2015","Medicine Hat, Alberta, municipal","48062","Facilitate terrorist activity","0","0","0","0","0","0","0","0","0","0","0","0","0","0"
"2016","Medicine Hat, Alberta, municipal","48062","Facilitate terrorist activity","0","0","0","0","0","0","0","0","0","0","0","0","0","0"
"2002","Medicine Hat, Alberta, municipal","48062","Commission or instructing to carry out terrorist activity","0","0","0","0","0","0","0","0","0","0","0","0","0","0"
"2003","Medicine Hat, Alberta, municipal","48062","Commission or instructing to carry out terrorist activity","0","0","0","0","0","0","0","0","0","0","0","0","0","0"
"2004","Medicine Hat, Alberta, municipal","48062","Commission or instructing to carry out terrorist activity","0","0","0","0","0","0","0","0","0","0","0","0","0","0"
"2005","Medicine Hat, Alberta, municipal","48062","Commission or instructing to carry out terrorist activity","0","0","0","0","0","0","0","0","0","0","0","0","0","0"
"2006","Medicine Hat, Alberta, municipal","48062","Commission or instructing to carry out terrorist activity","0","0","0","0","0","0","0","0","0","0","0","0","0","0"
"2007","Medicine Hat, Alberta, municipal","48062","Commission or instructing to carry out terrorist activity","0","0","0","0","0","0","0","0","0","0","0","0","0","0"
"2008","Medicine Hat, Alberta, municipal","48062","Commission or instructing to carry out terrorist activity","0","0","0","0","0","0","0","0","0","0","0","0","0","0"
"2009","Medicine Hat, Alberta, municipal","48062","Commission or instructing to carry out terrorist activity","0","0","0","0","0","0","0","0","0","0","0","0","0","0"
"2010","Medicine Hat, Alberta, municipal","48062","Commission or instructing to carry out terrorist activity","0","0","0","0","0","0","0","0","0","0","0","0","0","0"
"2011","Medicine Hat, Alberta, municipal","48062","Commission or instructing to carry out terrorist activity","0","0","0","0","0","0","0","0","0","0","0","0","0","0"
"2012","Medicine Hat, Alberta, municipal","48062","Commission or instructing to carry out terrorist activity","0","0","0","0","0","0","0","0","0","0","0","0","0","0"
"2013","Medicine Hat, Alberta, municipal","48062","Commission or instructing to carry out terrorist activity","0","0","0","0","0","0","0","0","0","0","0","0","0","0"
"2014","Medicine Hat, Alberta, municipal","48062","Commission or instructing to carry out terrorist activity","0","0","0","0","0","0","0","0","0","0","0","0","0","0"
"2015","Medicine Hat, Alberta, municipal","48062","Commission or instructing to carry out terrorist activity","0","0","0","0","0","0","0","0","0","0","0","0","0","0"
"2016","Medicine Hat, Alberta, municipal","48062","Commission or instructing to carry out terrorist activity","0","0","0","0","0","0","0","0","0","0","0","0","0","0"
"2002","Medicine Hat, Alberta, municipal","48062","Harbour or conceal terrorist","0","0","0","0","0","0","0","0","0","0","0","0","0","0"
"2003","Medicine Hat, Alberta, municipal","48062","Harbour or conceal terrorist","0","0","0","0","0","0","0","0","0","0","0","0","0","0"
"2004","Medicine Hat, Alberta, municipal","48062","Harbour or conceal terrorist","0","0","0","0","0","0","0","0","0","0","0","0","0","0"
"2005","Medicine Hat, Alberta, municipal","48062","Harbour or conceal terrorist","0","0","0","0","0","0","0","0","0","0","0","0","0","0"
"2006","Medicine Hat, Alberta, municipal","48062","Harbour or conceal terrorist","0","0","0","0","0","0","0","0","0","0","0","0","0","0"
"2007","Medicine Hat, Alberta, municipal","48062","Harbour or conceal terrorist","0","0","0","0","0","0","0","0","0","0","0","0","0","0"
"2008","Medicine Hat, Alberta, municipal","48062","Harbour or conceal terrorist","0","0","0","0","0","0","0","0","0","0","0","0","0","0"
"2009","Medicine Hat, Alberta, municipal","48062","Harbour or conceal terrorist","0","0","0","0","0","0","0","0","0","0","0","0","0","0"
"2010","Medicine Hat, Alberta, municipal","48062","Harbour or conceal terrorist","0","0","0","0","0","0","0","0","0","0","0","0","0","0"
"2011","Medicine Hat, Alberta, municipal","48062","Harbour or conceal terrorist","0","0","0","0","0","0","0","0","0","0","0","0","0","0"
"2012","Medicine Hat, Alberta, municipal","48062","Harbour or conceal terrorist","0","0","0","0","0","0","0","0","0","0","0","0","0","0"
"2013","Medicine Hat, Alberta, municipal","48062","Harbour or conceal terrorist","0","0","0","0","0","0","0","0","0","0","0","0","0","0"
"2014","Medicine Hat, Alberta, municipal","48062","Harbour or conceal terrorist","0","0","0","0","0","0","0","0","0","0","0","0","0","0"
"2015","Medicine Hat, Alberta, municipal","48062","Harbour or conceal terrorist","0","0","0","0","0","0","0","0","0","0","0","0","0","0"
"2016","Medicine Hat, Alberta, municipal","48062","Harbour or conceal terrorist","0","0","0","0","0","0","0","0","0","0","0","0","0","0"
"2005","Medicine Hat, Alberta, municipal","48062","Hoax terrorism","0","0","0","0","0","0","0","0","0","0","0","0","0","0"
"2006","Medicine Hat, Alberta, municipal","48062","Hoax terrorism","0","0","0","0","0","0","0","0","0","0","0","0","0","0"
"2007","Medicine Hat, Alberta, municipal","48062","Hoax terrorism","0","0","0","0","0","0","0","0","0","0","0","0","0","0"
"2008","Medicine Hat, Alberta, municipal","48062","Hoax terrorism","0","0","0","0","0","0","0","0","0","0","0","0","0","0"
"2009","Medicine Hat, Alberta, municipal","48062","Hoax terrorism","0","0","0","0","0","0","0","0","0","0","0","0","0","0"
"2010","Medicine Hat, Alberta, municipal","48062","Hoax terrorism","0","0","0","0","0","0","0","0","0","0","0","0","0","0"
"2011","Medicine Hat, Alberta, municipal","48062","Hoax terrorism","0","0","0","0","0","0","0","0","0","0","0","0","0","0"
"2012","Medicine Hat, Alberta, municipal","48062","Hoax terrorism","0","0","0","0","0","0","0","0","0","0","0","0","0","0"
"2013","Medicine Hat, Alberta, municipal","48062","Hoax terrorism","0","0","0","0","0","0","0","0","0","0","0","0","0","0"
"2014","Medicine Hat, Alberta, municipal","48062","Hoax terrorism","0","0","0","0","0","0","0","0","0","0","0","0","0","0"
"2015","Medicine Hat, Alberta, municipal","48062","Hoax terrorism","0","0","0","0","0","0","0","0","0","0","0","0","0","0"
"2016","Medicine Hat, Alberta, municipal","48062","Hoax terrorism","0","0","0","0","0","0","0","0","0","0","0","0","0","0"
"2012","Medicine Hat, Alberta, municipal","48062","Advocating/Promoting terrorism offence","0","0","0","0","0","0","0","0","0","0","0","0","0","0"
"2013","Medicine Hat, Alberta, municipal","48062","Advocating/Promoting terrorism offence","0","0","0","0","0","0","0","0","0","0","0","0","0","0"
"2014","Medicine Hat, Alberta, municipal","48062","Advocating/Promoting terrorism offence","0","0","0","0","0","0","0","0","0","0","0","0","0","0"
"2015","Medicine Hat, Alberta, municipal","48062","Advocating/Promoting terrorism offence","0","0","0","0","0","0","0","0","0","0","0","0","0","0"
"2016","Medicine Hat, Alberta, municipal","48062","Advocating/Promoting terrorism offence","0","0","0","0","0","0","0","0","0","0","0","0","0","0"
"1998","Medicine Hat, Alberta, municipal","48062","Firearms and other offensive weapons (Part III Criminal Code)","0","0","0","0","0","0","0","0","0","0","0","0","0","0"
"1999","Medicine Hat, Alberta, municipal","48062","Firearms and other offensive weapons (Part III Criminal Code)","0","0","0","0","0","0","0","0","0","0","0","0","0","0"
"2000","Medicine Hat, Alberta, municipal","48062","Firearms and other offensive weapons (Part III Criminal Code)","0","0","0","0","0","0","0","0","0","0","0","0","0","0"
"2001","Medicine Hat, Alberta, municipal","48062","Firearms and other offensive weapons (Part III Criminal Code)","1","0","0","0","1.9","0","0","0","0","0","1","1","0","0"
"2002","Medicine Hat, Alberta, municipal","48062","Firearms and other offensive weapons (Part III Criminal Code)","6","1","1","490.62","11.23","0","0","0","0","2","1","1","0","2"
"2003","Medicine Hat, Alberta, municipal","48062","Firearms and other offensive weapons (Part III Criminal Code)","0","0","0","-100","0","0","0","0","0","0","0","0","0","0"
"2004","Medicine Hat, Alberta, municipal","48062","Firearms and other offensive weapons (Part III Criminal Code)","4","0","0","0","7.16","0","0","0","0","0","0","0","0","0"
"2005","Medicine Hat, Alberta, municipal","48062","Firearms and other offensive weapons (Part III Criminal Code)","6","0","0","45.93","10.45","0","0","0","0","0","0","0","0","0"
"2006","Medicine Hat, Alberta, municipal","48062","Firearms and other offensive weapons (Part III Criminal Code)","1","0","0","-83.77","1.7","0","0","0","0","0","0","0","0","0"
"2007","Medicine Hat, Alberta, municipal","48062","Firearms and other offensive weapons (Part III Criminal Code)","1","0","0","-2.34","1.66","0","0","0","0","0","0","0","0","0"
"2008","Medicine Hat, Alberta, municipal","48062","Firearms and other offensive weapons (Part III Criminal Code)","0","0","0","-100","0","0","0","0","0","0","0","0","0","0"
"2009","Medicine Hat, Alberta, municipal","48062","Firearms and other offensive weapons (Part III Criminal Code)","0","0","0","0","0","0","0","0","0","0","0","0","0","0"
"2010","Medicine Hat, Alberta, municipal","48062","Firearms and other offensive weapons (Part III Criminal Code)","0","0","0","0","0","0","0","0","0","0","0","0","0","0"
"2011","Medicine Hat, Alberta, municipal","48062","Firearms and other offensive weapons (Part III Criminal Code)","2","0","0","0","3.23","0","0","0","0","0","0","0","0","0"
"2012","Medicine Hat, Alberta, municipal","48062","Firearms and other offensive weapons (Part III Criminal Code)","1","0","0","-50.6","1.59","0","0","0","0","0","0","0","0","0"
"2013","Medicine Hat, Alberta, municipal","48062","Firearms and other offensive weapons (Part III Criminal Code)","2","0","0","97.54","3.15","0","0","0","0","0","0","0","0","0"
"2014","Medicine Hat, Alberta, municipal","48062","Firearms and other offensive weapons (Part III Criminal Code)","1","1","0","-50.43","1.56","1.96","1.81","0","0","1","1","1","0","0"
"2015","Medicine Hat, Alberta, municipal","48062","Firearms and other offensive weapons (Part III Criminal Code)","2","2","0","98.48","3.1","3.9","3.6","0","0","2","2","2","0","0"
"2016","Medicine Hat, Alberta, municipal","48062","Firearms and other offensive weapons (Part III Criminal Code)","0","0","0","-100","0","0","0","0","0","0","0","0","0","0"
"2012","Medicine Hat, Alberta, municipal","48062","Leaving Canada to participate in activity of terrorist group","0","0","0","0","0","0","0","0","0","0","0","0","0","0"
"2013","Medicine Hat, Alberta, municipal","48062","Leaving Canada to participate in activity of terrorist group","0","0","0","0","0","0","0","0","0","0","0","0","0","0"
"2014","Medicine Hat, Alberta, municipal","48062","Leaving Canada to participate in activity of terrorist group","0","0","0","0","0","0","0","0","0","0","0","0","0","0"
"2015","Medicine Hat, Alberta, municipal","48062","Leaving Canada to participate in activity of terrorist group","0","0","0","0","0","0","0","0","0","0","0","0","0","0"
"2016","Medicine Hat, Alberta, municipal","48062","Leaving Canada to participate in activity of terrorist group","0","0","0","0","0","0","0","0","0","0","0","0","0","0"
"2012","Medicine Hat, Alberta, municipal","48062","Leaving Canada to facilitate terrorist activity","0","0","0","0","0","0","0","0","0","0","0","0","0","0"
"2013","Medicine Hat, Alberta, municipal","48062","Leaving Canada to facilitate terrorist activity","0","0","0","0","0","0","0","0","0","0","0","0","0","0"
"2014","Medicine Hat, Alberta, municipal","48062","Leaving Canada to facilitate terrorist activity","0","0","0","0","0","0","0","0","0","0","0","0","0","0"
"2015","Medicine Hat, Alberta, municipal","48062","Leaving Canada to facilitate terrorist activity","0","0","0","0","0","0","0","0","0","0","0","0","0","0"
"2016","Medicine Hat, Alberta, municipal","48062","Leaving Canada to facilitate terrorist activity","0","0","0","0","0","0","0","0","0","0","0","0","0","0"
"2012","Medicine Hat, Alberta, municipal","48062","Leaving Canada to commit offence for terrorist group","0","0","0","0","0","0","0","0","0","0","0","0","0","0"
"2013","Medicine Hat, Alberta, municipal","48062","Leaving Canada to commit offence for terrorist group","0","0","0","0","0","0","0","0","0","0","0","0","0","0"
"2014","Medicine Hat, Alberta, municipal","48062","Leaving Canada to commit offence for terrorist group","0","0","0","0","0","0","0","0","0","0","0","0","0","0"
"2015","Medicine Hat, Alberta, municipal","48062","Leaving Canada to commit offence for terrorist group","0","0","0","0","0","0","0","0","0","0","0","0","0","0"
"2016","Medicine Hat, Alberta, municipal","48062","Leaving Canada to commit offence for terrorist group","0","0","0","0","0","0","0","0","0","0","0","0","0","0"
"2012","Medicine Hat, Alberta, municipal","48062","Leaving Canada to commit offence that is terrorist activity","0","0","0","0","0","0","0","0","0","0","0","0","0","0"
"2013","Medicine Hat, Alberta, municipal","48062","Leaving Canada to commit offence that is terrorist activity","0","0","0","0","0","0","0","0","0","0","0","0","0","0"
"2014","Medicine Hat, Alberta, municipal","48062","Leaving Canada to commit offence that is terrorist activity","0","0","0","0","0","0","0","0","0","0","0","0","0","0"
"2015","Medicine Hat, Alberta, municipal","48062","Leaving Canada to commit offence that is terrorist activity","0","0","0","0","0","0","0","0","0","0","0","0","0","0"
"2016","Medicine Hat, Alberta, municipal","48062","Leaving Canada to commit offence that is terrorist activity","0","0","0","0","0","0","0","0","0","0","0","0","0","0"
"2012","Medicine Hat, Alberta, municipal","48062","Concealing person who carried out terrorist activity that is a terrorism offence for which that person is liable to imprisonment for life","0","0","0","0","0","0","0","0","0","0","0","0","0","0"
"2013","Medicine Hat, Alberta, municipal","48062","Concealing person who carried out terrorist activity that is a terrorism offence for which that person is liable to imprisonment for life","0","0","0","0","0","0","0","0","0","0","0","0","0","0"
"2014","Medicine Hat, Alberta, municipal","48062","Concealing person who carried out terrorist activity that is a terrorism offence for which that person is liable to imprisonment for life","0","0","0","0","0","0","0","0","0","0","0","0","0","0"
"2015","Medicine Hat, Alberta, municipal","48062","Concealing person who carried out terrorist activity that is a terrorism offence for which that person is liable to imprisonment for life","0","0","0","0","0","0","0","0","0","0","0","0","0","0"
"2016","Medicine Hat, Alberta, municipal","48062","Concealing person who carried out terrorist activity that is a terrorism offence for which that person is liable to imprisonment for life","1","0","0","0","1.54","0","0","0","0","0","0","0","0","0"
"2012","Medicine Hat, Alberta, municipal","48062","Concealing person who carried out terrorist activity that is a terrorism offence for which that person is liable to any punishment other than life","0","0","0","0","0","0","0","0","0","0","0","0","0","0"
"2013","Medicine Hat, Alberta, municipal","48062","Concealing person who carried out terrorist activity that is a terrorism offence for which that person is liable to any punishment other than life","0","0","0","0","0","0","0","0","0","0","0","0","0","0"
"2014","Medicine Hat, Alberta, municipal","48062","Concealing person who carried out terrorist activity that is a terrorism offence for which that person is liable to any punishment other than life","0","0","0","0","0","0","0","0","0","0","0","0","0","0"
"2015","Medicine Hat, Alberta, municipal","48062","Concealing person who carried out terrorist activity that is a terrorism offence for which that person is liable to any punishment other than life","0","0","0","0","0","0","0","0","0","0","0","0","0","0"
"2016","Medicine Hat, Alberta, municipal","48062","Concealing person who carried out terrorist activity that is a terrorism offence for which that person is liable to any punishment other than life","0","0","0","0","0","0","0","0","0","0","0","0","0","0"
"2012","Medicine Hat, Alberta, municipal","48062","Concealing person who is likely to carry out terrorist activity","0","0","0","0","0","0","0","0","0","0","0","0","0","0"
"2013","Medicine Hat, Alberta, municipal","48062","Concealing person who is likely to carry out terrorist activity","0","0","0","0","0","0","0","0","0","0","0","0","0","0"
"2014","Medicine Hat, Alberta, municipal","48062","Concealing person who is likely to carry out terrorist activity","0","0","0","0","0","0","0","0","0","0","0","0","0","0"
"2015","Medicine Hat, Alberta, municipal","48062","Concealing person who is likely to carry out terrorist activity","0","0","0","0","0","0","0","0","0","0","0","0","0","0"
"2016","Medicine Hat, Alberta, municipal","48062","Concealing person who is likely to carry out terrorist activity","0","0","0","0","0","0","0","0","0","0","0","0","0","0"
"1998","Medicine Hat, Alberta, municipal","48062","Sexual offences, public morals and disorderly conduct (Part V Criminal Code)","0","0","0","0","0","0","0","0","0","0","0","0","0","0"
"1999","Medicine Hat, Alberta, municipal","48062","Sexual offences, public morals and disorderly conduct (Part V Criminal Code)","0","0","0","0","0","0","0","0","0","0","0","0","0","0"
"2000","Medicine Hat, Alberta, municipal","48062","Sexual offences, public morals and disorderly conduct (Part V Criminal Code)","0","0","0","0","0","0","0","0","0","0","0","0","0","0"
"2001","Medicine Hat, Alberta, municipal","48062","Sexual offences, public morals and disorderly conduct (Part V Criminal Code)","1","0","0","0","1.9","0","0","0","0","0","0","0","0","0"
"2002","Medicine Hat, Alberta, municipal","48062","Sexual offences, public morals and disorderly conduct (Part V Criminal Code)","0","0","0","-100","0","0","0","0","0","0","0","0","0","0"
"2003","Medicine Hat, Alberta, municipal","48062","Sexual offences, public morals and disorderly conduct (Part V Criminal Code)","0","0","0","0","0","0","0","0","0","0","0","0","0","0"
"2004","Medicine Hat, Alberta, municipal","48062","Sexual offences, public morals and disorderly conduct (Part V Criminal Code)","1","1","0","0","1.79","2.29","2.08","0","0","1","1","1","0","0"
"2005","Medicine Hat, Alberta, municipal","48062","Sexual offences, public morals and disorderly conduct (Part V Criminal Code)","0","0","0","-100","0","0","0","0","0","0","0","0","0","0"
"2006","Medicine Hat, Alberta, municipal","48062","Sexual offences, public morals and disorderly conduct (Part V Criminal Code)","1","0","0","0","1.7","0","0","0","0","0","0","0","0","0"
"2007","Medicine Hat, Alberta, municipal","48062","Sexual offences, public morals and disorderly conduct (Part V Criminal Code)","0","0","0","-100","0","0","0","0","0","0","0","0","0","0"
"2008","Medicine Hat, Alberta, municipal","48062","Sexual offences, public morals and disorderly conduct (Part V Criminal Code)","2","0","1","0","3.26","0","0","0","0","1","0","0","0","0"
"2009","Medicine Hat, Alberta, municipal","48062","Sexual offences, public morals and disorderly conduct (Part V Criminal Code)","0","0","0","-100","0","0","0","0","0","0","0","0","0","0"
"2010","Medicine Hat, Alberta, municipal","48062","Sexual offences, public morals and disorderly conduct (Part V Criminal Code)","0","0","0","0","0","0","0","0","0","0","0","0","0","0"
"2011","Medicine Hat, Alberta, municipal","48062","Sexual offences, public morals and disorderly conduct (Part V Criminal Code)","0","0","0","0","0","0","0","0","0","0","0","0","0","0"
"2012","Medicine Hat, Alberta, municipal","48062","Sexual offences, public morals and disorderly conduct (Part V Criminal Code)","0","0","0","0","0","0","0","0","0","0","0","0","0","0"
"2013","Medicine Hat, Alberta, municipal","48062","Sexual offences, public morals and disorderly conduct (Part V Criminal Code)","0","0","0","0","0","0","0","0","0","0","0","0","0","0"
"2014","Medicine Hat, Alberta, municipal","48062","Sexual offences, public morals and disorderly conduct (Part V Criminal Code)","1","0","0","0","1.56","0","0","0","0","0","0","0","0","0"
"2015","Medicine Hat, Alberta, municipal","48062","Sexual offences, public morals and disorderly conduct (Part V Criminal Code)","1","0","0","-0.76","1.55","0","0","0","0","0","0","0","0","0"
"2016","Medicine Hat, Alberta, municipal","48062","Sexual offences, public morals and disorderly conduct (Part V Criminal Code)","0","0","0","-100","0","0","0","0","0","0","0","0","0","0"
"1998","Medicine Hat, Alberta, municipal","48062","Invasion of privacy (Part VI Criminal Code)","0","0","0","0","0","0","0","0","0","0","0","0","0","0"
"1999","Medicine Hat, Alberta, municipal","48062","Invasion of privacy (Part VI Criminal Code)","0","0","0","0","0","0","0","0","0","0","0","0","0","0"
"2000","Medicine Hat, Alberta, municipal","48062","Invasion of privacy (Part VI Criminal Code)","0","0","0","0","0","0","0","0","0","0","0","0","0","0"
"2001","Medicine Hat, Alberta, municipal","48062","Invasion of privacy (Part VI Criminal Code)","0","0","0","0","0","0","0","0","0","0","0","0","0","0"
"2002","Medicine Hat, Alberta, municipal","48062","Invasion of privacy (Part VI Criminal Code)","0","0","0","0","0","0","0","0","0","0","0","0","0","0"
"2003","Medicine Hat, Alberta, municipal","48062","Invasion of privacy (Part VI Criminal Code)","0","0","0","0","0","0","0","0","0","0","0","0","0","0"
"2004","Medicine Hat, Alberta, municipal","48062","Invasion of privacy (Part VI Criminal Code)","0","0","0","0","0","0","0","0","0","0","0","0","0","0"
"2005","Medicine Hat, Alberta, municipal","48062","Invasion of privacy (Part VI Criminal Code)","0","0","0","0","0","0","0","0","0","0","0","0","0","0"
"2006","Medicine Hat, Alberta, municipal","48062","Invasion of privacy (Part VI Criminal Code)","0","0","0","0","0","0","0","0","0","0","0","0","0","0"
"2007","Medicine Hat, Alberta, municipal","48062","Invasion of privacy (Part VI Criminal Code)","0","0","0","0","0","0","0","0","0","0","0","0","0","0"
"2008","Medicine Hat, Alberta, municipal","48062","Invasion of privacy (Part VI Criminal Code)","0","0","0","0","0","0","0","0","0","0","0","0","0","0"
"2009","Medicine Hat, Alberta, municipal","48062","Invasion of privacy (Part VI Criminal Code)","0","0","0","0","0","0","0","0","0","0","0","0","0","0"
"2010","Medicine Hat, Alberta, municipal","48062","Invasion of privacy (Part VI Criminal Code)","0","0","0","0","0","0","0","0","0","0","0","0","0","0"
"2011","Medicine Hat, Alberta, municipal","48062","Invasion of privacy (Part VI Criminal Code)","0","0","0","0","0","0","0","0","0","0","0","0","0","0"
"2012","Medicine Hat, Alberta, municipal","48062","Invasion of privacy (Part VI Criminal Code)","0","0","0","0","0","0","0","0","0","0","0","0","0","0"
"2013","Medicine Hat, Alberta, municipal","48062","Invasion of privacy (Part VI Criminal Code)","0","0","0","0","0","0","0","0","0","0","0","0","0","0"
"2014","Medicine Hat, Alberta, municipal","48062","Invasion of privacy (Part VI Criminal Code)","0","0","0","0","0","0","0","0","0","0","0","0","0","0"
"2015","Medicine Hat, Alberta, municipal","48062","Invasion of privacy (Part VI Criminal Code)","0","0","0","0","0","0","0","0","0","0","0","0","0","0"
"2016","Medicine Hat, Alberta, municipal","48062","Invasion of privacy (Part VI Criminal Code)","0","0","0","0","0","0","0","0","0","0","0","0","0","0"
"1998","Medicine Hat, Alberta, municipal","48062","Disorderly houses, gaming and betting","0","0","0","0","0","0","0","0","0","0","0","0","0","0"
"1999","Medicine Hat, Alberta, municipal","48062","Disorderly houses, gaming and betting","0","0","0","0","0","0","0","0","0","0","0","0","0","0"
"2000","Medicine Hat, Alberta, municipal","48062","Disorderly houses, gaming and betting","0","0","0","0","0","0","0","0","0","0","0","0","0","0"
"2001","Medicine Hat, Alberta, municipal","48062","Disorderly houses, gaming and betting","0","0","0","0","0","0","0","0","0","0","0","0","0","0"
"2002","Medicine Hat, Alberta, municipal","48062","Disorderly houses, gaming and betting","0","0","0","0","0","0","0","0","0","0","0","0","0","0"
"2003","Medicine Hat, Alberta, municipal","48062","Disorderly houses, gaming and betting","0","0","0","0","0","0","0","0","0","0","0","0","0","0"
"2004","Medicine Hat, Alberta, municipal","48062","Disorderly houses, gaming and betting","0","0","0","0","0","0","0","0","0","0","0","0","0","0"
"2005","Medicine Hat, Alberta, municipal","48062","Disorderly houses, gaming and betting","0","0","0","0","0","0","0","0","0","0","0","0","0","0"
"2006","Medicine Hat, Alberta, municipal","48062","Disorderly houses, gaming and betting","0","0","0","0","0","0","0","0","0","0","0","0","0","0"
"2007","Medicine Hat, Alberta, municipal","48062","Disorderly houses, gaming and betting","0","0","0","0","0","0","0","0","0","0","0","0","0","0"
"2008","Medicine Hat, Alberta, municipal","48062","Disorderly houses, gaming and betting","0","0","0","0","0","0","0","0","0","0","0","0","0","0"
"2009","Medicine Hat, Alberta, municipal","48062","Disorderly houses, gaming and betting","0","0","0","0","0","0","0","0","0","0","0","0","0","0"
"2010","Medicine Hat, Alberta, municipal","48062","Disorderly houses, gaming and betting","0","0","0","0","0","0","0","0","0","0","0","0","0","0"
"2011","Medicine Hat, Alberta, municipal","48062","Disorderly houses, gaming and betting","0","0","0","0","0","0","0","0","0","0","0","0","0","0"
"2012","Medicine Hat, Alberta, municipal","48062","Disorderly houses, gaming and betting","0","0","0","0","0","0","0","0","0","0","0","0","0","0"
"2013","Medicine Hat, Alberta, municipal","48062","Disorderly houses, gaming and betting","0","0","0","0","0","0","0","0","0","0","0","0","0","0"
"2014","Medicine Hat, Alberta, municipal","48062","Disorderly houses, gaming and betting","0","0","0","0","0","0","0","0","0","0","0","0","0","0"
"2015","Medicine Hat, Alberta, municipal","48062","Disorderly houses, gaming and betting","0","0","0","0","0","0","0","0","0","0","0","0","0","0"
"2016","Medicine Hat, Alberta, municipal","48062","Disorderly houses, gaming and betting","0","0","0","0","0","0","0","0","0","0","0","0","0","0"
"1998","Medicine Hat, Alberta, municipal","48062","Offences against the person and reputation (Part VIII Criminal Code)","23","12","3","0","46.28","0","0","0","0","15","7","9","2","1"
"1999","Medicine Hat, Alberta, municipal","48062","Offences against the person and reputation (Part VIII Criminal Code)","10","3","0","-57.34","19.74","0","0","0","0","3","2","2","0","0"
"2000","Medicine Hat, Alberta, municipal","48062","Offences against the person and reputation (Part VIII Criminal Code)","5","1","0","-51.12","9.65","0","0","0","0","1","1","1","0","0"
"2001","Medicine Hat, Alberta, municipal","48062","Offences against the person and reputation (Part VIII Criminal Code)","1","0","0","-80.29","1.9","0","0","0","0","0","0","0","0","0"
"2002","Medicine Hat, Alberta, municipal","48062","Offences against the person and reputation (Part VIII Criminal Code)","0","0","0","-100","0","0","0","0","0","0","0","0","0","0"
"2003","Medicine Hat, Alberta, municipal","48062","Offences against the person and reputation (Part VIII Criminal Code)","1","0","0","0","1.85","0","0","0","0","0","0","0","0","0"
"2004","Medicine Hat, Alberta, municipal","48062","Offences against the person and reputation (Part VIII Criminal Code)","0","0","0","-100","0","0","0","0","0","0","0","0","0","0"
"2005","Medicine Hat, Alberta, municipal","48062","Offences against the person and reputation (Part VIII Criminal Code)","0","0","0","0","0","0","0","0","0","0","0","0","0","0"
"2006","Medicine Hat, Alberta, municipal","48062","Offences against the person and reputation (Part VIII Criminal Code)","0","0","0","0","0","0","0","0","0","0","0","0","0","0"
"2007","Medicine Hat, Alberta, municipal","48062","Offences against the person and reputation (Part VIII Criminal Code)","0","0","0","0","0","0","0","0","0","0","0","0","0","0"
"2008","Medicine Hat, Alberta, municipal","48062","Offences against the person and reputation (Part VIII Criminal Code)","0","0","0","0","0","0","0","0","0","0","0","0","0","0"
"2009","Medicine Hat, Alberta, municipal","48062","Offences against the person and reputation (Part VIII Criminal Code)","0","0","0","0","0","0","0","0","0","0","0","0","0","0"
"2010","Medicine Hat, Alberta, municipal","48062","Offences against the person and reputation (Part VIII Criminal Code)","0","0","0","0","0","0","0","0","0","0","0","0","0","0"
"2011","Medicine Hat, Alberta, municipal","48062","Offences against the person and reputation (Part VIII Criminal Code)","2","2","0","0","3.23","4.07","3.74","0","0","2","2","2","0","0"
"2012","Medicine Hat, Alberta, municipal","48062","Offences against the person and reputation (Part VIII Criminal Code)","0","0","0","-100","0","0","0","0","0","0","0","0","0","0"
"2013","Medicine Hat, Alberta, municipal","48062","Offences against the person and reputation (Part VIII Criminal Code)","1","1","0","0","1.57","1.98","1.83","0","0","1","1","1","0","0"
"2014","Medicine Hat, Alberta, municipal","48062","Offences against the person and reputation (Part VIII Criminal Code)","0","0","0","-100","0","0","0","0","0","0","0","0","0","0"
"2015","Medicine Hat, Alberta, municipal","48062","Offences against the person and reputation (Part VIII Criminal Code)","0","0","0","0","0","0","0","0","0","0","0","0","0","0"
"2016","Medicine Hat, Alberta, municipal","48062","Offences against the person and reputation (Part VIII Criminal Code)","0","0","0","0","0","0","0","0","0","0","0","0","0","0"
"2012","Medicine Hat, Alberta, municipal","48062","Failure to comply with the regulations/obligations for medical assistance in dying","0","0","0","0","0","0","0","0","0","0","0","0","0","0"
"2013","Medicine Hat, Alberta, municipal","48062","Failure to comply with the regulations/obligations for medical assistance in dying","0","0","0","0","0","0","0","0","0","0","0","0","0","0"
"2014","Medicine Hat, Alberta, municipal","48062","Failure to comply with the regulations/obligations for medical assistance in dying","0","0","0","0","0","0","0","0","0","0","0","0","0","0"
"2015","Medicine Hat, Alberta, municipal","48062","Failure to comply with the regulations/obligations for medical assistance in dying","0","0","0","0","0","0","0","0","0","0","0","0","0","0"
"2016","Medicine Hat, Alberta, municipal","48062","Failure to comply with the regulations/obligations for medical assistance in dying","0","0","0","0","0","0","0","0","0","0","0","0","0","0"
"1998","Medicine Hat, Alberta, municipal","48062","Offences against rights of property (Part IX Criminal Code)","2","2","0","0","4.02","0","0","0","0","2","2","4","2","0"
"1999","Medicine Hat, Alberta, municipal","48062","Offences against rights of property (Part IX Criminal Code)","3","3","0","47.17","5.92","0","0","0","0","3","3","4","1","0"
"2000","Medicine Hat, Alberta, municipal","48062","Offences against rights of property (Part IX Criminal Code)","3","3","0","-2.24","5.79","0","0","0","0","3","3","5","2","0"
"2001","Medicine Hat, Alberta, municipal","48062","Offences against rights of property (Part IX Criminal Code)","0","0","0","-100","0","0","0","0","0","0","0","0","0","0"
"2002","Medicine Hat, Alberta, municipal","48062","Offences against rights of property (Part IX Criminal Code)","0","0","0","0","0","0","0","0","0","0","0","0","0","0"
"2003","Medicine Hat, Alberta, municipal","48062","Offences against rights of property (Part IX Criminal Code)","2","1","0","0","3.69","0","0","0","0","1","2","2","0","0"
"2004","Medicine Hat, Alberta, municipal","48062","Offences against rights of property (Part IX Criminal Code)","2","2","0","-2.97","3.58","4.58","4.16","0","0","2","2","2","0","0"
"2005","Medicine Hat, Alberta, municipal","48062","Offences against rights of property (Part IX Criminal Code)","0","0","0","-100","0","0","0","0","0","0","0","0","0","0"
"2006","Medicine Hat, Alberta, municipal","48062","Offences against rights of property (Part IX Criminal Code)","2","1","0","0","3.39","4.31","3.93","0","0","1","2","2","0","0"
"2007","Medicine Hat, Alberta, municipal","48062","Offences against rights of property (Part IX Criminal Code)","0","0","0","-100","0","0","0","0","0","0","0","0","0","0"
"2008","Medicine Hat, Alberta, municipal","48062","Offences against rights of property (Part IX Criminal Code)","4","4","0","0","6.52","4.12","11.33","89.89","0","4","2","6","4","0"
"2009","Medicine Hat, Alberta, municipal","48062","Offences against rights of property (Part IX Criminal Code)","2","2","0","-50.53","3.23","2.04","9.35","91.37","0","2","1","5","4","0"
"2010","Medicine Hat, Alberta, municipal","48062","Offences against rights of property (Part IX Criminal Code)","5","5","0","149.97","8.06","8.15","9.35","22.93","0","5","4","5","1","0"
"2011","Medicine Hat, Alberta, municipal","48062","Offences against rights of property (Part IX Criminal Code)","0","0","0","-100","0","0","0","0","0","0","0","0","0","0"
"2012","Medicine Hat, Alberta, municipal","48062","Offences against rights of property (Part IX Criminal Code)","5","5","0","0","7.97","8.04","12.93","68.51","0","5","4","7","3","0"
"2013","Medicine Hat, Alberta, municipal","48062","Offences against rights of property (Part IX Criminal Code)","0","0","0","-100","0","0","0","0","0","0","0","0","0","0"
"2014","Medicine Hat, Alberta, municipal","48062","Offences against rights of property (Part IX Criminal Code)","1","1","0","0","1.56","1.96","1.81","0","0","1","1","1","0","0"
"2015","Medicine Hat, Alberta, municipal","48062","Offences against rights of property (Part IX Criminal Code)","3","3","0","197.72","4.65","9.76","9","0","0","3","5","5","0","0"
"2016","Medicine Hat, Alberta, municipal","48062","Offences against rights of property (Part IX Criminal Code)","5","5","0","65.65","7.7","9.72","10.75","22.93","0","5","5","6","1","0"
"1998","Medicine Hat, Alberta, municipal","48062","Fraudulent transactions relating to contracts and trade (Part X Criminal Code)","0","0","0","0","0","0","0","0","0","0","0","0","0","0"
"1999","Medicine Hat, Alberta, municipal","48062","Fraudulent transactions relating to contracts and trade (Part X Criminal Code)","1","0","0","0","1.97","0","0","0","0","0","0","0","0","0"
"2000","Medicine Hat, Alberta, municipal","48062","Fraudulent transactions relating to contracts and trade (Part X Criminal Code)","1","0","0","-2.24","1.93","0","0","0","0","0","0","0","0","0"
"2001","Medicine Hat, Alberta, municipal","48062","Fraudulent transactions relating to contracts and trade (Part X Criminal Code)","1","0","0","-1.44","1.9","0","0","0","0","0","0","0","0","0"
"2002","Medicine Hat, Alberta, municipal","48062","Fraudulent transactions relating to contracts and trade (Part X Criminal Code)","2","0","0","96.87","3.74","0","0","0","0","0","0","0","0","0"
"2003","Medicine Hat, Alberta, municipal","48062","Fraudulent transactions relating to contracts and trade (Part X Criminal Code)","3","0","0","47.83","5.54","0","0","0","0","0","0","0","0","0"
"2004","Medicine Hat, Alberta, municipal","48062","Fraudulent transactions relating to contracts and trade (Part X Criminal Code)","3","1","1","-2.97","5.37","2.29","2.08","0","0","2","1","1","0","0"
"2005","Medicine Hat, Alberta, municipal","48062","Fraudulent transactions relating to contracts and trade (Part X Criminal Code)","3","2","0","-2.72","5.23","4.44","4.04","0","0","2","2","2","0","0"
"2006","Medicine Hat, Alberta, municipal","48062","Fraudulent transactions relating to contracts and trade (Part X Criminal Code)","4","2","1","29.85","6.79","4.31","3.93","0","0","3","2","2","0","0"
"2007","Medicine Hat, Alberta, municipal","48062","Fraudulent transactions relating to contracts and trade (Part X Criminal Code)","3","1","0","-26.75","4.97","2.1","1.92","0","0","1","1","1","0","0"
"2008","Medicine Hat, Alberta, municipal","48062","Fraudulent transactions relating to contracts and trade (Part X Criminal Code)","0","0","0","-100","0","0","0","0","0","0","0","0","0","0"
"2009","Medicine Hat, Alberta, municipal","48062","Fraudulent transactions relating to contracts and trade (Part X Criminal Code)","0","0","0","0","0","0","0","0","0","0","0","0","0","0"
"2010","Medicine Hat, Alberta, municipal","48062","Fraudulent transactions relating to contracts and trade (Part X Criminal Code)","3","1","0","0","4.84","2.04","1.87","0","0","1","1","1","0","0"
"2011","Medicine Hat, Alberta, municipal","48062","Fraudulent transactions relating to contracts and trade (Part X Criminal Code)","0","0","0","-100","0","0","0","0","0","0","0","0","0","0"
"2012","Medicine Hat, Alberta, municipal","48062","Fraudulent transactions relating to contracts and trade (Part X Criminal Code)","0","0","0","0","0","0","0","0","0","0","0","0","0","0"
"2013","Medicine Hat, Alberta, municipal","48062","Fraudulent transactions relating to contracts and trade (Part X Criminal Code)","1","0","0","0","1.57","0","0","0","0","0","0","0","0","0"
"2014","Medicine Hat, Alberta, municipal","48062","Fraudulent transactions relating to contracts and trade (Part X Criminal Code)","0","0","0","-100","0","0","0","0","0","0","0","0","0","0"
"2015","Medicine Hat, Alberta, municipal","48062","Fraudulent transactions relating to contracts and trade (Part X Criminal Code)","1","1","0","0","1.55","1.95","1.8","0","0","1","1","1","0","0"
"2016","Medicine Hat, Alberta, municipal","48062","Fraudulent transactions relating to contracts and trade (Part X Criminal Code)","1","0","0","-0.61","1.54","0","0","0","0","0","0","0","0","0"
"1998","Medicine Hat, Alberta, municipal","48062","Willful and forbidden acts in respect of certain property (Part XI Criminal Code)","1","1","0","0","2.01","0","0","0","0","1","0","0","0","0"
"1999","Medicine Hat, Alberta, municipal","48062","Willful and forbidden acts in respect of certain property (Part XI Criminal Code)","1","0","0","-1.89","1.97","0","0","0","0","0","0","0","0","0"
"2000","Medicine Hat, Alberta, municipal","48062","Willful and forbidden acts in respect of certain property (Part XI Criminal Code)","1","0","0","-2.24","1.93","0","0","0","0","0","0","0","0","0"
"2001","Medicine Hat, Alberta, municipal","48062","Willful and forbidden acts in respect of certain property (Part XI Criminal Code)","1","0","0","-1.44","1.9","0","0","0","0","0","0","0","0","0"
"2002","Medicine Hat, Alberta, municipal","48062","Willful and forbidden acts in respect of certain property (Part XI Criminal Code)","1","1","0","-1.56","1.87","0","0","0","0","1","1","1","0","0"
"2003","Medicine Hat, Alberta, municipal","48062","Willful and forbidden acts in respect of certain property (Part XI Criminal Code)","2","1","0","97.11","3.69","0","0","0","0","1","1","1","0","0"
"2004","Medicine Hat, Alberta, municipal","48062","Willful and forbidden acts in respect of certain property (Part XI Criminal Code)","2","1","0","-2.97","3.58","2.29","2.08","0","0","1","1","1","0","0"
"2005","Medicine Hat, Alberta, municipal","48062","Willful and forbidden acts in respect of certain property (Part XI Criminal Code)","1","1","0","-51.36","1.74","0","2.02","22.2","0","1","0","1","1","0"
"2006","Medicine Hat, Alberta, municipal","48062","Willful and forbidden acts in respect of certain property (Part XI Criminal Code)","2","0","0","94.77","3.39","0","0","0","0","0","0","0","0","0"
"2007","Medicine Hat, Alberta, municipal","48062","Willful and forbidden acts in respect of certain property (Part XI Criminal Code)","0","0","0","-100","0","0","0","0","0","0","0","0","0","0"
"2008","Medicine Hat, Alberta, municipal","48062","Willful and forbidden acts in respect of certain property (Part XI Criminal Code)","2","2","0","0","3.26","4.12","3.78","0","0","2","2","2","0","0"
"2009","Medicine Hat, Alberta, municipal","48062","Willful and forbidden acts in respect of certain property (Part XI Criminal Code)","5","2","0","147.33","8.06","4.07","3.74","0","0","2","2","2","0","0"
"2010","Medicine Hat, Alberta, municipal","48062","Willful and forbidden acts in respect of certain property (Part XI Criminal Code)","3","2","0","-40.01","4.84","4.07","3.74","0","0","2","2","2","0","0"
"2011","Medicine Hat, Alberta, municipal","48062","Willful and forbidden acts in respect of certain property (Part XI Criminal Code)","2","0","1","-33.32","3.23","0","0","0","0","1","0","0","0","0"
"2012","Medicine Hat, Alberta, municipal","48062","Willful and forbidden acts in respect of certain property (Part XI Criminal Code)","2","0","0","-1.2","3.19","0","0","0","0","0","0","0","0","0"
"2013","Medicine Hat, Alberta, municipal","48062","Willful and forbidden acts in respect of certain property (Part XI Criminal Code)","0","0","0","-100","0","0","0","0","0","0","0","0","0","0"
"2014","Medicine Hat, Alberta, municipal","48062","Willful and forbidden acts in respect of certain property (Part XI Criminal Code)","1","0","0","0","1.56","0","0","0","0","0","0","0","0","0"
"2015","Medicine Hat, Alberta, municipal","48062","Willful and forbidden acts in respect of certain property (Part XI Criminal Code)","5","3","1","396.21","7.74","3.9","3.6","0","46.09","4","2","2","0","2"
"2016","Medicine Hat, Alberta, municipal","48062","Willful and forbidden acts in respect of certain property (Part XI Criminal Code)","3","2","0","-40.37","4.62","3.89","3.58","0","0","2","2","2","0","0"
"1998","Medicine Hat, Alberta, municipal","48062","Offences relating to currency (Part XII Criminal Code)","0","0","0","0","0","0","0","0","0","0","0","0","0","0"
"1999","Medicine Hat, Alberta, municipal","48062","Offences relating to currency (Part XII Criminal Code)","0","0","0","0","0","0","0","0","0","0","0","0","0","0"
"2000","Medicine Hat, Alberta, municipal","48062","Offences relating to currency (Part XII Criminal Code)","0","0","0","0","0","0","0","0","0","0","0","0","0","0"
"2001","Medicine Hat, Alberta, municipal","48062","Offences relating to currency (Part XII Criminal Code)","0","0","0","0","0","0","0","0","0","0","0","0","0","0"
"2002","Medicine Hat, Alberta, municipal","48062","Offences relating to currency (Part XII Criminal Code)","0","0","0","0","0","0","0","0","0","0","0","0","0","0"
"2003","Medicine Hat, Alberta, municipal","48062","Offences relating to currency (Part XII Criminal Code)","6","2","0","0","11.07","0","0","0","0","2","1","1","0","0"
"2004","Medicine Hat, Alberta, municipal","48062","Offences relating to currency (Part XII Criminal Code)","12","1","0","94.07","21.49","0","0","0","0","1","0","0","0","0"
"2005","Medicine Hat, Alberta, municipal","48062","Offences relating to currency (Part XII Criminal Code)","6","0","0","-51.36","10.45","0","0","0","0","0","0","0","0","0"
"2006","Medicine Hat, Alberta, municipal","48062","Offences relating to currency (Part XII Criminal Code)","1","0","0","-83.77","1.7","0","0","0","0","0","0","0","0","0"
"2007","Medicine Hat, Alberta, municipal","48062","Offences relating to currency (Part XII Criminal Code)","2","0","0","95.33","3.31","0","0","0","0","0","0","0","0","0"
"2008","Medicine Hat, Alberta, municipal","48062","Offences relating to currency (Part XII Criminal Code)","0","0","0","-100","0","0","0","0","0","0","0","0","0","0"
"2009","Medicine Hat, Alberta, municipal","48062","Offences relating to currency (Part XII Criminal Code)","0","0","0","0","0","0","0","0","0","0","0","0","0","0"
"2010","Medicine Hat, Alberta, municipal","48062","Offences relating to currency (Part XII Criminal Code)","2","2","0","0","3.23","2.04","1.87","0","0","2","1","1","0","0"
"2011","Medicine Hat, Alberta, municipal","48062","Offences relating to currency (Part XII Criminal Code)","1","0","0","-49.99","1.61","0","0","0","0","0","0","0","0","0"
"2012","Medicine Hat, Alberta, municipal","48062","Offences relating to currency (Part XII Criminal Code)","1","1","0","-1.2","1.59","2.01","1.85","0","0","1","1","1","0","0"
"2013","Medicine Hat, Alberta, municipal","48062","Offences relating to currency (Part XII Criminal Code)","0","0","0","-100","0","0","0","0","0","0","0","0","0","0"
"2014","Medicine Hat, Alberta, municipal","48062","Offences relating to currency (Part XII Criminal Code)","0","0","0","0","0","0","0","0","0","0","0","0","0","0"
"2015","Medicine Hat, Alberta, municipal","48062","Offences relating to currency (Part XII Criminal Code)","0","0","0","0","0","0","0","0","0","0","0","0","0","0"
"2016","Medicine Hat, Alberta, municipal","48062","Offences relating to currency (Part XII Criminal Code)","2","0","0","0","3.08","0","0","0","0","0","0","0","0","0"
"1998","Medicine Hat, Alberta, municipal","48062","Proceeds of crime (Part XII.2 Criminal Code)","0","0","0","0","0","0","0","0","0","0","0","0","0","0"
"1999","Medicine Hat, Alberta, municipal","48062","Proceeds of crime (Part XII.2 Criminal Code)","0","0","0","0","0","0","0","0","0","0","0","0","0","0"
"2000","Medicine Hat, Alberta, municipal","48062","Proceeds of crime (Part XII.2 Criminal Code)","0","0","0","0","0","0","0","0","0","0","0","0","0","0"
"2001","Medicine Hat, Alberta, municipal","48062","Proceeds of crime (Part XII.2 Criminal Code)","0","0","0","0","0","0","0","0","0","0","0","0","0","0"
"2002","Medicine Hat, Alberta, municipal","48062","Proceeds of crime (Part XII.2 Criminal Code)","0","0","0","0","0","0","0","0","0","0","0","0","0","0"
"2003","Medicine Hat, Alberta, municipal","48062","Proceeds of crime (Part XII.2 Criminal Code)","2","1","0","0","3.69","0","0","0","0","1","1","2","1","0"
"2004","Medicine Hat, Alberta, municipal","48062","Proceeds of crime (Part XII.2 Criminal Code)","2","1","1","-2.97","3.58","2.29","2.08","0","0","2","1","1","0","0"
"2005","Medicine Hat, Alberta, municipal","48062","Proceeds of crime (Part XII.2 Criminal Code)","6","6","0","191.85","10.45","19.99","20.19","22.2","0","6","9","10","1","0"
"2006","Medicine Hat, Alberta, municipal","48062","Proceeds of crime (Part XII.2 Criminal Code)","5","5","0","-18.85","8.48","12.93","11.79","0","0","5","6","6","0","0"
"2007","Medicine Hat, Alberta, municipal","48062","Proceeds of crime (Part XII.2 Criminal Code)","3","3","0","-41.4","4.97","10.49","9.59","0","0","3","5","5","0","0"
"2008","Medicine Hat, Alberta, municipal","48062","Proceeds of crime (Part XII.2 Criminal Code)","3","3","0","-1.6","4.89","10.31","9.44","0","0","3","5","5","0","0"
"2009","Medicine Hat, Alberta, municipal","48062","Proceeds of crime (Part XII.2 Criminal Code)","2","1","0","-34.04","3.23","4.07","3.74","0","0","1","2","2","0","0"
"2010","Medicine Hat, Alberta, municipal","48062","Proceeds of crime (Part XII.2 Criminal Code)","4","4","0","99.97","6.45","12.22","11.22","0","0","4","6","6","0","0"
"2011","Medicine Hat, Alberta, municipal","48062","Proceeds of crime (Part XII.2 Criminal Code)","10","8","0","150.03","16.13","18.32","16.83","0","0","8","9","9","0","0"
"2012","Medicine Hat, Alberta, municipal","48062","Proceeds of crime (Part XII.2 Criminal Code)","5","3","0","-50.6","7.97","12.06","11.09","0","0","3","6","6","0","0"
"2013","Medicine Hat, Alberta, municipal","48062","Proceeds of crime (Part XII.2 Criminal Code)","6","7","0","18.52","9.44","25.79","23.74","0","0","7","13","13","0","0"
"2014","Medicine Hat, Alberta, municipal","48062","Proceeds of crime (Part XII.2 Criminal Code)","1","1","0","-83.48","1.56","1.96","1.81","0","0","1","1","1","0","0"
"2015","Medicine Hat, Alberta, municipal","48062","Proceeds of crime (Part XII.2 Criminal Code)","1","1","0","-0.76","1.55","3.9","3.6","0","0","1","2","2","0","0"
"2016","Medicine Hat, Alberta, municipal","48062","Proceeds of crime (Part XII.2 Criminal Code)","2","0","0","98.78","3.08","0","0","0","0","0","0","0","0","0"
"1998","Medicine Hat, Alberta, municipal","48062","Attempts, conspiracies, accessories (Part XIII Criminal Code)","2","0","0","0","4.02","0","0","0","0","0","0","0","0","0"
"1999","Medicine Hat, Alberta, municipal","48062","Attempts, conspiracies, accessories (Part XIII Criminal Code)","2","1","0","-1.89","3.95","0","0","0","0","1","1","1","0","0"
"2000","Medicine Hat, Alberta, municipal","48062","Attempts, conspiracies, accessories (Part XIII Criminal Code)","1","1","0","-51.12","1.93","0","0","0","0","1","1","1","0","0"
"2001","Medicine Hat, Alberta, municipal","48062","Attempts, conspiracies, accessories (Part XIII Criminal Code)","0","0","0","-100","0","0","0","0","0","0","0","0","0","0"
"2002","Medicine Hat, Alberta, municipal","48062","Attempts, conspiracies, accessories (Part XIII Criminal Code)","0","0","0","0","0","0","0","0","0","0","0","0","0","0"
"2003","Medicine Hat, Alberta, municipal","48062","Attempts, conspiracies, accessories (Part XIII Criminal Code)","0","0","0","0","0","0","0","0","0","0","0","0","0","0"
"2004","Medicine Hat, Alberta, municipal","48062","Attempts, conspiracies, accessories (Part XIII Criminal Code)","0","0","0","0","0","0","0","0","0","0","0","0","0","0"
"2005","Medicine Hat, Alberta, municipal","48062","Attempts, conspiracies, accessories (Part XIII Criminal Code)","0","0","0","0","0","0","0","0","0","0","0","0","0","0"
"2006","Medicine Hat, Alberta, municipal","48062","Attempts, conspiracies, accessories (Part XIII Criminal Code)","1","1","0","0","1.7","2.15","1.96","0","0","1","1","1","0","0"
"2007","Medicine Hat, Alberta, municipal","48062","Attempts, conspiracies, accessories (Part XIII Criminal Code)","0","0","0","-100","0","0","0","0","0","0","0","0","0","0"
"2008","Medicine Hat, Alberta, municipal","48062","Attempts, conspiracies, accessories (Part XIII Criminal Code)","0","0","0","0","0","0","0","0","0","0","0","0","0","0"
"2009","Medicine Hat, Alberta, municipal","48062","Attempts, conspiracies, accessories (Part XIII Criminal Code)","0","0","0","0","0","0","0","0","0","0","0","0","0","0"
"2010","Medicine Hat, Alberta, municipal","48062","Attempts, conspiracies, accessories (Part XIII Criminal Code)","0","0","0","0","0","0","0","0","0","0","0","0","0","0"
"2011","Medicine Hat, Alberta, municipal","48062","Attempts, conspiracies, accessories (Part XIII Criminal Code)","1","0","0","0","1.61","0","0","0","0","0","0","0","0","0"
"2012","Medicine Hat, Alberta, municipal","48062","Attempts, conspiracies, accessories (Part XIII Criminal Code)","0","0","0","-100","0","0","0","0","0","0","0","0","0","0"
"2013","Medicine Hat, Alberta, municipal","48062","Attempts, conspiracies, accessories (Part XIII Criminal Code)","0","0","0","0","0","0","0","0","0","0","0","0","0","0"
"2014","Medicine Hat, Alberta, municipal","48062","Attempts, conspiracies, accessories (Part XIII Criminal Code)","0","0","0","0","0","0","0","0","0","0","0","0","0","0"
"2015","Medicine Hat, Alberta, municipal","48062","Attempts, conspiracies, accessories (Part XIII Criminal Code)","0","0","0","0","0","0","0","0","0","0","0","0","0","0"
"2016","Medicine Hat, Alberta, municipal","48062","Attempts, conspiracies, accessories (Part XIII Criminal Code)","2","1","1","0","3.08","3.89","3.58","0","0","2","2","2","0","0"
"2002","Medicine Hat, Alberta, municipal","48062","Instruct offence for criminal organization","0","0","0","0","0","0","0","0","0","0","0","0","0","0"
"2003","Medicine Hat, Alberta, municipal","48062","Instruct offence for criminal organization","0","0","0","0","0","0","0","0","0","0","0","0","0","0"
"2004","Medicine Hat, Alberta, municipal","48062","Instruct offence for criminal organization","0","0","0","0","0","0","0","0","0","0","0","0","0","0"
"2005","Medicine Hat, Alberta, municipal","48062","Instruct offence for criminal organization","0","0","0","0","0","0","0","0","0","0","0","0","0","0"
"2006","Medicine Hat, Alberta, municipal","48062","Instruct offence for criminal organization","0","0","0","0","0","0","0","0","0","0","0","0","0","0"
"2007","Medicine Hat, Alberta, municipal","48062","Instruct offence for criminal organization","0","0","0","0","0","0","0","0","0","0","0","0","0","0"
"2008","Medicine Hat, Alberta, municipal","48062","Instruct offence for criminal organization","0","0","0","0","0","0","0","0","0","0","0","0","0","0"
"2009","Medicine Hat, Alberta, municipal","48062","Instruct offence for criminal organization","0","0","0","0","0","0","0","0","0","0","0","0","0","0"
"2010","Medicine Hat, Alberta, municipal","48062","Instruct offence for criminal organization","0","0","0","0","0","0","0","0","0","0","0","0","0","0"
"2011","Medicine Hat, Alberta, municipal","48062","Instruct offence for criminal organization","0","0","0","0","0","0","0","0","0","0","0","0","0","0"
"2012","Medicine Hat, Alberta, municipal","48062","Instruct offence for criminal organization","0","0","0","0","0","0","0","0","0","0","0","0","0","0"
"2013","Medicine Hat, Alberta, municipal","48062","Instruct offence for criminal organization","0","0","0","0","0","0","0","0","0","0","0","0","0","0"
"2014","Medicine Hat, Alberta, municipal","48062","Instruct offence for criminal organization","0","0","0","0","0","0","0","0","0","0","0","0","0","0"
"2015","Medicine Hat, Alberta, municipal","48062","Instruct offence for criminal organization","0","0","0","0","0","0","0","0","0","0","0","0","0","0"
"2016","Medicine Hat, Alberta, municipal","48062","Instruct offence for criminal organization","0","0","0","0","0","0","0","0","0","0","0","0","0","0"
"2002","Medicine Hat, Alberta, municipal","48062","Commit offence for criminal organization","0","0","0","0","0","0","0","0","0","0","0","0","0","0"
"2003","Medicine Hat, Alberta, municipal","48062","Commit offence for criminal organization","0","0","0","0","0","0","0","0","0","0","0","0","0","0"
"2004","Medicine Hat, Alberta, municipal","48062","Commit offence for criminal organization","0","0","0","0","0","0","0","0","0","0","0","0","0","0"
"2005","Medicine Hat, Alberta, municipal","48062","Commit offence for criminal organization","0","0","0","0","0","0","0","0","0","0","0","0","0","0"
"2006","Medicine Hat, Alberta, municipal","48062","Commit offence for criminal organization","0","0","0","0","0","0","0","0","0","0","0","0","0","0"
"2007","Medicine Hat, Alberta, municipal","48062","Commit offence for criminal organization","0","0","0","0","0","0","0","0","0","0","0","0","0","0"
"2008","Medicine Hat, Alberta, municipal","48062","Commit offence for criminal organization","0","0","0","0","0","0","0","0","0","0","0","0","0","0"
"2009","Medicine Hat, Alberta, municipal","48062","Commit offence for criminal organization","0","0","0","0","0","0","0","0","0","0","0","0","0","0"
"2010","Medicine Hat, Alberta, municipal","48062","Commit offence for criminal organization","0","0","0","0","0","0","0","0","0","0","0","0","0","0"
"2011","Medicine Hat, Alberta, municipal","48062","Commit offence for criminal organization","0","0","0","0","0","0","0","0","0","0","0","0","0","0"
"2012","Medicine Hat, Alberta, municipal","48062","Commit offence for criminal organization","0","0","0","0","0","0","0","0","0","0","0","0","0","0"
"2013","Medicine Hat, Alberta, municipal","48062","Commit offence for criminal organization","0","0","0","0","0","0","0","0","0","0","0","0","0","0"
"2014","Medicine Hat, Alberta, municipal","48062","Commit offence for criminal organization","0","0","0","0","0","0","0","0","0","0","0","0","0","0"
"2015","Medicine Hat, Alberta, municipal","48062","Commit offence for criminal organization","0","0","0","0","0","0","0","0","0","0","0","0","0","0"
"2016","Medicine Hat, Alberta, municipal","48062","Commit offence for criminal organization","0","0","0","0","0","0","0","0","0","0","0","0","0","0"
"2002","Medicine Hat, Alberta, municipal","48062","Participate in activities of criminal organization","0","0","0","0","0","0","0","0","0","0","0","0","0","0"
"2003","Medicine Hat, Alberta, municipal","48062","Participate in activities of criminal organization","0","0","0","0","0","0","0","0","0","0","0","0","0","0"
"2004","Medicine Hat, Alberta, municipal","48062","Participate in activities of criminal organization","0","0","0","0","0","0","0","0","0","0","0","0","0","0"
"2005","Medicine Hat, Alberta, municipal","48062","Participate in activities of criminal organization","0","0","0","0","0","0","0","0","0","0","0","0","0","0"
"2006","Medicine Hat, Alberta, municipal","48062","Participate in activities of criminal organization","0","0","0","0","0","0","0","0","0","0","0","0","0","0"
"2007","Medicine Hat, Alberta, municipal","48062","Participate in activities of criminal organization","0","0","0","0","0","0","0","0","0","0","0","0","0","0"
"2008","Medicine Hat, Alberta, municipal","48062","Participate in activities of criminal organization","0","0","0","0","0","0","0","0","0","0","0","0","0","0"
"2009","Medicine Hat, Alberta, municipal","48062","Participate in activities of criminal organization","0","0","0","0","0","0","0","0","0","0","0","0","0","0"
"2010","Medicine Hat, Alberta, municipal","48062","Participate in activities of criminal organization","0","0","0","0","0","0","0","0","0","0","0","0","0","0"
"2011","Medicine Hat, Alberta, municipal","48062","Participate in activities of criminal organization","0","0","0","0","0","0","0","0","0","0","0","0","0","0"
"2012","Medicine Hat, Alberta, municipal","48062","Participate in activities of criminal organization","0","0","0","0","0","0","0","0","0","0","0","0","0","0"
"2013","Medicine Hat, Alberta, municipal","48062","Participate in activities of criminal organization","0","0","0","0","0","0","0","0","0","0","0","0","0","0"
"2014","Medicine Hat, Alberta, municipal","48062","Participate in activities of criminal organization","0","0","0","0","0","0","0","0","0","0","0","0","0","0"
"2015","Medicine Hat, Alberta, municipal","48062","Participate in activities of criminal organization","0","0","0","0","0","0","0","0","0","0","0","0","0","0"
"2016","Medicine Hat, Alberta, municipal","48062","Participate in activities of criminal organization","0","0","0","0","0","0","0","0","0","0","0","0","0","0"
"2012","Medicine Hat, Alberta, municipal","48062","Recruitment of members by a criminal organization","0","0","0","0","0","0","0","0","0","0","0","0","0","0"
"2013","Medicine Hat, Alberta, municipal","48062","Recruitment of members by a criminal organization","0","0","0","0","0","0","0","0","0","0","0","0","0","0"
"2014","Medicine Hat, Alberta, municipal","48062","Recruitment of members by a criminal organization","0","0","0","0","0","0","0","0","0","0","0","0","0","0"
"2015","Medicine Hat, Alberta, municipal","48062","Recruitment of members by a criminal organization","0","0","0","0","0","0","0","0","0","0","0","0","0","0"
"2016","Medicine Hat, Alberta, municipal","48062","Recruitment of members by a criminal organization","0","0","0","0","0","0","0","0","0","0","0","0","0","0"
"1998","Medicine Hat, Alberta, municipal","48062","All other Criminal Code (includes Part XII.1 Criminal Code)","2","1","0","0","4.02","0","0","0","0","1","1","1","0","0"
"1999","Medicine Hat, Alberta, municipal","48062","All other Criminal Code (includes Part XII.1 Criminal Code)","3","1","0","47.17","5.92","0","0","0","0","1","1","1","0","0"
"2000","Medicine Hat, Alberta, municipal","48062","All other Criminal Code (includes Part XII.1 Criminal Code)","3","1","0","-2.24","5.79","0","0","0","0","1","1","1","0","0"
"2001","Medicine Hat, Alberta, municipal","48062","All other Criminal Code (includes Part XII.1 Criminal Code)","0","0","0","-100","0","0","0","0","0","0","0","0","0","0"
"2002","Medicine Hat, Alberta, municipal","48062","All other Criminal Code (includes Part XII.1 Criminal Code)","0","0","0","0","0","0","0","0","0","0","0","0","0","0"
"2003","Medicine Hat, Alberta, municipal","48062","All other Criminal Code (includes Part XII.1 Criminal Code)","0","0","0","0","0","0","0","0","0","0","0","0","0","0"
"2004","Medicine Hat, Alberta, municipal","48062","All other Criminal Code (includes Part XII.1 Criminal Code)","0","0","0","0","0","0","0","0","0","0","0","0","0","0"
"2005","Medicine Hat, Alberta, municipal","48062","All other Criminal Code (includes Part XII.1 Criminal Code)","0","0","0","0","0","0","0","0","0","0","0","0","0","0"
"2006","Medicine Hat, Alberta, municipal","48062","All other Criminal Code (includes Part XII.1 Criminal Code)","0","0","0","0","0","0","0","0","0","0","0","0","0","0"
"2007","Medicine Hat, Alberta, municipal","48062","All other Criminal Code (includes Part XII.1 Criminal Code)","0","0","0","0","0","0","0","0","0","0","0","0","0","0"
"2008","Medicine Hat, Alberta, municipal","48062","All other Criminal Code (includes Part XII.1 Criminal Code)","0","0","0","0","0","0","0","0","0","0","0","0","0","0"
"2009","Medicine Hat, Alberta, municipal","48062","All other Criminal Code (includes Part XII.1 Criminal Code)","0","0","0","0","0","0","0","0","0","0","0","0","0","0"
"2010","Medicine Hat, Alberta, municipal","48062","All other Criminal Code (includes Part XII.1 Criminal Code)","1","0","0","0","1.61","0","0","0","0","0","0","0","0","0"
"2011","Medicine Hat, Alberta, municipal","48062","All other Criminal Code (includes Part XII.1 Criminal Code)","0","0","0","-100","0","0","0","0","0","0","0","0","0","0"
"2012","Medicine Hat, Alberta, municipal","48062","All other Criminal Code (includes Part XII.1 Criminal Code)","1","1","0","0","1.59","2.01","1.85","0","0","1","1","1","0","0"
"2013","Medicine Hat, Alberta, municipal","48062","All other Criminal Code (includes Part XII.1 Criminal Code)","0","0","0","-100","0","0","0","0","0","0","0","0","0","0"
"2014","Medicine Hat, Alberta, municipal","48062","All other Criminal Code (includes Part XII.1 Criminal Code)","0","0","0","0","0","0","0","0","0","0","0","0","0","0"
"2015","Medicine Hat, Alberta, municipal","48062","All other Criminal Code (includes Part XII.1 Criminal Code)","0","0","0","0","0","0","0","0","0","0","0","0","0","0"
"2016","Medicine Hat, Alberta, municipal","48062","All other Criminal Code (includes Part XII.1 Criminal Code)","1","1","0","0","1.54","1.94","1.79","0","0","1","1","1","0","0"
"1998","Medicine Hat, Alberta, municipal","48062","Total Criminal Code traffic violations","219","205","1","0","440.66","0","0","0","0","206","210","210","0","0"
"1999","Medicine Hat, Alberta, municipal","48062","Total Criminal Code traffic violations","199","208","0","-10.85","392.86","0","0","0","0","208","211","211","0","0"
"2000","Medicine Hat, Alberta, municipal","48062","Total Criminal Code traffic violations","216","200","1","6.11","416.87","0","0","0","0","201","206","206","0","0"
"2001","Medicine Hat, Alberta, municipal","48062","Total Criminal Code traffic violations","213","201","0","-2.81","405.16","0","0","0","0","201","202","202","0","0"
"2002","Medicine Hat, Alberta, municipal","48062","Total Criminal Code traffic violations","254","249","1","17.38","475.59","0","0","0","0","250","253","254","1","0"
"2003","Medicine Hat, Alberta, municipal","48062","Total Criminal Code traffic violations","223","207","0","-13.47","411.52","0","0","0","0","207","206","206","0","0"
"2004","Medicine Hat, Alberta, municipal","48062","Total Criminal Code traffic violations","229","240","3","-0.36","410.05","549.56","498.85","0","0","243","240","240","0","0"
"2005","Medicine Hat, Alberta, municipal","48062","Total Criminal Code traffic violations","248","219","2","5.36","432.01","495.35","450.3","0","0","221","223","223","0","0"
"2006","Medicine Hat, Alberta, municipal","48062","Total Criminal Code traffic violations","242","219","2","-4.97","410.54","484.81","441.99","0","0","221","225","225","0","0"
"2007","Medicine Hat, Alberta, municipal","48062","Total Criminal Code traffic violations","362","355","1","46.09","599.76","736.74","688.64","178.17","0","356","351","359","8","0"
"2008","Medicine Hat, Alberta, municipal","48062","Total Criminal Code traffic violations","368","363","2","0.03","599.97","731.99","687.47","202.25","0","365","355","364","9","0"
"2009","Medicine Hat, Alberta, municipal","48062","Total Criminal Code traffic violations","425","423","1","14.26","685.52","853.1","796.37","159.89","0","424","419","426","7","0"
"2010","Medicine Hat, Alberta, municipal","48062","Total Criminal Code traffic violations","513","509","2","20.69","827.35","1028.62","957.78","160.48","0","511","505","512","7","0"
"2011","Medicine Hat, Alberta, municipal","48062","Total Criminal Code traffic violations","474","457","2","-7.59","764.55","920.29","856.47","137.61","0","459","452","458","6","0"
"2012","Medicine Hat, Alberta, municipal","48062","Total Criminal Code traffic violations","364","362","1","-24.13","580.09","709.6","672.52","251.2","0","363","353","364","11","0"
"2013","Medicine Hat, Alberta, municipal","48062","Total Criminal Code traffic violations","271","242","21","-26.47","426.56","482.14","445.56","22.92","45.84","263","243","244","1","2"
"2014","Medicine Hat, Alberta, municipal","48062","Total Criminal Code traffic violations","236","221","14","-13.67","368.27","426.26","400.09","92.38","0","235","217","221","4","0"
"2015","Medicine Hat, Alberta, municipal","48062","Total Criminal Code traffic violations","205","197","4","-13.79","317.47","378.57","354.41","69.14","0","201","194","197","3","0"
"2016","Medicine Hat, Alberta, municipal","48062","Total Criminal Code traffic violations","151","148","0","-26.79","232.41","277.85","259.73","45.86","0","148","143","145","2","0"
"1998","Medicine Hat, Alberta, municipal","48062","Total impaired driving","194","183","1","0","390.36","0","0","0","0","184","188","188","0","0"
"1999","Medicine Hat, Alberta, municipal","48062","Total impaired driving","180","186","0","-8.97","355.35","0","0","0","0","186","189","189","0","0"
"2000","Medicine Hat, Alberta, municipal","48062","Total impaired driving","205","191","0","11.34","395.64","0","0","0","0","191","196","196","0","0"
"2001","Medicine Hat, Alberta, municipal","48062","Total impaired driving","184","180","0","-11.54","350","0","0","0","0","180","182","182","0","0"
"2002","Medicine Hat, Alberta, municipal","48062","Total impaired driving","239","236","0","27.86","447.51","0","0","0","0","236","241","241","0","0"
"2003","Medicine Hat, Alberta, municipal","48062","Total impaired driving","208","194","0","-14.23","383.83","0","0","0","0","194","193","193","0","0"
"2004","Medicine Hat, Alberta, municipal","48062","Total impaired driving","192","206","3","-10.43","343.8","469.42","426.1","0","0","209","205","205","0","0"
"2005","Medicine Hat, Alberta, municipal","48062","Total impaired driving","194","187","2","-1.7","337.94","424.27","385.68","0","0","189","191","191","0","0"
"2006","Medicine Hat, Alberta, municipal","48062","Total impaired driving","197","196","2","-1.11","334.2","433.1","394.85","0","0","198","201","201","0","0"
"2007","Medicine Hat, Alberta, municipal","48062","Total impaired driving","304","303","0","50.71","503.67","633.89","588.89","111.36","0","303","302","307","5","0"
"2008","Medicine Hat, Alberta, municipal","48062","Total impaired driving","323","322","1","4.55","526.61","649.51","606.26","134.83","0","323","315","321","6","0"
"2009","Medicine Hat, Alberta, municipal","48062","Total impaired driving","391","390","1","19.76","630.68","787.95","732.81","114.21","0","391","387","392","5","0"
"2010","Medicine Hat, Alberta, municipal","48062","Total impaired driving","485","483","2","24.02","782.19","977.7","907.27","114.63","0","485","480","485","5","0"
"2011","Medicine Hat, Alberta, municipal","48062","Total impaired driving","438","425","1","-9.68","706.49","857.17","794.76","91.74","0","426","421","425","4","0"
"2012","Medicine Hat, Alberta, municipal","48062","Total impaired driving","328","327","1","-26.01","522.72","647.29","607.85","159.85","0","328","322","329","7","0"
"2013","Medicine Hat, Alberta, municipal","48062","Total impaired driving","200","200","0","-39.77","314.81","396.83","367.04","22.92","0","200","200","201","1","0"
"2014","Medicine Hat, Alberta, municipal","48062","Total impaired driving","190","186","3","-5.82","296.49","361.44","336.72","46.19","0","189","184","186","2","0"
"2015","Medicine Hat, Alberta, municipal","48062","Total impaired driving","166","165","1","-13.29","257.07","318.07","298.64","69.14","0","166","163","166","3","0"
"2016","Medicine Hat, Alberta, municipal","48062","Total impaired driving","118","118","0","-29.35","181.62","223.45","209.58","45.86","0","118","115","117","2","0"
"1998","Medicine Hat, Alberta, municipal","48062","Impaired operation, causing death","0","0","0","0","0","0","0","0","0","0","0","0","0","0"
"1999","Medicine Hat, Alberta, municipal","48062","Impaired operation, causing death","0","0","0","0","0","0","0","0","0","0","0","0","0","0"
"2000","Medicine Hat, Alberta, municipal","48062","Impaired operation, causing death","0","0","0","0","0","0","0","0","0","0","0","0","0","0"
"2001","Medicine Hat, Alberta, municipal","48062","Impaired operation, causing death","0","0","0","0","0","0","0","0","0","0","0","0","0","0"
"2002","Medicine Hat, Alberta, municipal","48062","Impaired operation, causing death","0","0","0","0","0","0","0","0","0","0","0","0","0","0"
"2003","Medicine Hat, Alberta, municipal","48062","Impaired operation, causing death","1","1","0","0","1.85","0","0","0","0","1","1","1","0","0"
"2004","Medicine Hat, Alberta, municipal","48062","Impaired operation, causing death","2","2","0","94.07","3.58","4.58","4.16","0","0","2","2","2","0","0"
"2005","Medicine Hat, Alberta, municipal","48062","Impaired operation, causing death","0","0","0","-100","0","0","0","0","0","0","0","0","0","0"
"2006","Medicine Hat, Alberta, municipal","48062","Impaired operation, causing death","0","0","0","0","0","0","0","0","0","0","0","0","0","0"
"2007","Medicine Hat, Alberta, municipal","48062","Impaired operation, causing death","1","0","0","0","1.66","0","0","0","0","0","0","0","0","0"
"2008","Medicine Hat, Alberta, municipal","48062","Impaired operation, causing death","0","0","0","-100","0","0","0","0","0","0","0","0","0","0"
"2009","Medicine Hat, Alberta, municipal","48062","Impaired operation, causing death","0","0","0","0","0","0","0","0","0","0","0","0","0","0"
"2010","Medicine Hat, Alberta, municipal","48062","Impaired operation, causing death","0","0","0","0","0","0","0","0","0","0","0","0","0","0"
"2011","Medicine Hat, Alberta, municipal","48062","Impaired operation, causing death","0","0","0","0","0","0","0","0","0","0","0","0","0","0"
"2012","Medicine Hat, Alberta, municipal","48062","Impaired operation, causing death","0","0","0","0","0","0","0","0","0","0","0","0","0","0"
"2013","Medicine Hat, Alberta, municipal","48062","Impaired operation, causing death","0","0","0","0","0","0","0","0","0","0","0","0","0","0"
"2014","Medicine Hat, Alberta, municipal","48062","Impaired operation, causing death","0","0","0","0","0","0","0","0","0","0","0","0","0","0"
"2015","Medicine Hat, Alberta, municipal","48062","Impaired operation, causing death","0","0","0","0","0","0","0","0","0","0","0","0","0","0"
"2016","Medicine Hat, Alberta, municipal","48062","Impaired operation, causing death","0","0","0","0","0","0","0","0","0","0","0","0","0","0"
"2005","Medicine Hat, Alberta, municipal","48062","Impaired operation (drugs), causing death","0","0","0","0","0","0","0","0","0","0","0","0","0","0"
"2006","Medicine Hat, Alberta, municipal","48062","Impaired operation (drugs), causing death","0","0","0","0","0","0","0","0","0","0","0","0","0","0"
"2007","Medicine Hat, Alberta, municipal","48062","Impaired operation (drugs), causing death","0","0","0","0","0","0","0","0","0","0","0","0","0","0"
"2008","Medicine Hat, Alberta, municipal","48062","Impaired operation (drugs), causing death","0","0","0","0","0","0","0","0","0","0","0","0","0","0"
"2009","Medicine Hat, Alberta, municipal","48062","Impaired operation (drugs), causing death","0","0","0","0","0","0","0","0","0","0","0","0","0","0"
"2010","Medicine Hat, Alberta, municipal","48062","Impaired operation (drugs), causing death","0","0","0","0","0","0","0","0","0","0","0","0","0","0"
"2011","Medicine Hat, Alberta, municipal","48062","Impaired operation (drugs), causing death","0","0","0","0","0","0","0","0","0","0","0","0","0","0"
"2012","Medicine Hat, Alberta, municipal","48062","Impaired operation (drugs), causing death","0","0","0","0","0","0","0","0","0","0","0","0","0","0"
"2013","Medicine Hat, Alberta, municipal","48062","Impaired operation (drugs), causing death","0","0","0","0","0","0","0","0","0","0","0","0","0","0"
"2014","Medicine Hat, Alberta, municipal","48062","Impaired operation (drugs), causing death","0","0","0","0","0","0","0","0","0","0","0","0","0","0"
"2015","Medicine Hat, Alberta, municipal","48062","Impaired operation (drugs), causing death","0","0","0","0","0","0","0","0","0","0","0","0","0","0"
"2016","Medicine Hat, Alberta, municipal","48062","Impaired operation (drugs), causing death","0","0","0","0","0","0","0","0","0","0","0","0","0","0"
"1998","Medicine Hat, Alberta, municipal","48062","Impaired operation, causing bodily harm","1","1","0","0","2.01","0","0","0","0","1","1","1","0","0"
"1999","Medicine Hat, Alberta, municipal","48062","Impaired operation, causing bodily harm","2","1","0","96.23","3.95","0","0","0","0","1","1","1","0","0"
"2000","Medicine Hat, Alberta, municipal","48062","Impaired operation, causing bodily harm","1","1","0","-51.12","1.93","0","0","0","0","1","1","1","0","0"
"2001","Medicine Hat, Alberta, municipal","48062","Impaired operation, causing bodily harm","1","1","0","-1.44","1.9","0","0","0","0","1","1","1","0","0"
"2002","Medicine Hat, Alberta, municipal","48062","Impaired operation, causing bodily harm","2","2","0","96.87","3.74","0","0","0","0","2","2","2","0","0"
"2003","Medicine Hat, Alberta, municipal","48062","Impaired operation, causing bodily harm","0","0","0","-100","0","0","0","0","0","0","0","0","0","0"
"2004","Medicine Hat, Alberta, municipal","48062","Impaired operation, causing bodily harm","3","3","0","0","5.37","6.87","6.24","0","0","3","3","3","0","0"
"2005","Medicine Hat, Alberta, municipal","48062","Impaired operation, causing bodily harm","1","1","0","-67.57","1.74","2.22","2.02","0","0","1","1","1","0","0"
"2006","Medicine Hat, Alberta, municipal","48062","Impaired operation, causing bodily harm","1","1","0","-2.61","1.7","2.15","1.96","0","0","1","1","1","0","0"
"2007","Medicine Hat, Alberta, municipal","48062","Impaired operation, causing bodily harm","1","1","0","-2.34","1.66","2.1","3.84","22.27","0","1","1","2","1","0"
"2008","Medicine Hat, Alberta, municipal","48062","Impaired operation, causing bodily harm","2","2","0","96.81","3.26","4.12","3.78","0","0","2","2","2","0","0"
"2009","Medicine Hat, Alberta, municipal","48062","Impaired operation, causing bodily harm","4","4","0","97.87","6.45","8.14","7.48","0","0","4","4","4","0","0"
"2010","Medicine Hat, Alberta, municipal","48062","Impaired operation, causing bodily harm","0","0","0","-100","0","0","0","0","0","0","0","0","0","0"
"2011","Medicine Hat, Alberta, municipal","48062","Impaired operation, causing bodily harm","0","0","0","0","0","0","0","0","0","0","0","0","0","0"
"2012","Medicine Hat, Alberta, municipal","48062","Impaired operation, causing bodily harm","0","0","0","0","0","0","0","0","0","0","0","0","0","0"
"2013","Medicine Hat, Alberta, municipal","48062","Impaired operation, causing bodily harm","0","0","0","0","0","0","0","0","0","0","0","0","0","0"
"2014","Medicine Hat, Alberta, municipal","48062","Impaired operation, causing bodily harm","1","1","0","0","1.56","1.96","1.81","0","0","1","1","1","0","0"
"2015","Medicine Hat, Alberta, municipal","48062","Impaired operation, causing bodily harm","0","0","0","-100","0","0","0","0","0","0","0","0","0","0"
"2016","Medicine Hat, Alberta, municipal","48062","Impaired operation, causing bodily harm","0","0","0","0","0","0","0","0","0","0","0","0","0","0"
"2005","Medicine Hat, Alberta, municipal","48062","Impaired operation (drugs), causing bodily harm","0","0","0","0","0","0","0","0","0","0","0","0","0","0"
"2006","Medicine Hat, Alberta, municipal","48062","Impaired operation (drugs), causing bodily harm","0","0","0","0","0","0","0","0","0","0","0","0","0","0"
"2007","Medicine Hat, Alberta, municipal","48062","Impaired operation (drugs), causing bodily harm","0","0","0","0","0","0","0","0","0","0","0","0","0","0"
"2008","Medicine Hat, Alberta, municipal","48062","Impaired operation (drugs), causing bodily harm","0","0","0","0","0","0","0","0","0","0","0","0","0","0"
"2009","Medicine Hat, Alberta, municipal","48062","Impaired operation (drugs), causing bodily harm","0","0","0","0","0","0","0","0","0","0","0","0","0","0"
"2010","Medicine Hat, Alberta, municipal","48062","Impaired operation (drugs), causing bodily harm","0","0","0","0","0","0","0","0","0","0","0","0","0","0"
"2011","Medicine Hat, Alberta, municipal","48062","Impaired operation (drugs), causing bodily harm","0","0","0","0","0","0","0","0","0","0","0","0","0","0"
"2012","Medicine Hat, Alberta, municipal","48062","Impaired operation (drugs), causing bodily harm","0","0","0","0","0","0","0","0","0","0","0","0","0","0"
"2013","Medicine Hat, Alberta, municipal","48062","Impaired operation (drugs), causing bodily harm","0","0","0","0","0","0","0","0","0","0","0","0","0","0"
"2014","Medicine Hat, Alberta, municipal","48062","Impaired operation (drugs), causing bodily harm","0","0","0","0","0","0","0","0","0","0","0","0","0","0"
"2015","Medicine Hat, Alberta, municipal","48062","Impaired operation (drugs), causing bodily harm","0","0","0","0","0","0","0","0","0","0","0","0","0","0"
"2016","Medicine Hat, Alberta, municipal","48062","Impaired operation (drugs), causing bodily harm","0","0","0","0","0","0","0","0","0","0","0","0","0","0"
"1998","Medicine Hat, Alberta, municipal","48062","Impaired operation of motor vehicle, vessel or aircraft","178","168","1","0","358.16","0","0","0","0","169","173","173","0","0"
"1999","Medicine Hat, Alberta, municipal","48062","Impaired operation of motor vehicle, vessel or aircraft","143","150","0","-21.18","282.31","0","0","0","0","150","151","151","0","0"
"2000","Medicine Hat, Alberta, municipal","48062","Impaired operation of motor vehicle, vessel or aircraft","190","176","0","29.89","366.69","0","0","0","0","176","180","180","0","0"
"2001","Medicine Hat, Alberta, municipal","48062","Impaired operation of motor vehicle, vessel or aircraft","173","169","0","-10.26","329.07","0","0","0","0","169","171","171","0","0"
"2002","Medicine Hat, Alberta, municipal","48062","Impaired operation of motor vehicle, vessel or aircraft","228","225","0","29.73","426.91","0","0","0","0","225","230","230","0","0"
"2003","Medicine Hat, Alberta, municipal","48062","Impaired operation of motor vehicle, vessel or aircraft","198","184","0","-14.41","365.38","0","0","0","0","184","183","183","0","0"
"2004","Medicine Hat, Alberta, municipal","48062","Impaired operation of motor vehicle, vessel or aircraft","183","196","3","-10.32","327.68","446.52","405.31","0","0","199","195","195","0","0"
"2005","Medicine Hat, Alberta, municipal","48062","Impaired operation of motor vehicle, vessel or aircraft","181","174","2","-3.78","315.3","395.39","359.43","0","0","176","178","178","0","0"
"2006","Medicine Hat, Alberta, municipal","48062","Impaired operation of motor vehicle, vessel or aircraft","188","187","2","1.15","318.93","413.7","377.17","0","0","189","192","192","0","0"
"2007","Medicine Hat, Alberta, municipal","48062","Impaired operation of motor vehicle, vessel or aircraft","287","287","0","49.09","475.5","600.31","556.28","89.09","0","287","286","290","4","0"
"2008","Medicine Hat, Alberta, municipal","48062","Impaired operation of motor vehicle, vessel or aircraft","306","305","1","4.92","498.89","614.46","574.15","134.83","0","306","298","304","6","0"
"2009","Medicine Hat, Alberta, municipal","48062","Impaired operation of motor vehicle, vessel or aircraft","373","372","1","20.6","601.64","751.3","699.16","114.21","0","373","369","374","5","0"
"2010","Medicine Hat, Alberta, municipal","48062","Impaired operation of motor vehicle, vessel or aircraft","455","453","2","21.97","733.81","916.59","851.15","114.63","0","455","450","455","5","0"
"2011","Medicine Hat, Alberta, municipal","48062","Impaired operation of motor vehicle, vessel or aircraft","393","382","1","-13.62","633.9","769.62","714.35","91.74","0","383","378","382","4","0"
"2012","Medicine Hat, Alberta, municipal","48062","Impaired operation of motor vehicle, vessel or aircraft","290","290","0","-27.09","462.16","570.9","537.64","159.85","0","290","284","291","7","0"
"2013","Medicine Hat, Alberta, municipal","48062","Impaired operation of motor vehicle, vessel or aircraft","177","177","0","-39.72","278.6","351.19","325.04","22.92","0","177","177","178","1","0"
"2014","Medicine Hat, Alberta, municipal","48062","Impaired operation of motor vehicle, vessel or aircraft","166","162","3","-7.02","259.04","314.29","293.28","46.19","0","165","160","162","2","0"
"2015","Medicine Hat, Alberta, municipal","48062","Impaired operation of motor vehicle, vessel or aircraft","150","149","1","-10.32","232.3","286.85","269.86","69.14","0","150","147","150","3","0"
"2016","Medicine Hat, Alberta, municipal","48062","Impaired operation of motor vehicle, vessel or aircraft","110","110","0","-27.11","169.31","207.9","195.25","45.86","0","110","107","109","2","0"
"2005","Medicine Hat, Alberta, municipal","48062","Impaired operation (drugs) vehicle, vessel, aircraft","0","0","0","0","0","0","0","0","0","0","0","0","0","0"
"2006","Medicine Hat, Alberta, municipal","48062","Impaired operation (drugs) vehicle, vessel, aircraft","0","0","0","0","0","0","0","0","0","0","0","0","0","0"
"2007","Medicine Hat, Alberta, municipal","48062","Impaired operation (drugs) vehicle, vessel, aircraft","0","0","0","0","0","0","0","0","0","0","0","0","0","0"
"2008","Medicine Hat, Alberta, municipal","48062","Impaired operation (drugs) vehicle, vessel, aircraft","0","0","0","0","0","0","0","0","0","0","0","0","0","0"
"2009","Medicine Hat, Alberta, municipal","48062","Impaired operation (drugs) vehicle, vessel, aircraft","0","0","0","0","0","0","0","0","0","0","0","0","0","0"
"2010","Medicine Hat, Alberta, municipal","48062","Impaired operation (drugs) vehicle, vessel, aircraft","0","0","0","0","0","0","0","0","0","0","0","0","0","0"
"2011","Medicine Hat, Alberta, municipal","48062","Impaired operation (drugs) vehicle, vessel, aircraft","5","3","0","0","8.06","6.11","5.61","0","0","3","3","3","0","0"
"2012","Medicine Hat, Alberta, municipal","48062","Impaired operation (drugs) vehicle, vessel, aircraft","3","3","0","-40.72","4.78","6.03","5.54","0","0","3","3","3","0","0"
"2013","Medicine Hat, Alberta, municipal","48062","Impaired operation (drugs) vehicle, vessel, aircraft","0","0","0","-100","0","0","0","0","0","0","0","0","0","0"
"2014","Medicine Hat, Alberta, municipal","48062","Impaired operation (drugs) vehicle, vessel, aircraft","0","0","0","0","0","0","0","0","0","0","0","0","0","0"
"2015","Medicine Hat, Alberta, municipal","48062","Impaired operation (drugs) vehicle, vessel, aircraft","0","0","0","0","0","0","0","0","0","0","0","0","0","0"
"2016","Medicine Hat, Alberta, municipal","48062","Impaired operation (drugs) vehicle, vessel, aircraft","0","0","0","0","0","0","0","0","0","0","0","0","0","0"
"1998","Medicine Hat, Alberta, municipal","48062","Impaired operation, failure to provide breath sample","15","14","0","0","30.18","0","0","0","0","14","14","14","0","0"
"1999","Medicine Hat, Alberta, municipal","48062","Impaired operation, failure to provide breath sample","34","34","0","122.39","67.12","0","0","0","0","34","36","36","0","0"
"2000","Medicine Hat, Alberta, municipal","48062","Impaired operation, failure to provide breath sample","13","14","0","-62.62","25.09","0","0","0","0","14","15","15","0","0"
"2001","Medicine Hat, Alberta, municipal","48062","Impaired operation, failure to provide breath sample","10","10","0","-24.18","19.02","0","0","0","0","10","10","10","0","0"
"2002","Medicine Hat, Alberta, municipal","48062","Impaired operation, failure to provide breath sample","8","8","0","-21.25","14.98","0","0","0","0","8","8","8","0","0"
"2003","Medicine Hat, Alberta, municipal","48062","Impaired operation, failure to provide breath sample","9","9","0","10.87","16.61","0","0","0","0","9","9","9","0","0"
"2004","Medicine Hat, Alberta, municipal","48062","Impaired operation, failure to provide breath sample","4","5","0","-56.87","7.16","11.45","10.39","0","0","5","5","5","0","0"
"2005","Medicine Hat, Alberta, municipal","48062","Impaired operation, failure to provide breath sample","12","12","0","191.85","20.9","26.66","24.23","0","0","12","12","12","0","0"
"2006","Medicine Hat, Alberta, municipal","48062","Impaired operation, failure to provide breath sample","8","8","0","-35.08","13.57","17.24","15.72","0","0","8","8","8","0","0"
"2007","Medicine Hat, Alberta, municipal","48062","Impaired operation, failure to provide breath sample","15","15","0","83.12","24.85","31.48","28.77","0","0","15","15","15","0","0"
"2008","Medicine Hat, Alberta, municipal","48062","Impaired operation, failure to provide breath sample","15","15","0","-1.6","24.46","30.93","28.33","0","0","15","15","15","0","0"
"2009","Medicine Hat, Alberta, municipal","48062","Impaired operation, failure to provide breath sample","14","14","0","-7.66","22.58","28.5","26.17","0","0","14","14","14","0","0"
"2010","Medicine Hat, Alberta, municipal","48062","Impaired operation, failure to provide breath sample","30","30","0","114.26","48.38","61.11","56.12","0","0","30","30","30","0","0"
"2011","Medicine Hat, Alberta, municipal","48062","Impaired operation, failure to provide breath sample","40","40","0","33.35","64.52","81.44","74.8","0","0","40","40","40","0","0"
"2012","Medicine Hat, Alberta, municipal","48062","Impaired operation, failure to provide breath sample","35","34","1","-13.55","55.78","70.36","64.67","0","0","35","35","35","0","0"
"2013","Medicine Hat, Alberta, municipal","48062","Impaired operation, failure to provide breath sample","23","23","0","-35.09","36.2","45.63","42","0","0","23","23","23","0","0"
"2014","Medicine Hat, Alberta, municipal","48062","Impaired operation, failure to provide breath sample","23","23","0","-0.86","35.89","45.18","41.64","0","0","23","23","23","0","0"
"2015","Medicine Hat, Alberta, municipal","48062","Impaired operation, failure to provide breath sample","16","16","0","-30.96","24.78","31.22","28.78","0","0","16","16","16","0","0"
"2016","Medicine Hat, Alberta, municipal","48062","Impaired operation, failure to provide breath sample","8","8","0","-50.31","12.31","15.54","14.33","0","0","8","8","8","0","0"
"2005","Medicine Hat, Alberta, municipal","48062","Failure to comply or refusal (drugs)","0","0","0","0","0","0","0","0","0","0","0","0","0","0"
"2006","Medicine Hat, Alberta, municipal","48062","Failure to comply or refusal (drugs)","0","0","0","0","0","0","0","0","0","0","0","0","0","0"
"2007","Medicine Hat, Alberta, municipal","48062","Failure to comply or refusal (drugs)","0","0","0","0","0","0","0","0","0","0","0","0","0","0"
"2008","Medicine Hat, Alberta, municipal","48062","Failure to comply or refusal (drugs)","0","0","0","0","0","0","0","0","0","0","0","0","0","0"
"2009","Medicine Hat, Alberta, municipal","48062","Failure to comply or refusal (drugs)","0","0","0","0","0","0","0","0","0","0","0","0","0","0"
"2010","Medicine Hat, Alberta, municipal","48062","Failure to comply or refusal (drugs)","0","0","0","0","0","0","0","0","0","0","0","0","0","0"
"2011","Medicine Hat, Alberta, municipal","48062","Failure to comply or refusal (drugs)","0","0","0","0","0","0","0","0","0","0","0","0","0","0"
"2012","Medicine Hat, Alberta, municipal","48062","Failure to comply or refusal (drugs)","0","0","0","0","0","0","0","0","0","0","0","0","0","0"
"2013","Medicine Hat, Alberta, municipal","48062","Failure to comply or refusal (drugs)","0","0","0","0","0","0","0","0","0","0","0","0","0","0"
"2014","Medicine Hat, Alberta, municipal","48062","Failure to comply or refusal (drugs)","0","0","0","0","0","0","0","0","0","0","0","0","0","0"
"2015","Medicine Hat, Alberta, municipal","48062","Failure to comply or refusal (drugs)","0","0","0","0","0","0","0","0","0","0","0","0","0","0"
"2016","Medicine Hat, Alberta, municipal","48062","Failure to comply or refusal (drugs)","0","0","0","0","0","0","0","0","0","0","0","0","0","0"
"1998","Medicine Hat, Alberta, municipal","48062","Impaired operation, failure to provide blood sample","0","0","0","0","0","0","0","0","0","0","0","0","0","0"
"1999","Medicine Hat, Alberta, municipal","48062","Impaired operation, failure to provide blood sample","1","1","0","0","1.97","0","0","0","0","1","1","1","0","0"
"2000","Medicine Hat, Alberta, municipal","48062","Impaired operation, failure to provide blood sample","1","0","0","-2.24","1.93","0","0","0","0","0","0","0","0","0"
"2001","Medicine Hat, Alberta, municipal","48062","Impaired operation, failure to provide blood sample","0","0","0","-100","0","0","0","0","0","0","0","0","0","0"
"2002","Medicine Hat, Alberta, municipal","48062","Impaired operation, failure to provide blood sample","1","1","0","0","1.87","0","0","0","0","1","1","1","0","0"
"2003","Medicine Hat, Alberta, municipal","48062","Impaired operation, failure to provide blood sample","0","0","0","-100","0","0","0","0","0","0","0","0","0","0"
"2004","Medicine Hat, Alberta, municipal","48062","Impaired operation, failure to provide blood sample","0","0","0","0","0","0","0","0","0","0","0","0","0","0"
"2005","Medicine Hat, Alberta, municipal","48062","Impaired operation, failure to provide blood sample","0","0","0","0","0","0","0","0","0","0","0","0","0","0"
"2006","Medicine Hat, Alberta, municipal","48062","Impaired operation, failure to provide blood sample","0","0","0","0","0","0","0","0","0","0","0","0","0","0"
"2007","Medicine Hat, Alberta, municipal","48062","Impaired operation, failure to provide blood sample","0","0","0","0","0","0","0","0","0","0","0","0","0","0"
"2008","Medicine Hat, Alberta, municipal","48062","Impaired operation, failure to provide blood sample","0","0","0","0","0","0","0","0","0","0","0","0","0","0"
"2009","Medicine Hat, Alberta, municipal","48062","Impaired operation, failure to provide blood sample","0","0","0","0","0","0","0","0","0","0","0","0","0","0"
"2010","Medicine Hat, Alberta, municipal","48062","Impaired operation, failure to provide blood sample","0","0","0","0","0","0","0","0","0","0","0","0","0","0"
"2011","Medicine Hat, Alberta, municipal","48062","Impaired operation, failure to provide blood sample","0","0","0","0","0","0","0","0","0","0","0","0","0","0"
"2012","Medicine Hat, Alberta, municipal","48062","Impaired operation, failure to provide blood sample","0","0","0","0","0","0","0","0","0","0","0","0","0","0"
"2013","Medicine Hat, Alberta, municipal","48062","Impaired operation, failure to provide blood sample","0","0","0","0","0","0","0","0","0","0","0","0","0","0"
"2014","Medicine Hat, Alberta, municipal","48062","Impaired operation, failure to provide blood sample","0","0","0","0","0","0","0","0","0","0","0","0","0","0"
"2015","Medicine Hat, Alberta, municipal","48062","Impaired operation, failure to provide blood sample","0","0","0","0","0","0","0","0","0","0","0","0","0","0"
"2016","Medicine Hat, Alberta, municipal","48062","Impaired operation, failure to provide blood sample","0","0","0","0","0","0","0","0","0","0","0","0","0","0"
"2005","Medicine Hat, Alberta, municipal","48062","Failure to provide blood sample (drugs)","0","0","0","0","0","0","0","0","0","0","0","0","0","0"
"2006","Medicine Hat, Alberta, municipal","48062","Failure to provide blood sample (drugs)","0","0","0","0","0","0","0","0","0","0","0","0","0","0"
"2007","Medicine Hat, Alberta, municipal","48062","Failure to provide blood sample (drugs)","0","0","0","0","0","0","0","0","0","0","0","0","0","0"
"2008","Medicine Hat, Alberta, municipal","48062","Failure to provide blood sample (drugs)","0","0","0","0","0","0","0","0","0","0","0","0","0","0"
"2009","Medicine Hat, Alberta, municipal","48062","Failure to provide blood sample (drugs)","0","0","0","0","0","0","0","0","0","0","0","0","0","0"
"2010","Medicine Hat, Alberta, municipal","48062","Failure to provide blood sample (drugs)","0","0","0","0","0","0","0","0","0","0","0","0","0","0"
"2011","Medicine Hat, Alberta, municipal","48062","Failure to provide blood sample (drugs)","0","0","0","0","0","0","0","0","0","0","0","0","0","0"
"2012","Medicine Hat, Alberta, municipal","48062","Failure to provide blood sample (drugs)","0","0","0","0","0","0","0","0","0","0","0","0","0","0"
"2013","Medicine Hat, Alberta, municipal","48062","Failure to provide blood sample (drugs)","0","0","0","0","0","0","0","0","0","0","0","0","0","0"
"2014","Medicine Hat, Alberta, municipal","48062","Failure to provide blood sample (drugs)","0","0","0","0","0","0","0","0","0","0","0","0","0","0"
"2015","Medicine Hat, Alberta, municipal","48062","Failure to provide blood sample (drugs)","0","0","0","0","0","0","0","0","0","0","0","0","0","0"
"2016","Medicine Hat, Alberta, municipal","48062","Failure to provide blood sample (drugs)","0","0","0","0","0","0","0","0","0","0","0","0","0","0"
"1998","Medicine Hat, Alberta, municipal","48062","Total other Criminal Code traffic violations","25","22","0","0","50.3","0","0","0","0","22","22","22","0","0"
"1999","Medicine Hat, Alberta, municipal","48062","Total other Criminal Code traffic violations","19","22","0","-25.43","37.51","0","0","0","0","22","22","22","0","0"
"2000","Medicine Hat, Alberta, municipal","48062","Total other Criminal Code traffic violations","11","9","1","-43.4","21.23","0","0","0","0","10","10","10","0","0"
"2001","Medicine Hat, Alberta, municipal","48062","Total other Criminal Code traffic violations","29","21","0","159.84","55.16","0","0","0","0","21","20","20","0","0"
"2002","Medicine Hat, Alberta, municipal","48062","Total other Criminal Code traffic violations","15","13","1","-49.08","28.09","0","0","0","0","14","12","13","1","0"
"2003","Medicine Hat, Alberta, municipal","48062","Total other Criminal Code traffic violations","15","13","0","-1.44","27.68","0","0","0","0","13","13","13","0","0"
"2004","Medicine Hat, Alberta, municipal","48062","Total other Criminal Code traffic violations","37","34","0","139.35","66.25","80.14","72.75","0","0","34","35","35","0","0"
"2005","Medicine Hat, Alberta, municipal","48062","Total other Criminal Code traffic violations","54","32","0","41.98","94.07","71.08","64.62","0","0","32","32","32","0","0"
"2006","Medicine Hat, Alberta, municipal","48062","Total other Criminal Code traffic violations","45","23","0","-18.85","76.34","51.71","47.15","0","0","23","24","24","0","0"
"2007","Medicine Hat, Alberta, municipal","48062","Total other Criminal Code traffic violations","58","52","1","25.88","96.09","102.85","99.75","66.82","0","53","49","52","3","0"
"2008","Medicine Hat, Alberta, municipal","48062","Total other Criminal Code traffic violations","45","41","1","-23.65","73.37","82.48","81.21","67.42","0","42","40","43","3","0"
"2009","Medicine Hat, Alberta, municipal","48062","Total other Criminal Code traffic violations","34","33","0","-25.25","54.84","65.15","63.56","45.68","0","33","32","34","2","0"
"2010","Medicine Hat, Alberta, municipal","48062","Total other Criminal Code traffic violations","28","26","0","-17.66","45.16","50.92","50.51","45.85","0","26","25","27","2","0"
"2011","Medicine Hat, Alberta, municipal","48062","Total other Criminal Code traffic violations","36","32","1","28.59","58.07","63.12","61.71","45.87","0","33","31","33","2","0"
"2012","Medicine Hat, Alberta, municipal","48062","Total other Criminal Code traffic violations","36","35","0","-1.2","57.37","62.32","64.67","91.35","0","35","31","35","4","0"
"2013","Medicine Hat, Alberta, municipal","48062","Total other Criminal Code traffic violations","71","42","21","94.79","111.76","85.32","78.52","0","45.84","63","43","43","0","2"
"2014","Medicine Hat, Alberta, municipal","48062","Total other Criminal Code traffic violations","46","35","11","-35.77","71.78","64.82","63.36","46.19","0","46","33","35","2","0"
"2015","Medicine Hat, Alberta, municipal","48062","Total other Criminal Code traffic violations","39","32","3","-15.86","60.4","60.49","55.77","0","0","35","31","31","0","0"
"2016","Medicine Hat, Alberta, municipal","48062","Total other Criminal Code traffic violations","33","30","0","-15.9","50.79","54.4","50.15","0","0","30","28","28","0","0"
"1998","Medicine Hat, Alberta, municipal","48062","Dangerous operation, causing death","0","0","0","0","0","0","0","0","0","0","0","0","0","0"
"1999","Medicine Hat, Alberta, municipal","48062","Dangerous operation, causing death","0","0","0","0","0","0","0","0","0","0","0","0","0","0"
"2000","Medicine Hat, Alberta, municipal","48062","Dangerous operation, causing death","0","0","0","0","0","0","0","0","0","0","0","0","0","0"
"2001","Medicine Hat, Alberta, municipal","48062","Dangerous operation, causing death","0","0","0","0","0","0","0","0","0","0","0","0","0","0"
"2002","Medicine Hat, Alberta, municipal","48062","Dangerous operation, causing death","0","0","0","0","0","0","0","0","0","0","0","0","0","0"
"2003","Medicine Hat, Alberta, municipal","48062","Dangerous operation, causing death","0","0","0","0","0","0","0","0","0","0","0","0","0","0"
"2004","Medicine Hat, Alberta, municipal","48062","Dangerous operation, causing death","0","0","0","0","0","0","0","0","0","0","0","0","0","0"
"2005","Medicine Hat, Alberta, municipal","48062","Dangerous operation, causing death","0","0","0","0","0","0","0","0","0","0","0","0","0","0"
"2006","Medicine Hat, Alberta, municipal","48062","Dangerous operation, causing death","0","0","0","0","0","0","0","0","0","0","0","0","0","0"
"2007","Medicine Hat, Alberta, municipal","48062","Dangerous operation, causing death","0","0","0","0","0","0","0","0","0","0","0","0","0","0"
"2008","Medicine Hat, Alberta, municipal","48062","Dangerous operation, causing death","0","0","0","0","0","0","0","0","0","0","0","0","0","0"
"2009","Medicine Hat, Alberta, municipal","48062","Dangerous operation, causing death","0","0","0","0","0","0","0","0","0","0","0","0","0","0"
"2010","Medicine Hat, Alberta, municipal","48062","Dangerous operation, causing death","0","0","0","0","0","0","0","0","0","0","0","0","0","0"
"2011","Medicine Hat, Alberta, municipal","48062","Dangerous operation, causing death","0","0","0","0","0","0","0","0","0","0","0","0","0","0"
"2012","Medicine Hat, Alberta, municipal","48062","Dangerous operation, causing death","0","0","0","0","0","0","0","0","0","0","0","0","0","0"
"2013","Medicine Hat, Alberta, municipal","48062","Dangerous operation, causing death","0","0","0","0","0","0","0","0","0","0","0","0","0","0"
"2014","Medicine Hat, Alberta, municipal","48062","Dangerous operation, causing death","0","0","0","0","0","0","0","0","0","0","0","0","0","0"
"2015","Medicine Hat, Alberta, municipal","48062","Dangerous operation, causing death","0","0","0","0","0","0","0","0","0","0","0","0","0","0"
"2016","Medicine Hat, Alberta, municipal","48062","Dangerous operation, causing death","0","0","0","0","0","0","0","0","0","0","0","0","0","0"
"1998","Medicine Hat, Alberta, municipal","48062","Dangerous operation, causing bodily harm","0","0","0","0","0","0","0","0","0","0","0","0","0","0"
"1999","Medicine Hat, Alberta, municipal","48062","Dangerous operation, causing bodily harm","0","1","0","0","0","0","0","0","0","1","1","1","0","0"
"2000","Medicine Hat, Alberta, municipal","48062","Dangerous operation, causing bodily harm","1","1","0","0","1.93","0","0","0","0","1","1","1","0","0"
"2001","Medicine Hat, Alberta, municipal","48062","Dangerous operation, causing bodily harm","1","1","0","-1.44","1.9","0","0","0","0","1","1","1","0","0"
"2002","Medicine Hat, Alberta, municipal","48062","Dangerous operation, causing bodily harm","2","1","0","96.87","3.74","0","0","0","0","1","1","1","0","0"
"2003","Medicine Hat, Alberta, municipal","48062","Dangerous operation, causing bodily harm","0","0","0","-100","0","0","0","0","0","0","0","0","0","0"
"2004","Medicine Hat, Alberta, municipal","48062","Dangerous operation, causing bodily harm","2","2","0","0","3.58","4.58","4.16","0","0","2","2","2","0","0"
"2005","Medicine Hat, Alberta, municipal","48062","Dangerous operation, causing bodily harm","0","0","0","-100","0","0","0","0","0","0","0","0","0","0"
"2006","Medicine Hat, Alberta, municipal","48062","Dangerous operation, causing bodily harm","0","0","0","0","0","0","0","0","0","0","0","0","0","0"
"2007","Medicine Hat, Alberta, municipal","48062","Dangerous operation, causing bodily harm","2","2","0","0","3.31","4.2","3.84","0","0","2","2","2","0","0"
"2008","Medicine Hat, Alberta, municipal","48062","Dangerous operation, causing bodily harm","0","0","0","-100","0","0","0","0","0","0","0","0","0","0"
"2009","Medicine Hat, Alberta, municipal","48062","Dangerous operation, causing bodily harm","0","0","0","0","0","0","0","0","0","0","0","0","0","0"
"2010","Medicine Hat, Alberta, municipal","48062","Dangerous operation, causing bodily harm","0","0","0","0","0","0","0","0","0","0","0","0","0","0"
"2011","Medicine Hat, Alberta, municipal","48062","Dangerous operation, causing bodily harm","0","0","0","0","0","0","0","0","0","0","0","0","0","0"
"2012","Medicine Hat, Alberta, municipal","48062","Dangerous operation, causing bodily harm","0","0","0","0","0","0","0","0","0","0","0","0","0","0"
"2013","Medicine Hat, Alberta, municipal","48062","Dangerous operation, causing bodily harm","0","0","0","0","0","0","0","0","0","0","0","0","0","0"
"2014","Medicine Hat, Alberta, municipal","48062","Dangerous operation, causing bodily harm","1","1","0","0","1.56","1.96","1.81","0","0","1","1","1","0","0"
"2015","Medicine Hat, Alberta, municipal","48062","Dangerous operation, causing bodily harm","0","0","0","-100","0","0","0","0","0","0","0","0","0","0"
"2016","Medicine Hat, Alberta, municipal","48062","Dangerous operation, causing bodily harm","1","1","0","0","1.54","1.94","1.79","0","0","1","1","1","0","0"
"1998","Medicine Hat, Alberta, municipal","48062","Dangerous operation of motor vehicle, vessel or aircraft","12","11","0","0","24.15","0","0","0","0","11","11","11","0","0"
"1999","Medicine Hat, Alberta, municipal","48062","Dangerous operation of motor vehicle, vessel or aircraft","12","14","0","-1.89","23.69","0","0","0","0","14","14","14","0","0"
"2000","Medicine Hat, Alberta, municipal","48062","Dangerous operation of motor vehicle, vessel or aircraft","5","4","0","-59.27","9.65","0","0","0","0","4","4","4","0","0"
"2001","Medicine Hat, Alberta, municipal","48062","Dangerous operation of motor vehicle, vessel or aircraft","3","2","0","-40.86","5.71","0","0","0","0","2","2","2","0","0"
"2002","Medicine Hat, Alberta, municipal","48062","Dangerous operation of motor vehicle, vessel or aircraft","5","5","0","64.06","9.36","0","0","0","0","5","6","6","0","0"
"2003","Medicine Hat, Alberta, municipal","48062","Dangerous operation of motor vehicle, vessel or aircraft","7","7","0","37.98","12.92","0","0","0","0","7","7","7","0","0"
"2004","Medicine Hat, Alberta, municipal","48062","Dangerous operation of motor vehicle, vessel or aircraft","8","8","0","10.89","14.32","18.32","16.63","0","0","8","8","8","0","0"
"2005","Medicine Hat, Alberta, municipal","48062","Dangerous operation of motor vehicle, vessel or aircraft","6","6","0","-27.04","10.45","13.33","12.12","0","0","6","6","6","0","0"
"2006","Medicine Hat, Alberta, municipal","48062","Dangerous operation of motor vehicle, vessel or aircraft","14","11","0","127.23","23.75","23.7","21.61","0","0","11","11","11","0","0"
"2007","Medicine Hat, Alberta, municipal","48062","Dangerous operation of motor vehicle, vessel or aircraft","18","18","1","25.57","29.82","31.48","34.53","66.82","0","19","15","18","3","0"
"2008","Medicine Hat, Alberta, municipal","48062","Dangerous operation of motor vehicle, vessel or aircraft","12","10","0","-34.4","19.56","16.5","18.89","44.94","0","10","8","10","2","0"
"2009","Medicine Hat, Alberta, municipal","48062","Dangerous operation of motor vehicle, vessel or aircraft","11","11","0","-9.31","17.74","22.4","20.56","0","0","11","11","11","0","0"
"2010","Medicine Hat, Alberta, municipal","48062","Dangerous operation of motor vehicle, vessel or aircraft","16","16","0","45.44","25.8","28.52","29.93","45.85","0","16","14","16","2","0"
"2011","Medicine Hat, Alberta, municipal","48062","Dangerous operation of motor vehicle, vessel or aircraft","20","18","0","25.02","32.26","36.65","35.53","22.94","0","18","18","19","1","0"
"2012","Medicine Hat, Alberta, municipal","48062","Dangerous operation of motor vehicle, vessel or aircraft","21","20","0","3.74","33.47","32.16","36.95","91.35","0","20","16","20","4","0"
"2013","Medicine Hat, Alberta, municipal","48062","Dangerous operation of motor vehicle, vessel or aircraft","13","13","0","-38.86","20.46","25.79","23.74","0","0","13","13","13","0","0"
"2014","Medicine Hat, Alberta, municipal","48062","Dangerous operation of motor vehicle, vessel or aircraft","8","8","0","-38.99","12.48","13.75","14.48","23.09","0","8","7","8","1","0"
"2015","Medicine Hat, Alberta, municipal","48062","Dangerous operation of motor vehicle, vessel or aircraft","13","13","0","61.27","20.13","25.37","23.39","0","0","13","13","13","0","0"
"2016","Medicine Hat, Alberta, municipal","48062","Dangerous operation of motor vehicle, vessel or aircraft","10","9","0","-23.55","15.39","17.49","16.12","0","0","9","9","9","0","0"
"2000","Medicine Hat, Alberta, municipal","48062","Dangerous operation evading police, causing death","0","0","0","0","0","0","0","0","0","0","0","0","0","0"
"2001","Medicine Hat, Alberta, municipal","48062","Dangerous operation evading police, causing death","0","0","0","0","0","0","0","0","0","0","0","0","0","0"
"2002","Medicine Hat, Alberta, municipal","48062","Dangerous operation evading police, causing death","0","0","0","0","0","0","0","0","0","0","0","0","0","0"
"2003","Medicine Hat, Alberta, municipal","48062","Dangerous operation evading police, causing death","0","0","0","0","0","0","0","0","0","0","0","0","0","0"
"2004","Medicine Hat, Alberta, municipal","48062","Dangerous operation evading police, causing death","0","0","0","0","0","0","0","0","0","0","0","0","0","0"
"2005","Medicine Hat, Alberta, municipal","48062","Dangerous operation evading police, causing death","0","0","0","0","0","0","0","0","0","0","0","0","0","0"
"2006","Medicine Hat, Alberta, municipal","48062","Dangerous operation evading police, causing death","0","0","0","0","0","0","0","0","0","0","0","0","0","0"
"2007","Medicine Hat, Alberta, municipal","48062","Dangerous operation evading police, causing death","0","0","0","0","0","0","0","0","0","0","0","0","0","0"
"2008","Medicine Hat, Alberta, municipal","48062","Dangerous operation evading police, causing death","0","0","0","0","0","0","0","0","0","0","0","0","0","0"
"2009","Medicine Hat, Alberta, municipal","48062","Dangerous operation evading police, causing death","0","0","0","0","0","0","0","0","0","0","0","0","0","0"
"2010","Medicine Hat, Alberta, municipal","48062","Dangerous operation evading police, causing death","0","0","0","0","0","0","0","0","0","0","0","0","0","0"
"2011","Medicine Hat, Alberta, municipal","48062","Dangerous operation evading police, causing death","0","0","0","0","0","0","0","0","0","0","0","0","0","0"
"2012","Medicine Hat, Alberta, municipal","48062","Dangerous operation evading police, causing death","0","0","0","0","0","0","0","0","0","0","0","0","0","0"
"2013","Medicine Hat, Alberta, municipal","48062","Dangerous operation evading police, causing death","0","0","0","0","0","0","0","0","0","0","0","0","0","0"
"2014","Medicine Hat, Alberta, municipal","48062","Dangerous operation evading police, causing death","0","0","0","0","0","0","0","0","0","0","0","0","0","0"
"2015","Medicine Hat, Alberta, municipal","48062","Dangerous operation evading police, causing death","0","0","0","0","0","0","0","0","0","0","0","0","0","0"
"2016","Medicine Hat, Alberta, municipal","48062","Dangerous operation evading police, causing death","0","0","0","0","0","0","0","0","0","0","0","0","0","0"
"2000","Medicine Hat, Alberta, municipal","48062","Dangerous operation evading police, causing bodily harm","0","0","0","0","0","0","0","0","0","0","0","0","0","0"
"2001","Medicine Hat, Alberta, municipal","48062","Dangerous operation evading police, causing bodily harm","0","0","0","0","0","0","0","0","0","0","0","0","0","0"
"2002","Medicine Hat, Alberta, municipal","48062","Dangerous operation evading police, causing bodily harm","0","0","0","0","0","0","0","0","0","0","0","0","0","0"
"2003","Medicine Hat, Alberta, municipal","48062","Dangerous operation evading police, causing bodily harm","0","0","0","0","0","0","0","0","0","0","0","0","0","0"
"2004","Medicine Hat, Alberta, municipal","48062","Dangerous operation evading police, causing bodily harm","0","0","0","0","0","0","0","0","0","0","0","0","0","0"
"2005","Medicine Hat, Alberta, municipal","48062","Dangerous operation evading police, causing bodily harm","0","0","0","0","0","0","0","0","0","0","0","0","0","0"
"2006","Medicine Hat, Alberta, municipal","48062","Dangerous operation evading police, causing bodily harm","0","0","0","0","0","0","0","0","0","0","0","0","0","0"
"2007","Medicine Hat, Alberta, municipal","48062","Dangerous operation evading police, causing bodily harm","0","0","0","0","0","0","0","0","0","0","0","0","0","0"
"2008","Medicine Hat, Alberta, municipal","48062","Dangerous operation evading police, causing bodily harm","0","0","0","0","0","0","0","0","0","0","0","0","0","0"
"2009","Medicine Hat, Alberta, municipal","48062","Dangerous operation evading police, causing bodily harm","0","0","0","0","0","0","0","0","0","0","0","0","0","0"
"2010","Medicine Hat, Alberta, municipal","48062","Dangerous operation evading police, causing bodily harm","0","0","0","0","0","0","0","0","0","0","0","0","0","0"
"2011","Medicine Hat, Alberta, municipal","48062","Dangerous operation evading police, causing bodily harm","0","0","0","0","0","0","0","0","0","0","0","0","0","0"
"2012","Medicine Hat, Alberta, municipal","48062","Dangerous operation evading police, causing bodily harm","0","0","0","0","0","0","0","0","0","0","0","0","0","0"
"2013","Medicine Hat, Alberta, municipal","48062","Dangerous operation evading police, causing bodily harm","0","0","0","0","0","0","0","0","0","0","0","0","0","0"
"2014","Medicine Hat, Alberta, municipal","48062","Dangerous operation evading police, causing bodily harm","0","0","0","0","0","0","0","0","0","0","0","0","0","0"
"2015","Medicine Hat, Alberta, municipal","48062","Dangerous operation evading police, causing bodily harm","0","0","0","0","0","0","0","0","0","0","0","0","0","0"
"2016","Medicine Hat, Alberta, municipal","48062","Dangerous operation evading police, causing bodily harm","0","0","0","0","0","0","0","0","0","0","0","0","0","0"
"2000","Medicine Hat, Alberta, municipal","48062","Dangerous operation of motor vehicle evading police","0","0","0","0","0","0","0","0","0","0","0","0","0","0"
"2001","Medicine Hat, Alberta, municipal","48062","Dangerous operation of motor vehicle evading police","2","2","0","0","3.8","0","0","0","0","2","1","1","0","0"
"2002","Medicine Hat, Alberta, municipal","48062","Dangerous operation of motor vehicle evading police","3","3","0","47.65","5.62","0","0","0","0","3","2","2","0","0"
"2003","Medicine Hat, Alberta, municipal","48062","Dangerous operation of motor vehicle evading police","0","0","0","-100","0","0","0","0","0","0","0","0","0","0"
"2004","Medicine Hat, Alberta, municipal","48062","Dangerous operation of motor vehicle evading police","11","9","0","0","19.7","22.9","20.79","0","0","9","10","10","0","0"
"2005","Medicine Hat, Alberta, municipal","48062","Dangerous operation of motor vehicle evading police","9","9","0","-20.4","15.68","19.99","18.17","0","0","9","9","9","0","0"
"2006","Medicine Hat, Alberta, municipal","48062","Dangerous operation of motor vehicle evading police","2","1","0","-78.36","3.39","2.15","1.96","0","0","1","1","1","0","0"
"2007","Medicine Hat, Alberta, municipal","48062","Dangerous operation of motor vehicle evading police","10","9","0","388.32","16.57","18.89","17.26","0","0","9","9","9","0","0"
"2008","Medicine Hat, Alberta, municipal","48062","Dangerous operation of motor vehicle evading police","7","6","1","-31.12","11.41","12.37","11.33","0","0","7","6","6","0","0"
"2009","Medicine Hat, Alberta, municipal","48062","Dangerous operation of motor vehicle evading police","6","6","0","-15.2","9.68","8.14","11.22","45.68","0","6","4","6","2","0"
"2010","Medicine Hat, Alberta, municipal","48062","Dangerous operation of motor vehicle evading police","4","2","0","-33.34","6.45","4.07","3.74","0","0","2","2","2","0","0"
"2011","Medicine Hat, Alberta, municipal","48062","Dangerous operation of motor vehicle evading police","8","7","0","100.03","12.9","14.25","13.09","0","0","7","7","7","0","0"
"2012","Medicine Hat, Alberta, municipal","48062","Dangerous operation of motor vehicle evading police","5","5","0","-38.25","7.97","10.05","9.24","0","0","5","5","5","0","0"
"2013","Medicine Hat, Alberta, municipal","48062","Dangerous operation of motor vehicle evading police","7","5","0","38.28","11.02","9.92","9.13","0","0","5","5","5","0","0"
"2014","Medicine Hat, Alberta, municipal","48062","Dangerous operation of motor vehicle evading police","6","5","0","-15.02","9.36","7.86","9.05","23.09","0","5","4","5","1","0"
"2015","Medicine Hat, Alberta, municipal","48062","Dangerous operation of motor vehicle evading police","5","3","0","-17.3","7.74","5.85","5.4","0","0","3","3","3","0","0"
"2016","Medicine Hat, Alberta, municipal","48062","Dangerous operation of motor vehicle evading police","5","4","0","-0.61","7.7","7.77","7.16","0","0","4","4","4","0","0"
"1998","Medicine Hat, Alberta, municipal","48062","Total fail to stop or remain","0","0","0","0","0","0","0","0","0","0","0","0","0","0"
"1999","Medicine Hat, Alberta, municipal","48062","Total fail to stop or remain","0","0","0","0","0","0","0","0","0","0","0","0","0","0"
"2000","Medicine Hat, Alberta, municipal","48062","Total fail to stop or remain","0","0","0","0","0","0","0","0","0","0","0","0","0","0"
"2001","Medicine Hat, Alberta, municipal","48062","Total fail to stop or remain","13","6","0","0","24.73","0","0","0","0","6","6","6","0","0"
"2002","Medicine Hat, Alberta, municipal","48062","Total fail to stop or remain","2","2","0","-84.86","3.74","0","0","0","0","2","2","2","0","0"
"2003","Medicine Hat, Alberta, municipal","48062","Total fail to stop or remain","2","1","0","-1.44","3.69","0","0","0","0","1","1","1","0","0"
"2004","Medicine Hat, Alberta, municipal","48062","Total fail to stop or remain","5","3","0","142.58","8.95","6.87","6.24","0","0","3","3","3","0","0"
"2005","Medicine Hat, Alberta, municipal","48062","Total fail to stop or remain","26","4","0","405.88","45.29","8.89","8.08","0","0","4","4","4","0","0"
"2006","Medicine Hat, Alberta, municipal","48062","Total fail to stop or remain","20","2","0","-25.09","33.93","4.31","3.93","0","0","2","2","2","0","0"
"2007","Medicine Hat, Alberta, municipal","48062","Total fail to stop or remain","7","2","0","-65.82","11.6","4.2","3.84","0","0","2","2","2","0","0"
"2008","Medicine Hat, Alberta, municipal","48062","Total fail to stop or remain","2","1","0","-71.88","3.26","2.06","1.89","0","0","1","1","1","0","0"
"2009","Medicine Hat, Alberta, municipal","48062","Total fail to stop or remain","2","2","0","-1.07","3.23","4.07","3.74","0","0","2","2","2","0","0"
"2010","Medicine Hat, Alberta, municipal","48062","Total fail to stop or remain","0","0","0","-100","0","0","0","0","0","0","0","0","0","0"
"2011","Medicine Hat, Alberta, municipal","48062","Total fail to stop or remain","2","2","0","0","3.23","2.04","3.74","22.94","0","2","1","2","1","0"
"2012","Medicine Hat, Alberta, municipal","48062","Total fail to stop or remain","0","0","0","-100","0","0","0","0","0","0","0","0","0","0"
"2013","Medicine Hat, Alberta, municipal","48062","Total fail to stop or remain","30","3","21","0","47.22","7.94","7.3","0","45.84","24","4","4","0","2"
"2014","Medicine Hat, Alberta, municipal","48062","Total fail to stop or remain","12","2","11","-60.34","18.73","3.93","3.62","0","0","13","2","2","0","0"
"2015","Medicine Hat, Alberta, municipal","48062","Total fail to stop or remain","7","2","3","-42.11","10.84","1.95","1.8","0","0","5","1","1","0","0"
"2016","Medicine Hat, Alberta, municipal","48062","Total fail to stop or remain","1","0","0","-85.8","1.54","0","0","0","0","0","0","0","0","0"
"1998","Medicine Hat, Alberta, municipal","48062","Driving while prohibited","13","11","0","0","26.16","0","0","0","0","11","11","11","0","0"
"1999","Medicine Hat, Alberta, municipal","48062","Driving while prohibited","7","7","0","-47.17","13.82","0","0","0","0","7","7","7","0","0"
"2000","Medicine Hat, Alberta, municipal","48062","Driving while prohibited","4","3","1","-44.14","7.72","0","0","0","0","4","4","4","0","0"
"2001","Medicine Hat, Alberta, municipal","48062","Driving while prohibited","10","10","0","146.4","19.02","0","0","0","0","10","10","10","0","0"
"2002","Medicine Hat, Alberta, municipal","48062","Driving while prohibited","1","1","0","-90.16","1.87","0","0","0","0","1","1","1","0","0"
"2003","Medicine Hat, Alberta, municipal","48062","Driving while prohibited","5","4","0","392.78","9.23","0","0","0","0","4","4","4","0","0"
"2004","Medicine Hat, Alberta, municipal","48062","Driving while prohibited","10","11","0","94.07","17.91","25.19","22.86","0","0","11","11","11","0","0"
"2005","Medicine Hat, Alberta, municipal","48062","Driving while prohibited","12","12","0","16.74","20.9","26.66","24.23","0","0","12","12","12","0","0"
"2006","Medicine Hat, Alberta, municipal","48062","Driving while prohibited","9","9","0","-26.96","15.27","21.55","19.64","0","0","9","10","10","0","0"
"2007","Medicine Hat, Alberta, municipal","48062","Driving while prohibited","21","21","0","127.88","34.79","44.08","40.28","0","0","21","21","21","0","0"
"2008","Medicine Hat, Alberta, municipal","48062","Driving while prohibited","24","24","0","12.46","39.13","51.55","49.1","22.47","0","24","25","26","1","0"
"2009","Medicine Hat, Alberta, municipal","48062","Driving while prohibited","14","14","0","-42.29","22.58","30.54","28.04","0","0","14","15","15","0","0"
"2010","Medicine Hat, Alberta, municipal","48062","Driving while prohibited","8","8","0","-42.86","12.9","18.33","16.84","0","0","8","9","9","0","0"
"2011","Medicine Hat, Alberta, municipal","48062","Driving while prohibited","6","5","1","-24.99","9.68","10.18","9.35","0","0","6","5","5","0","0"
"2012","Medicine Hat, Alberta, municipal","48062","Driving while prohibited","10","10","0","64.67","15.94","20.1","18.48","0","0","10","10","10","0","0"
"2013","Medicine Hat, Alberta, municipal","48062","Driving while prohibited","21","21","0","107.42","33.05","41.67","38.35","0","0","21","21","21","0","0"
"2014","Medicine Hat, Alberta, municipal","48062","Driving while prohibited","19","19","0","-10.3","29.65","37.32","34.4","0","0","19","19","19","0","0"
"2015","Medicine Hat, Alberta, municipal","48062","Driving while prohibited","14","14","0","-26.87","21.68","27.32","25.19","0","0","14","14","14","0","0"
"2016","Medicine Hat, Alberta, municipal","48062","Driving while prohibited","16","16","0","13.59","24.63","27.2","25.08","0","0","16","14","14","0","0"
"1998","Medicine Hat, Alberta, municipal","48062","Other Criminal Code traffic violations","0","0","0","0","0","0","0","0","0","0","0","0","0","0"
"1999","Medicine Hat, Alberta, municipal","48062","Other Criminal Code traffic violations","0","0","0","0","0","0","0","0","0","0","0","0","0","0"
"2000","Medicine Hat, Alberta, municipal","48062","Other Criminal Code traffic violations","1","1","0","0","1.93","0","0","0","0","1","1","1","0","0"
"2001","Medicine Hat, Alberta, municipal","48062","Other Criminal Code traffic violations","0","0","0","-100","0","0","0","0","0","0","0","0","0","0"
"2002","Medicine Hat, Alberta, municipal","48062","Other Criminal Code traffic violations","2","1","1","0","3.74","0","0","0","0","2","0","1","1","0"
"2003","Medicine Hat, Alberta, municipal","48062","Other Criminal Code traffic violations","1","1","0","-50.72","1.85","0","0","0","0","1","1","1","0","0"
"2004","Medicine Hat, Alberta, municipal","48062","Other Criminal Code traffic violations","1","1","0","-2.97","1.79","2.29","2.08","0","0","1","1","1","0","0"
"2005","Medicine Hat, Alberta, municipal","48062","Other Criminal Code traffic violations","1","1","0","-2.72","1.74","2.22","2.02","0","0","1","1","1","0","0"
"2006","Medicine Hat, Alberta, municipal","48062","Other Criminal Code traffic violations","0","0","0","-100","0","0","0","0","0","0","0","0","0","0"
"2007","Medicine Hat, Alberta, municipal","48062","Other Criminal Code traffic violations","0","0","0","0","0","0","0","0","0","0","0","0","0","0"
"2008","Medicine Hat, Alberta, municipal","48062","Other Criminal Code traffic violations","0","0","0","0","0","0","0","0","0","0","0","0","0","0"
"2009","Medicine Hat, Alberta, municipal","48062","Other Criminal Code traffic violations","1","0","0","0","1.61","0","0","0","0","0","0","0","0","0"
"2010","Medicine Hat, Alberta, municipal","48062","Other Criminal Code traffic violations","0","0","0","-100","0","0","0","0","0","0","0","0","0","0"
"2011","Medicine Hat, Alberta, municipal","48062","Other Criminal Code traffic violations","0","0","0","0","0","0","0","0","0","0","0","0","0","0"
"2012","Medicine Hat, Alberta, municipal","48062","Other Criminal Code traffic violations","0","0","0","0","0","0","0","0","0","0","0","0","0","0"
"2013","Medicine Hat, Alberta, municipal","48062","Other Criminal Code traffic violations","0","0","0","0","0","0","0","0","0","0","0","0","0","0"
"2014","Medicine Hat, Alberta, municipal","48062","Other Criminal Code traffic violations","0","0","0","0","0","0","0","0","0","0","0","0","0","0"
"2015","Medicine Hat, Alberta, municipal","48062","Other Criminal Code traffic violations","0","0","0","0","0","0","0","0","0","0","0","0","0","0"
"2016","Medicine Hat, Alberta, municipal","48062","Other Criminal Code traffic violations","0","0","0","0","0","0","0","0","0","0","0","0","0","0"
"2005","Medicine Hat, Alberta, municipal","48062","Causing death by criminal negligence while street racing","0","0","0","0","0","0","0","0","0","0","0","0","0","0"
"2006","Medicine Hat, Alberta, municipal","48062","Causing death by criminal negligence while street racing","0","0","0","0","0","0","0","0","0","0","0","0","0","0"
"2007","Medicine Hat, Alberta, municipal","48062","Causing death by criminal negligence while street racing","0","0","0","0","0","0","0","0","0","0","0","0","0","0"
"2008","Medicine Hat, Alberta, municipal","48062","Causing death by criminal negligence while street racing","0","0","0","0","0","0","0","0","0","0","0","0","0","0"
"2009","Medicine Hat, Alberta, municipal","48062","Causing death by criminal negligence while street racing","0","0","0","0","0","0","0","0","0","0","0","0","0","0"
"2010","Medicine Hat, Alberta, municipal","48062","Causing death by criminal negligence while street racing","0","0","0","0","0","0","0","0","0","0","0","0","0","0"
"2011","Medicine Hat, Alberta, municipal","48062","Causing death by criminal negligence while street racing","0","0","0","0","0","0","0","0","0","0","0","0","0","0"
"2012","Medicine Hat, Alberta, municipal","48062","Causing death by criminal negligence while street racing","0","0","0","0","0","0","0","0","0","0","0","0","0","0"
"2013","Medicine Hat, Alberta, municipal","48062","Causing death by criminal negligence while street racing","0","0","0","0","0","0","0","0","0","0","0","0","0","0"
"2014","Medicine Hat, Alberta, municipal","48062","Causing death by criminal negligence while street racing","0","0","0","0","0","0","0","0","0","0","0","0","0","0"
"2015","Medicine Hat, Alberta, municipal","48062","Causing death by criminal negligence while street racing","0","0","0","0","0","0","0","0","0","0","0","0","0","0"
"2016","Medicine Hat, Alberta, municipal","48062","Causing death by criminal negligence while street racing","0","0","0","0","0","0","0","0","0","0","0","0","0","0"
"2005","Medicine Hat, Alberta, municipal","48062","Causing bodily harm by criminal negligence while street racing","0","0","0","0","0","0","0","0","0","0","0","0","0","0"
"2006","Medicine Hat, Alberta, municipal","48062","Causing bodily harm by criminal negligence while street racing","0","0","0","0","0","0","0","0","0","0","0","0","0","0"
"2007","Medicine Hat, Alberta, municipal","48062","Causing bodily harm by criminal negligence while street racing","0","0","0","0","0","0","0","0","0","0","0","0","0","0"
"2008","Medicine Hat, Alberta, municipal","48062","Causing bodily harm by criminal negligence while street racing","0","0","0","0","0","0","0","0","0","0","0","0","0","0"
"2009","Medicine Hat, Alberta, municipal","48062","Causing bodily harm by criminal negligence while street racing","0","0","0","0","0","0","0","0","0","0","0","0","0","0"
"2010","Medicine Hat, Alberta, municipal","48062","Causing bodily harm by criminal negligence while street racing","0","0","0","0","0","0","0","0","0","0","0","0","0","0"
"2011","Medicine Hat, Alberta, municipal","48062","Causing bodily harm by criminal negligence while street racing","0","0","0","0","0","0","0","0","0","0","0","0","0","0"
"2012","Medicine Hat, Alberta, municipal","48062","Causing bodily harm by criminal negligence while street racing","0","0","0","0","0","0","0","0","0","0","0","0","0","0"
"2013","Medicine Hat, Alberta, municipal","48062","Causing bodily harm by criminal negligence while street racing","0","0","0","0","0","0","0","0","0","0","0","0","0","0"
"2014","Medicine Hat, Alberta, municipal","48062","Causing bodily harm by criminal negligence while street racing","0","0","0","0","0","0","0","0","0","0","0","0","0","0"
"2015","Medicine Hat, Alberta, municipal","48062","Causing bodily harm by criminal negligence while street racing","0","0","0","0","0","0","0","0","0","0","0","0","0","0"
"2016","Medicine Hat, Alberta, municipal","48062","Causing bodily harm by criminal negligence while street racing","0","0","0","0","0","0","0","0","0","0","0","0","0","0"
"2005","Medicine Hat, Alberta, municipal","48062","Dangerous operation causing death while street racing","0","0","0","0","0","0","0","0","0","0","0","0","0","0"
"2006","Medicine Hat, Alberta, municipal","48062","Dangerous operation causing death while street racing","0","0","0","0","0","0","0","0","0","0","0","0","0","0"
"2007","Medicine Hat, Alberta, municipal","48062","Dangerous operation causing death while street racing","0","0","0","0","0","0","0","0","0","0","0","0","0","0"
"2008","Medicine Hat, Alberta, municipal","48062","Dangerous operation causing death while street racing","0","0","0","0","0","0","0","0","0","0","0","0","0","0"
"2009","Medicine Hat, Alberta, municipal","48062","Dangerous operation causing death while street racing","0","0","0","0","0","0","0","0","0","0","0","0","0","0"
"2010","Medicine Hat, Alberta, municipal","48062","Dangerous operation causing death while street racing","0","0","0","0","0","0","0","0","0","0","0","0","0","0"
"2011","Medicine Hat, Alberta, municipal","48062","Dangerous operation causing death while street racing","0","0","0","0","0","0","0","0","0","0","0","0","0","0"
"2012","Medicine Hat, Alberta, municipal","48062","Dangerous operation causing death while street racing","0","0","0","0","0","0","0","0","0","0","0","0","0","0"
"2013","Medicine Hat, Alberta, municipal","48062","Dangerous operation causing death while street racing","0","0","0","0","0","0","0","0","0","0","0","0","0","0"
"2014","Medicine Hat, Alberta, municipal","48062","Dangerous operation causing death while street racing","0","0","0","0","0","0","0","0","0","0","0","0","0","0"
"2015","Medicine Hat, Alberta, municipal","48062","Dangerous operation causing death while street racing","0","0","0","0","0","0","0","0","0","0","0","0","0","0"
"2016","Medicine Hat, Alberta, municipal","48062","Dangerous operation causing death while street racing","0","0","0","0","0","0","0","0","0","0","0","0","0","0"
"2005","Medicine Hat, Alberta, municipal","48062","Dangerous operation causing bodily harm while street racing","0","0","0","0","0","0","0","0","0","0","0","0","0","0"
"2006","Medicine Hat, Alberta, municipal","48062","Dangerous operation causing bodily harm while street racing","0","0","0","0","0","0","0","0","0","0","0","0","0","0"
"2007","Medicine Hat, Alberta, municipal","48062","Dangerous operation causing bodily harm while street racing","0","0","0","0","0","0","0","0","0","0","0","0","0","0"
"2008","Medicine Hat, Alberta, municipal","48062","Dangerous operation causing bodily harm while street racing","0","0","0","0","0","0","0","0","0","0","0","0","0","0"
"2009","Medicine Hat, Alberta, municipal","48062","Dangerous operation causing bodily harm while street racing","0","0","0","0","0","0","0","0","0","0","0","0","0","0"
"2010","Medicine Hat, Alberta, municipal","48062","Dangerous operation causing bodily harm while street racing","0","0","0","0","0","0","0","0","0","0","0","0","0","0"
"2011","Medicine Hat, Alberta, municipal","48062","Dangerous operation causing bodily harm while street racing","0","0","0","0","0","0","0","0","0","0","0","0","0","0"
"2012","Medicine Hat, Alberta, municipal","48062","Dangerous operation causing bodily harm while street racing","0","0","0","0","0","0","0","0","0","0","0","0","0","0"
"2013","Medicine Hat, Alberta, municipal","48062","Dangerous operation causing bodily harm while street racing","0","0","0","0","0","0","0","0","0","0","0","0","0","0"
"2014","Medicine Hat, Alberta, municipal","48062","Dangerous operation causing bodily harm while street racing","0","0","0","0","0","0","0","0","0","0","0","0","0","0"
"2015","Medicine Hat, Alberta, municipal","48062","Dangerous operation causing bodily harm while street racing","0","0","0","0","0","0","0","0","0","0","0","0","0","0"
"2016","Medicine Hat, Alberta, municipal","48062","Dangerous operation causing bodily harm while street racing","0","0","0","0","0","0","0","0","0","0","0","0","0","0"
"2005","Medicine Hat, Alberta, municipal","48062","Dangerous operation of motor vehicle while street racing","0","0","0","0","0","0","0","0","0","0","0","0","0","0"
"2006","Medicine Hat, Alberta, municipal","48062","Dangerous operation of motor vehicle while street racing","0","0","0","0","0","0","0","0","0","0","0","0","0","0"
"2007","Medicine Hat, Alberta, municipal","48062","Dangerous operation of motor vehicle while street racing","0","0","0","0","0","0","0","0","0","0","0","0","0","0"
"2008","Medicine Hat, Alberta, municipal","48062","Dangerous operation of motor vehicle while street racing","0","0","0","0","0","0","0","0","0","0","0","0","0","0"
"2009","Medicine Hat, Alberta, municipal","48062","Dangerous operation of motor vehicle while street racing","0","0","0","0","0","0","0","0","0","0","0","0","0","0"
"2010","Medicine Hat, Alberta, municipal","48062","Dangerous operation of motor vehicle while street racing","0","0","0","0","0","0","0","0","0","0","0","0","0","0"
"2011","Medicine Hat, Alberta, municipal","48062","Dangerous operation of motor vehicle while street racing","0","0","0","0","0","0","0","0","0","0","0","0","0","0"
"2012","Medicine Hat, Alberta, municipal","48062","Dangerous operation of motor vehicle while street racing","0","0","0","0","0","0","0","0","0","0","0","0","0","0"
"2013","Medicine Hat, Alberta, municipal","48062","Dangerous operation of motor vehicle while street racing","0","0","0","0","0","0","0","0","0","0","0","0","0","0"
"2014","Medicine Hat, Alberta, municipal","48062","Dangerous operation of motor vehicle while street racing","0","0","0","0","0","0","0","0","0","0","0","0","0","0"
"2015","Medicine Hat, Alberta, municipal","48062","Dangerous operation of motor vehicle while street racing","0","0","0","0","0","0","0","0","0","0","0","0","0","0"
"2016","Medicine Hat, Alberta, municipal","48062","Dangerous operation of motor vehicle while street racing","0","0","0","0","0","0","0","0","0","0","0","0","0","0"
"1998","Medicine Hat, Alberta, municipal","48062","Total Federal Statute violations","250","252","5","0","503.04","0","0","0","0","257","100","269","169","6"
"1999","Medicine Hat, Alberta, municipal","48062","Total Federal Statute violations","268","248","8","5.18","529.08","0","0","0","0","256","87","276","189","3"
"2000","Medicine Hat, Alberta, municipal","48062","Total Federal Statute violations","201","177","2","-26.68","387.92","0","0","0","0","179","81","188","107","1"
"2001","Medicine Hat, Alberta, municipal","48062","Total Federal Statute violations","170","149","6","-16.64","323.37","0","0","0","0","155","100","164","64","7"
"2002","Medicine Hat, Alberta, municipal","48062","Total Federal Statute violations","183","168","4","5.96","342.65","0","0","0","0","172","92","189","97","3"
"2003","Medicine Hat, Alberta, municipal","48062","Total Federal Statute violations","255","217","6","37.33","470.57","0","0","0","0","223","161","238","77","3"
"2004","Medicine Hat, Alberta, municipal","48062","Total Federal Statute violations","157","138","8","-40.26","281.13","270.2","322.17","833.33","180.18","146","118","155","37","8"
"2005","Medicine Hat, Alberta, municipal","48062","Total Federal Statute violations","246","233","8","52.43","428.53","515.34","571.45","1132.33","88.81","241","232","283","51","4"
"2006","Medicine Hat, Alberta, municipal","48062","Total Federal Statute violations","183","156","2","-27.55","310.45","407.24","422.35","578.29","88.97","158","189","215","26","4"
"2007","Medicine Hat, Alberta, municipal","48062","Total Federal Statute violations","250","231","12","33.42","414.2","594.01","592.73","579.06","89.09","243","283","309","26","4"
"2008","Medicine Hat, Alberta, municipal","48062","Total Federal Statute violations","290","250","33","14.15","472.81","517.55","625.14","1797.75","224.72","283","251","331","80","10"
"2009","Medicine Hat, Alberta, municipal","48062","Total Federal Statute violations","287","242","29","-2.09","462.93","511.05","618.77","1827.32","319.78","271","251","331","80","14"
"2010","Medicine Hat, Alberta, municipal","48062","Total Federal Statute violations","324","268","38","12.88","522.54","659.95","695.89","1100.41","389.73","306","324","372","48","17"
"2011","Medicine Hat, Alberta, municipal","48062","Total Federal Statute violations","346","298","27","6.8","558.09","669.86","738.66","1513.76","114.68","325","329","395","66","5"
"2012","Medicine Hat, Alberta, municipal","48062","Total Federal Statute violations","345","297","22","-1.48","549.81","689.5","729.79","1187.49","228.36","319","343","395","52","10"
"2013","Medicine Hat, Alberta, municipal","48062","Total Federal Statute violations","295","244","23","-15.55","464.34","676.59","723.12","1260.6","160.44","267","341","396","55","7"
"2014","Medicine Hat, Alberta, municipal","48062","Total Federal Statute violations","300","234","63","0.82","468.14","428.22","530.43","1732.1","392.61","297","218","293","75","17"
"2015","Medicine Hat, Alberta, municipal","48062","Total Federal Statute violations","288","206","65","-4.73","446.01","446.86","496.54","1083.2","898.82","271","229","276","47","39"
"2016","Medicine Hat, Alberta, municipal","48062","Total Federal Statute violations","285","226","44","-1.65","438.66","551.82","546.33","481.54","435.68","270","284","305","21","19"
"1998","Medicine Hat, Alberta, municipal","48062","Total Drug violations","78","81","1","0","156.95","0","0","0","0","82","85","93","8","1"
"1999","Medicine Hat, Alberta, municipal","48062","Total Drug violations","69","60","3","-13.21","136.22","0","0","0","0","63","62","83","21","2"
"2000","Medicine Hat, Alberta, municipal","48062","Total Drug violations","65","57","1","-7.91","125.45","0","0","0","0","58","50","65","15","1"
"2001","Medicine Hat, Alberta, municipal","48062","Total Drug violations","90","75","6","36.47","171.19","0","0","0","0","81","76","89","13","6"
"2002","Medicine Hat, Alberta, municipal","48062","Total Drug violations","89","77","3","-2.66","166.64","0","0","0","0","80","68","98","30","2"
"2003","Medicine Hat, Alberta, municipal","48062","Total Drug violations","165","134","3","82.71","304.48","0","0","0","0","137","137","159","22","2"
"2004","Medicine Hat, Alberta, municipal","48062","Total Drug violations","121","105","5","-28.84","216.66","235.85","253.58","427.93","180.18","110","103","122","19","8"
"2005","Medicine Hat, Alberta, municipal","48062","Total Drug violations","212","202","8","70.45","369.3","497.57","506.84","599.47","88.81","210","224","251","27","4"
"2006","Medicine Hat, Alberta, municipal","48062","Total Drug violations","162","138","2","-25.58","274.82","377.07","375.2","355.87","88.97","140","175","191","16","4"
"2007","Medicine Hat, Alberta, municipal","48062","Total Drug violations","230","215","10","38.66","381.07","587.72","562.03","289.53","66.82","225","280","293","13","3"
"2008","Medicine Hat, Alberta, municipal","48062","Total Drug violations","234","200","28","0.12","381.51","496.93","525.04","831.46","224.72","228","241","278","37","10"
"2009","Medicine Hat, Alberta, municipal","48062","Total Drug violations","226","193","25","-4.45","364.53","490.69","521.56","867.98","319.78","218","241","279","38","14"
"2010","Medicine Hat, Alberta, municipal","48062","Total Drug violations","302","251","34","33.61","487.06","645.69","662.21","848.23","389.73","285","317","354","37","17"
"2011","Medicine Hat, Alberta, municipal","48062","Total Drug violations","295","251","21","-2.31","475.83","643.39","647.03","688.07","114.68","272","316","346","30","5"
"2012","Medicine Hat, Alberta, municipal","48062","Total Drug violations","321","275","21","7.51","511.56","677.44","681.76","730.76","228.36","296","337","369","32","10"
"2013","Medicine Hat, Alberta, municipal","48062","Total Drug violations","251","205","21","-22.77","395.08","664.68","644.6","412.56","160.44","226","335","353","18","7"
"2014","Medicine Hat, Alberta, municipal","48062","Total Drug violations","222","163","61","-12.32","346.43","408.58","403.71","346.42","369.52","224","208","223","15","16"
"2015","Medicine Hat, Alberta, municipal","48062","Total Drug violations","230","160","61","2.82","356.19","431.25","402.99","69.14","852.73","221","221","224","3","37"
"2016","Medicine Hat, Alberta, municipal","48062","Total Drug violations","266","210","44","14.95","409.42","547.93","519.46","183.44","435.68","254","282","290","8","19"
"1998","Medicine Hat, Alberta, municipal","48062","Possession, cannabis","39","36","1","0","78.47","0","0","0","0","37","30","38","8","1"
"1999","Medicine Hat, Alberta, municipal","48062","Possession, cannabis","42","37","3","5.66","82.92","0","0","0","0","40","23","38","15","2"
"2000","Medicine Hat, Alberta, municipal","48062","Possession, cannabis","37","34","1","-13.88","71.41","0","0","0","0","35","28","39","11","1"
"2001","Medicine Hat, Alberta, municipal","48062","Possession, cannabis","57","51","4","51.84","108.42","0","0","0","0","55","46","57","11","4"
"2002","Medicine Hat, Alberta, municipal","48062","Possession, cannabis","55","49","3","-5.02","102.98","0","0","0","0","52","33","52","19","1"
"2003","Medicine Hat, Alberta, municipal","48062","Possession, cannabis","50","39","2","-10.4","92.27","0","0","0","0","41","35","43","8","1"
"2004","Medicine Hat, Alberta, municipal","48062","Possession, cannabis","38","30","5","-26.25","68.04","64.12","76.91","202.7","180.18","35","28","37","9","8"
"2005","Medicine Hat, Alberta, municipal","48062","Possession, cannabis","81","73","3","107.37","141.1","162.15","179.71","355.24","44.4","76","73","89","16","2"
"2006","Medicine Hat, Alberta, municipal","48062","Possession, cannabis","54","45","2","-35.08","91.61","101.27","106.08","155.69","66.73","47","47","54","7","3"
"2007","Medicine Hat, Alberta, municipal","48062","Possession, cannabis","90","78","8","62.77","149.11","178.41","176.48","155.9","66.82","86","85","92","7","3"
"2008","Medicine Hat, Alberta, municipal","48062","Possession, cannabis","130","104","26","42.14","211.95","220.63","254.97","629.21","202.25","130","107","135","28","9"
"2009","Medicine Hat, Alberta, municipal","48062","Possession, cannabis","111","87","21","-15.53","179.04","181.21","222.46","685.24","296.94","108","89","119","30","13"
"2010","Medicine Hat, Alberta, municipal","48062","Possession, cannabis","158","126","30","42.32","254.82","295.35","316.14","550.21","389.73","156","145","169","24","17"
"2011","Medicine Hat, Alberta, municipal","48062","Possession, cannabis","125","101","17","-20.88","201.62","221.93","235.62","389.91","91.74","118","109","126","17","4"
"2012","Medicine Hat, Alberta, municipal","48062","Possession, cannabis","115","87","18","-9.1","183.27","186.95","212.47","502.4","228.36","105","93","115","22","10"
"2013","Medicine Hat, Alberta, municipal","48062","Possession, cannabis","119","84","21","2.2","187.31","180.56","193.56","343.8","160.44","105","91","106","15","7"
"2014","Medicine Hat, Alberta, municipal","48062","Possession, cannabis","123","67","56","2.47","191.94","141.43","148.45","230.95","369.52","123","72","82","10","16"
"2015","Medicine Hat, Alberta, municipal","48062","Possession, cannabis","91","34","53","-26.58","140.93","68.3","66.56","46.09","829.68","87","35","37","2","36"
"2016","Medicine Hat, Alberta, municipal","48062","Possession, cannabis","67","25","38","-26.82","103.12","48.58","50.15","68.79","412.75","63","25","28","3","18"
"1998","Medicine Hat, Alberta, municipal","48062","Possession, cocaine","1","1","0","0","2.01","0","0","0","0","1","1","1","0","0"
"1999","Medicine Hat, Alberta, municipal","48062","Possession, cocaine","2","1","0","96.23","3.95","0","0","0","0","1","1","1","0","0"
"2000","Medicine Hat, Alberta, municipal","48062","Possession, cocaine","3","3","0","46.64","5.79","0","0","0","0","3","2","2","0","0"
"2001","Medicine Hat, Alberta, municipal","48062","Possession, cocaine","4","3","0","31.41","7.61","0","0","0","0","3","4","4","0","0"
"2002","Medicine Hat, Alberta, municipal","48062","Possession, cocaine","10","8","0","146.09","18.72","0","0","0","0","8","11","12","1","0"
"2003","Medicine Hat, Alberta, municipal","48062","Possession, cocaine","9","10","0","-11.3","16.61","0","0","0","0","10","12","12","0","0"
"2004","Medicine Hat, Alberta, municipal","48062","Possession, cocaine","22","20","0","137.19","39.39","45.8","43.65","22.52","0","20","20","21","1","0"
"2005","Medicine Hat, Alberta, municipal","48062","Possession, cocaine","39","34","1","72.46","67.94","91.07","86.83","44.4","0","35","41","43","2","0"
"2006","Medicine Hat, Alberta, municipal","48062","Possession, cocaine","43","38","0","7.37","72.95","94.81","90.36","44.48","0","38","44","46","2","0"
"2007","Medicine Hat, Alberta, municipal","48062","Possession, cocaine","56","54","1","27.19","92.78","140.63","132.36","44.54","0","55","67","69","2","0"
"2008","Medicine Hat, Alberta, municipal","48062","Possession, cocaine","33","31","1","-42.01","53.8","72.17","67.99","22.47","0","32","35","36","1","0"
"2009","Medicine Hat, Alberta, municipal","48062","Possession, cocaine","10","9","1","-70.02","16.13","24.43","22.43","0","0","10","12","12","0","0"
"2010","Medicine Hat, Alberta, municipal","48062","Possession, cocaine","25","21","2","149.97","40.32","59.07","57.99","45.85","0","23","29","31","2","0"
"2011","Medicine Hat, Alberta, municipal","48062","Possession, cocaine","26","23","2","4.01","41.94","59.05","54.23","0","0","25","29","29","0","0"
"2012","Medicine Hat, Alberta, municipal","48062","Possession, cocaine","17","13","1","-35.4","27.09","32.16","29.56","0","0","14","16","16","0","0"
"2013","Medicine Hat, Alberta, municipal","48062","Possession, cocaine","18","18","0","4.58","28.33","61.51","56.61","0","0","18","31","31","0","0"
"2014","Medicine Hat, Alberta, municipal","48062","Possession, cocaine","29","26","4","59.72","45.25","60.89","56.12","0","0","30","31","31","0","0"
"2015","Medicine Hat, Alberta, municipal","48062","Possession, cocaine","26","23","3","-11.03","40.26","54.64","50.37","0","0","26","28","28","0","0"
"2016","Medicine Hat, Alberta, municipal","48062","Possession, cocaine","26","23","1","-0.61","40.02","52.46","51.95","45.86","0","24","27","29","2","0"
"1998","Medicine Hat, Alberta, municipal","48062","Total, possession, other Controlled Drugs and Substances Act drugs","3","3","0","0","6.04","0","0","0","0","3","3","3","0","0"
"1999","Medicine Hat, Alberta, municipal","48062","Total, possession, other Controlled Drugs and Substances Act drugs","3","2","0","-1.89","5.92","0","0","0","0","2","2","2","0","0"
"2000","Medicine Hat, Alberta, municipal","48062","Total, possession, other Controlled Drugs and Substances Act drugs","3","1","0","-2.24","5.79","0","0","0","0","1","1","1","0","0"
"2001","Medicine Hat, Alberta, municipal","48062","Total, possession, other Controlled Drugs and Substances Act drugs","6","6","0","97.12","11.41","0","0","0","0","6","6","6","0","0"
"2002","Medicine Hat, Alberta, municipal","48062","Total, possession, other Controlled Drugs and Substances Act drugs","6","6","0","-1.56","11.23","0","0","0","0","6","5","8","3","0"
"2003","Medicine Hat, Alberta, municipal","48062","Total, possession, other Controlled Drugs and Substances Act drugs","11","9","0","80.68","20.3","0","0","0","0","9","9","10","1","0"
"2004","Medicine Hat, Alberta, municipal","48062","Total, possession, other Controlled Drugs and Substances Act drugs","6","3","0","-47.07","10.74","2.29","6.24","45.05","0","3","1","3","2","0"
"2005","Medicine Hat, Alberta, municipal","48062","Total, possession, other Controlled Drugs and Substances Act drugs","17","10","1","175.64","29.61","24.43","22.21","0","0","11","11","11","0","0"
"2006","Medicine Hat, Alberta, municipal","48062","Total, possession, other Controlled Drugs and Substances Act drugs","7","6","0","-59.9","11.88","15.08","17.68","44.48","0","6","7","9","2","0"
"2007","Medicine Hat, Alberta, municipal","48062","Total, possession, other Controlled Drugs and Substances Act drugs","7","7","0","-2.34","11.6","12.59","13.43","22.27","0","7","6","7","1","0"
"2008","Medicine Hat, Alberta, municipal","48062","Total, possession, other Controlled Drugs and Substances Act drugs","4","3","0","-43.77","6.52","2.06","5.67","44.94","0","3","1","3","2","0"
"2009","Medicine Hat, Alberta, municipal","48062","Total, possession, other Controlled Drugs and Substances Act drugs","10","7","2","147.33","16.13","14.25","14.96","22.84","22.84","9","7","8","1","1"
"2010","Medicine Hat, Alberta, municipal","48062","Total, possession, other Controlled Drugs and Substances Act drugs","14","12","0","39.98","22.58","24.44","24.32","22.93","0","12","12","13","1","0"
"2011","Medicine Hat, Alberta, municipal","48062","Total, possession, other Controlled Drugs and Substances Act drugs","11","7","2","-21.42","17.74","18.32","16.83","0","22.94","9","9","9","0","1"
"2012","Medicine Hat, Alberta, municipal","48062","Total, possession, other Controlled Drugs and Substances Act drugs","15","15","0","34.73","23.9","38.19","36.95","22.84","0","15","19","20","1","0"
"2013","Medicine Hat, Alberta, municipal","48062","Total, possession, other Controlled Drugs and Substances Act drugs","13","12","0","-14.4","20.46","29.76","27.39","0","0","12","15","15","0","0"
"2014","Medicine Hat, Alberta, municipal","48062","Total, possession, other Controlled Drugs and Substances Act drugs","18","17","1","37.27","28.09","41.25","41.64","46.19","0","18","21","23","2","0"
"2015","Medicine Hat, Alberta, municipal","48062","Total, possession, other Controlled Drugs and Substances Act drugs","41","36","5","126.05","63.49","76.1","71.96","23.05","23.05","41","39","40","1","1"
"2016","Medicine Hat, Alberta, municipal","48062","Total, possession, other Controlled Drugs and Substances Act drugs","94","87","4","127.87","144.68","194.3","180.92","22.93","22.93","91","100","101","1","1"
"1998","Medicine Hat, Alberta, municipal","48062","Heroin, possession","0","0","0","0","0","0","0","0","0","0","0","0","0","0"
"1999","Medicine Hat, Alberta, municipal","48062","Heroin, possession","0","0","0","0","0","0","0","0","0","0","0","0","0","0"
"2000","Medicine Hat, Alberta, municipal","48062","Heroin, possession","0","0","0","0","0","0","0","0","0","0","0","0","0","0"
"2001","Medicine Hat, Alberta, municipal","48062","Heroin, possession","0","0","0","0","0","0","0","0","0","0","0","0","0","0"
"2002","Medicine Hat, Alberta, municipal","48062","Heroin, possession","0","0","0","0","0","0","0","0","0","0","0","0","0","0"
"2003","Medicine Hat, Alberta, municipal","48062","Heroin, possession","0","0","0","0","0","0","0","0","0","0","0","0","0","0"
"2004","Medicine Hat, Alberta, municipal","48062","Heroin, possession","0","0","0","0","0","0","0","0","0","0","0","0","0","0"
"2005","Medicine Hat, Alberta, municipal","48062","Heroin, possession","0","0","0","0","0","0","0","0","0","0","0","0","0","0"
"2006","Medicine Hat, Alberta, municipal","48062","Heroin, possession","0","0","0","0","0","0","0","0","0","0","0","0","0","0"
"2007","Medicine Hat, Alberta, municipal","48062","Heroin, possession","0","0","0","0","0","0","0","0","0","0","0","0","0","0"
"2008","Medicine Hat, Alberta, municipal","48062","Heroin, possession","0","0","0","0","0","0","0","0","0","0","0","0","0","0"
"2009","Medicine Hat, Alberta, municipal","48062","Heroin, possession","0","0","0","0","0","0","0","0","0","0","0","0","0","0"
"2010","Medicine Hat, Alberta, municipal","48062","Heroin, possession","0","0","0","0","0","0","0","0","0","0","0","0","0","0"
"2011","Medicine Hat, Alberta, municipal","48062","Heroin, possession","0","0","0","0","0","0","0","0","0","0","0","0","0","0"
"2012","Medicine Hat, Alberta, municipal","48062","Heroin, possession","0","0","0","0","0","0","0","0","0","0","0","0","0","0"
"2013","Medicine Hat, Alberta, municipal","48062","Heroin, possession","0","0","0","0","0","0","0","0","0","0","0","0","0","0"
"2014","Medicine Hat, Alberta, municipal","48062","Heroin, possession","0","0","0","0","0","0","0","0","0","0","0","0","0","0"
"2015","Medicine Hat, Alberta, municipal","48062","Heroin, possession","1","1","0","0","1.55","3.9","3.6","0","0","1","2","2","0","0"
"2016","Medicine Hat, Alberta, municipal","48062","Heroin, possession","5","5","0","396.94","7.7","9.72","8.96","0","0","5","5","5","0","0"
"1998","Medicine Hat, Alberta, municipal","48062","Other Controlled Drugs and Substances Act, possession","3","3","0","0","6.04","0","0","0","0","3","3","3","0","0"
"1999","Medicine Hat, Alberta, municipal","48062","Other Controlled Drugs and Substances Act, possession","3","2","0","-1.89","5.92","0","0","0","0","2","2","2","0","0"
"2000","Medicine Hat, Alberta, municipal","48062","Other Controlled Drugs and Substances Act, possession","3","1","0","-2.24","5.79","0","0","0","0","1","1","1","0","0"
"2001","Medicine Hat, Alberta, municipal","48062","Other Controlled Drugs and Substances Act, possession","6","6","0","97.12","11.41","0","0","0","0","6","6","6","0","0"
"2002","Medicine Hat, Alberta, municipal","48062","Other Controlled Drugs and Substances Act, possession","6","6","0","-1.56","11.23","0","0","0","0","6","5","8","3","0"
"2003","Medicine Hat, Alberta, municipal","48062","Other Controlled Drugs and Substances Act, possession","11","9","0","80.68","20.3","0","0","0","0","9","9","10","1","0"
"2004","Medicine Hat, Alberta, municipal","48062","Other Controlled Drugs and Substances Act, possession","6","3","0","-47.07","10.74","2.29","6.24","45.05","0","3","1","3","2","0"
"2005","Medicine Hat, Alberta, municipal","48062","Other Controlled Drugs and Substances Act, possession","17","10","1","175.64","29.61","24.43","22.21","0","0","11","11","11","0","0"
"2006","Medicine Hat, Alberta, municipal","48062","Other Controlled Drugs and Substances Act, possession","7","6","0","-59.9","11.88","15.08","17.68","44.48","0","6","7","9","2","0"
"2007","Medicine Hat, Alberta, municipal","48062","Other Controlled Drugs and Substances Act, possession","7","7","0","-2.34","11.6","12.59","13.43","22.27","0","7","6","7","1","0"
"2008","Medicine Hat, Alberta, municipal","48062","Other Controlled Drugs and Substances Act, possession","4","3","0","-43.77","6.52","2.06","5.67","44.94","0","3","1","3","2","0"
"2009","Medicine Hat, Alberta, municipal","48062","Other Controlled Drugs and Substances Act, possession","7","4","2","73.13","11.29","12.22","11.22","0","22.84","6","6","6","0","1"
"2010","Medicine Hat, Alberta, municipal","48062","Other Controlled Drugs and Substances Act, possession","10","8","0","42.84","16.13","14.26","14.97","22.93","0","8","7","8","1","0"
"2011","Medicine Hat, Alberta, municipal","48062","Other Controlled Drugs and Substances Act, possession","9","6","1","-9.99","14.52","16.29","14.96","0","22.94","7","8","8","0","1"
"2012","Medicine Hat, Alberta, municipal","48062","Other Controlled Drugs and Substances Act, possession","11","11","0","20.76","17.53","30.15","27.71","0","0","11","15","15","0","0"
"2013","Medicine Hat, Alberta, municipal","48062","Other Controlled Drugs and Substances Act, possession","13","12","0","16.73","20.46","29.76","27.39","0","0","12","15","15","0","0"
"2014","Medicine Hat, Alberta, municipal","48062","Other Controlled Drugs and Substances Act, possession","11","10","1","-16.11","17.17","19.64","21.72","46.19","0","11","10","12","2","0"
"2015","Medicine Hat, Alberta, municipal","48062","Other Controlled Drugs and Substances Act, possession","11","8","3","-0.76","17.03","13.66","12.59","0","23.05","11","7","7","0","1"
"2016","Medicine Hat, Alberta, municipal","48062","Other Controlled Drugs and Substances Act, possession","18","18","0","62.64","27.71","36.92","34.03","0","0","18","19","19","0","0"
"2005","Medicine Hat, Alberta, municipal","48062","Methamphetamines (crystal meth), possession","0","0","0","0","0","0","0","0","0","0","0","0","0","0"
"2006","Medicine Hat, Alberta, municipal","48062","Methamphetamines (crystal meth), possession","0","0","0","0","0","0","0","0","0","0","0","0","0","0"
"2007","Medicine Hat, Alberta, municipal","48062","Methamphetamines (crystal meth), possession","0","0","0","0","0","0","0","0","0","0","0","0","0","0"
"2008","Medicine Hat, Alberta, municipal","48062","Methamphetamines (crystal meth), possession","0","0","0","0","0","0","0","0","0","0","0","0","0","0"
"2009","Medicine Hat, Alberta, municipal","48062","Methamphetamines (crystal meth), possession","0","0","0","0","0","0","0","0","0","0","0","0","0","0"
"2010","Medicine Hat, Alberta, municipal","48062","Methamphetamines (crystal meth), possession","1","1","0","0","1.61","2.04","1.87","0","0","1","1","1","0","0"
"2011","Medicine Hat, Alberta, municipal","48062","Methamphetamines (crystal meth), possession","1","1","0","0.01","1.61","2.04","1.87","0","0","1","1","1","0","0"
"2012","Medicine Hat, Alberta, municipal","48062","Methamphetamines (crystal meth), possession","3","3","0","196.4","4.78","8.04","7.39","0","0","3","4","4","0","0"
"2013","Medicine Hat, Alberta, municipal","48062","Methamphetamines (crystal meth), possession","0","0","0","-100","0","0","0","0","0","0","0","0","0","0"
"2014","Medicine Hat, Alberta, municipal","48062","Methamphetamines (crystal meth), possession","7","7","0","0","10.92","21.61","19.91","0","0","7","11","11","0","0"
"2015","Medicine Hat, Alberta, municipal","48062","Methamphetamines (crystal meth), possession","29","27","2","311.14","44.91","58.54","55.77","23.05","0","29","30","31","1","0"
"2016","Medicine Hat, Alberta, municipal","48062","Methamphetamines (crystal meth), possession","71","64","4","143.33","109.28","147.67","137.93","22.93","22.93","68","76","77","1","1"
"2005","Medicine Hat, Alberta, municipal","48062","Methylenedioxyamphetamine (ecstasy), possession","0","0","0","0","0","0","0","0","0","0","0","0","0","0"
"2006","Medicine Hat, Alberta, municipal","48062","Methylenedioxyamphetamine (ecstasy), possession","0","0","0","0","0","0","0","0","0","0","0","0","0","0"
"2007","Medicine Hat, Alberta, municipal","48062","Methylenedioxyamphetamine (ecstasy), possession","0","0","0","0","0","0","0","0","0","0","0","0","0","0"
"2008","Medicine Hat, Alberta, municipal","48062","Methylenedioxyamphetamine (ecstasy), possession","0","0","0","0","0","0","0","0","0","0","0","0","0","0"
"2009","Medicine Hat, Alberta, municipal","48062","Methylenedioxyamphetamine (ecstasy), possession","3","3","0","0","4.84","2.04","3.74","22.84","0","3","1","2","1","0"
"2010","Medicine Hat, Alberta, municipal","48062","Methylenedioxyamphetamine (ecstasy), possession","3","3","0","-0.01","4.84","8.15","7.48","0","0","3","4","4","0","0"
"2011","Medicine Hat, Alberta, municipal","48062","Methylenedioxyamphetamine (ecstasy), possession","1","0","1","-66.66","1.61","0","0","0","0","1","0","0","0","0"
"2012","Medicine Hat, Alberta, municipal","48062","Methylenedioxyamphetamine (ecstasy), possession","1","1","0","-1.2","1.59","0","1.85","22.84","0","1","0","1","1","0"
"2013","Medicine Hat, Alberta, municipal","48062","Methylenedioxyamphetamine (ecstasy), possession","0","0","0","-100","0","0","0","0","0","0","0","0","0","0"
"2014","Medicine Hat, Alberta, municipal","48062","Methylenedioxyamphetamine (ecstasy), possession","0","0","0","0","0","0","0","0","0","0","0","0","0","0"
"2015","Medicine Hat, Alberta, municipal","48062","Methylenedioxyamphetamine (ecstasy), possession","0","0","0","0","0","0","0","0","0","0","0","0","0","0"
"2016","Medicine Hat, Alberta, municipal","48062","Methylenedioxyamphetamine (ecstasy), possession","0","0","0","0","0","0","0","0","0","0","0","0","0","0"
"1998","Medicine Hat, Alberta, municipal","48062","Total cannabis, trafficking, production or distribution","13","17","0","0","26.16","0","0","0","0","17","24","24","0","0"
"1999","Medicine Hat, Alberta, municipal","48062","Total cannabis, trafficking, production or distribution","9","9","0","-32.08","17.77","0","0","0","0","9","9","14","5","0"
"2000","Medicine Hat, Alberta, municipal","48062","Total cannabis, trafficking, production or distribution","15","12","0","62.93","28.95","0","0","0","0","12","13","16","3","0"
"2001","Medicine Hat, Alberta, municipal","48062","Total cannabis, trafficking, production or distribution","13","10","2","-14.58","24.73","0","0","0","0","12","13","15","2","2"
"2002","Medicine Hat, Alberta, municipal","48062","Total cannabis, trafficking, production or distribution","8","5","0","-39.42","14.98","0","0","0","0","5","8","12","4","0"
"2003","Medicine Hat, Alberta, municipal","48062","Total cannabis, trafficking, production or distribution","36","36","1","343.5","66.43","0","0","0","0","37","42","50","8","1"
"2004","Medicine Hat, Alberta, municipal","48062","Total cannabis, trafficking, production or distribution","3","4","0","-91.91","5.37","11.45","12.47","22.52","0","4","5","6","1","0"
"2005","Medicine Hat, Alberta, municipal","48062","Total cannabis, trafficking, production or distribution","10","9","1","224.28","17.42","26.66","28.27","44.4","0","10","12","14","2","0"
"2006","Medicine Hat, Alberta, municipal","48062","Total cannabis, trafficking, production or distribution","14","13","0","36.34","23.75","36.63","43.22","111.21","22.24","13","17","22","5","1"
"2007","Medicine Hat, Alberta, municipal","48062","Total cannabis, trafficking, production or distribution","15","15","0","4.64","24.85","48.28","46.04","22.27","0","15","23","24","1","0"
"2008","Medicine Hat, Alberta, municipal","48062","Total cannabis, trafficking, production or distribution","13","11","1","-14.72","21.19","28.87","32.11","67.42","22.47","12","14","17","3","1"
"2009","Medicine Hat, Alberta, municipal","48062","Total cannabis, trafficking, production or distribution","34","32","0","158.75","54.84","83.48","76.65","0","0","32","41","41","0","0"
"2010","Medicine Hat, Alberta, municipal","48062","Total cannabis, trafficking, production or distribution","45","42","0","32.34","72.57","112.03","115.98","160.48","0","42","55","62","7","0"
"2011","Medicine Hat, Alberta, municipal","48062","Total cannabis, trafficking, production or distribution","53","48","0","17.79","85.49","128.27","127.16","114.68","0","48","63","68","5","0"
"2012","Medicine Hat, Alberta, municipal","48062","Total cannabis, trafficking, production or distribution","35","34","0","-34.75","55.78","96.49","99.77","137.02","0","34","48","54","6","0"
"2013","Medicine Hat, Alberta, municipal","48062","Total cannabis, trafficking, production or distribution","21","20","0","-40.74","33.05","79.37","74.87","22.92","0","20","40","41","1","0"
"2014","Medicine Hat, Alberta, municipal","48062","Total cannabis, trafficking, production or distribution","8","8","0","-62.23","12.48","15.71","18.1","46.19","0","8","8","10","2","0"
"2015","Medicine Hat, Alberta, municipal","48062","Total cannabis, trafficking, production or distribution","5","5","0","-37.97","7.74","11.71","10.79","0","0","5","6","6","0","0"
"2016","Medicine Hat, Alberta, municipal","48062","Total cannabis, trafficking, production or distribution","7","6","1","39.14","10.77","17.49","16.12","0","0","7","9","9","0","0"
"1998","Medicine Hat, Alberta, municipal","48062","Cannabis, trafficking","12","16","0","0","24.15","0","0","0","0","16","22","22","0","0"
"1999","Medicine Hat, Alberta, municipal","48062","Cannabis, trafficking","7","7","0","-42.77","13.82","0","0","0","0","7","6","11","5","0"
"2000","Medicine Hat, Alberta, municipal","48062","Cannabis, trafficking","12","10","0","67.59","23.16","0","0","0","0","10","12","14","2","0"
"2001","Medicine Hat, Alberta, municipal","48062","Cannabis, trafficking","11","9","1","-9.65","20.92","0","0","0","0","10","12","14","2","2"
"2002","Medicine Hat, Alberta, municipal","48062","Cannabis, trafficking","7","4","0","-37.36","13.11","0","0","0","0","4","6","10","4","0"
"2003","Medicine Hat, Alberta, municipal","48062","Cannabis, trafficking","34","35","1","378.7","62.74","0","0","0","0","36","40","48","8","1"
"2004","Medicine Hat, Alberta, municipal","48062","Cannabis, trafficking","3","3","0","-91.44","5.37","6.87","8.31","22.52","0","3","3","4","1","0"
"2005","Medicine Hat, Alberta, municipal","48062","Cannabis, trafficking","9","9","0","191.85","15.68","26.66","28.27","44.4","0","9","12","14","2","0"
"2006","Medicine Hat, Alberta, municipal","48062","Cannabis, trafficking","13","12","0","40.67","22.05","34.48","39.29","88.97","22.24","12","16","20","4","1"
"2007","Medicine Hat, Alberta, municipal","48062","Cannabis, trafficking","14","14","0","5.18","23.2","44.08","42.2","22.27","0","14","21","22","1","0"
"2008","Medicine Hat, Alberta, municipal","48062","Cannabis, trafficking","11","10","1","-22.68","17.93","26.81","30.22","67.42","22.47","11","13","16","3","1"
"2009","Medicine Hat, Alberta, municipal","48062","Cannabis, trafficking","34","32","0","205.8","54.84","83.48","76.65","0","0","32","41","41","0","0"
"2010","Medicine Hat, Alberta, municipal","48062","Cannabis, trafficking","45","42","0","32.34","72.57","112.03","115.98","160.48","0","42","55","62","7","0"
"2011","Medicine Hat, Alberta, municipal","48062","Cannabis, trafficking","51","46","0","13.35","82.26","120.13","119.68","114.68","0","46","59","64","5","0"
"2012","Medicine Hat, Alberta, municipal","48062","Cannabis, trafficking","35","34","0","-32.19","55.78","96.49","99.77","137.02","0","34","48","54","6","0"
"2013","Medicine Hat, Alberta, municipal","48062","Cannabis, trafficking","20","19","0","-43.56","31.48","75.4","71.22","22.92","0","19","38","39","1","0"
"2014","Medicine Hat, Alberta, municipal","48062","Cannabis, trafficking","7","7","0","-65.3","10.92","15.71","18.1","46.19","0","7","8","10","2","0"
"2015","Medicine Hat, Alberta, municipal","48062","Cannabis, trafficking","4","4","0","-43.29","6.19","9.76","9","0","0","4","5","5","0","0"
"2016","Medicine Hat, Alberta, municipal","48062","Cannabis, trafficking","6","6","0","49.08","9.24","17.49","16.12","0","0","6","9","9","0","0"
"1998","Medicine Hat, Alberta, municipal","48062","Cannabis, importation and exportation","0","0","0","0","0","0","0","0","0","0","0","0","0","0"
"1999","Medicine Hat, Alberta, municipal","48062","Cannabis, importation and exportation","0","0","0","0","0","0","0","0","0","0","0","0","0","0"
"2000","Medicine Hat, Alberta, municipal","48062","Cannabis, importation and exportation","0","0","0","0","0","0","0","0","0","0","0","0","0","0"
"2001","Medicine Hat, Alberta, municipal","48062","Cannabis, importation and exportation","0","0","0","0","0","0","0","0","0","0","0","0","0","0"
"2002","Medicine Hat, Alberta, municipal","48062","Cannabis, importation and exportation","1","1","0","0","1.87","0","0","0","0","1","2","2","0","0"
"2003","Medicine Hat, Alberta, municipal","48062","Cannabis, importation and exportation","0","0","0","-100","0","0","0","0","0","0","0","0","0","0"
"2004","Medicine Hat, Alberta, municipal","48062","Cannabis, importation and exportation","0","0","0","0","0","0","0","0","0","0","0","0","0","0"
"2005","Medicine Hat, Alberta, municipal","48062","Cannabis, importation and exportation","1","0","1","0","1.74","0","0","0","0","1","0","0","0","0"
"2006","Medicine Hat, Alberta, municipal","48062","Cannabis, importation and exportation","0","0","0","-100","0","0","0","0","0","0","0","0","0","0"
"2007","Medicine Hat, Alberta, municipal","48062","Cannabis, importation and exportation","0","0","0","0","0","0","0","0","0","0","0","0","0","0"
"2008","Medicine Hat, Alberta, municipal","48062","Cannabis, importation and exportation","0","0","0","0","0","0","0","0","0","0","0","0","0","0"
"2009","Medicine Hat, Alberta, municipal","48062","Cannabis, importation and exportation","0","0","0","0","0","0","0","0","0","0","0","0","0","0"
"2010","Medicine Hat, Alberta, municipal","48062","Cannabis, importation and exportation","0","0","0","0","0","0","0","0","0","0","0","0","0","0"
"2011","Medicine Hat, Alberta, municipal","48062","Cannabis, importation and exportation","0","0","0","0","0","0","0","0","0","0","0","0","0","0"
"2012","Medicine Hat, Alberta, municipal","48062","Cannabis, importation and exportation","0","0","0","0","0","0","0","0","0","0","0","0","0","0"
"2013","Medicine Hat, Alberta, municipal","48062","Cannabis, importation and exportation","0","0","0","0","0","0","0","0","0","0","0","0","0","0"
"2014","Medicine Hat, Alberta, municipal","48062","Cannabis, importation and exportation","0","0","0","0","0","0","0","0","0","0","0","0","0","0"
"2015","Medicine Hat, Alberta, municipal","48062","Cannabis, importation and exportation","0","0","0","0","0","0","0","0","0","0","0","0","0","0"
"2016","Medicine Hat, Alberta, municipal","48062","Cannabis, importation and exportation","0","0","0","0","0","0","0","0","0","0","0","0","0","0"
"1998","Medicine Hat, Alberta, municipal","48062","Cannabis, production","1","1","0","0","2.01","0","0","0","0","1","2","2","0","0"
"1999","Medicine Hat, Alberta, municipal","48062","Cannabis, production","2","2","0","96.23","3.95","0","0","0","0","2","3","3","0","0"
"2000","Medicine Hat, Alberta, municipal","48062","Cannabis, production","3","2","0","46.64","5.79","0","0","0","0","2","1","2","1","0"
"2001","Medicine Hat, Alberta, municipal","48062","Cannabis, production","2","1","1","-34.29","3.8","0","0","0","0","2","1","1","0","0"
"2002","Medicine Hat, Alberta, municipal","48062","Cannabis, production","0","0","0","-100","0","0","0","0","0","0","0","0","0","0"
"2003","Medicine Hat, Alberta, municipal","48062","Cannabis, production","2","1","0","0","3.69","0","0","0","0","1","2","2","0","0"
"2004","Medicine Hat, Alberta, municipal","48062","Cannabis, production","0","1","0","-100","0","4.58","4.16","0","0","1","2","2","0","0"
"2005","Medicine Hat, Alberta, municipal","48062","Cannabis, production","0","0","0","0","0","0","0","0","0","0","0","0","0","0"
"2006","Medicine Hat, Alberta, municipal","48062","Cannabis, production","1","1","0","0","1.7","2.15","3.93","22.24","0","1","1","2","1","0"
"2007","Medicine Hat, Alberta, municipal","48062","Cannabis, production","1","1","0","-2.34","1.66","4.2","3.84","0","0","1","2","2","0","0"
"2008","Medicine Hat, Alberta, municipal","48062","Cannabis, production","2","1","0","96.81","3.26","2.06","1.89","0","0","1","1","1","0","0"
"2009","Medicine Hat, Alberta, municipal","48062","Cannabis, production","0","0","0","-100","0","0","0","0","0","0","0","0","0","0"
"2010","Medicine Hat, Alberta, municipal","48062","Cannabis, production","0","0","0","0","0","0","0","0","0","0","0","0","0","0"
"2011","Medicine Hat, Alberta, municipal","48062","Cannabis, production","2","2","0","0","3.23","8.14","7.48","0","0","2","4","4","0","0"
"2012","Medicine Hat, Alberta, municipal","48062","Cannabis, production","0","0","0","-100","0","0","0","0","0","0","0","0","0","0"
"2013","Medicine Hat, Alberta, municipal","48062","Cannabis, production","1","1","0","0","1.57","3.97","3.65","0","0","1","2","2","0","0"
"2014","Medicine Hat, Alberta, municipal","48062","Cannabis, production","1","1","0","-0.86","1.56","0","0","0","0","1","0","0","0","0"
"2015","Medicine Hat, Alberta, municipal","48062","Cannabis, production","1","1","0","-0.76","1.55","1.95","1.8","0","0","1","1","1","0","0"
"2016","Medicine Hat, Alberta, municipal","48062","Cannabis, production","1","0","1","-0.61","1.54","0","0","0","0","1","0","0","0","0"
"1998","Medicine Hat, Alberta, municipal","48062","Total cocaine, trafficking, production or distribution","0","2","0","0","0","0","0","0","0","2","3","3","0","0"
"1999","Medicine Hat, Alberta, municipal","48062","Total cocaine, trafficking, production or distribution","4","4","0","0","7.9","0","0","0","0","4","17","17","0","0"
"2000","Medicine Hat, Alberta, municipal","48062","Total cocaine, trafficking, production or distribution","1","1","0","-75.56","1.93","0","0","0","0","1","1","1","0","0"
"2001","Medicine Hat, Alberta, municipal","48062","Total cocaine, trafficking, production or distribution","7","4","0","589.92","13.32","0","0","0","0","4","6","6","0","0"
"2002","Medicine Hat, Alberta, municipal","48062","Total cocaine, trafficking, production or distribution","7","6","0","-1.56","13.11","0","0","0","0","6","7","7","0","0"
"2003","Medicine Hat, Alberta, municipal","48062","Total cocaine, trafficking, production or distribution","54","37","0","660.28","99.65","0","0","0","0","37","35","40","5","0"
"2004","Medicine Hat, Alberta, municipal","48062","Total cocaine, trafficking, production or distribution","50","46","0","-10.15","89.53","109.91","112.24","135.14","0","46","48","54","6","0"
"2005","Medicine Hat, Alberta, municipal","48062","Total cocaine, trafficking, production or distribution","55","66","2","7.01","95.81","177.7","173.66","133.21","22.2","68","80","86","6","1"
"2006","Medicine Hat, Alberta, municipal","48062","Total cocaine, trafficking, production or distribution","35","28","0","-38.03","59.38","103.43","94.29","0","0","28","48","48","0","0"
"2007","Medicine Hat, Alberta, municipal","48062","Total cocaine, trafficking, production or distribution","55","55","0","53.47","91.12","191.01","178.39","44.54","0","55","91","93","2","0"
"2008","Medicine Hat, Alberta, municipal","48062","Total cocaine, trafficking, production or distribution","50","47","0","-10.54","81.52","158.77","151.09","67.42","0","47","77","80","3","0"
"2009","Medicine Hat, Alberta, municipal","48062","Total cocaine, trafficking, production or distribution","39","36","1","-22.83","62.91","114.02","106.56","22.84","0","37","56","57","1","0"
"2010","Medicine Hat, Alberta, municipal","48062","Total cocaine, trafficking, production or distribution","39","36","0","-0.01","62.9","124.25","117.85","45.85","0","36","61","63","2","0"
"2011","Medicine Hat, Alberta, municipal","48062","Total cocaine, trafficking, production or distribution","67","61","0","71.82","108.07","187.32","185.13","160.55","0","61","92","99","7","0"
"2012","Medicine Hat, Alberta, municipal","48062","Total cocaine, trafficking, production or distribution","124","113","1","82.86","197.61","281.43","262.36","45.67","0","114","140","142","2","0"
"2013","Medicine Hat, Alberta, municipal","48062","Total cocaine, trafficking, production or distribution","70","64","0","-44.24","110.18","277.78","259.3","45.84","0","64","140","142","2","0"
"2014","Medicine Hat, Alberta, municipal","48062","Total cocaine, trafficking, production or distribution","35","36","0","-50.43","54.62","125.72","117.67","23.09","0","36","64","65","1","0"
"2015","Medicine Hat, Alberta, municipal","48062","Total cocaine, trafficking, production or distribution","34","31","0","-3.59","52.65","113.18","104.34","0","0","31","58","58","0","0"
"2016","Medicine Hat, Alberta, municipal","48062","Total cocaine, trafficking, production or distribution","24","23","0","-29.84","36.94","85.49","78.81","0","0","23","44","44","0","0"
"1998","Medicine Hat, Alberta, municipal","48062","Cocaine, trafficking","0","2","0","0","0","0","0","0","0","2","3","3","0","0"
"1999","Medicine Hat, Alberta, municipal","48062","Cocaine, trafficking","4","4","0","0","7.9","0","0","0","0","4","17","17","0","0"
"2000","Medicine Hat, Alberta, municipal","48062","Cocaine, trafficking","1","1","0","-75.56","1.93","0","0","0","0","1","1","1","0","0"
"2001","Medicine Hat, Alberta, municipal","48062","Cocaine, trafficking","7","4","0","589.92","13.32","0","0","0","0","4","6","6","0","0"
"2002","Medicine Hat, Alberta, municipal","48062","Cocaine, trafficking","7","6","0","-1.56","13.11","0","0","0","0","6","7","7","0","0"
"2003","Medicine Hat, Alberta, municipal","48062","Cocaine, trafficking","54","37","0","660.28","99.65","0","0","0","0","37","35","40","5","0"
"2004","Medicine Hat, Alberta, municipal","48062","Cocaine, trafficking","50","46","0","-10.15","89.53","109.91","112.24","135.14","0","46","48","54","6","0"
"2005","Medicine Hat, Alberta, municipal","48062","Cocaine, trafficking","55","66","2","7.01","95.81","177.7","173.66","133.21","22.2","68","80","86","6","1"
"2006","Medicine Hat, Alberta, municipal","48062","Cocaine, trafficking","35","28","0","-38.03","59.38","103.43","94.29","0","0","28","48","48","0","0"
"2007","Medicine Hat, Alberta, municipal","48062","Cocaine, trafficking","55","55","0","53.47","91.12","191.01","178.39","44.54","0","55","91","93","2","0"
"2008","Medicine Hat, Alberta, municipal","48062","Cocaine, trafficking","50","47","0","-10.54","81.52","158.77","151.09","67.42","0","47","77","80","3","0"
"2009","Medicine Hat, Alberta, municipal","48062","Cocaine, trafficking","39","36","1","-22.83","62.91","114.02","106.56","22.84","0","37","56","57","1","0"
"2010","Medicine Hat, Alberta, municipal","48062","Cocaine, trafficking","39","36","0","-0.01","62.9","124.25","117.85","45.85","0","36","61","63","2","0"
"2011","Medicine Hat, Alberta, municipal","48062","Cocaine, trafficking","67","61","0","71.82","108.07","187.32","185.13","160.55","0","61","92","99","7","0"
"2012","Medicine Hat, Alberta, municipal","48062","Cocaine, trafficking","123","113","1","81.38","196.02","281.43","262.36","45.67","0","114","140","142","2","0"
"2013","Medicine Hat, Alberta, municipal","48062","Cocaine, trafficking","70","64","0","-43.79","110.18","277.78","259.3","45.84","0","64","140","142","2","0"
"2014","Medicine Hat, Alberta, municipal","48062","Cocaine, trafficking","35","36","0","-50.43","54.62","125.72","117.67","23.09","0","36","64","65","1","0"
"2015","Medicine Hat, Alberta, municipal","48062","Cocaine, trafficking","34","31","0","-3.59","52.65","113.18","104.34","0","0","31","58","58","0","0"
"2016","Medicine Hat, Alberta, municipal","48062","Cocaine, trafficking","24","23","0","-29.84","36.94","85.49","78.81","0","0","23","44","44","0","0"
"1998","Medicine Hat, Alberta, municipal","48062","Cocaine, importation and exportation","0","0","0","0","0","0","0","0","0","0","0","0","0","0"
"1999","Medicine Hat, Alberta, municipal","48062","Cocaine, importation and exportation","0","0","0","0","0","0","0","0","0","0","0","0","0","0"
"2000","Medicine Hat, Alberta, municipal","48062","Cocaine, importation and exportation","0","0","0","0","0","0","0","0","0","0","0","0","0","0"
"2001","Medicine Hat, Alberta, municipal","48062","Cocaine, importation and exportation","0","0","0","0","0","0","0","0","0","0","0","0","0","0"
"2002","Medicine Hat, Alberta, municipal","48062","Cocaine, importation and exportation","0","0","0","0","0","0","0","0","0","0","0","0","0","0"
"2003","Medicine Hat, Alberta, municipal","48062","Cocaine, importation and exportation","0","0","0","0","0","0","0","0","0","0","0","0","0","0"
"2004","Medicine Hat, Alberta, municipal","48062","Cocaine, importation and exportation","0","0","0","0","0","0","0","0","0","0","0","0","0","0"
"2005","Medicine Hat, Alberta, municipal","48062","Cocaine, importation and exportation","0","0","0","0","0","0","0","0","0","0","0","0","0","0"
"2006","Medicine Hat, Alberta, municipal","48062","Cocaine, importation and exportation","0","0","0","0","0","0","0","0","0","0","0","0","0","0"
"2007","Medicine Hat, Alberta, municipal","48062","Cocaine, importation and exportation","0","0","0","0","0","0","0","0","0","0","0","0","0","0"
"2008","Medicine Hat, Alberta, municipal","48062","Cocaine, importation and exportation","0","0","0","0","0","0","0","0","0","0","0","0","0","0"
"2009","Medicine Hat, Alberta, municipal","48062","Cocaine, importation and exportation","0","0","0","0","0","0","0","0","0","0","0","0","0","0"
"2010","Medicine Hat, Alberta, municipal","48062","Cocaine, importation and exportation","0","0","0","0","0","0","0","0","0","0","0","0","0","0"
"2011","Medicine Hat, Alberta, municipal","48062","Cocaine, importation and exportation","0","0","0","0","0","0","0","0","0","0","0","0","0","0"
"2012","Medicine Hat, Alberta, municipal","48062","Cocaine, importation and exportation","1","0","0","0","1.59","0","0","0","0","0","0","0","0","0"
"2013","Medicine Hat, Alberta, municipal","48062","Cocaine, importation and exportation","0","0","0","-100","0","0","0","0","0","0","0","0","0","0"
"2014","Medicine Hat, Alberta, municipal","48062","Cocaine, importation and exportation","0","0","0","0","0","0","0","0","0","0","0","0","0","0"
"2015","Medicine Hat, Alberta, municipal","48062","Cocaine, importation and exportation","0","0","0","0","0","0","0","0","0","0","0","0","0","0"
"2016","Medicine Hat, Alberta, municipal","48062","Cocaine, importation and exportation","0","0","0","0","0","0","0","0","0","0","0","0","0","0"
"2005","Medicine Hat, Alberta, municipal","48062","Cocaine, production","0","0","0","0","0","0","0","0","0","0","0","0","0","0"
"2006","Medicine Hat, Alberta, municipal","48062","Cocaine, production","0","0","0","0","0","0","0","0","0","0","0","0","0","0"
"2007","Medicine Hat, Alberta, municipal","48062","Cocaine, production","0","0","0","0","0","0","0","0","0","0","0","0","0","0"
"2008","Medicine Hat, Alberta, municipal","48062","Cocaine, production","0","0","0","0","0","0","0","0","0","0","0","0","0","0"
"2009","Medicine Hat, Alberta, municipal","48062","Cocaine, production","0","0","0","0","0","0","0","0","0","0","0","0","0","0"
"2010","Medicine Hat, Alberta, municipal","48062","Cocaine, production","0","0","0","0","0","0","0","0","0","0","0","0","0","0"
"2011","Medicine Hat, Alberta, municipal","48062","Cocaine, production","0","0","0","0","0","0","0","0","0","0","0","0","0","0"
"2012","Medicine Hat, Alberta, municipal","48062","Cocaine, production","0","0","0","0","0","0","0","0","0","0","0","0","0","0"
"2013","Medicine Hat, Alberta, municipal","48062","Cocaine, production","0","0","0","0","0","0","0","0","0","0","0","0","0","0"
"2014","Medicine Hat, Alberta, municipal","48062","Cocaine, production","0","0","0","0","0","0","0","0","0","0","0","0","0","0"
"2015","Medicine Hat, Alberta, municipal","48062","Cocaine, production","0","0","0","0","0","0","0","0","0","0","0","0","0","0"
"2016","Medicine Hat, Alberta, municipal","48062","Cocaine, production","0","0","0","0","0","0","0","0","0","0","0","0","0","0"
"1998","Medicine Hat, Alberta, municipal","48062","Total other Controlled Drugs and Substances Act drugs, trafficking, production or distribution","22","22","0","0","44.27","0","0","0","0","22","24","24","0","0"
"1999","Medicine Hat, Alberta, municipal","48062","Total other Controlled Drugs and Substances Act drugs, trafficking, production or distribution","9","7","0","-59.86","17.77","0","0","0","0","7","10","11","1","0"
"2000","Medicine Hat, Alberta, municipal","48062","Total other Controlled Drugs and Substances Act drugs, trafficking, production or distribution","6","6","0","-34.83","11.58","0","0","0","0","6","5","6","1","0"
"2001","Medicine Hat, Alberta, municipal","48062","Total other Controlled Drugs and Substances Act drugs, trafficking, production or distribution","3","1","0","-50.72","5.71","0","0","0","0","1","1","1","0","0"
"2002","Medicine Hat, Alberta, municipal","48062","Total other Controlled Drugs and Substances Act drugs, trafficking, production or distribution","3","3","0","-1.56","5.62","0","0","0","0","3","4","7","3","1"
"2003","Medicine Hat, Alberta, municipal","48062","Total other Controlled Drugs and Substances Act drugs, trafficking, production or distribution","5","3","0","64.26","9.23","0","0","0","0","3","4","4","0","0"
"2004","Medicine Hat, Alberta, municipal","48062","Total other Controlled Drugs and Substances Act drugs, trafficking, production or distribution","2","2","0","-61.19","3.58","2.29","2.08","0","0","2","1","1","0","0"
"2005","Medicine Hat, Alberta, municipal","48062","Total other Controlled Drugs and Substances Act drugs, trafficking, production or distribution","10","10","0","386.42","17.42","15.55","16.15","22.2","22.2","10","7","8","1","1"
"2006","Medicine Hat, Alberta, municipal","48062","Total other Controlled Drugs and Substances Act drugs, trafficking, production or distribution","9","8","0","-12.35","15.27","25.86","23.57","0","0","8","12","12","0","0"
"2007","Medicine Hat, Alberta, municipal","48062","Total other Controlled Drugs and Substances Act drugs, trafficking, production or distribution","7","6","1","-24.04","11.6","16.79","15.35","0","0","7","8","8","0","0"
"2008","Medicine Hat, Alberta, municipal","48062","Total other Controlled Drugs and Substances Act drugs, trafficking, production or distribution","4","4","0","-43.77","6.52","14.43","13.22","0","0","4","7","7","0","0"
"2009","Medicine Hat, Alberta, municipal","48062","Total other Controlled Drugs and Substances Act drugs, trafficking, production or distribution","22","22","0","444.14","35.49","73.3","78.51","137.05","0","22","36","42","6","0"
"2010","Medicine Hat, Alberta, municipal","48062","Total other Controlled Drugs and Substances Act drugs, trafficking, production or distribution","21","14","2","-4.56","33.87","30.55","29.93","22.93","0","16","15","16","1","0"
"2011","Medicine Hat, Alberta, municipal","48062","Total other Controlled Drugs and Substances Act drugs, trafficking, production or distribution","13","11","0","-38.09","20.97","28.5","28.05","22.94","0","11","14","15","1","0"
"2012","Medicine Hat, Alberta, municipal","48062","Total other Controlled Drugs and Substances Act drugs, trafficking, production or distribution","15","13","1","14","23.9","42.21","40.65","22.84","0","14","21","22","1","0"
"2013","Medicine Hat, Alberta, municipal","48062","Total other Controlled Drugs and Substances Act drugs, trafficking, production or distribution","10","7","0","-34.15","15.74","35.71","32.87","0","0","7","18","18","0","0"
"2014","Medicine Hat, Alberta, municipal","48062","Total other Controlled Drugs and Substances Act drugs, trafficking, production or distribution","9","9","0","-10.78","14.04","23.57","21.72","0","0","9","12","12","0","0"
"2015","Medicine Hat, Alberta, municipal","48062","Total other Controlled Drugs and Substances Act drugs, trafficking, production or distribution","33","31","0","263.88","51.1","107.33","98.95","0","0","31","55","55","0","0"
"2016","Medicine Hat, Alberta, municipal","48062","Total other Controlled Drugs and Substances Act drugs, trafficking, production or distribution","48","46","0","44.57","73.88","149.61","141.51","45.86","0","46","77","79","2","0"
"1998","Medicine Hat, Alberta, municipal","48062","Heroin, trafficking","0","0","0","0","0","0","0","0","0","0","0","0","0","0"
"1999","Medicine Hat, Alberta, municipal","48062","Heroin, trafficking","0","0","0","0","0","0","0","0","0","0","0","0","0","0"
"2000","Medicine Hat, Alberta, municipal","48062","Heroin, trafficking","0","0","0","0","0","0","0","0","0","0","0","0","0","0"
"2001","Medicine Hat, Alberta, municipal","48062","Heroin, trafficking","0","0","0","0","0","0","0","0","0","0","0","0","0","0"
"2002","Medicine Hat, Alberta, municipal","48062","Heroin, trafficking","0","0","0","0","0","0","0","0","0","0","0","0","0","0"
"2003","Medicine Hat, Alberta, municipal","48062","Heroin, trafficking","0","0","0","0","0","0","0","0","0","0","0","0","0","0"
"2004","Medicine Hat, Alberta, municipal","48062","Heroin, trafficking","0","0","0","0","0","0","0","0","0","0","0","0","0","0"
"2005","Medicine Hat, Alberta, municipal","48062","Heroin, trafficking","0","0","0","0","0","0","0","0","0","0","0","0","0","0"
"2006","Medicine Hat, Alberta, municipal","48062","Heroin, trafficking","1","1","0","0","1.7","4.31","3.93","0","0","1","2","2","0","0"
"2007","Medicine Hat, Alberta, municipal","48062","Heroin, trafficking","0","0","0","-100","0","0","0","0","0","0","0","0","0","0"
"2008","Medicine Hat, Alberta, municipal","48062","Heroin, trafficking","0","0","0","0","0","0","0","0","0","0","0","0","0","0"
"2009","Medicine Hat, Alberta, municipal","48062","Heroin, trafficking","0","0","0","0","0","0","0","0","0","0","0","0","0","0"
"2010","Medicine Hat, Alberta, municipal","48062","Heroin, trafficking","0","0","0","0","0","0","0","0","0","0","0","0","0","0"
"2011","Medicine Hat, Alberta, municipal","48062","Heroin, trafficking","0","0","0","0","0","0","0","0","0","0","0","0","0","0"
"2012","Medicine Hat, Alberta, municipal","48062","Heroin, trafficking","0","0","0","0","0","0","0","0","0","0","0","0","0","0"
"2013","Medicine Hat, Alberta, municipal","48062","Heroin, trafficking","0","0","0","0","0","0","0","0","0","0","0","0","0","0"
"2014","Medicine Hat, Alberta, municipal","48062","Heroin, trafficking","0","0","0","0","0","0","0","0","0","0","0","0","0","0"
"2015","Medicine Hat, Alberta, municipal","48062","Heroin, trafficking","0","0","0","0","0","0","0","0","0","0","0","0","0","0"
"2016","Medicine Hat, Alberta, municipal","48062","Heroin, trafficking","2","2","0","0","3.08","11.66","10.75","0","0","2","6","6","0","0"
"1998","Medicine Hat, Alberta, municipal","48062","Other Controlled Drugs and Substances Act, trafficking","22","22","0","0","44.27","0","0","0","0","22","24","24","0","0"
"1999","Medicine Hat, Alberta, municipal","48062","Other Controlled Drugs and Substances Act, trafficking","9","7","0","-59.86","17.77","0","0","0","0","7","10","11","1","0"
"2000","Medicine Hat, Alberta, municipal","48062","Other Controlled Drugs and Substances Act, trafficking","6","6","0","-34.83","11.58","0","0","0","0","6","5","6","1","0"
"2001","Medicine Hat, Alberta, municipal","48062","Other Controlled Drugs and Substances Act, trafficking","3","1","0","-50.72","5.71","0","0","0","0","1","1","1","0","0"
"2002","Medicine Hat, Alberta, municipal","48062","Other Controlled Drugs and Substances Act, trafficking","3","3","0","-1.56","5.62","0","0","0","0","3","4","7","3","1"
"2003","Medicine Hat, Alberta, municipal","48062","Other Controlled Drugs and Substances Act, trafficking","5","3","0","64.26","9.23","0","0","0","0","3","4","4","0","0"
"2004","Medicine Hat, Alberta, municipal","48062","Other Controlled Drugs and Substances Act, trafficking","2","2","0","-61.19","3.58","2.29","2.08","0","0","2","1","1","0","0"
"2005","Medicine Hat, Alberta, municipal","48062","Other Controlled Drugs and Substances Act, trafficking","10","10","0","386.42","17.42","15.55","16.15","22.2","22.2","10","7","8","1","1"
"2006","Medicine Hat, Alberta, municipal","48062","Other Controlled Drugs and Substances Act, trafficking","8","7","0","-22.09","13.57","21.55","19.64","0","0","7","10","10","0","0"
"2007","Medicine Hat, Alberta, municipal","48062","Other Controlled Drugs and Substances Act, trafficking","7","6","1","-14.54","11.6","16.79","15.35","0","0","7","8","8","0","0"
"2008","Medicine Hat, Alberta, municipal","48062","Other Controlled Drugs and Substances Act, trafficking","2","2","0","-71.88","3.26","8.25","7.55","0","0","2","4","4","0","0"
"2009","Medicine Hat, Alberta, municipal","48062","Other Controlled Drugs and Substances Act, trafficking","6","6","0","196.8","9.68","14.25","16.82","45.68","0","6","7","9","2","0"
"2010","Medicine Hat, Alberta, municipal","48062","Other Controlled Drugs and Substances Act, trafficking","16","9","2","166.63","25.8","16.29","14.97","0","0","11","8","8","0","0"
"2011","Medicine Hat, Alberta, municipal","48062","Other Controlled Drugs and Substances Act, trafficking","7","6","0","-56.24","11.29","16.29","14.96","0","0","6","8","8","0","0"
"2012","Medicine Hat, Alberta, municipal","48062","Other Controlled Drugs and Substances Act, trafficking","10","10","0","41.15","15.94","28.14","27.71","22.84","0","10","14","15","1","0"
"2013","Medicine Hat, Alberta, municipal","48062","Other Controlled Drugs and Substances Act, trafficking","9","6","0","-11.11","14.17","27.78","25.56","0","0","6","14","14","0","0"
"2014","Medicine Hat, Alberta, municipal","48062","Other Controlled Drugs and Substances Act, trafficking","6","7","0","-33.91","9.36","17.68","16.29","0","0","7","9","9","0","0"
"2015","Medicine Hat, Alberta, municipal","48062","Other Controlled Drugs and Substances Act, trafficking","8","7","0","32.32","12.39","21.47","19.79","0","0","7","11","11","0","0"
"2016","Medicine Hat, Alberta, municipal","48062","Other Controlled Drugs and Substances Act, trafficking","7","7","0","-13.03","10.77","29.15","28.66","22.93","0","7","15","16","1","0"
"2005","Medicine Hat, Alberta, municipal","48062","Methamphetamines (crystal meth), trafficking","0","0","0","0","0","0","0","0","0","0","0","0","0","0"
"2006","Medicine Hat, Alberta, municipal","48062","Methamphetamines (crystal meth), trafficking","0","0","0","0","0","0","0","0","0","0","0","0","0","0"
"2007","Medicine Hat, Alberta, municipal","48062","Methamphetamines (crystal meth), trafficking","0","0","0","0","0","0","0","0","0","0","0","0","0","0"
"2008","Medicine Hat, Alberta, municipal","48062","Methamphetamines (crystal meth), trafficking","1","1","0","0","1.63","4.12","3.78","0","0","1","2","2","0","0"
"2009","Medicine Hat, Alberta, municipal","48062","Methamphetamines (crystal meth), trafficking","0","0","0","-100","0","0","0","0","0","0","0","0","0","0"
"2010","Medicine Hat, Alberta, municipal","48062","Methamphetamines (crystal meth), trafficking","0","0","0","0","0","0","0","0","0","0","0","0","0","0"
"2011","Medicine Hat, Alberta, municipal","48062","Methamphetamines (crystal meth), trafficking","0","0","0","0","0","0","0","0","0","0","0","0","0","0"
"2012","Medicine Hat, Alberta, municipal","48062","Methamphetamines (crystal meth), trafficking","4","3","1","0","6.37","14.07","12.93","0","0","4","7","7","0","0"
"2013","Medicine Hat, Alberta, municipal","48062","Methamphetamines (crystal meth), trafficking","1","1","0","-75.31","1.57","7.94","7.3","0","0","1","4","4","0","0"
"2014","Medicine Hat, Alberta, municipal","48062","Methamphetamines (crystal meth), trafficking","2","2","0","98.28","3.12","5.89","5.43","0","0","2","3","3","0","0"
"2015","Medicine Hat, Alberta, municipal","48062","Methamphetamines (crystal meth), trafficking","25","24","0","1140.51","38.72","85.86","79.16","0","0","24","44","44","0","0"
"2016","Medicine Hat, Alberta, municipal","48062","Methamphetamines (crystal meth), trafficking","39","37","0","55.05","60.03","108.81","102.1","22.93","0","37","56","57","1","0"
"2005","Medicine Hat, Alberta, municipal","48062","Methylenedioxyamphetamine (ecstasy), trafficking","0","0","0","0","0","0","0","0","0","0","0","0","0","0"
"2006","Medicine Hat, Alberta, municipal","48062","Methylenedioxyamphetamine (ecstasy), trafficking","0","0","0","0","0","0","0","0","0","0","0","0","0","0"
"2007","Medicine Hat, Alberta, municipal","48062","Methylenedioxyamphetamine (ecstasy), trafficking","0","0","0","0","0","0","0","0","0","0","0","0","0","0"
"2008","Medicine Hat, Alberta, municipal","48062","Methylenedioxyamphetamine (ecstasy), trafficking","1","1","0","0","1.63","2.06","1.89","0","0","1","1","1","0","0"
"2009","Medicine Hat, Alberta, municipal","48062","Methylenedioxyamphetamine (ecstasy), trafficking","7","7","0","592.54","11.29","20.36","24.3","68.52","0","7","10","13","3","0"
"2010","Medicine Hat, Alberta, municipal","48062","Methylenedioxyamphetamine (ecstasy), trafficking","2","2","0","-71.43","3.23","2.04","1.87","0","0","2","1","1","0","0"
"2011","Medicine Hat, Alberta, municipal","48062","Methylenedioxyamphetamine (ecstasy), trafficking","1","1","0","-49.99","1.61","2.04","1.87","0","0","1","1","1","0","0"
"2012","Medicine Hat, Alberta, municipal","48062","Methylenedioxyamphetamine (ecstasy), trafficking","0","0","0","-100","0","0","0","0","0","0","0","0","0","0"
"2013","Medicine Hat, Alberta, municipal","48062","Methylenedioxyamphetamine (ecstasy), trafficking","0","0","0","0","0","0","0","0","0","0","0","0","0","0"
"2014","Medicine Hat, Alberta, municipal","48062","Methylenedioxyamphetamine (ecstasy), trafficking","0","0","0","0","0","0","0","0","0","0","0","0","0","0"
"2015","Medicine Hat, Alberta, municipal","48062","Methylenedioxyamphetamine (ecstasy), trafficking","0","0","0","0","0","0","0","0","0","0","0","0","0","0"
"2016","Medicine Hat, Alberta, municipal","48062","Methylenedioxyamphetamine (ecstasy), trafficking","0","0","0","0","0","0","0","0","0","0","0","0","0","0"
"1998","Medicine Hat, Alberta, municipal","48062","Heroin, importation and exportation","0","0","0","0","0","0","0","0","0","0","0","0","0","0"
"1999","Medicine Hat, Alberta, municipal","48062","Heroin, importation and exportation","0","0","0","0","0","0","0","0","0","0","0","0","0","0"
"2000","Medicine Hat, Alberta, municipal","48062","Heroin, importation and exportation","0","0","0","0","0","0","0","0","0","0","0","0","0","0"
"2001","Medicine Hat, Alberta, municipal","48062","Heroin, importation and exportation","0","0","0","0","0","0","0","0","0","0","0","0","0","0"
"2002","Medicine Hat, Alberta, municipal","48062","Heroin, importation and exportation","0","0","0","0","0","0","0","0","0","0","0","0","0","0"
"2003","Medicine Hat, Alberta, municipal","48062","Heroin, importation and exportation","0","0","0","0","0","0","0","0","0","0","0","0","0","0"
"2004","Medicine Hat, Alberta, municipal","48062","Heroin, importation and exportation","0","0","0","0","0","0","0","0","0","0","0","0","0","0"
"2005","Medicine Hat, Alberta, municipal","48062","Heroin, importation and exportation","0","0","0","0","0","0","0","0","0","0","0","0","0","0"
"2006","Medicine Hat, Alberta, municipal","48062","Heroin, importation and exportation","0","0","0","0","0","0","0","0","0","0","0","0","0","0"
"2007","Medicine Hat, Alberta, municipal","48062","Heroin, importation and exportation","0","0","0","0","0","0","0","0","0","0","0","0","0","0"
"2008","Medicine Hat, Alberta, municipal","48062","Heroin, importation and exportation","0","0","0","0","0","0","0","0","0","0","0","0","0","0"
"2009","Medicine Hat, Alberta, municipal","48062","Heroin, importation and exportation","0","0","0","0","0","0","0","0","0","0","0","0","0","0"
"2010","Medicine Hat, Alberta, municipal","48062","Heroin, importation and exportation","0","0","0","0","0","0","0","0","0","0","0","0","0","0"
"2011","Medicine Hat, Alberta, municipal","48062","Heroin, importation and exportation","0","0","0","0","0","0","0","0","0","0","0","0","0","0"
"2012","Medicine Hat, Alberta, municipal","48062","Heroin, importation and exportation","0","0","0","0","0","0","0","0","0","0","0","0","0","0"
"2013","Medicine Hat, Alberta, municipal","48062","Heroin, importation and exportation","0","0","0","0","0","0","0","0","0","0","0","0","0","0"
"2014","Medicine Hat, Alberta, municipal","48062","Heroin, importation and exportation","0","0","0","0","0","0","0","0","0","0","0","0","0","0"
"2015","Medicine Hat, Alberta, municipal","48062","Heroin, importation and exportation","0","0","0","0","0","0","0","0","0","0","0","0","0","0"
"2016","Medicine Hat, Alberta, municipal","48062","Heroin, importation and exportation","0","0","0","0","0","0","0","0","0","0","0","0","0","0"
"1998","Medicine Hat, Alberta, municipal","48062","Other Controlled Drugs and Substances Act, importation and exportation","0","0","0","0","0","0","0","0","0","0","0","0","0","0"
"1999","Medicine Hat, Alberta, municipal","48062","Other Controlled Drugs and Substances Act, importation and exportation","0","0","0","0","0","0","0","0","0","0","0","0","0","0"
"2000","Medicine Hat, Alberta, municipal","48062","Other Controlled Drugs and Substances Act, importation and exportation","0","0","0","0","0","0","0","0","0","0","0","0","0","0"
"2001","Medicine Hat, Alberta, municipal","48062","Other Controlled Drugs and Substances Act, importation and exportation","0","0","0","0","0","0","0","0","0","0","0","0","0","0"
"2002","Medicine Hat, Alberta, municipal","48062","Other Controlled Drugs and Substances Act, importation and exportation","0","0","0","0","0","0","0","0","0","0","0","0","0","0"
"2003","Medicine Hat, Alberta, municipal","48062","Other Controlled Drugs and Substances Act, importation and exportation","0","0","0","0","0","0","0","0","0","0","0","0","0","0"
"2004","Medicine Hat, Alberta, municipal","48062","Other Controlled Drugs and Substances Act, importation and exportation","0","0","0","0","0","0","0","0","0","0","0","0","0","0"
"2005","Medicine Hat, Alberta, municipal","48062","Other Controlled Drugs and Substances Act, importation and exportation","0","0","0","0","0","0","0","0","0","0","0","0","0","0"
"2006","Medicine Hat, Alberta, municipal","48062","Other Controlled Drugs and Substances Act, importation and exportation","0","0","0","0","0","0","0","0","0","0","0","0","0","0"
"2007","Medicine Hat, Alberta, municipal","48062","Other Controlled Drugs and Substances Act, importation and exportation","0","0","0","0","0","0","0","0","0","0","0","0","0","0"
"2008","Medicine Hat, Alberta, municipal","48062","Other Controlled Drugs and Substances Act, importation and exportation","0","0","0","0","0","0","0","0","0","0","0","0","0","0"
"2009","Medicine Hat, Alberta, municipal","48062","Other Controlled Drugs and Substances Act, importation and exportation","0","0","0","0","0","0","0","0","0","0","0","0","0","0"
"2010","Medicine Hat, Alberta, municipal","48062","Other Controlled Drugs and Substances Act, importation and exportation","0","0","0","0","0","0","0","0","0","0","0","0","0","0"
"2011","Medicine Hat, Alberta, municipal","48062","Other Controlled Drugs and Substances Act, importation and exportation","0","0","0","0","0","0","0","0","0","0","0","0","0","0"
"2012","Medicine Hat, Alberta, municipal","48062","Other Controlled Drugs and Substances Act, importation and exportation","0","0","0","0","0","0","0","0","0","0","0","0","0","0"
"2013","Medicine Hat, Alberta, municipal","48062","Other Controlled Drugs and Substances Act, importation and exportation","0","0","0","0","0","0","0","0","0","0","0","0","0","0"
"2014","Medicine Hat, Alberta, municipal","48062","Other Controlled Drugs and Substances Act, importation and exportation","1","0","0","0","1.56","0","0","0","0","0","0","0","0","0"
"2015","Medicine Hat, Alberta, municipal","48062","Other Controlled Drugs and Substances Act, importation and exportation","0","0","0","-100","0","0","0","0","0","0","0","0","0","0"
"2016","Medicine Hat, Alberta, municipal","48062","Other Controlled Drugs and Substances Act, importation and exportation","0","0","0","0","0","0","0","0","0","0","0","0","0","0"
"2005","Medicine Hat, Alberta, municipal","48062","Methamphetamines (crystal meth), importation and exportation","0","0","0","0","0","0","0","0","0","0","0","0","0","0"
"2006","Medicine Hat, Alberta, municipal","48062","Methamphetamines (crystal meth), importation and exportation","0","0","0","0","0","0","0","0","0","0","0","0","0","0"
"2007","Medicine Hat, Alberta, municipal","48062","Methamphetamines (crystal meth), importation and exportation","0","0","0","0","0","0","0","0","0","0","0","0","0","0"
"2008","Medicine Hat, Alberta, municipal","48062","Methamphetamines (crystal meth), importation and exportation","0","0","0","0","0","0","0","0","0","0","0","0","0","0"
"2009","Medicine Hat, Alberta, municipal","48062","Methamphetamines (crystal meth), importation and exportation","0","0","0","0","0","0","0","0","0","0","0","0","0","0"
"2010","Medicine Hat, Alberta, municipal","48062","Methamphetamines (crystal meth), importation and exportation","0","0","0","0","0","0","0","0","0","0","0","0","0","0"
"2011","Medicine Hat, Alberta, municipal","48062","Methamphetamines (crystal meth), importation and exportation","0","0","0","0","0","0","0","0","0","0","0","0","0","0"
"2012","Medicine Hat, Alberta, municipal","48062","Methamphetamines (crystal meth), importation and exportation","0","0","0","0","0","0","0","0","0","0","0","0","0","0"
"2013","Medicine Hat, Alberta, municipal","48062","Methamphetamines (crystal meth), importation and exportation","0","0","0","0","0","0","0","0","0","0","0","0","0","0"
"2014","Medicine Hat, Alberta, municipal","48062","Methamphetamines (crystal meth), importation and exportation","0","0","0","0","0","0","0","0","0","0","0","0","0","0"
"2015","Medicine Hat, Alberta, municipal","48062","Methamphetamines (crystal meth), importation and exportation","0","0","0","0","0","0","0","0","0","0","0","0","0","0"
"2016","Medicine Hat, Alberta, municipal","48062","Methamphetamines (crystal meth), importation and exportation","0","0","0","0","0","0","0","0","0","0","0","0","0","0"
"2005","Medicine Hat, Alberta, municipal","48062","Methylenedioxyamphetamine (ecstasy), importation and exportation","0","0","0","0","0","0","0","0","0","0","0","0","0","0"
"2006","Medicine Hat, Alberta, municipal","48062","Methylenedioxyamphetamine (ecstasy), importation and exportation","0","0","0","0","0","0","0","0","0","0","0","0","0","0"
"2007","Medicine Hat, Alberta, municipal","48062","Methylenedioxyamphetamine (ecstasy), importation and exportation","0","0","0","0","0","0","0","0","0","0","0","0","0","0"
"2008","Medicine Hat, Alberta, municipal","48062","Methylenedioxyamphetamine (ecstasy), importation and exportation","0","0","0","0","0","0","0","0","0","0","0","0","0","0"
"2009","Medicine Hat, Alberta, municipal","48062","Methylenedioxyamphetamine (ecstasy), importation and exportation","0","0","0","0","0","0","0","0","0","0","0","0","0","0"
"2010","Medicine Hat, Alberta, municipal","48062","Methylenedioxyamphetamine (ecstasy), importation and exportation","0","0","0","0","0","0","0","0","0","0","0","0","0","0"
"2011","Medicine Hat, Alberta, municipal","48062","Methylenedioxyamphetamine (ecstasy), importation and exportation","0","0","0","0","0","0","0","0","0","0","0","0","0","0"
"2012","Medicine Hat, Alberta, municipal","48062","Methylenedioxyamphetamine (ecstasy), importation and exportation","0","0","0","0","0","0","0","0","0","0","0","0","0","0"
"2013","Medicine Hat, Alberta, municipal","48062","Methylenedioxyamphetamine (ecstasy), importation and exportation","0","0","0","0","0","0","0","0","0","0","0","0","0","0"
"2014","Medicine Hat, Alberta, municipal","48062","Methylenedioxyamphetamine (ecstasy), importation and exportation","0","0","0","0","0","0","0","0","0","0","0","0","0","0"
"2015","Medicine Hat, Alberta, municipal","48062","Methylenedioxyamphetamine (ecstasy), importation and exportation","0","0","0","0","0","0","0","0","0","0","0","0","0","0"
"2016","Medicine Hat, Alberta, municipal","48062","Methylenedioxyamphetamine (ecstasy), importation and exportation","0","0","0","0","0","0","0","0","0","0","0","0","0","0"
"2005","Medicine Hat, Alberta, municipal","48062","Heroin, production","0","0","0","0","0","0","0","0","0","0","0","0","0","0"
"2006","Medicine Hat, Alberta, municipal","48062","Heroin, production","0","0","0","0","0","0","0","0","0","0","0","0","0","0"
"2007","Medicine Hat, Alberta, municipal","48062","Heroin, production","0","0","0","0","0","0","0","0","0","0","0","0","0","0"
"2008","Medicine Hat, Alberta, municipal","48062","Heroin, production","0","0","0","0","0","0","0","0","0","0","0","0","0","0"
"2009","Medicine Hat, Alberta, municipal","48062","Heroin, production","0","0","0","0","0","0","0","0","0","0","0","0","0","0"
"2010","Medicine Hat, Alberta, municipal","48062","Heroin, production","0","0","0","0","0","0","0","0","0","0","0","0","0","0"
"2011","Medicine Hat, Alberta, municipal","48062","Heroin, production","0","0","0","0","0","0","0","0","0","0","0","0","0","0"
"2012","Medicine Hat, Alberta, municipal","48062","Heroin, production","0","0","0","0","0","0","0","0","0","0","0","0","0","0"
"2013","Medicine Hat, Alberta, municipal","48062","Heroin, production","0","0","0","0","0","0","0","0","0","0","0","0","0","0"
"2014","Medicine Hat, Alberta, municipal","48062","Heroin, production","0","0","0","0","0","0","0","0","0","0","0","0","0","0"
"2015","Medicine Hat, Alberta, municipal","48062","Heroin, production","0","0","0","0","0","0","0","0","0","0","0","0","0","0"
"2016","Medicine Hat, Alberta, municipal","48062","Heroin, production","0","0","0","0","0","0","0","0","0","0","0","0","0","0"
"2005","Medicine Hat, Alberta, municipal","48062","Other Controlled Drugs and Substances Act, production","0","0","0","0","0","0","0","0","0","0","0","0","0","0"
"2006","Medicine Hat, Alberta, municipal","48062","Other Controlled Drugs and Substances Act, production","0","0","0","0","0","0","0","0","0","0","0","0","0","0"
"2007","Medicine Hat, Alberta, municipal","48062","Other Controlled Drugs and Substances Act, production","0","0","0","0","0","0","0","0","0","0","0","0","0","0"
"2008","Medicine Hat, Alberta, municipal","48062","Other Controlled Drugs and Substances Act, production","0","0","0","0","0","0","0","0","0","0","0","0","0","0"
"2009","Medicine Hat, Alberta, municipal","48062","Other Controlled Drugs and Substances Act, production","9","9","0","0","14.52","38.68","37.39","22.84","0","9","19","20","1","0"
"2010","Medicine Hat, Alberta, municipal","48062","Other Controlled Drugs and Substances Act, production","3","3","0","-66.67","4.84","12.22","13.09","22.93","0","3","6","7","1","0"
"2011","Medicine Hat, Alberta, municipal","48062","Other Controlled Drugs and Substances Act, production","5","4","0","66.69","8.06","10.18","11.22","22.94","0","4","5","6","1","0"
"2012","Medicine Hat, Alberta, municipal","48062","Other Controlled Drugs and Substances Act, production","1","0","0","-80.24","1.59","0","0","0","0","0","0","0","0","0"
"2013","Medicine Hat, Alberta, municipal","48062","Other Controlled Drugs and Substances Act, production","0","0","0","-100","0","0","0","0","0","0","0","0","0","0"
"2014","Medicine Hat, Alberta, municipal","48062","Other Controlled Drugs and Substances Act, production","0","0","0","0","0","0","0","0","0","0","0","0","0","0"
"2015","Medicine Hat, Alberta, municipal","48062","Other Controlled Drugs and Substances Act, production","0","0","0","0","0","0","0","0","0","0","0","0","0","0"
"2016","Medicine Hat, Alberta, municipal","48062","Other Controlled Drugs and Substances Act, production","0","0","0","0","0","0","0","0","0","0","0","0","0","0"
"2005","Medicine Hat, Alberta, municipal","48062","Methamphetamines (crystal meth), production","0","0","0","0","0","0","0","0","0","0","0","0","0","0"
"2006","Medicine Hat, Alberta, municipal","48062","Methamphetamines (crystal meth), production","0","0","0","0","0","0","0","0","0","0","0","0","0","0"
"2007","Medicine Hat, Alberta, municipal","48062","Methamphetamines (crystal meth), production","0","0","0","0","0","0","0","0","0","0","0","0","0","0"
"2008","Medicine Hat, Alberta, municipal","48062","Methamphetamines (crystal meth), production","0","0","0","0","0","0","0","0","0","0","0","0","0","0"
"2009","Medicine Hat, Alberta, municipal","48062","Methamphetamines (crystal meth), production","0","0","0","0","0","0","0","0","0","0","0","0","0","0"
"2010","Medicine Hat, Alberta, municipal","48062","Methamphetamines (crystal meth), production","0","0","0","0","0","0","0","0","0","0","0","0","0","0"
"2011","Medicine Hat, Alberta, municipal","48062","Methamphetamines (crystal meth), production","0","0","0","0","0","0","0","0","0","0","0","0","0","0"
"2012","Medicine Hat, Alberta, municipal","48062","Methamphetamines (crystal meth), production","0","0","0","0","0","0","0","0","0","0","0","0","0","0"
"2013","Medicine Hat, Alberta, municipal","48062","Methamphetamines (crystal meth), production","0","0","0","0","0","0","0","0","0","0","0","0","0","0"
"2014","Medicine Hat, Alberta, municipal","48062","Methamphetamines (crystal meth), production","0","0","0","0","0","0","0","0","0","0","0","0","0","0"
"2015","Medicine Hat, Alberta, municipal","48062","Methamphetamines (crystal meth), production","0","0","0","0","0","0","0","0","0","0","0","0","0","0"
"2016","Medicine Hat, Alberta, municipal","48062","Methamphetamines (crystal meth), production","0","0","0","0","0","0","0","0","0","0","0","0","0","0"
"2005","Medicine Hat, Alberta, municipal","48062","Methylenedioxyamphetamine (ecstasy), production","0","0","0","0","0","0","0","0","0","0","0","0","0","0"
"2006","Medicine Hat, Alberta, municipal","48062","Methylenedioxyamphetamine (ecstasy), production","0","0","0","0","0","0","0","0","0","0","0","0","0","0"
"2007","Medicine Hat, Alberta, municipal","48062","Methylenedioxyamphetamine (ecstasy), production","0","0","0","0","0","0","0","0","0","0","0","0","0","0"
"2008","Medicine Hat, Alberta, municipal","48062","Methylenedioxyamphetamine (ecstasy), production","0","0","0","0","0","0","0","0","0","0","0","0","0","0"
"2009","Medicine Hat, Alberta, municipal","48062","Methylenedioxyamphetamine (ecstasy), production","0","0","0","0","0","0","0","0","0","0","0","0","0","0"
"2010","Medicine Hat, Alberta, municipal","48062","Methylenedioxyamphetamine (ecstasy), production","0","0","0","0","0","0","0","0","0","0","0","0","0","0"
"2011","Medicine Hat, Alberta, municipal","48062","Methylenedioxyamphetamine (ecstasy), production","0","0","0","0","0","0","0","0","0","0","0","0","0","0"
"2012","Medicine Hat, Alberta, municipal","48062","Methylenedioxyamphetamine (ecstasy), production","0","0","0","0","0","0","0","0","0","0","0","0","0","0"
"2013","Medicine Hat, Alberta, municipal","48062","Methylenedioxyamphetamine (ecstasy), production","0","0","0","0","0","0","0","0","0","0","0","0","0","0"
"2014","Medicine Hat, Alberta, municipal","48062","Methylenedioxyamphetamine (ecstasy), production","0","0","0","0","0","0","0","0","0","0","0","0","0","0"
"2015","Medicine Hat, Alberta, municipal","48062","Methylenedioxyamphetamine (ecstasy), production","0","0","0","0","0","0","0","0","0","0","0","0","0","0"
"2016","Medicine Hat, Alberta, municipal","48062","Methylenedioxyamphetamine (ecstasy), production","0","0","0","0","0","0","0","0","0","0","0","0","0","0"
"2005","Medicine Hat, Alberta, municipal","48062","Precursor or equipment (crystal meth, ecstasy)","0","0","0","0","0","0","0","0","0","0","0","0","0","0"
"2006","Medicine Hat, Alberta, municipal","48062","Precursor or equipment (crystal meth, ecstasy)","0","0","0","0","0","0","0","0","0","0","0","0","0","0"
"2007","Medicine Hat, Alberta, municipal","48062","Precursor or equipment (crystal meth, ecstasy)","0","0","0","0","0","0","0","0","0","0","0","0","0","0"
"2008","Medicine Hat, Alberta, municipal","48062","Precursor or equipment (crystal meth, ecstasy)","0","0","0","0","0","0","0","0","0","0","0","0","0","0"
"2009","Medicine Hat, Alberta, municipal","48062","Precursor or equipment (crystal meth, ecstasy)","0","0","0","0","0","0","0","0","0","0","0","0","0","0"
"2010","Medicine Hat, Alberta, municipal","48062","Precursor or equipment (crystal meth, ecstasy)","0","0","0","0","0","0","0","0","0","0","0","0","0","0"
"2011","Medicine Hat, Alberta, municipal","48062","Precursor or equipment (crystal meth, ecstasy)","0","0","0","0","0","0","0","0","0","0","0","0","0","0"
"2012","Medicine Hat, Alberta, municipal","48062","Precursor or equipment (crystal meth, ecstasy)","0","0","0","0","0","0","0","0","0","0","0","0","0","0"
"2013","Medicine Hat, Alberta, municipal","48062","Precursor or equipment (crystal meth, ecstasy)","0","0","0","0","0","0","0","0","0","0","0","0","0","0"
"2014","Medicine Hat, Alberta, municipal","48062","Precursor or equipment (crystal meth, ecstasy)","0","0","0","0","0","0","0","0","0","0","0","0","0","0"
"2015","Medicine Hat, Alberta, municipal","48062","Precursor or equipment (crystal meth, ecstasy)","0","0","0","0","0","0","0","0","0","0","0","0","0","0"
"2016","Medicine Hat, Alberta, municipal","48062","Precursor or equipment (crystal meth, ecstasy)","0","0","0","0","0","0","0","0","0","0","0","0","0","0"
"1998","Medicine Hat, Alberta, municipal","48062","Youth Criminal Justice Act","150","150","0","0","301.82","0","0","0","0","150","9","167","158","5"
"1999","Medicine Hat, Alberta, municipal","48062","Youth Criminal Justice Act","165","161","1","7.92","325.74","0","0","0","0","162","13","180","167","1"
"2000","Medicine Hat, Alberta, municipal","48062","Youth Criminal Justice Act","112","102","0","-33.64","216.15","0","0","0","0","102","16","107","91","0"
"2001","Medicine Hat, Alberta, municipal","48062","Youth Criminal Justice Act","58","53","0","-48.96","110.32","0","0","0","0","53","16","54","38","1"
"2002","Medicine Hat, Alberta, municipal","48062","Youth Criminal Justice Act","78","78","0","32.38","146.05","0","0","0","0","78","18","79","61","1"
"2003","Medicine Hat, Alberta, municipal","48062","Youth Criminal Justice Act","69","68","1","-12.82","127.33","0","0","0","0","69","16","66","50","1"
"2004","Medicine Hat, Alberta, municipal","48062","Youth Criminal Justice Act","16","17","0","-77.5","28.65","9.16","31.18","247.75","0","17","4","15","11","0"
"2005","Medicine Hat, Alberta, municipal","48062","Youth Criminal Justice Act","24","24","0","45.93","41.81","4.44","52.5","532.86","0","24","2","26","24","0"
"2006","Medicine Hat, Alberta, municipal","48062","Youth Criminal Justice Act","12","11","0","-51.31","20.36","15.08","33.39","222.42","0","11","7","17","10","0"
"2007","Medicine Hat, Alberta, municipal","48062","Youth Criminal Justice Act","12","11","1","-2.34","19.88","0","21.1","244.99","22.27","12","0","11","11","1"
"2008","Medicine Hat, Alberta, municipal","48062","Youth Criminal Justice Act","48","48","0","293.62","78.26","18.56","96.32","943.82","0","48","9","51","42","0"
"2009","Medicine Hat, Alberta, municipal","48062","Youth Criminal Justice Act","48","47","0","-1.07","77.42","16.29","93.47","959.34","0","47","8","50","42","0"
"2010","Medicine Hat, Alberta, municipal","48062","Youth Criminal Justice Act","14","15","0","-70.84","22.58","12.22","29.93","229.25","0","15","6","16","10","0"
"2011","Medicine Hat, Alberta, municipal","48062","Youth Criminal Justice Act","44","43","0","214.33","70.97","18.32","80.41","779.82","0","43","9","43","34","0"
"2012","Medicine Hat, Alberta, municipal","48062","Youth Criminal Justice Act","19","18","1","-57.34","30.28","12.06","35.1","296.87","0","19","6","19","13","0"
"2013","Medicine Hat, Alberta, municipal","48062","Youth Criminal Justice Act","40","39","0","107.93","62.96","11.9","78.52","848.04","0","39","6","43","37","0"
"2014","Medicine Hat, Alberta, municipal","48062","Youth Criminal Justice Act","73","68","1","80.93","113.91","19.64","121.29","1316.4","23.09","69","10","67","57","1"
"2015","Medicine Hat, Alberta, municipal","48062","Youth Criminal Justice Act","47","45","2","-36.11","72.79","13.66","91.75","1014.06","46.09","47","7","51","44","2"
"2016","Medicine Hat, Alberta, municipal","48062","Youth Criminal Justice Act","15","15","0","-68.28","23.09","3.89","25.08","275.17","0","15","2","14","12","0"
"1998","Medicine Hat, Alberta, municipal","48062","Total other Federal Statutes","22","21","4","0","44.27","0","0","0","0","25","6","9","3","0"
"1999","Medicine Hat, Alberta, municipal","48062","Total other Federal Statutes","34","27","4","51.63","67.12","0","0","0","0","31","12","13","1","0"
"2000","Medicine Hat, Alberta, municipal","48062","Total other Federal Statutes","24","18","1","-30.99","46.32","0","0","0","0","19","15","16","1","0"
"2001","Medicine Hat, Alberta, municipal","48062","Total other Federal Statutes","22","21","0","-9.65","41.85","0","0","0","0","21","8","21","13","0"
"2002","Medicine Hat, Alberta, municipal","48062","Total other Federal Statutes","16","13","1","-28.41","29.96","0","0","0","0","14","6","12","6","0"
"2003","Medicine Hat, Alberta, municipal","48062","Total other Federal Statutes","21","15","2","29.35","38.75","0","0","0","0","17","8","13","5","0"
"2004","Medicine Hat, Alberta, municipal","48062","Total other Federal Statutes","20","16","3","-7.59","35.81","25.19","37.41","157.66","0","19","11","18","7","0"
"2005","Medicine Hat, Alberta, municipal","48062","Total other Federal Statutes","10","7","0","-51.36","17.42","13.33","12.12","0","0","7","6","6","0","0"
"2006","Medicine Hat, Alberta, municipal","48062","Total other Federal Statutes","9","7","0","-12.35","15.27","15.08","13.75","0","0","7","7","7","0","0"
"2007","Medicine Hat, Alberta, municipal","48062","Total other Federal Statutes","8","5","1","-13.19","13.25","6.3","9.59","44.54","0","6","3","5","2","0"
"2008","Medicine Hat, Alberta, municipal","48062","Total other Federal Statutes","8","2","5","-1.6","13.04","2.06","3.78","22.47","0","7","1","2","1","0"
"2009","Medicine Hat, Alberta, municipal","48062","Total other Federal Statutes","13","2","4","60.77","20.97","4.07","3.74","0","0","6","2","2","0","0"
"2010","Medicine Hat, Alberta, municipal","48062","Total other Federal Statutes","8","2","4","-38.47","12.9","2.04","3.74","22.93","0","6","1","2","1","0"
"2011","Medicine Hat, Alberta, municipal","48062","Total other Federal Statutes","7","4","6","-12.49","11.29","8.14","11.22","45.87","0","10","4","6","2","0"
"2012","Medicine Hat, Alberta, municipal","48062","Total other Federal Statutes","5","4","0","-29.43","7.97","0","12.93","159.85","0","4","0","7","7","0"
"2013","Medicine Hat, Alberta, municipal","48062","Total other Federal Statutes","4","0","2","-20.98","6.3","0","0","0","0","2","0","0","0","0"
"2014","Medicine Hat, Alberta, municipal","48062","Total other Federal Statutes","5","3","1","23.92","7.8","0","5.43","69.28","0","4","0","3","3","0"
"2015","Medicine Hat, Alberta, municipal","48062","Total other Federal Statutes","11","1","2","118.33","17.03","1.95","1.8","0","0","3","1","1","0","0"
"2016","Medicine Hat, Alberta, municipal","48062","Total other Federal Statutes","4","1","0","-63.86","6.16","0","1.79","22.93","0","1","0","1","1","0"
"1998","Medicine Hat, Alberta, municipal","48062","Bankruptcy Act","0","0","0","0","0","0","0","0","0","0","0","0","0","0"
"1999","Medicine Hat, Alberta, municipal","48062","Bankruptcy Act","0","0","0","0","0","0","0","0","0","0","0","0","0","0"
"2000","Medicine Hat, Alberta, municipal","48062","Bankruptcy Act","0","0","0","0","0","0","0","0","0","0","0","0","0","0"
"2001","Medicine Hat, Alberta, municipal","48062","Bankruptcy Act","0","0","0","0","0","0","0","0","0","0","0","0","0","0"
"2002","Medicine Hat, Alberta, municipal","48062","Bankruptcy Act","0","0","0","0","0","0","0","0","0","0","0","0","0","0"
"2003","Medicine Hat, Alberta, municipal","48062","Bankruptcy Act","0","0","0","0","0","0","0","0","0","0","0","0","0","0"
"2004","Medicine Hat, Alberta, municipal","48062","Bankruptcy Act","0","0","0","0","0","0","0","0","0","0","0","0","0","0"
"2005","Medicine Hat, Alberta, municipal","48062","Bankruptcy Act","0","0","0","0","0","0","0","0","0","0","0","0","0","0"
"2006","Medicine Hat, Alberta, municipal","48062","Bankruptcy Act","0","0","0","0","0","0","0","0","0","0","0","0","0","0"
"2007","Medicine Hat, Alberta, municipal","48062","Bankruptcy Act","0","0","0","0","0","0","0","0","0","0","0","0","0","0"
"2008","Medicine Hat, Alberta, municipal","48062","Bankruptcy Act","0","0","0","0","0","0","0","0","0","0","0","0","0","0"
"2009","Medicine Hat, Alberta, municipal","48062","Bankruptcy Act","0","0","0","0","0","0","0","0","0","0","0","0","0","0"
"2010","Medicine Hat, Alberta, municipal","48062","Bankruptcy Act","0","0","0","0","0","0","0","0","0","0","0","0","0","0"
"2011","Medicine Hat, Alberta, municipal","48062","Bankruptcy Act","0","0","0","0","0","0","0","0","0","0","0","0","0","0"
"2012","Medicine Hat, Alberta, municipal","48062","Bankruptcy Act","0","0","0","0","0","0","0","0","0","0","0","0","0","0"
"2013","Medicine Hat, Alberta, municipal","48062","Bankruptcy Act","0","0","0","0","0","0","0","0","0","0","0","0","0","0"
"2014","Medicine Hat, Alberta, municipal","48062","Bankruptcy Act","0","0","0","0","0","0","0","0","0","0","0","0","0","0"
"2015","Medicine Hat, Alberta, municipal","48062","Bankruptcy Act","0","0","0","0","0","0","0","0","0","0","0","0","0","0"
"2016","Medicine Hat, Alberta, municipal","48062","Bankruptcy Act","0","0","0","0","0","0","0","0","0","0","0","0","0","0"
"1998","Medicine Hat, Alberta, municipal","48062","Income Tax Act","0","0","0","0","0","0","0","0","0","0","0","0","0","0"
"1999","Medicine Hat, Alberta, municipal","48062","Income Tax Act","0","0","0","0","0","0","0","0","0","0","0","0","0","0"
"2000","Medicine Hat, Alberta, municipal","48062","Income Tax Act","0","0","0","0","0","0","0","0","0","0","0","0","0","0"
"2001","Medicine Hat, Alberta, municipal","48062","Income Tax Act","0","0","0","0","0","0","0","0","0","0","0","0","0","0"
"2002","Medicine Hat, Alberta, municipal","48062","Income Tax Act","0","0","0","0","0","0","0","0","0","0","0","0","0","0"
"2003","Medicine Hat, Alberta, municipal","48062","Income Tax Act","0","0","0","0","0","0","0","0","0","0","0","0","0","0"
"2004","Medicine Hat, Alberta, municipal","48062","Income Tax Act","0","0","0","0","0","0","0","0","0","0","0","0","0","0"
"2005","Medicine Hat, Alberta, municipal","48062","Income Tax Act","0","0","0","0","0","0","0","0","0","0","0","0","0","0"
"2006","Medicine Hat, Alberta, municipal","48062","Income Tax Act","0","0","0","0","0","0","0","0","0","0","0","0","0","0"
"2007","Medicine Hat, Alberta, municipal","48062","Income Tax Act","0","0","0","0","0","0","0","0","0","0","0","0","0","0"
"2008","Medicine Hat, Alberta, municipal","48062","Income Tax Act","0","0","0","0","0","0","0","0","0","0","0","0","0","0"
"2009","Medicine Hat, Alberta, municipal","48062","Income Tax Act","0","0","0","0","0","0","0","0","0","0","0","0","0","0"
"2010","Medicine Hat, Alberta, municipal","48062","Income Tax Act","0","0","0","0","0","0","0","0","0","0","0","0","0","0"
"2011","Medicine Hat, Alberta, municipal","48062","Income Tax Act","0","0","0","0","0","0","0","0","0","0","0","0","0","0"
"2012","Medicine Hat, Alberta, municipal","48062","Income Tax Act","0","0","0","0","0","0","0","0","0","0","0","0","0","0"
"2013","Medicine Hat, Alberta, municipal","48062","Income Tax Act","0","0","0","0","0","0","0","0","0","0","0","0","0","0"
"2014","Medicine Hat, Alberta, municipal","48062","Income Tax Act","0","0","0","0","0","0","0","0","0","0","0","0","0","0"
"2015","Medicine Hat, Alberta, municipal","48062","Income Tax Act","0","0","0","0","0","0","0","0","0","0","0","0","0","0"
"2016","Medicine Hat, Alberta, municipal","48062","Income Tax Act","0","0","0","0","0","0","0","0","0","0","0","0","0","0"
"1998","Medicine Hat, Alberta, municipal","48062","Canada Shipping Act","0","0","0","0","0","0","0","0","0","0","0","0","0","0"
"1999","Medicine Hat, Alberta, municipal","48062","Canada Shipping Act","1","1","0","0","1.97","0","0","0","0","1","1","1","0","0"
"2000","Medicine Hat, Alberta, municipal","48062","Canada Shipping Act","0","0","0","-100","0","0","0","0","0","0","0","0","0","0"
"2001","Medicine Hat, Alberta, municipal","48062","Canada Shipping Act","0","0","0","0","0","0","0","0","0","0","0","0","0","0"
"2002","Medicine Hat, Alberta, municipal","48062","Canada Shipping Act","0","0","0","0","0","0","0","0","0","0","0","0","0","0"
"2003","Medicine Hat, Alberta, municipal","48062","Canada Shipping Act","0","0","0","0","0","0","0","0","0","0","0","0","0","0"
"2004","Medicine Hat, Alberta, municipal","48062","Canada Shipping Act","0","0","0","0","0","0","0","0","0","0","0","0","0","0"
"2005","Medicine Hat, Alberta, municipal","48062","Canada Shipping Act","0","0","0","0","0","0","0","0","0","0","0","0","0","0"
"2006","Medicine Hat, Alberta, municipal","48062","Canada Shipping Act","0","0","0","0","0","0","0","0","0","0","0","0","0","0"
"2007","Medicine Hat, Alberta, municipal","48062","Canada Shipping Act","0","0","0","0","0","0","0","0","0","0","0","0","0","0"
"2008","Medicine Hat, Alberta, municipal","48062","Canada Shipping Act","0","0","0","0","0","0","0","0","0","0","0","0","0","0"
"2009","Medicine Hat, Alberta, municipal","48062","Canada Shipping Act","0","0","0","0","0","0","0","0","0","0","0","0","0","0"
"2010","Medicine Hat, Alberta, municipal","48062","Canada Shipping Act","0","0","0","0","0","0","0","0","0","0","0","0","0","0"
"2011","Medicine Hat, Alberta, municipal","48062","Canada Shipping Act","0","0","0","0","0","0","0","0","0","0","0","0","0","0"
"2012","Medicine Hat, Alberta, municipal","48062","Canada Shipping Act","0","0","0","0","0","0","0","0","0","0","0","0","0","0"
"2013","Medicine Hat, Alberta, municipal","48062","Canada Shipping Act","0","0","0","0","0","0","0","0","0","0","0","0","0","0"
"2014","Medicine Hat, Alberta, municipal","48062","Canada Shipping Act","0","0","0","0","0","0","0","0","0","0","0","0","0","0"
"2015","Medicine Hat, Alberta, municipal","48062","Canada Shipping Act","0","0","0","0","0","0","0","0","0","0","0","0","0","0"
"2016","Medicine Hat, Alberta, municipal","48062","Canada Shipping Act","0","0","0","0","0","0","0","0","0","0","0","0","0","0"
"2009","Medicine Hat, Alberta, municipal","48062","Other federal statutes","1","0","0","0","1.61","0","0","0","0","0","0","0","0","0"
"2010","Medicine Hat, Alberta, municipal","48062","Other federal statutes","4","1","1","299.95","6.45","0","1.87","22.93","0","2","0","1","1","0"
"2011","Medicine Hat, Alberta, municipal","48062","Other federal statutes","6","4","1","50.02","9.68","8.14","11.22","45.87","0","5","4","6","2","0"
"2012","Medicine Hat, Alberta, municipal","48062","Other federal statutes","4","4","0","-34.13","6.37","0","12.93","159.85","0","4","0","7","7","0"
"2013","Medicine Hat, Alberta, municipal","48062","Other federal statutes","3","0","2","-25.92","4.72","0","0","0","0","2","0","0","0","0"
"2014","Medicine Hat, Alberta, municipal","48062","Other federal statutes","5","3","1","65.23","7.8","0","5.43","69.28","0","4","0","3","3","0"
"2015","Medicine Hat, Alberta, municipal","48062","Other federal statutes","8","0","0","58.79","12.39","0","0","0","0","0","0","0","0","0"
"2016","Medicine Hat, Alberta, municipal","48062","Other federal statutes","4","1","0","-50.31","6.16","0","1.79","22.93","0","1","0","1","1","0"
"1998","Medicine Hat, Alberta, municipal","48062","Other federal statutes","19","20","0","0","38.23","0","0","0","0","20","5","8","3","0"
"1999","Medicine Hat, Alberta, municipal","48062","Other federal statutes","28","25","0","44.59","55.28","0","0","0","0","25","11","12","1","0"
"2000","Medicine Hat, Alberta, municipal","48062","Other federal statutes","21","16","0","-26.68","40.53","0","0","0","0","16","13","14","1","0"
"2001","Medicine Hat, Alberta, municipal","48062","Other federal statutes","21","21","0","-1.44","39.95","0","0","0","0","21","8","21","13","0"
"2002","Medicine Hat, Alberta, municipal","48062","Other federal statutes","15","13","1","-29.69","28.09","0","0","0","0","14","6","12","6","0"
"2003","Medicine Hat, Alberta, municipal","48062","Other federal statutes","19","15","1","24.84","35.06","0","0","0","0","16","8","13","5","0"
"2004","Medicine Hat, Alberta, municipal","48062","Other federal statutes","18","16","2","-8.07","32.23","25.19","37.41","157.66","0","18","11","18","7","0"
"2005","Medicine Hat, Alberta, municipal","48062","Other federal statutes","8","7","0","-56.76","13.94","13.33","12.12","0","0","7","6","6","0","0"
"2006","Medicine Hat, Alberta, municipal","48062","Other federal statutes","6","5","0","-26.96","10.18","10.77","9.82","0","0","5","5","5","0","0"
"2007","Medicine Hat, Alberta, municipal","48062","Other federal statutes","6","4","1","-2.34","9.94","2.1","5.75","44.54","0","5","1","3","2","0"
"2008","Medicine Hat, Alberta, municipal","48062","Other federal statutes","0","1","0","-100","0","0","1.89","22.47","0","1","0","1","1","0"
"","","","","0","0","0","0","0","0","0","0","0","0","0","0","0","0"
"1998","Medicine Hat, Alberta, municipal","48062","Canada Health Act","0","0","0","0","0","0","0","0","0","0","0","0","0","0"
"1999","Medicine Hat, Alberta, municipal","48062","Canada Health Act","1","1","0","0","1.97","0","0","0","0","1","0","0","0","0"
"2000","Medicine Hat, Alberta, municipal","48062","Canada Health Act","0","0","0","-100","0","0","0","0","0","0","0","0","0","0"
"2001","Medicine Hat, Alberta, municipal","48062","Canada Health Act","0","0","0","0","0","0","0","0","0","0","0","0","0","0"
"2002","Medicine Hat, Alberta, municipal","48062","Canada Health Act","0","0","0","0","0","0","0","0","0","0","0","0","0","0"
"2003","Medicine Hat, Alberta, municipal","48062","Canada Health Act","1","0","0","0","1.85","0","0","0","0","0","0","0","0","0"
"2004","Medicine Hat, Alberta, municipal","48062","Canada Health Act","1","0","1","-2.97","1.79","0","0","0","0","1","0","0","0","0"
"2005","Medicine Hat, Alberta, municipal","48062","Canada Health Act","0","0","0","-100","0","0","0","0","0","0","0","0","0","0"
"2006","Medicine Hat, Alberta, municipal","48062","Canada Health Act","2","2","0","0","3.39","4.31","3.93","0","0","2","2","2","0","0"
"2007","Medicine Hat, Alberta, municipal","48062","Canada Health Act","0","0","0","-100","0","0","0","0","0","0","0","0","0","0"
"2008","Medicine Hat, Alberta, municipal","48062","Canada Health Act","0","0","0","0","0","0","0","0","0","0","0","0","0","0"
"2009","Medicine Hat, Alberta, municipal","48062","Canada Health Act","0","0","0","0","0","0","0","0","0","0","0","0","0","0"
"2010","Medicine Hat, Alberta, municipal","48062","Canada Health Act","0","0","0","0","0","0","0","0","0","0","0","0","0","0"
"2011","Medicine Hat, Alberta, municipal","48062","Canada Health Act","1","0","0","0","1.61","0","0","0","0","0","0","0","0","0"
"2012","Medicine Hat, Alberta, municipal","48062","Canada Health Act","0","0","0","-100","0","0","0","0","0","0","0","0","0","0"
"2013","Medicine Hat, Alberta, municipal","48062","Canada Health Act","1","0","0","0","1.57","0","0","0","0","0","0","0","0","0"
"2014","Medicine Hat, Alberta, municipal","48062","Canada Health Act","0","0","0","-100","0","0","0","0","0","0","0","0","0","0"
"2015","Medicine Hat, Alberta, municipal","48062","Canada Health Act","0","0","0","0","0","0","0","0","0","0","0","0","0","0"
"2016","Medicine Hat, Alberta, municipal","48062","Canada Health Act","0","0","0","0","0","0","0","0","0","0","0","0","0","0"
"1998","Medicine Hat, Alberta, municipal","48062","Customs Act","2","0","2","0","4.02","0","0","0","0","2","0","0","0","0"
"1999","Medicine Hat, Alberta, municipal","48062","Customs Act","0","0","0","-100","0","0","0","0","0","0","0","0","0","0"
"2000","Medicine Hat, Alberta, municipal","48062","Customs Act","0","0","0","0","0","0","0","0","0","0","0","0","0","0"
"2001","Medicine Hat, Alberta, municipal","48062","Customs Act","0","0","0","0","0","0","0","0","0","0","0","0","0","0"
"2002","Medicine Hat, Alberta, municipal","48062","Customs Act","0","0","0","0","0","0","0","0","0","0","0","0","0","0"
"2003","Medicine Hat, Alberta, municipal","48062","Customs Act","0","0","0","0","0","0","0","0","0","0","0","0","0","0"
"2004","Medicine Hat, Alberta, municipal","48062","Customs Act","0","0","0","0","0","0","0","0","0","0","0","0","0","0"
"2005","Medicine Hat, Alberta, municipal","48062","Customs Act","0","0","0","0","0","0","0","0","0","0","0","0","0","0"
"2006","Medicine Hat, Alberta, municipal","48062","Customs Act","0","0","0","0","0","0","0","0","0","0","0","0","0","0"
"2007","Medicine Hat, Alberta, municipal","48062","Customs Act","0","0","0","0","0","0","0","0","0","0","0","0","0","0"
"2008","Medicine Hat, Alberta, municipal","48062","Customs Act","0","0","0","0","0","0","0","0","0","0","0","0","0","0"
"2009","Medicine Hat, Alberta, municipal","48062","Customs Act","0","0","0","0","0","0","0","0","0","0","0","0","0","0"
"2010","Medicine Hat, Alberta, municipal","48062","Customs Act","0","0","0","0","0","0","0","0","0","0","0","0","0","0"
"2011","Medicine Hat, Alberta, municipal","48062","Customs Act","0","0","0","0","0","0","0","0","0","0","0","0","0","0"
"2012","Medicine Hat, Alberta, municipal","48062","Customs Act","0","0","0","0","0","0","0","0","0","0","0","0","0","0"
"2013","Medicine Hat, Alberta, municipal","48062","Customs Act","0","0","0","0","0","0","0","0","0","0","0","0","0","0"
"2014","Medicine Hat, Alberta, municipal","48062","Customs Act","0","0","0","0","0","0","0","0","0","0","0","0","0","0"
"2015","Medicine Hat, Alberta, municipal","48062","Customs Act","1","0","1","0","1.55","0","0","0","0","1","0","0","0","0"
"2016","Medicine Hat, Alberta, municipal","48062","Customs Act","0","0","0","-100","0","0","0","0","0","0","0","0","0","0"
"1998","Medicine Hat, Alberta, municipal","48062","Competition Act","0","0","0","0","0","0","0","0","0","0","0","0","0","0"
"1999","Medicine Hat, Alberta, municipal","48062","Competition Act","0","0","0","0","0","0","0","0","0","0","0","0","0","0"
"2000","Medicine Hat, Alberta, municipal","48062","Competition Act","0","0","0","0","0","0","0","0","0","0","0","0","0","0"
"2001","Medicine Hat, Alberta, municipal","48062","Competition Act","0","0","0","0","0","0","0","0","0","0","0","0","0","0"
"2002","Medicine Hat, Alberta, municipal","48062","Competition Act","0","0","0","0","0","0","0","0","0","0","0","0","0","0"
"2003","Medicine Hat, Alberta, municipal","48062","Competition Act","0","0","0","0","0","0","0","0","0","0","0","0","0","0"
"2004","Medicine Hat, Alberta, municipal","48062","Competition Act","0","0","0","0","0","0","0","0","0","0","0","0","0","0"
"2005","Medicine Hat, Alberta, municipal","48062","Competition Act","0","0","0","0","0","0","0","0","0","0","0","0","0","0"
"2006","Medicine Hat, Alberta, municipal","48062","Competition Act","0","0","0","0","0","0","0","0","0","0","0","0","0","0"
"2007","Medicine Hat, Alberta, municipal","48062","Competition Act","0","0","0","0","0","0","0","0","0","0","0","0","0","0"
"2008","Medicine Hat, Alberta, municipal","48062","Competition Act","0","0","0","0","0","0","0","0","0","0","0","0","0","0"
"2009","Medicine Hat, Alberta, municipal","48062","Competition Act","0","0","0","0","0","0","0","0","0","0","0","0","0","0"
"2010","Medicine Hat, Alberta, municipal","48062","Competition Act","0","0","0","0","0","0","0","0","0","0","0","0","0","0"
"2011","Medicine Hat, Alberta, municipal","48062","Competition Act","0","0","0","0","0","0","0","0","0","0","0","0","0","0"
"2012","Medicine Hat, Alberta, municipal","48062","Competition Act","0","0","0","0","0","0","0","0","0","0","0","0","0","0"
"2013","Medicine Hat, Alberta, municipal","48062","Competition Act","0","0","0","0","0","0","0","0","0","0","0","0","0","0"
"2014","Medicine Hat, Alberta, municipal","48062","Competition Act","0","0","0","0","0","0","0","0","0","0","0","0","0","0"
"2015","Medicine Hat, Alberta, municipal","48062","Competition Act","0","0","0","0","0","0","0","0","0","0","0","0","0","0"
"2016","Medicine Hat, Alberta, municipal","48062","Competition Act","0","0","0","0","0","0","0","0","0","0","0","0","0","0"
"1998","Medicine Hat, Alberta, municipal","48062","Excise Act","1","0","1","0","2.01","0","0","0","0","1","0","0","0","0"
"1999","Medicine Hat, Alberta, municipal","48062","Excise Act","0","0","0","-100","0","0","0","0","0","0","0","0","0","0"
"2000","Medicine Hat, Alberta, municipal","48062","Excise Act","0","0","0","0","0","0","0","0","0","0","0","0","0","0"
"2001","Medicine Hat, Alberta, municipal","48062","Excise Act","0","0","0","0","0","0","0","0","0","0","0","0","0","0"
"2002","Medicine Hat, Alberta, municipal","48062","Excise Act","0","0","0","0","0","0","0","0","0","0","0","0","0","0"
"2003","Medicine Hat, Alberta, municipal","48062","Excise Act","0","0","0","0","0","0","0","0","0","0","0","0","0","0"
"2004","Medicine Hat, Alberta, municipal","48062","Excise Act","1","0","0","0","1.79","0","0","0","0","0","0","0","0","0"
"2005","Medicine Hat, Alberta, municipal","48062","Excise Act","0","0","0","-100","0","0","0","0","0","0","0","0","0","0"
"2006","Medicine Hat, Alberta, municipal","48062","Excise Act","0","0","0","0","0","0","0","0","0","0","0","0","0","0"
"2007","Medicine Hat, Alberta, municipal","48062","Excise Act","1","1","0","0","1.66","4.2","3.84","0","0","1","2","2","0","0"
"2008","Medicine Hat, Alberta, municipal","48062","Excise Act","7","1","5","588.83","11.41","2.06","1.89","0","0","6","1","1","0","0"
"2009","Medicine Hat, Alberta, municipal","48062","Excise Act","11","1","4","55.47","17.74","2.04","1.87","0","0","5","1","1","0","0"
"2010","Medicine Hat, Alberta, municipal","48062","Excise Act","3","0","3","-72.73","4.84","0","0","0","0","3","0","0","0","0"
"2011","Medicine Hat, Alberta, municipal","48062","Excise Act","0","0","5","-100","0","0","0","0","0","5","0","0","0","0"
"2012","Medicine Hat, Alberta, municipal","48062","Excise Act","0","0","0","0","0","0","0","0","0","0","0","0","0","0"
"2013","Medicine Hat, Alberta, municipal","48062","Excise Act","0","0","0","0","0","0","0","0","0","0","0","0","0","0"
"2014","Medicine Hat, Alberta, municipal","48062","Excise Act","0","0","0","0","0","0","0","0","0","0","0","0","0","0"
"2015","Medicine Hat, Alberta, municipal","48062","Excise Act","0","0","0","0","0","0","0","0","0","0","0","0","0","0"
"2016","Medicine Hat, Alberta, municipal","48062","Excise Act","0","0","0","0","0","0","0","0","0","0","0","0","0","0"
"1998","Medicine Hat, Alberta, municipal","48062","Total Immigration and Refugee Protection Act","0","1","1","0","0","0","0","0","0","2","1","1","0","0"
"1999","Medicine Hat, Alberta, municipal","48062","Total Immigration and Refugee Protection Act","4","0","4","0","7.9","0","0","0","0","4","0","0","0","0"
"2000","Medicine Hat, Alberta, municipal","48062","Total Immigration and Refugee Protection Act","1","0","1","-75.56","1.93","0","0","0","0","1","0","0","0","0"
"2001","Medicine Hat, Alberta, municipal","48062","Total Immigration and Refugee Protection Act","0","0","0","-100","0","0","0","0","0","0","0","0","0","0"
"2002","Medicine Hat, Alberta, municipal","48062","Total Immigration and Refugee Protection Act","1","0","0","0","1.87","0","0","0","0","0","0","0","0","0"
"2003","Medicine Hat, Alberta, municipal","48062","Total Immigration and Refugee Protection Act","1","0","1","-1.44","1.85","0","0","0","0","1","0","0","0","0"
"2004","Medicine Hat, Alberta, municipal","48062","Total Immigration and Refugee Protection Act","0","0","0","-100","0","0","0","0","0","0","0","0","0","0"
"2005","Medicine Hat, Alberta, municipal","48062","Total Immigration and Refugee Protection Act","2","0","0","0","3.48","0","0","0","0","0","0","0","0","0"
"2006","Medicine Hat, Alberta, municipal","48062","Total Immigration and Refugee Protection Act","1","0","0","-51.31","1.7","0","0","0","0","0","0","0","0","0"
"2007","Medicine Hat, Alberta, municipal","48062","Total Immigration and Refugee Protection Act","0","0","0","-100","0","0","0","0","0","0","0","0","0","0"
"2008","Medicine Hat, Alberta, municipal","48062","Total Immigration and Refugee Protection Act","1","0","0","0","1.63","0","0","0","0","0","0","0","0","0"
"2009","Medicine Hat, Alberta, municipal","48062","Total Immigration and Refugee Protection Act","0","0","0","-100","0","0","0","0","0","0","0","0","0","0"
"2010","Medicine Hat, Alberta, municipal","48062","Total Immigration and Refugee Protection Act","0","0","0","0","0","0","0","0","0","0","0","0","0","0"
"2011","Medicine Hat, Alberta, municipal","48062","Total Immigration and Refugee Protection Act","0","0","0","0","0","0","0","0","0","0","0","0","0","0"
"2012","Medicine Hat, Alberta, municipal","48062","Total Immigration and Refugee Protection Act","1","0","0","0","1.59","0","0","0","0","0","0","0","0","0"
"2013","Medicine Hat, Alberta, municipal","48062","Total Immigration and Refugee Protection Act","0","0","0","-100","0","0","0","0","0","0","0","0","0","0"
"2014","Medicine Hat, Alberta, municipal","48062","Total Immigration and Refugee Protection Act","0","0","0","0","0","0","0","0","0","0","0","0","0","0"
"2015","Medicine Hat, Alberta, municipal","48062","Total Immigration and Refugee Protection Act","2","1","1","0","3.1","1.95","1.8","0","0","2","1","1","0","0"
"2016","Medicine Hat, Alberta, municipal","48062","Total Immigration and Refugee Protection Act","0","0","0","-100","0","0","0","0","0","0","0","0","0","0"
"1998","Medicine Hat, Alberta, municipal","48062","Firearms Act","0","0","0","0","0","0","0","0","0","0","0","0","0","0"
"1999","Medicine Hat, Alberta, municipal","48062","Firearms Act","0","0","0","0","0","0","0","0","0","0","0","0","0","0"
"2000","Medicine Hat, Alberta, municipal","48062","Firearms Act","2","2","0","0","3.86","0","0","0","0","2","2","2","0","0"
"2001","Medicine Hat, Alberta, municipal","48062","Firearms Act","1","0","0","-50.72","1.9","0","0","0","0","0","0","0","0","0"
"2002","Medicine Hat, Alberta, municipal","48062","Firearms Act","0","0","0","-100","0","0","0","0","0","0","0","0","0","0"
"2003","Medicine Hat, Alberta, municipal","48062","Firearms Act","0","0","0","0","0","0","0","0","0","0","0","0","0","0"
"2004","Medicine Hat, Alberta, municipal","48062","Firearms Act","0","0","0","0","0","0","0","0","0","0","0","0","0","0"
"2005","Medicine Hat, Alberta, municipal","48062","Firearms Act","0","0","0","0","0","0","0","0","0","0","0","0","0","0"
"2006","Medicine Hat, Alberta, municipal","48062","Firearms Act","0","0","0","0","0","0","0","0","0","0","0","0","0","0"
"2007","Medicine Hat, Alberta, municipal","48062","Firearms Act","1","0","0","0","1.66","0","0","0","0","0","0","0","0","0"
"2008","Medicine Hat, Alberta, municipal","48062","Firearms Act","0","0","0","-100","0","0","0","0","0","0","0","0","0","0"
"2009","Medicine Hat, Alberta, municipal","48062","Firearms Act","1","1","0","0","1.61","2.04","1.87","0","0","1","1","1","0","0"
"2010","Medicine Hat, Alberta, municipal","48062","Firearms Act","1","1","0","-0.01","1.61","2.04","1.87","0","0","1","1","1","0","0"
"2011","Medicine Hat, Alberta, municipal","48062","Firearms Act","0","0","0","-100","0","0","0","0","0","0","0","0","0","0"
"2012","Medicine Hat, Alberta, municipal","48062","Firearms Act","0","0","0","0","0","0","0","0","0","0","0","0","0","0"
"2013","Medicine Hat, Alberta, municipal","48062","Firearms Act","0","0","0","0","0","0","0","0","0","0","0","0","0","0"
"2014","Medicine Hat, Alberta, municipal","48062","Firearms Act","0","0","0","0","0","0","0","0","0","0","0","0","0","0"
"2015","Medicine Hat, Alberta, municipal","48062","Firearms Act","0","0","0","0","0","0","0","0","0","0","0","0","0","0"
"2016","Medicine Hat, Alberta, municipal","48062","Firearms Act","0","0","0","0","0","0","0","0","0","0","0","0","0","0"
"2002","Medicine Hat, Alberta, municipal","48062","National Defence Act","0","0","0","0","0","0","0","0","0","0","0","0","0","0"
"2003","Medicine Hat, Alberta, municipal","48062","National Defence Act","0","0","0","0","0","0","0","0","0","0","0","0","0","0"
"2004","Medicine Hat, Alberta, municipal","48062","National Defence Act","0","0","0","0","0","0","0","0","0","0","0","0","0","0"
"2005","Medicine Hat, Alberta, municipal","48062","National Defence Act","0","0","0","0","0","0","0","0","0","0","0","0","0","0"
"2006","Medicine Hat, Alberta, municipal","48062","National Defence Act","0","0","0","0","0","0","0","0","0","0","0","0","0","0"
"2007","Medicine Hat, Alberta, municipal","48062","National Defence Act","0","0","0","0","0","0","0","0","0","0","0","0","0","0"
"2008","Medicine Hat, Alberta, municipal","48062","National Defence Act","0","0","0","0","0","0","0","0","0","0","0","0","0","0"
"2009","Medicine Hat, Alberta, municipal","48062","National Defence Act","0","0","0","0","0","0","0","0","0","0","0","0","0","0"
"2010","Medicine Hat, Alberta, municipal","48062","National Defence Act","0","0","0","0","0","0","0","0","0","0","0","0","0","0"
"2011","Medicine Hat, Alberta, municipal","48062","National Defence Act","0","0","0","0","0","0","0","0","0","0","0","0","0","0"
"2012","Medicine Hat, Alberta, municipal","48062","National Defence Act","0","0","0","0","0","0","0","0","0","0","0","0","0","0"
"2013","Medicine Hat, Alberta, municipal","48062","National Defence Act","0","0","0","0","0","0","0","0","0","0","0","0","0","0"
"2014","Medicine Hat, Alberta, municipal","48062","National Defence Act","0","0","0","0","0","0","0","0","0","0","0","0","0","0"
"2015","Medicine Hat, Alberta, municipal","48062","National Defence Act","0","0","0","0","0","0","0","0","0","0","0","0","0","0"
"2016","Medicine Hat, Alberta, municipal","48062","National Defence Act","0","0","0","0","0","0","0","0","0","0","0","0","0","0"
